datetime,D21Z,D22Z,D41Z,D42Z,Total
2024-03-01 01:00:00,4,1,2,1,8
2024-03-01 01:10:00,5,1,1,0,7
2024-03-01 01:20:00,10,3,1,0,14
2024-03-01 01:30:00,9,2,3,0,14
2024-03-01 01:40:00,4,1,4,3,12
2024-03-01 01:50:00,2,0,0,0,2
2024-03-01 02:00:00,10,1,1,0,12
2024-03-01 02:10:00,2,0,2,3,7
2024-03-01 02:20:00,1,0,0,0,1
2024-03-01 02:30:00,1,1,1,0,3
2024-03-01 02:40:00,7,0,4,1,12
2024-03-01 02:50:00,6,1,2,1,10
2024-03-01 03:00:00,7,1,0,0,8
2024-03-01 03:10:00,5,0,1,0,6
2024-03-01 03:20:00,10,2,1,1,14
2024-03-01 03:30:00,8,1,3,0,12
2024-03-01 03:40:00,3,0,1,2,6
2024-03-01 03:50:00,7,2,2,1,12
2024-03-01 04:00:00,5,3,1,0,9
2024-03-01 04:10:00,4,0,1,0,5
2024-03-01 04:20:00,8,1,2,0,11
2024-03-01 04:30:00,6,3,2,1,12
2024-03-01 04:40:00,12,6,4,1,23
2024-03-01 04:50:00,11,1,3,2,17
2024-03-01 05:00:00,13,3,3,1,20
2024-03-01 05:10:00,15,3,5,4,27
2024-03-01 05:20:00,23,9,7,4,43
2024-03-01 05:30:00,25,13,14,5,57
2024-03-01 05:40:00,35,14,15,8,72
2024-03-01 05:50:00,31,11,13,8,63
2024-03-01 06:00:00,41,12,20,11,84
2024-03-01 06:10:00,43,12,20,10,85
2024-03-01 06:20:00,46,12,17,9,84
2024-03-01 06:30:00,46,23,26,26,121
2024-03-01 06:40:00,64,24,28,13,129
2024-03-01 06:50:00,46,18,24,25,113
2024-03-01 07:00:00,51,22,32,24,129
2024-03-01 07:10:00,67,23,41,25,156
2024-03-01 07:20:00,67,27,40,35,169
2024-03-01 07:30:00,70,35,49,42,196
2024-03-01 07:40:00,77,41,48,54,220
2024-03-01 07:50:00,68,36,52,38,194
2024-03-01 08:00:00,68,34,54,40,196
2024-03-01 08:10:00,73,33,54,35,195
2024-03-01 08:20:00,64,34,45,37,180
2024-03-01 08:30:00,51,19,46,36,152
2024-03-01 08:40:00,68,38,52,33,191
2024-03-01 08:50:00,70,24,41,34,169
2024-03-01 09:00:00,59,28,39,31,157
2024-03-01 09:10:00,67,26,40,25,158
2024-03-01 09:20:00,55,29,37,34,155
2024-03-01 09:30:00,63,24,41,28,156
2024-03-01 09:40:00,60,30,52,33,175
2024-03-01 09:50:00,51,21,54,29,155
2024-03-01 10:00:00,55,18,54,25,152
2024-03-01 10:10:00,47,15,56,32,150
2024-03-01 10:20:00,45,24,48,26,143
2024-03-01 10:30:00,67,28,42,27,164
2024-03-01 10:40:00,57,19,42,35,153
2024-03-01 10:50:00,55,26,41,27,149
2024-03-01 11:00:00,66,24,50,26,166
2024-03-01 11:10:00,72,26,49,35,182
2024-03-01 11:20:00,60,23,31,27,141
2024-03-01 11:30:00,85,45,32,25,187
2024-03-01 11:40:00,75,30,46,30,181
2024-03-01 11:50:00,72,33,36,22,163
2024-03-01 12:00:00,80,37,42,28,187
2024-03-01 12:10:00,78,43,33,17,171
2024-03-01 12:20:00,69,28,52,33,182
2024-03-01 12:30:00,69,37,37,17,160
2024-03-01 12:40:00,74,37,38,31,180
2024-03-01 12:50:00,78,30,36,35,179
2024-03-01 13:00:00,65,44,51,37,197
2024-03-01 13:10:00,91,56,35,41,223
2024-03-01 13:20:00,84,43,40,27,194
2024-03-01 13:30:00,73,39,41,34,187
2024-03-01 13:40:00,78,43,45,25,191
2024-03-01 13:50:00,62,28,59,31,180
2024-03-01 14:00:00,74,31,49,15,169
2024-03-01 14:10:00,82,40,57,33,212
2024-03-01 14:20:00,82,42,53,33,210
2024-03-01 14:30:00,69,38,45,38,190
2024-03-01 14:40:00,79,45,57,36,217
2024-03-01 14:50:00,66,42,43,28,179
2024-03-01 15:00:00,81,40,49,31,201
2024-03-01 15:10:00,70,46,54,36,206
2024-03-01 15:20:00,82,39,64,39,224
2024-03-01 15:30:00,52,37,53,37,179
2024-03-01 15:40:00,83,47,51,26,207
2024-03-01 15:50:00,88,37,45,32,202
2024-03-01 16:00:00,77,36,38,35,186
2024-03-01 16:10:00,79,37,44,39,199
2024-03-01 16:20:00,79,46,48,23,196
2024-03-01 16:30:00,84,47,41,27,199
2024-03-01 16:40:00,79,44,41,31,195
2024-03-01 16:50:00,74,29,43,22,168
2024-03-01 17:00:00,68,21,46,28,163
2024-03-01 17:10:00,58,36,44,30,168
2024-03-01 17:20:00,84,27,40,24,175
2024-03-01 17:30:00,78,32,56,25,191
2024-03-01 17:40:00,84,35,53,34,206
2024-03-01 17:50:00,69,29,38,24,160
2024-03-01 18:00:00,63,22,39,36,160
2024-03-01 18:10:00,77,42,39,31,189
2024-03-01 18:20:00,83,34,38,18,173
2024-03-01 18:30:00,72,38,44,24,178
2024-03-01 18:40:00,64,29,44,21,158
2024-03-01 18:50:00,77,30,35,23,165
2024-03-01 19:00:00,73,22,47,27,169
2024-03-01 19:10:00,79,38,49,23,189
2024-03-01 19:20:00,66,26,40,22,154
2024-03-01 19:30:00,49,24,36,18,127
2024-03-01 19:40:00,65,30,34,18,147
2024-03-01 19:50:00,59,31,39,19,148
2024-03-01 20:00:00,36,14,37,14,101
2024-03-01 20:10:00,70,23,27,13,133
2024-03-01 20:20:00,54,19,16,11,100
2024-03-01 20:30:00,50,18,28,10,106
2024-03-01 20:40:00,50,16,24,12,102
2024-03-01 20:50:00,52,14,28,13,107
2024-03-01 21:00:00,34,13,25,10,82
2024-03-01 21:10:00,31,9,14,13,67
2024-03-01 21:20:00,48,9,28,18,103
2024-03-01 21:30:00,42,14,19,12,87
2024-03-01 21:40:00,45,13,15,9,82
2024-03-01 21:50:00,41,11,21,6,79
2024-03-01 22:00:00,52,10,12,5,79
2024-03-01 22:10:00,47,15,15,13,90
2024-03-01 22:20:00,39,22,16,10,87
2024-03-01 22:30:00,34,14,15,11,74
2024-03-01 22:40:00,43,14,20,7,84
2024-03-01 22:50:00,44,23,12,9,88
2024-03-01 23:00:00,42,20,15,5,82
2024-03-01 23:10:00,49,22,15,5,91
2024-03-01 23:20:00,36,14,14,3,67
2024-03-01 23:30:00,37,9,14,6,66
2024-03-01 23:40:00,37,7,15,4,63
2024-03-01 23:50:00,21,7,6,5,39
2024-03-02 00:00:00,25,10,10,5,50
2024-03-02 00:10:00,27,10,13,3,53
2024-03-02 00:20:00,30,5,10,3,48
2024-03-02 00:30:00,20,7,4,4,35
2024-03-02 00:40:00,20,6,3,3,32
2024-03-02 00:50:00,18,4,4,1,27
2024-03-02 01:00:00,20,11,5,1,37
2024-03-02 01:10:00,10,4,4,3,21
2024-03-02 01:20:00,10,3,5,3,21
2024-03-02 01:30:00,16,3,5,2,26
2024-03-02 01:40:00,17,4,10,0,31
2024-03-02 01:50:00,9,3,5,0,17
2024-03-02 02:00:00,7,1,8,4,20
2024-03-02 02:10:00,8,2,3,1,14
2024-03-02 02:20:00,6,1,3,3,13
2024-03-02 02:30:00,10,2,1,1,14
2024-03-02 02:40:00,10,6,3,1,20
2024-03-02 02:50:00,10,4,2,0,16
2024-03-02 03:00:00,5,4,1,0,10
2024-03-02 03:10:00,7,2,4,6,19
2024-03-02 03:20:00,8,3,3,1,15
2024-03-02 03:30:00,3,0,1,0,4
2024-03-02 03:40:00,3,0,2,0,5
2024-03-02 03:50:00,8,1,4,0,13
2024-03-02 04:00:00,6,2,1,0,9
2024-03-02 04:10:00,5,1,2,1,9
2024-03-02 04:20:00,7,0,2,1,10
2024-03-02 04:30:00,15,5,1,1,22
2024-03-02 04:40:00,9,3,4,2,18
2024-03-02 04:50:00,13,3,6,3,25
2024-03-02 05:00:00,8,2,3,1,14
2024-03-02 05:10:00,8,0,4,5,17
2024-03-02 05:20:00,11,3,9,3,26
2024-03-02 05:30:00,14,5,8,4,31
2024-03-02 05:40:00,18,5,7,2,32
2024-03-02 05:50:00,9,3,8,3,23
2024-03-02 06:00:00,14,2,6,5,27
2024-03-02 06:10:00,12,3,4,3,22
2024-03-02 06:20:00,19,7,3,3,32
2024-03-02 06:30:00,17,5,12,3,37
2024-03-02 06:40:00,19,7,10,6,42
2024-03-02 06:50:00,20,4,12,8,44
2024-03-02 07:00:00,22,12,8,4,46
2024-03-02 07:10:00,21,7,8,4,40
2024-03-02 07:20:00,18,6,6,3,33
2024-03-02 07:30:00,34,12,8,6,60
2024-03-02 07:40:00,22,8,9,4,43
2024-03-02 07:50:00,16,6,8,16,46
2024-03-02 08:00:00,27,15,13,6,61
2024-03-02 08:10:00,29,4,10,9,52
2024-03-02 08:20:00,25,1,10,4,40
2024-03-02 08:30:00,33,17,13,6,69
2024-03-02 08:40:00,38,10,14,12,74
2024-03-02 08:50:00,38,16,34,16,104
2024-03-02 09:00:00,40,7,26,16,89
2024-03-02 09:10:00,49,15,23,18,105
2024-03-02 09:20:00,50,17,26,12,105
2024-03-02 09:30:00,48,15,30,14,107
2024-03-02 09:40:00,51,18,32,15,116
2024-03-02 09:50:00,41,11,32,19,103
2024-03-02 10:00:00,45,16,31,13,105
2024-03-02 10:10:00,43,15,33,18,109
2024-03-02 10:20:00,38,18,38,19,113
2024-03-02 10:30:00,42,13,41,19,115
2024-03-02 10:40:00,40,23,37,23,123
2024-03-02 10:50:00,54,11,59,19,143
2024-03-02 11:00:00,56,25,40,21,142
2024-03-02 11:10:00,50,28,55,25,158
2024-03-02 11:20:00,52,19,46,25,142
2024-03-02 11:30:00,59,29,42,15,145
2024-03-02 11:40:00,57,24,53,30,164
2024-03-02 11:50:00,56,28,37,25,146
2024-03-02 12:00:00,72,21,41,25,159
2024-03-02 12:10:00,66,21,48,33,168
2024-03-02 12:20:00,53,25,48,22,148
2024-03-02 12:30:00,65,37,51,17,170
2024-03-02 12:40:00,70,29,43,24,166
2024-03-02 12:50:00,57,27,47,33,164
2024-03-02 13:00:00,78,46,52,31,207
2024-03-02 13:10:00,71,30,37,25,163
2024-03-02 13:20:00,58,22,48,16,144
2024-03-02 13:30:00,69,31,58,31,189
2024-03-02 13:40:00,64,21,60,28,173
2024-03-02 13:50:00,67,30,45,17,159
2024-03-02 14:00:00,69,31,49,25,174
2024-03-02 14:10:00,94,49,72,28,243
2024-03-02 14:20:00,74,33,47,38,192
2024-03-02 14:30:00,81,36,61,18,196
2024-03-02 14:40:00,82,32,66,27,207
2024-03-02 14:50:00,71,25,52,29,177
2024-03-02 15:00:00,62,33,59,26,180
2024-03-02 15:10:00,78,32,71,27,208
2024-03-02 15:20:00,79,29,44,22,174
2024-03-02 15:30:00,74,29,50,20,173
2024-03-02 15:40:00,66,32,50,22,170
2024-03-02 15:50:00,76,35,48,22,181
2024-03-02 16:00:00,53,24,55,17,149
2024-03-02 16:10:00,74,29,44,22,169
2024-03-02 16:20:00,69,22,37,19,147
2024-03-02 16:30:00,72,23,40,15,150
2024-03-02 16:40:00,56,22,45,23,146
2024-03-02 16:50:00,68,27,41,26,162
2024-03-02 17:00:00,67,30,47,28,172
2024-03-02 17:10:00,85,35,37,24,181
2024-03-02 17:20:00,70,25,47,22,164
2024-03-02 17:30:00,81,45,41,28,195
2024-03-02 17:40:00,71,25,40,28,164
2024-03-02 17:50:00,67,34,49,25,175
2024-03-02 18:00:00,96,52,36,20,204
2024-03-02 18:10:00,71,32,45,17,165
2024-03-02 18:20:00,75,40,43,28,186
2024-03-02 18:30:00,68,32,39,24,163
2024-03-02 18:40:00,74,21,47,26,168
2024-03-02 18:50:00,77,31,54,14,176
2024-03-02 19:00:00,65,30,53,15,163
2024-03-02 19:10:00,75,32,32,11,150
2024-03-02 19:20:00,74,18,36,17,145
2024-03-02 19:30:00,63,18,38,17,136
2024-03-02 19:40:00,68,25,26,17,136
2024-03-02 19:50:00,66,28,30,21,145
2024-03-02 20:00:00,48,21,21,12,102
2024-03-02 20:10:00,53,21,11,6,91
2024-03-02 20:20:00,66,20,27,18,131
2024-03-02 20:30:00,57,22,29,14,122
2024-03-02 20:40:00,52,22,22,7,103
2024-03-02 20:50:00,48,19,27,8,102
2024-03-02 21:00:00,47,12,32,9,100
2024-03-02 21:10:00,51,23,27,5,106
2024-03-02 21:20:00,37,13,24,5,79
2024-03-02 21:30:00,43,16,23,8,90
2024-03-02 21:40:00,41,14,22,5,82
2024-03-02 21:50:00,43,16,28,7,94
2024-03-02 22:00:00,52,14,16,5,87
2024-03-02 22:10:00,38,9,20,6,73
2024-03-02 22:20:00,62,24,20,9,115
2024-03-02 22:30:00,61,28,18,4,111
2024-03-02 22:40:00,54,18,25,4,101
2024-03-02 22:50:00,52,19,25,6,102
2024-03-02 23:00:00,48,16,29,4,97
2024-03-02 23:10:00,35,11,19,1,66
2024-03-02 23:20:00,36,8,16,5,65
2024-03-02 23:30:00,42,20,17,3,82
2024-03-02 23:40:00,45,13,16,2,76
2024-03-02 23:50:00,27,5,15,0,47
2024-03-03 00:00:00,31,6,17,4,58
2024-03-03 00:10:00,22,6,13,3,44
2024-03-03 00:20:00,31,11,13,5,60
2024-03-03 00:30:00,24,8,8,5,45
2024-03-03 00:40:00,20,9,11,7,47
2024-03-03 00:50:00,32,4,8,8,52
2024-03-03 01:00:00,33,6,8,3,50
2024-03-03 01:10:00,26,7,7,3,43
2024-03-03 01:20:00,14,1,7,6,28
2024-03-03 01:30:00,13,7,7,3,30
2024-03-03 01:40:00,15,5,11,1,32
2024-03-03 01:50:00,13,3,6,3,25
2024-03-03 02:00:00,16,5,6,4,31
2024-03-03 02:10:00,13,3,6,3,25
2024-03-03 02:20:00,13,7,2,0,22
2024-03-03 02:30:00,18,5,5,3,31
2024-03-03 02:40:00,9,6,3,1,19
2024-03-03 02:50:00,10,2,4,0,16
2024-03-03 03:00:00,11,3,2,3,19
2024-03-03 03:10:00,10,1,4,1,16
2024-03-03 03:20:00,6,1,2,1,10
2024-03-03 03:30:00,7,2,4,0,13
2024-03-03 03:40:00,3,0,3,0,6
2024-03-03 03:50:00,8,1,3,0,12
2024-03-03 04:00:00,3,1,1,1,6
2024-03-03 04:10:00,6,1,1,3,11
2024-03-03 04:20:00,8,2,0,0,10
2024-03-03 04:30:00,10,1,5,2,18
2024-03-03 04:40:00,4,2,2,0,8
2024-03-03 04:50:00,8,2,3,1,14
2024-03-03 05:00:00,9,1,4,1,15
2024-03-03 05:10:00,9,1,2,1,13
2024-03-03 05:20:00,9,3,3,2,17
2024-03-03 05:30:00,9,1,2,3,15
2024-03-03 05:40:00,6,1,1,0,8
2024-03-03 05:50:00,9,2,3,2,16
2024-03-03 06:00:00,15,1,10,0,26
2024-03-03 06:10:00,9,4,3,1,17
2024-03-03 06:20:00,5,0,3,4,12
2024-03-03 06:30:00,7,3,1,2,13
2024-03-03 06:40:00,7,3,2,0,12
2024-03-03 06:50:00,5,1,3,2,11
2024-03-03 07:00:00,8,2,3,1,14
2024-03-03 07:10:00,7,1,0,0,8
2024-03-03 07:20:00,3,1,5,1,10
2024-03-03 07:30:00,11,0,8,3,22
2024-03-03 07:40:00,13,2,3,5,23
2024-03-03 07:50:00,6,1,5,3,15
2024-03-03 08:00:00,16,6,4,4,30
2024-03-03 08:10:00,22,4,8,5,39
2024-03-03 08:20:00,22,7,8,2,39
2024-03-03 08:30:00,24,4,5,5,38
2024-03-03 08:40:00,29,8,16,7,60
2024-03-03 08:50:00,21,4,4,2,31
2024-03-03 09:00:00,19,5,13,5,42
2024-03-03 09:10:00,32,10,16,7,65
2024-03-03 09:20:00,26,10,8,6,50
2024-03-03 09:30:00,31,7,14,8,60
2024-03-03 09:40:00,27,5,18,8,58
2024-03-03 09:50:00,26,9,25,8,68
2024-03-03 10:00:00,42,13,19,9,83
2024-03-03 10:10:00,37,15,15,9,76
2024-03-03 10:20:00,39,17,21,11,88
2024-03-03 10:30:00,37,14,25,12,88
2024-03-03 10:40:00,51,20,25,7,103
2024-03-03 10:50:00,51,16,21,7,95
2024-03-03 11:00:00,35,7,17,10,69
2024-03-03 11:10:00,40,20,18,10,88
2024-03-03 11:20:00,49,28,18,7,102
2024-03-03 11:30:00,50,17,27,13,107
2024-03-03 11:40:00,32,14,39,9,94
2024-03-03 11:50:00,46,15,24,11,96
2024-03-03 12:00:00,48,17,33,15,113
2024-03-03 12:10:00,47,17,26,11,101
2024-03-03 12:20:00,74,35,30,11,150
2024-03-03 12:30:00,41,13,38,16,108
2024-03-03 12:40:00,56,26,27,12,121
2024-03-03 12:50:00,54,18,25,8,105
2024-03-03 13:00:00,56,24,33,18,131
2024-03-03 13:10:00,74,24,37,17,152
2024-03-03 13:20:00,71,23,33,22,149
2024-03-03 13:30:00,70,28,35,16,149
2024-03-03 13:40:00,76,28,32,14,150
2024-03-03 13:50:00,81,33,39,13,166
2024-03-03 14:00:00,61,24,35,14,134
2024-03-03 14:10:00,82,29,25,9,145
2024-03-03 14:20:00,53,29,36,17,135
2024-03-03 14:30:00,69,25,37,18,149
2024-03-03 14:40:00,64,22,42,21,149
2024-03-03 14:50:00,65,20,36,21,142
2024-03-03 15:00:00,60,22,32,14,128
2024-03-03 15:10:00,67,35,32,16,150
2024-03-03 15:20:00,52,22,21,10,105
2024-03-03 15:30:00,55,17,36,14,122
2024-03-03 15:40:00,53,18,33,21,125
2024-03-03 15:50:00,67,30,28,17,142
2024-03-03 16:00:00,62,26,36,9,133
2024-03-03 16:10:00,67,25,28,13,133
2024-03-03 16:20:00,73,23,22,8,126
2024-03-03 16:30:00,67,28,34,17,146
2024-03-03 16:40:00,65,30,27,12,134
2024-03-03 16:50:00,77,32,31,30,170
2024-03-03 17:00:00,72,30,34,15,151
2024-03-03 17:10:00,66,25,30,15,136
2024-03-03 17:20:00,70,25,31,18,144
2024-03-03 17:30:00,65,28,30,13,136
2024-03-03 17:40:00,69,30,42,13,154
2024-03-03 17:50:00,67,26,25,16,134
2024-03-03 18:00:00,73,31,35,17,156
2024-03-03 18:10:00,78,31,32,17,158
2024-03-03 18:20:00,67,24,33,17,141
2024-03-03 18:30:00,51,24,31,20,126
2024-03-03 18:40:00,56,18,21,16,111
2024-03-03 18:50:00,64,27,26,24,141
2024-03-03 19:00:00,53,16,29,16,114
2024-03-03 19:10:00,48,16,32,15,111
2024-03-03 19:20:00,40,21,19,12,92
2024-03-03 19:30:00,47,12,28,12,99
2024-03-03 19:40:00,54,17,30,14,115
2024-03-03 19:50:00,45,9,22,16,92
2024-03-03 20:00:00,45,11,18,5,79
2024-03-03 20:10:00,41,20,28,14,103
2024-03-03 20:20:00,47,20,22,10,99
2024-03-03 20:30:00,45,12,19,5,81
2024-03-03 20:40:00,31,11,15,11,68
2024-03-03 20:50:00,33,12,19,9,73
2024-03-03 21:00:00,36,10,19,4,69
2024-03-03 21:10:00,38,12,17,6,73
2024-03-03 21:20:00,26,12,14,6,58
2024-03-03 21:30:00,34,12,13,10,69
2024-03-03 21:40:00,25,10,13,7,55
2024-03-03 21:50:00,35,9,11,6,61
2024-03-03 22:00:00,36,8,14,5,63
2024-03-03 22:10:00,47,14,14,6,81
2024-03-03 22:20:00,32,11,11,7,61
2024-03-03 22:30:00,29,9,7,3,48
2024-03-03 22:40:00,23,6,10,2,41
2024-03-03 22:50:00,16,5,10,5,36
2024-03-03 23:00:00,24,2,9,2,37
2024-03-03 23:10:00,15,6,5,3,29
2024-03-03 23:20:00,12,1,8,4,25
2024-03-03 23:30:00,11,3,8,4,26
2024-03-03 23:40:00,9,4,2,1,16
2024-03-03 23:50:00,7,3,2,1,13
2024-03-04 00:00:00,8,2,8,2,20
2024-03-04 00:10:00,12,3,3,2,20
2024-03-04 00:20:00,4,4,5,1,14
2024-03-04 00:30:00,8,3,1,1,13
2024-03-04 00:40:00,5,1,1,0,7
2024-03-04 00:50:00,5,3,2,4,14
2024-03-04 01:00:00,2,0,0,2,4
2024-03-04 01:10:00,4,0,0,1,5
2024-03-04 01:20:00,3,1,2,3,9
2024-03-04 01:30:00,5,2,3,2,12
2024-03-04 01:40:00,4,1,3,0,8
2024-03-04 01:50:00,6,0,1,0,7
2024-03-04 02:00:00,5,0,1,0,6
2024-03-04 02:10:00,4,1,3,1,9
2024-03-04 02:20:00,5,1,2,0,8
2024-03-04 02:30:00,2,0,1,1,4
2024-03-04 02:40:00,3,0,2,0,5
2024-03-04 02:50:00,5,2,0,1,8
2024-03-04 03:00:00,1,0,6,0,7
2024-03-04 03:10:00,4,0,2,0,6
2024-03-04 03:20:00,6,0,3,0,9
2024-03-04 03:30:00,7,2,1,0,10
2024-03-04 03:40:00,6,0,2,1,9
2024-03-04 03:50:00,3,0,1,0,4
2024-03-04 04:00:00,6,1,3,0,10
2024-03-04 04:10:00,2,1,4,1,8
2024-03-04 04:20:00,8,1,5,1,15
2024-03-04 04:30:00,11,3,1,3,18
2024-03-04 04:40:00,14,6,2,3,25
2024-03-04 04:50:00,14,3,8,0,25
2024-03-04 05:00:00,13,3,2,2,20
2024-03-04 05:10:00,19,3,5,0,27
2024-03-04 05:20:00,27,10,6,3,46
2024-03-04 05:30:00,30,11,14,8,63
2024-03-04 05:40:00,30,10,18,14,72
2024-03-04 05:50:00,43,21,13,8,85
2024-03-04 06:00:00,41,18,18,7,84
2024-03-04 06:10:00,52,15,24,12,103
2024-03-04 06:20:00,49,20,20,13,102
2024-03-04 06:30:00,45,18,34,24,121
2024-03-04 06:40:00,60,34,26,12,132
2024-03-04 06:50:00,54,26,31,24,135
2024-03-04 07:00:00,67,33,35,19,154
2024-03-04 07:10:00,74,28,35,31,168
2024-03-04 07:20:00,66,32,39,27,164
2024-03-04 07:30:00,70,31,64,53,218
2024-03-04 07:40:00,86,48,71,62,267
2024-03-04 07:50:00,79,42,52,45,218
2024-03-04 08:00:00,75,39,64,53,231
2024-03-04 08:10:00,96,38,44,47,225
2024-03-04 08:20:00,89,37,56,36,218
2024-03-04 08:30:00,76,36,55,52,219
2024-03-04 08:40:00,70,24,51,48,193
2024-03-04 08:50:00,86,41,47,38,212
2024-03-04 09:00:00,61,25,45,31,162
2024-03-04 09:10:00,67,24,35,30,156
2024-03-04 09:20:00,61,34,42,29,166
2024-03-04 09:30:00,56,24,37,32,149
2024-03-04 09:40:00,51,28,52,28,159
2024-03-04 09:50:00,54,23,43,18,138
2024-03-04 10:00:00,45,22,54,25,146
2024-03-04 10:10:00,54,30,39,23,146
2024-03-04 10:20:00,73,22,45,25,165
2024-03-04 10:30:00,63,18,37,21,139
2024-03-04 10:40:00,52,27,43,19,141
2024-03-04 10:50:00,59,30,47,30,166
2024-03-04 11:00:00,64,18,40,20,142
2024-03-04 11:10:00,50,23,37,18,128
2024-03-04 11:20:00,50,27,28,19,124
2024-03-04 11:30:00,63,26,41,35,165
2024-03-04 11:40:00,47,15,45,26,133
2024-03-04 11:50:00,64,28,48,30,170
2024-03-04 12:00:00,65,30,41,31,167
2024-03-04 12:10:00,61,29,26,23,139
2024-03-04 12:20:00,50,21,46,30,147
2024-03-04 12:30:00,82,35,34,28,179
2024-03-04 12:40:00,64,25,43,22,154
2024-03-04 12:50:00,60,32,40,26,158
2024-03-04 13:00:00,53,21,45,25,144
2024-03-04 13:10:00,64,38,41,31,174
2024-03-04 13:20:00,57,22,28,14,121
2024-03-04 13:30:00,68,29,39,20,156
2024-03-04 13:40:00,69,34,40,21,164
2024-03-04 13:50:00,61,28,44,24,157
2024-03-04 14:00:00,58,19,46,25,148
2024-03-04 14:10:00,68,36,47,30,181
2024-03-04 14:20:00,61,30,42,30,163
2024-03-04 14:30:00,74,32,40,23,169
2024-03-04 14:40:00,71,33,53,23,180
2024-03-04 14:50:00,62,32,54,29,177
2024-03-04 15:00:00,80,41,45,25,191
2024-03-04 15:10:00,85,48,55,19,207
2024-03-04 15:20:00,82,41,42,35,200
2024-03-04 15:30:00,60,30,57,34,181
2024-03-04 15:40:00,82,41,45,32,200
2024-03-04 15:50:00,86,41,53,31,211
2024-03-04 16:00:00,85,48,48,33,214
2024-03-04 16:10:00,71,52,48,38,209
2024-03-04 16:20:00,83,45,40,34,202
2024-03-04 16:30:00,86,52,45,30,213
2024-03-04 16:40:00,87,48,69,36,240
2024-03-04 16:50:00,83,33,51,40,207
2024-03-04 17:00:00,85,38,39,27,189
2024-03-04 17:10:00,74,35,62,40,211
2024-03-04 17:20:00,78,55,49,30,212
2024-03-04 17:30:00,62,41,44,23,170
2024-03-04 17:40:00,84,50,39,29,202
2024-03-04 17:50:00,66,35,40,26,167
2024-03-04 18:00:00,60,26,50,32,168
2024-03-04 18:10:00,79,24,33,21,157
2024-03-04 18:20:00,56,30,27,22,135
2024-03-04 18:30:00,68,23,41,29,161
2024-03-04 18:40:00,48,23,38,21,130
2024-03-04 18:50:00,57,22,28,18,125
2024-03-04 19:00:00,50,26,35,21,132
2024-03-04 19:10:00,52,27,32,19,130
2024-03-04 19:20:00,52,26,20,13,111
2024-03-04 19:30:00,42,14,20,16,92
2024-03-04 19:40:00,40,16,23,21,100
2024-03-04 19:50:00,43,17,19,9,88
2024-03-04 20:00:00,40,19,17,9,85
2024-03-04 20:10:00,48,19,22,8,97
2024-03-04 20:20:00,33,13,19,7,72
2024-03-04 20:30:00,37,14,25,8,84
2024-03-04 20:40:00,34,6,21,11,72
2024-03-04 20:50:00,42,11,10,7,70
2024-03-04 21:00:00,23,7,19,7,56
2024-03-04 21:10:00,34,15,14,14,77
2024-03-04 21:20:00,32,19,13,8,72
2024-03-04 21:30:00,24,10,13,4,51
2024-03-04 21:40:00,35,11,17,8,71
2024-03-04 21:50:00,35,8,13,9,65
2024-03-04 22:00:00,33,8,17,4,62
2024-03-04 22:10:00,23,6,17,12,58
2024-03-04 22:20:00,36,15,12,9,72
2024-03-04 22:30:00,31,10,11,4,56
2024-03-04 22:40:00,13,4,11,3,31
2024-03-04 22:50:00,15,5,8,2,30
2024-03-04 23:00:00,13,2,6,2,23
2024-03-04 23:10:00,22,7,10,4,43
2024-03-04 23:20:00,15,6,9,4,34
2024-03-04 23:30:00,14,4,3,1,22
2024-03-04 23:40:00,8,3,8,3,22
2024-03-04 23:50:00,13,3,7,1,24
2024-03-05 00:00:00,9,3,3,2,17
2024-03-05 00:10:00,12,1,3,1,17
2024-03-05 00:20:00,6,1,0,1,8
2024-03-05 00:30:00,3,1,4,4,12
2024-03-05 00:40:00,7,2,3,2,14
2024-03-05 00:50:00,1,0,5,1,7
2024-03-05 01:00:00,4,2,2,0,8
2024-03-05 01:10:00,3,1,0,0,4
2024-03-05 01:20:00,9,1,2,0,12
2024-03-05 01:30:00,10,1,1,0,12
2024-03-05 01:40:00,5,1,1,0,7
2024-03-05 01:50:00,8,1,5,2,16
2024-03-05 02:00:00,3,0,1,0,4
2024-03-05 02:10:00,1,1,0,0,2
2024-03-05 02:20:00,5,3,0,0,8
2024-03-05 02:30:00,2,1,4,1,8
2024-03-05 02:40:00,5,1,0,0,6
2024-03-05 02:50:00,4,0,1,2,7
2024-03-05 03:00:00,5,1,3,1,10
2024-03-05 03:10:00,3,1,3,2,9
2024-03-05 03:20:00,4,0,1,1,6
2024-03-05 03:30:00,3,0,1,0,4
2024-03-05 03:40:00,2,0,2,0,4
2024-03-05 03:50:00,6,3,2,2,13
2024-03-05 04:00:00,4,3,4,0,11
2024-03-05 04:10:00,4,0,4,0,8
2024-03-05 04:20:00,8,2,3,0,13
2024-03-05 04:30:00,12,3,3,2,20
2024-03-05 04:40:00,11,2,4,4,21
2024-03-05 04:50:00,18,4,3,4,29
2024-03-05 05:00:00,14,2,2,3,21
2024-03-05 05:10:00,18,8,6,1,33
2024-03-05 05:20:00,30,6,8,3,47
2024-03-05 05:30:00,34,9,7,9,59
2024-03-05 05:40:00,31,12,17,13,73
2024-03-05 05:50:00,29,11,20,9,69
2024-03-05 06:00:00,42,19,21,9,91
2024-03-05 06:10:00,48,20,23,15,106
2024-03-05 06:20:00,53,19,26,14,112
2024-03-05 06:30:00,60,26,27,21,134
2024-03-05 06:40:00,66,30,34,25,155
2024-03-05 06:50:00,54,27,30,17,128
2024-03-05 07:00:00,66,27,33,29,155
2024-03-05 07:10:00,61,24,42,29,156
2024-03-05 07:20:00,72,42,37,31,182
2024-03-05 07:30:00,62,37,53,42,194
2024-03-05 07:40:00,79,36,65,47,227
2024-03-05 07:50:00,75,48,76,59,258
2024-03-05 08:00:00,79,41,62,45,227
2024-03-05 08:10:00,89,49,50,41,229
2024-03-05 08:20:00,99,42,51,38,230
2024-03-05 08:30:00,81,41,51,43,216
2024-03-05 08:40:00,83,34,62,38,217
2024-03-05 08:50:00,80,39,40,32,191
2024-03-05 09:00:00,76,33,49,37,195
2024-03-05 09:10:00,73,32,46,38,189
2024-03-05 09:20:00,69,29,48,30,176
2024-03-05 09:30:00,62,26,38,28,154
2024-03-05 09:40:00,69,37,57,41,204
2024-03-05 09:50:00,62,26,31,20,139
2024-03-05 10:00:00,72,24,42,27,165
2024-03-05 10:10:00,58,25,45,28,156
2024-03-05 10:20:00,59,24,41,26,150
2024-03-05 10:30:00,63,11,52,22,148
2024-03-05 10:40:00,72,21,40,19,152
2024-03-05 10:50:00,62,21,53,25,161
2024-03-05 11:00:00,64,18,37,17,136
2024-03-05 11:10:00,69,36,35,16,156
2024-03-05 11:20:00,59,27,30,28,144
2024-03-05 11:30:00,69,23,34,23,149
2024-03-05 11:40:00,55,18,47,30,150
2024-03-05 11:50:00,57,31,40,27,155
2024-03-05 12:00:00,66,31,40,32,169
2024-03-05 12:10:00,65,33,31,22,151
2024-03-05 12:20:00,66,28,39,22,155
2024-03-05 12:30:00,67,41,34,22,164
2024-03-05 12:40:00,75,42,39,24,180
2024-03-05 12:50:00,71,42,34,20,167
2024-03-05 13:00:00,64,30,44,30,168
2024-03-05 13:10:00,65,37,41,26,169
2024-03-05 13:20:00,65,38,28,17,148
2024-03-05 13:30:00,69,37,41,24,171
2024-03-05 13:40:00,79,37,35,22,173
2024-03-05 13:50:00,70,31,45,24,170
2024-03-05 14:00:00,67,22,39,27,155
2024-03-05 14:10:00,73,35,41,23,172
2024-03-05 14:20:00,67,23,47,34,171
2024-03-05 14:30:00,63,35,35,26,159
2024-03-05 14:40:00,73,38,58,35,204
2024-03-05 14:50:00,68,33,47,31,179
2024-03-05 15:00:00,58,27,44,32,161
2024-03-05 15:10:00,81,50,43,23,197
2024-03-05 15:20:00,61,34,44,30,169
2024-03-05 15:30:00,78,39,45,26,188
2024-03-05 15:40:00,54,30,49,35,168
2024-03-05 15:50:00,77,55,57,41,230
2024-03-05 16:00:00,80,52,44,42,218
2024-03-05 16:10:00,93,49,55,40,237
2024-03-05 16:20:00,87,41,58,33,219
2024-03-05 16:30:00,81,40,60,45,226
2024-03-05 16:40:00,82,45,69,37,233
2024-03-05 16:50:00,88,52,45,27,212
2024-03-05 17:00:00,84,40,62,45,231
2024-03-05 17:10:00,65,29,46,34,174
2024-03-05 17:20:00,84,53,46,36,219
2024-03-05 17:30:00,73,37,60,44,214
2024-03-05 17:40:00,85,41,44,41,211
2024-03-05 17:50:00,76,33,54,38,201
2024-03-05 18:00:00,60,22,48,29,159
2024-03-05 18:10:00,88,43,48,29,208
2024-03-05 18:20:00,74,50,52,30,206
2024-03-05 18:30:00,73,39,38,30,180
2024-03-05 18:40:00,72,27,33,26,158
2024-03-05 18:50:00,70,31,44,26,171
2024-03-05 19:00:00,53,19,21,19,112
2024-03-05 19:10:00,73,30,35,28,166
2024-03-05 19:20:00,63,26,28,17,134
2024-03-05 19:30:00,53,15,28,21,117
2024-03-05 19:40:00,52,19,38,20,129
2024-03-05 19:50:00,41,16,28,18,103
2024-03-05 20:00:00,49,14,27,13,103
2024-03-05 20:10:00,49,23,17,12,101
2024-03-05 20:20:00,41,18,19,12,90
2024-03-05 20:30:00,37,17,16,15,85
2024-03-05 20:40:00,50,11,13,11,85
2024-03-05 20:50:00,54,24,12,7,97
2024-03-05 21:00:00,34,10,14,4,62
2024-03-05 21:10:00,45,15,21,9,90
2024-03-05 21:20:00,45,15,12,10,82
2024-03-05 21:30:00,38,13,19,8,78
2024-03-05 21:40:00,34,15,13,7,69
2024-03-05 21:50:00,41,10,12,6,69
2024-03-05 22:00:00,36,11,15,10,72
2024-03-05 22:10:00,44,17,12,1,74
2024-03-05 22:20:00,39,16,16,5,76
2024-03-05 22:30:00,46,19,13,7,85
2024-03-05 22:40:00,49,29,9,3,90
2024-03-05 22:50:00,32,19,12,6,69
2024-03-05 23:00:00,22,8,14,3,47
2024-03-05 23:10:00,20,6,9,6,41
2024-03-05 23:20:00,20,14,6,5,45
2024-03-05 23:30:00,19,3,8,4,34
2024-03-05 23:40:00,11,7,7,2,27
2024-03-05 23:50:00,11,3,4,2,20
2024-03-06 00:00:00,10,4,4,6,24
2024-03-06 00:10:00,19,5,0,1,25
2024-03-06 00:20:00,10,3,2,1,16
2024-03-06 00:30:00,11,2,2,1,16
2024-03-06 00:40:00,9,3,2,2,16
2024-03-06 00:50:00,3,1,2,1,7
2024-03-06 01:00:00,4,1,4,2,11
2024-03-06 01:10:00,7,1,1,1,10
2024-03-06 01:20:00,9,3,3,0,15
2024-03-06 01:30:00,8,1,2,0,11
2024-03-06 01:40:00,2,2,1,1,6
2024-03-06 01:50:00,4,0,2,0,6
2024-03-06 02:00:00,4,1,1,0,6
2024-03-06 02:10:00,3,0,0,0,3
2024-03-06 02:20:00,2,1,1,2,6
2024-03-06 02:30:00,0,0,3,0,3
2024-03-06 02:40:00,7,1,2,0,10
2024-03-06 02:50:00,5,1,1,1,8
2024-03-06 03:00:00,5,1,3,0,9
2024-03-06 03:10:00,4,3,1,0,8
2024-03-06 03:20:00,2,0,1,1,4
2024-03-06 03:30:00,4,0,2,1,7
2024-03-06 03:40:00,5,0,2,0,7
2024-03-06 03:50:00,11,1,2,1,15
2024-03-06 04:00:00,4,1,3,1,9
2024-03-06 04:10:00,8,2,4,1,15
2024-03-06 04:20:00,9,1,2,0,12
2024-03-06 04:30:00,8,3,3,2,16
2024-03-06 04:40:00,9,3,8,3,23
2024-03-06 04:50:00,15,3,3,3,24
2024-03-06 05:00:00,10,3,5,0,18
2024-03-06 05:10:00,13,5,4,5,27
2024-03-06 05:20:00,31,10,13,5,59
2024-03-06 05:30:00,25,8,12,8,53
2024-03-06 05:40:00,31,10,13,11,65
2024-03-06 05:50:00,31,9,15,12,67
2024-03-06 06:00:00,42,14,13,8,77
2024-03-06 06:10:00,45,23,24,19,111
2024-03-06 06:20:00,54,21,17,8,100
2024-03-06 06:30:00,67,23,27,17,134
2024-03-06 06:40:00,65,25,21,27,138
2024-03-06 06:50:00,53,22,23,22,120
2024-03-06 07:00:00,70,31,27,20,148
2024-03-06 07:10:00,81,45,37,30,193
2024-03-06 07:20:00,68,28,31,33,160
2024-03-06 07:30:00,80,44,54,37,215
2024-03-06 07:40:00,93,43,65,56,257
2024-03-06 07:50:00,81,49,60,61,251
2024-03-06 08:00:00,75,38,56,51,220
2024-03-06 08:10:00,98,46,52,47,243
2024-03-06 08:20:00,74,39,41,35,189
2024-03-06 08:30:00,79,30,51,54,214
2024-03-06 08:40:00,82,35,56,39,212
2024-03-06 08:50:00,88,33,60,43,224
2024-03-06 09:00:00,76,34,47,52,209
2024-03-06 09:10:00,73,34,49,28,184
2024-03-06 09:20:00,74,37,40,34,185
2024-03-06 09:30:00,73,32,45,29,179
2024-03-06 09:40:00,67,20,46,30,163
2024-03-06 09:50:00,68,26,37,27,158
2024-03-06 10:00:00,63,28,43,36,170
2024-03-06 10:10:00,65,20,49,30,164
2024-03-06 10:20:00,59,24,36,19,138
2024-03-06 10:30:00,65,25,48,32,170
2024-03-06 10:40:00,70,30,50,21,171
2024-03-06 10:50:00,66,32,41,23,162
2024-03-06 11:00:00,63,21,36,23,143
2024-03-06 11:10:00,63,30,44,31,168
2024-03-06 11:20:00,63,24,38,25,150
2024-03-06 11:30:00,75,31,42,33,181
2024-03-06 11:40:00,51,23,37,24,135
2024-03-06 11:50:00,55,28,33,20,136
2024-03-06 12:00:00,64,25,43,24,156
2024-03-06 12:10:00,71,43,43,30,187
2024-03-06 12:20:00,66,39,38,22,165
2024-03-06 12:30:00,67,42,31,23,163
2024-03-06 12:40:00,58,32,43,33,166
2024-03-06 12:50:00,69,30,47,28,174
2024-03-06 13:00:00,78,31,35,28,172
2024-03-06 13:10:00,69,29,45,26,169
2024-03-06 13:20:00,62,37,37,34,170
2024-03-06 13:30:00,84,36,43,20,183
2024-03-06 13:40:00,84,32,52,38,206
2024-03-06 13:50:00,73,29,28,21,151
2024-03-06 14:00:00,63,20,47,27,157
2024-03-06 14:10:00,66,38,36,23,163
2024-03-06 14:20:00,80,37,38,32,187
2024-03-06 14:30:00,69,34,45,28,176
2024-03-06 14:40:00,81,33,47,37,198
2024-03-06 14:50:00,73,32,52,38,195
2024-03-06 15:00:00,70,21,52,35,178
2024-03-06 15:10:00,74,35,30,20,159
2024-03-06 15:20:00,76,45,29,30,180
2024-03-06 15:30:00,62,28,47,40,177
2024-03-06 15:40:00,84,42,40,37,203
2024-03-06 15:50:00,67,39,37,25,168
2024-03-06 16:00:00,63,34,48,37,182
2024-03-06 16:10:00,87,43,61,39,230
2024-03-06 16:20:00,88,55,50,24,217
2024-03-06 16:30:00,80,43,54,40,217
2024-03-06 16:40:00,74,49,62,37,222
2024-03-06 16:50:00,77,47,45,28,197
2024-03-06 17:00:00,83,40,48,35,206
2024-03-06 17:10:00,88,44,54,32,218
2024-03-06 17:20:00,80,42,55,39,216
2024-03-06 17:30:00,67,45,56,51,219
2024-03-06 17:40:00,66,37,50,35,188
2024-03-06 17:50:00,81,41,48,40,210
2024-03-06 18:00:00,61,37,54,36,188
2024-03-06 18:10:00,76,37,48,40,201
2024-03-06 18:20:00,67,34,57,28,186
2024-03-06 18:30:00,66,33,44,38,181
2024-03-06 18:40:00,73,38,41,29,181
2024-03-06 18:50:00,71,29,38,38,176
2024-03-06 19:00:00,65,34,22,28,149
2024-03-06 19:10:00,64,33,39,23,159
2024-03-06 19:20:00,57,27,34,21,139
2024-03-06 19:30:00,63,19,28,16,126
2024-03-06 19:40:00,49,20,36,19,124
2024-03-06 19:50:00,46,19,16,14,95
2024-03-06 20:00:00,46,13,16,11,86
2024-03-06 20:10:00,42,21,18,11,92
2024-03-06 20:20:00,59,22,18,13,112
2024-03-06 20:30:00,37,20,16,11,84
2024-03-06 20:40:00,38,12,25,14,89
2024-03-06 20:50:00,26,8,19,12,65
2024-03-06 21:00:00,31,12,23,10,76
2024-03-06 21:10:00,39,13,15,10,77
2024-03-06 21:20:00,32,16,14,7,69
2024-03-06 21:30:00,43,16,15,6,80
2024-03-06 21:40:00,47,21,13,7,88
2024-03-06 21:50:00,33,9,10,4,56
2024-03-06 22:00:00,37,13,10,5,65
2024-03-06 22:10:00,32,16,13,10,71
2024-03-06 22:20:00,35,16,15,8,74
2024-03-06 22:30:00,19,7,7,4,37
2024-03-06 22:40:00,23,4,10,10,47
2024-03-06 22:50:00,29,8,10,3,50
2024-03-06 23:00:00,18,7,13,2,40
2024-03-06 23:10:00,22,4,8,4,38
2024-03-06 23:20:00,15,7,5,2,29
2024-03-06 23:30:00,17,8,9,4,38
2024-03-06 23:40:00,10,4,5,2,21
2024-03-06 23:50:00,10,2,2,0,14
2024-03-07 00:00:00,11,4,5,1,21
2024-03-07 00:10:00,19,3,2,2,26
2024-03-07 00:20:00,6,0,2,2,10
2024-03-07 00:30:00,8,3,3,2,16
2024-03-07 00:40:00,6,1,2,3,12
2024-03-07 00:50:00,4,0,3,0,7
2024-03-07 01:00:00,5,0,1,2,8
2024-03-07 01:10:00,4,1,1,0,6
2024-03-07 01:20:00,10,1,4,2,17
2024-03-07 01:30:00,7,2,1,1,11
2024-03-07 01:40:00,2,0,3,0,5
2024-03-07 01:50:00,3,1,2,1,7
2024-03-07 02:00:00,7,1,1,1,10
2024-03-07 02:10:00,7,0,3,0,10
2024-03-07 02:20:00,6,1,1,0,8
2024-03-07 02:30:00,4,1,3,1,9
2024-03-07 02:40:00,4,1,1,0,6
2024-03-07 02:50:00,2,1,1,1,5
2024-03-07 03:00:00,2,0,1,2,5
2024-03-07 03:10:00,7,2,2,0,11
2024-03-07 03:20:00,1,1,0,0,2
2024-03-07 03:30:00,4,0,0,0,4
2024-03-07 03:40:00,4,0,3,0,7
2024-03-07 03:50:00,2,2,3,2,9
2024-03-07 04:00:00,4,1,5,1,11
2024-03-07 04:10:00,4,0,3,0,7
2024-03-07 04:20:00,12,1,2,2,17
2024-03-07 04:30:00,19,4,1,1,25
2024-03-07 04:40:00,6,5,5,2,18
2024-03-07 04:50:00,14,3,3,2,22
2024-03-07 05:00:00,10,2,1,2,15
2024-03-07 05:10:00,16,8,5,5,34
2024-03-07 05:20:00,21,7,13,5,46
2024-03-07 05:30:00,28,11,12,4,55
2024-03-07 05:40:00,30,11,17,11,69
2024-03-07 05:50:00,39,16,14,8,77
2024-03-07 06:00:00,29,13,17,11,70
2024-03-07 06:10:00,44,22,21,15,102
2024-03-07 06:20:00,54,23,21,14,112
2024-03-07 06:30:00,59,26,28,17,130
2024-03-07 06:40:00,55,22,32,20,129
2024-03-07 06:50:00,56,27,25,20,128
2024-03-07 07:00:00,67,24,30,22,143
2024-03-07 07:10:00,73,35,38,31,177
2024-03-07 07:20:00,67,28,39,33,167
2024-03-07 07:30:00,75,33,46,41,195
2024-03-07 07:40:00,96,52,72,66,286
2024-03-07 07:50:00,67,45,67,58,237
2024-03-07 08:00:00,75,44,58,43,220
2024-03-07 08:10:00,76,34,79,58,247
2024-03-07 08:20:00,84,53,59,41,237
2024-03-07 08:30:00,88,53,67,43,251
2024-03-07 08:40:00,75,36,68,43,222
2024-03-07 08:50:00,93,35,60,52,240
2024-03-07 09:00:00,70,21,63,38,192
2024-03-07 09:10:00,75,30,45,32,182
2024-03-07 09:20:00,72,30,42,26,170
2024-03-07 09:30:00,48,18,46,28,140
2024-03-07 09:40:00,49,27,58,32,166
2024-03-07 09:50:00,61,19,55,35,170
2024-03-07 10:00:00,63,19,40,29,151
2024-03-07 10:10:00,59,26,43,25,153
2024-03-07 10:20:00,68,35,51,29,183
2024-03-07 10:30:00,56,25,50,20,151
2024-03-07 10:40:00,71,28,42,27,168
2024-03-07 10:50:00,73,25,55,24,177
2024-03-07 11:00:00,56,28,43,26,153
2024-03-07 11:10:00,64,24,37,31,156
2024-03-07 11:20:00,66,30,33,37,166
2024-03-07 11:30:00,59,35,24,29,147
2024-03-07 11:40:00,56,20,47,27,150
2024-03-07 11:50:00,70,34,33,29,166
2024-03-07 12:00:00,70,30,50,32,182
2024-03-07 12:10:00,62,35,42,25,164
2024-03-07 12:20:00,71,32,41,37,181
2024-03-07 12:30:00,64,28,43,25,160
2024-03-07 12:40:00,73,31,43,31,178
2024-03-07 12:50:00,75,32,41,26,174
2024-03-07 13:00:00,72,39,40,29,180
2024-03-07 13:10:00,81,43,43,31,198
2024-03-07 13:20:00,85,40,37,16,178
2024-03-07 13:30:00,71,41,29,25,166
2024-03-07 13:40:00,68,27,33,28,156
2024-03-07 13:50:00,81,39,39,24,183
2024-03-07 14:00:00,64,27,51,28,170
2024-03-07 14:10:00,75,35,44,29,183
2024-03-07 14:20:00,82,36,48,37,203
2024-03-07 14:30:00,87,33,40,27,187
2024-03-07 14:40:00,90,40,48,31,209
2024-03-07 14:50:00,70,38,45,30,183
2024-03-07 15:00:00,85,47,61,35,228
2024-03-07 15:10:00,66,37,44,17,164
2024-03-07 15:20:00,94,41,47,36,218
2024-03-07 15:30:00,71,44,44,30,189
2024-03-07 15:40:00,76,51,44,28,199
2024-03-07 15:50:00,79,51,52,30,212
2024-03-07 16:00:00,83,62,42,33,220
2024-03-07 16:10:00,87,42,54,65,248
2024-03-07 16:20:00,87,43,43,53,226
2024-03-07 16:30:00,84,48,55,62,249
2024-03-07 16:40:00,83,41,63,49,236
2024-03-07 16:50:00,75,51,58,40,224
2024-03-07 17:00:00,86,45,65,49,245
2024-03-07 17:10:00,90,55,57,38,240
2024-03-07 17:20:00,77,55,55,37,224
2024-03-07 17:30:00,95,52,69,46,262
2024-03-07 17:40:00,100,47,66,37,250
2024-03-07 17:50:00,74,35,51,29,189
2024-03-07 18:00:00,71,32,54,35,192
2024-03-07 18:10:00,68,37,52,42,199
2024-03-07 18:20:00,85,54,35,22,196
2024-03-07 18:30:00,75,45,53,38,211
2024-03-07 18:40:00,57,23,43,26,149
2024-03-07 18:50:00,64,36,47,27,174
2024-03-07 19:00:00,59,39,40,25,163
2024-03-07 19:10:00,78,37,33,17,165
2024-03-07 19:20:00,62,23,35,19,139
2024-03-07 19:30:00,58,27,36,23,144
2024-03-07 19:40:00,50,21,39,18,128
2024-03-07 19:50:00,44,19,27,15,105
2024-03-07 20:00:00,56,36,26,12,130
2024-03-07 20:10:00,44,21,27,11,103
2024-03-07 20:20:00,45,25,18,7,95
2024-03-07 20:30:00,36,17,22,12,87
2024-03-07 20:40:00,44,16,27,15,102
2024-03-07 20:50:00,50,18,17,17,102
2024-03-07 21:00:00,37,8,5,7,57
2024-03-07 21:10:00,35,13,15,2,65
2024-03-07 21:20:00,37,16,20,8,81
2024-03-07 21:30:00,35,13,15,7,70
2024-03-07 21:40:00,37,18,13,9,77
2024-03-07 21:50:00,39,16,14,10,79
2024-03-07 22:00:00,33,12,14,6,65
2024-03-07 22:10:00,35,20,16,7,78
2024-03-07 22:20:00,41,15,18,9,83
2024-03-07 22:30:00,19,6,12,8,45
2024-03-07 22:40:00,31,4,15,2,52
2024-03-07 22:50:00,27,7,12,2,48
2024-03-07 23:00:00,14,9,7,3,33
2024-03-07 23:10:00,30,6,9,2,47
2024-03-07 23:20:00,19,10,7,4,40
2024-03-07 23:30:00,17,8,8,3,36
2024-03-07 23:40:00,13,2,5,3,23
2024-03-07 23:50:00,14,3,3,3,23
2024-03-08 00:00:00,15,6,2,1,24
2024-03-08 00:10:00,7,1,5,2,15
2024-03-08 00:20:00,9,1,7,4,21
2024-03-08 00:30:00,9,1,2,2,14
2024-03-08 00:40:00,6,4,5,2,17
2024-03-08 00:50:00,3,0,5,1,9
2024-03-08 01:00:00,7,2,1,0,10
2024-03-08 01:10:00,11,2,7,4,24
2024-03-08 01:20:00,4,1,5,1,11
2024-03-08 01:30:00,7,4,1,3,15
2024-03-08 01:40:00,1,0,0,3,4
2024-03-08 01:50:00,4,3,4,1,12
2024-03-08 02:00:00,12,2,2,1,17
2024-03-08 02:10:00,4,0,1,1,6
2024-03-08 02:20:00,6,0,1,0,7
2024-03-08 02:30:00,7,2,3,0,12
2024-03-08 02:40:00,7,1,3,0,11
2024-03-08 02:50:00,4,1,1,1,7
2024-03-08 03:00:00,5,0,3,0,8
2024-03-08 03:10:00,2,0,2,1,5
2024-03-08 03:20:00,6,0,1,0,7
2024-03-08 03:30:00,4,1,2,1,8
2024-03-08 03:40:00,4,0,2,0,6
2024-03-08 03:50:00,7,3,2,1,13
2024-03-08 04:00:00,3,0,2,0,5
2024-03-08 04:10:00,4,1,2,0,7
2024-03-08 04:20:00,7,2,4,0,13
2024-03-08 04:30:00,12,2,3,0,17
2024-03-08 04:40:00,11,3,4,2,20
2024-03-08 04:50:00,8,2,2,1,13
2024-03-08 05:00:00,13,6,3,2,24
2024-03-08 05:10:00,17,6,5,2,30
2024-03-08 05:20:00,25,8,11,7,51
2024-03-08 05:30:00,29,11,11,7,58
2024-03-08 05:40:00,29,8,13,9,59
2024-03-08 05:50:00,39,14,9,4,66
2024-03-08 06:00:00,27,4,16,8,55
2024-03-08 06:10:00,40,14,19,12,85
2024-03-08 06:20:00,54,18,24,12,108
2024-03-08 06:30:00,50,16,33,22,121
2024-03-08 06:40:00,60,22,20,19,121
2024-03-08 06:50:00,53,28,27,20,128
2024-03-08 07:00:00,56,20,31,15,122
2024-03-08 07:10:00,67,21,38,36,162
2024-03-08 07:20:00,58,28,36,24,146
2024-03-08 07:30:00,58,33,51,47,189
2024-03-08 07:40:00,66,44,59,52,221
2024-03-08 07:50:00,76,38,49,52,215
2024-03-08 08:00:00,63,38,59,39,199
2024-03-08 08:10:00,69,31,52,37,189
2024-03-08 08:20:00,73,35,44,28,180
2024-03-08 08:30:00,62,22,45,30,159
2024-03-08 08:40:00,74,30,39,33,176
2024-03-08 08:50:00,55,20,35,29,139
2024-03-08 09:00:00,60,24,46,26,156
2024-03-08 09:10:00,62,23,49,35,169
2024-03-08 09:20:00,59,26,34,23,142
2024-03-08 09:30:00,68,28,37,28,161
2024-03-08 09:40:00,54,19,56,34,163
2024-03-08 09:50:00,55,26,33,19,133
2024-03-08 10:00:00,61,19,38,27,145
2024-03-08 10:10:00,57,15,57,21,150
2024-03-08 10:20:00,58,22,38,24,142
2024-03-08 10:30:00,75,26,42,21,164
2024-03-08 10:40:00,58,17,42,19,136
2024-03-08 10:50:00,75,36,47,35,193
2024-03-08 11:00:00,54,23,44,19,140
2024-03-08 11:10:00,80,25,47,18,170
2024-03-08 11:20:00,81,27,36,27,171
2024-03-08 11:30:00,52,16,35,21,124
2024-03-08 11:40:00,64,27,30,23,144
2024-03-08 11:50:00,62,29,36,31,158
2024-03-08 12:00:00,62,35,58,29,184
2024-03-08 12:10:00,76,31,37,35,179
2024-03-08 12:20:00,72,39,58,38,207
2024-03-08 12:30:00,71,41,52,28,192
2024-03-08 12:40:00,81,48,43,20,192
2024-03-08 12:50:00,79,36,34,24,173
2024-03-08 13:00:00,91,46,57,32,226
2024-03-08 13:10:00,71,36,31,54,192
2024-03-08 13:20:00,78,37,48,29,192
2024-03-08 13:30:00,87,41,57,31,216
2024-03-08 13:40:00,89,43,47,32,211
2024-03-08 13:50:00,78,29,46,25,178
2024-03-08 14:00:00,83,36,62,27,208
2024-03-08 14:10:00,91,49,42,28,210
2024-03-08 14:20:00,70,30,44,34,178
2024-03-08 14:30:00,73,32,60,39,204
2024-03-08 14:40:00,74,35,43,20,172
2024-03-08 14:50:00,88,38,36,20,182
2024-03-08 15:00:00,65,33,47,29,174
2024-03-08 15:10:00,70,44,54,36,204
2024-03-08 15:20:00,77,47,60,39,223
2024-03-08 15:30:00,87,38,58,48,231
2024-03-08 15:40:00,77,34,61,35,207
2024-03-08 15:50:00,76,31,51,36,194
2024-03-08 16:00:00,72,30,52,35,189
2024-03-08 16:10:00,84,44,56,39,223
2024-03-08 16:20:00,78,33,62,38,211
2024-03-08 16:30:00,64,33,53,39,189
2024-03-08 16:40:00,79,40,44,34,197
2024-03-08 16:50:00,75,41,44,33,193
2024-03-08 17:00:00,66,26,57,41,190
2024-03-08 17:10:00,77,41,57,27,202
2024-03-08 17:20:00,77,36,51,33,197
2024-03-08 17:30:00,71,24,51,36,182
2024-03-08 17:40:00,76,30,51,31,188
2024-03-08 17:50:00,73,50,55,37,215
2024-03-08 18:00:00,87,33,44,28,192
2024-03-08 18:10:00,86,37,47,28,198
2024-03-08 18:20:00,82,30,43,39,194
2024-03-08 18:30:00,69,28,53,44,194
2024-03-08 18:40:00,65,30,56,28,179
2024-03-08 18:50:00,77,35,49,23,184
2024-03-08 19:00:00,65,30,44,27,166
2024-03-08 19:10:00,81,33,41,17,172
2024-03-08 19:20:00,67,30,29,14,140
2024-03-08 19:30:00,64,26,44,25,159
2024-03-08 19:40:00,67,28,39,20,154
2024-03-08 19:50:00,56,27,48,18,149
2024-03-08 20:00:00,66,34,36,13,149
2024-03-08 20:10:00,68,26,20,18,132
2024-03-08 20:20:00,62,25,23,9,119
2024-03-08 20:30:00,40,20,26,11,97
2024-03-08 20:40:00,52,22,16,11,101
2024-03-08 20:50:00,51,20,20,10,101
2024-03-08 21:00:00,45,19,15,10,89
2024-03-08 21:10:00,44,19,17,7,87
2024-03-08 21:20:00,53,16,21,16,106
2024-03-08 21:30:00,57,15,20,13,105
2024-03-08 21:40:00,44,20,30,14,108
2024-03-08 21:50:00,46,21,25,6,98
2024-03-08 22:00:00,42,18,23,13,96
2024-03-08 22:10:00,50,18,19,18,105
2024-03-08 22:20:00,81,47,9,10,147
2024-03-08 22:30:00,82,31,13,7,133
2024-03-08 22:40:00,68,27,20,7,122
2024-03-08 22:50:00,37,13,18,8,76
2024-03-08 23:00:00,54,12,17,6,89
2024-03-08 23:10:00,45,22,16,8,91
2024-03-08 23:20:00,34,15,12,2,63
2024-03-08 23:30:00,34,18,3,5,60
2024-03-08 23:40:00,30,16,15,6,67
2024-03-08 23:50:00,20,4,11,5,40
2024-03-09 00:00:00,29,9,10,6,54
2024-03-09 00:10:00,24,6,10,4,44
2024-03-09 00:20:00,21,3,12,2,38
2024-03-09 00:30:00,29,14,10,9,62
2024-03-09 00:40:00,35,11,5,1,52
2024-03-09 00:50:00,19,9,6,2,36
2024-03-09 01:00:00,17,8,12,3,40
2024-03-09 01:10:00,15,3,6,3,27
2024-03-09 01:20:00,16,2,14,3,35
2024-03-09 01:30:00,18,5,4,1,28
2024-03-09 01:40:00,11,3,5,2,21
2024-03-09 01:50:00,15,0,7,2,24
2024-03-09 02:00:00,13,2,5,3,23
2024-03-09 02:10:00,12,3,9,3,27
2024-03-09 02:20:00,7,2,1,0,10
2024-03-09 02:30:00,10,2,7,2,21
2024-03-09 02:40:00,7,0,3,1,11
2024-03-09 02:50:00,11,3,2,1,17
2024-03-09 03:00:00,9,3,3,0,15
2024-03-09 03:10:00,6,1,4,2,13
2024-03-09 03:20:00,10,2,1,2,15
2024-03-09 03:30:00,5,1,2,1,9
2024-03-09 03:40:00,6,1,2,0,9
2024-03-09 03:50:00,4,0,1,1,6
2024-03-09 04:00:00,10,2,2,2,16
2024-03-09 04:10:00,5,2,4,1,12
2024-03-09 04:20:00,5,2,4,3,14
2024-03-09 04:30:00,8,0,2,3,13
2024-03-09 04:40:00,5,2,3,2,12
2024-03-09 04:50:00,7,3,6,2,18
2024-03-09 05:00:00,6,1,3,2,12
2024-03-09 05:10:00,7,3,8,1,19
2024-03-09 05:20:00,10,4,2,5,21
2024-03-09 05:30:00,14,3,10,6,33
2024-03-09 05:40:00,11,3,11,1,26
2024-03-09 05:50:00,7,1,3,4,15
2024-03-09 06:00:00,11,2,3,5,21
2024-03-09 06:10:00,14,3,9,3,29
2024-03-09 06:20:00,17,2,10,1,30
2024-03-09 06:30:00,20,5,7,2,34
2024-03-09 06:40:00,15,5,5,3,28
2024-03-09 06:50:00,17,3,13,12,45
2024-03-09 07:00:00,25,8,5,6,44
2024-03-09 07:10:00,15,5,9,7,36
2024-03-09 07:20:00,14,1,6,7,28
2024-03-09 07:30:00,30,11,13,7,61
2024-03-09 07:40:00,22,12,13,15,62
2024-03-09 07:50:00,13,7,19,19,58
2024-03-09 08:00:00,29,6,15,11,61
2024-03-09 08:10:00,17,8,11,5,41
2024-03-09 08:20:00,29,6,16,9,60
2024-03-09 08:30:00,31,15,18,6,70
2024-03-09 08:40:00,31,6,24,6,67
2024-03-09 08:50:00,39,16,23,10,88
2024-03-09 09:00:00,42,18,23,12,95
2024-03-09 09:10:00,48,13,20,10,91
2024-03-09 09:20:00,41,11,33,15,100
2024-03-09 09:30:00,40,11,33,10,94
2024-03-09 09:40:00,41,16,33,16,106
2024-03-09 09:50:00,30,13,48,24,115
2024-03-09 10:00:00,49,15,52,19,135
2024-03-09 10:10:00,35,18,34,18,105
2024-03-09 10:20:00,52,16,45,16,129
2024-03-09 10:30:00,40,15,42,22,119
2024-03-09 10:40:00,60,26,40,14,140
2024-03-09 10:50:00,50,16,48,21,135
2024-03-09 11:00:00,47,19,36,15,117
2024-03-09 11:10:00,58,24,48,21,151
2024-03-09 11:20:00,50,25,54,22,151
2024-03-09 11:30:00,59,28,44,27,158
2024-03-09 11:40:00,61,27,46,26,160
2024-03-09 11:50:00,46,22,43,18,129
2024-03-09 12:00:00,74,35,57,29,195
2024-03-09 12:10:00,60,32,38,28,158
2024-03-09 12:20:00,73,25,50,27,175
2024-03-09 12:30:00,64,25,56,29,174
2024-03-09 12:40:00,79,29,48,28,184
2024-03-09 12:50:00,58,31,52,32,173
2024-03-09 13:00:00,68,31,57,28,184
2024-03-09 13:10:00,64,32,50,25,171
2024-03-09 13:20:00,78,37,45,19,179
2024-03-09 13:30:00,60,41,49,12,162
2024-03-09 13:40:00,72,29,55,28,184
2024-03-09 13:50:00,77,40,41,23,181
2024-03-09 14:00:00,48,27,52,36,163
2024-03-09 14:10:00,73,34,45,23,175
2024-03-09 14:20:00,79,41,56,31,207
2024-03-09 14:30:00,69,28,41,25,163
2024-03-09 14:40:00,78,40,53,26,197
2024-03-09 14:50:00,90,36,39,19,184
2024-03-09 15:00:00,86,49,43,17,195
2024-03-09 15:10:00,69,32,55,27,183
2024-03-09 15:20:00,86,41,35,23,185
2024-03-09 15:30:00,76,40,49,25,190
2024-03-09 15:40:00,74,21,36,16,147
2024-03-09 15:50:00,78,44,46,24,192
2024-03-09 16:00:00,62,38,49,17,166
2024-03-09 16:10:00,66,34,45,25,170
2024-03-09 16:20:00,72,35,45,18,170
2024-03-09 16:30:00,76,36,36,15,163
2024-03-09 16:40:00,71,30,38,23,162
2024-03-09 16:50:00,71,30,49,19,169
2024-03-09 17:00:00,66,31,47,17,161
2024-03-09 17:10:00,64,26,33,18,141
2024-03-09 17:20:00,69,31,44,26,170
2024-03-09 17:30:00,75,39,27,20,161
2024-03-09 17:40:00,98,33,41,20,192
2024-03-09 17:50:00,73,24,42,24,163
2024-03-09 18:00:00,79,33,37,19,168
2024-03-09 18:10:00,69,31,35,22,157
2024-03-09 18:20:00,65,30,30,14,139
2024-03-09 18:30:00,77,30,41,10,158
2024-03-09 18:40:00,76,29,42,28,175
2024-03-09 18:50:00,69,31,52,16,168
2024-03-09 19:00:00,57,33,48,16,154
2024-03-09 19:10:00,55,20,33,19,127
2024-03-09 19:20:00,69,33,29,23,154
2024-03-09 19:30:00,64,22,26,15,127
2024-03-09 19:40:00,53,18,36,17,124
2024-03-09 19:50:00,60,25,31,7,123
2024-03-09 20:00:00,59,20,29,12,120
2024-03-09 20:10:00,68,27,26,7,128
2024-03-09 20:20:00,46,18,24,14,102
2024-03-09 20:30:00,50,17,21,11,99
2024-03-09 20:40:00,51,19,26,7,103
2024-03-09 20:50:00,53,12,21,7,93
2024-03-09 21:00:00,43,12,18,8,81
2024-03-09 21:10:00,44,8,19,8,79
2024-03-09 21:20:00,50,24,15,8,97
2024-03-09 21:30:00,56,20,25,10,111
2024-03-09 21:40:00,48,22,15,9,94
2024-03-09 21:50:00,39,8,22,9,78
2024-03-09 22:00:00,38,9,14,7,68
2024-03-09 22:10:00,38,9,9,10,66
2024-03-09 22:20:00,47,18,15,8,88
2024-03-09 22:30:00,47,11,15,9,82
2024-03-09 22:40:00,43,18,12,9,82
2024-03-09 22:50:00,43,22,20,8,93
2024-03-09 23:00:00,40,18,17,7,82
2024-03-09 23:10:00,62,21,14,4,101
2024-03-09 23:20:00,55,15,12,7,89
2024-03-09 23:30:00,39,18,9,4,70
2024-03-09 23:40:00,48,17,14,5,84
2024-03-09 23:50:00,32,13,7,6,58
2024-03-10 00:00:00,23,5,14,6,48
2024-03-10 00:10:00,19,7,14,8,48
2024-03-10 00:20:00,19,5,10,4,38
2024-03-10 00:30:00,26,7,16,5,54
2024-03-10 00:40:00,27,8,17,6,58
2024-03-10 00:50:00,17,3,12,6,38
2024-03-10 01:00:00,20,10,8,1,39
2024-03-10 01:10:00,12,3,5,5,25
2024-03-10 01:20:00,14,8,9,2,33
2024-03-10 01:30:00,11,7,8,5,31
2024-03-10 01:40:00,21,4,6,2,33
2024-03-10 01:50:00,8,6,2,2,18
2024-03-10 02:00:00,11,1,5,4,21
2024-03-10 02:10:00,15,2,7,1,25
2024-03-10 02:20:00,11,5,7,1,24
2024-03-10 02:30:00,9,3,5,1,18
2024-03-10 02:40:00,10,5,5,1,21
2024-03-10 02:50:00,12,3,4,1,20
2024-03-10 03:00:00,8,1,2,2,13
2024-03-10 03:10:00,11,3,8,4,26
2024-03-10 03:20:00,17,2,2,2,23
2024-03-10 03:30:00,10,1,3,1,15
2024-03-10 03:40:00,8,1,1,2,12
2024-03-10 03:50:00,10,2,3,1,16
2024-03-10 04:00:00,11,2,1,0,14
2024-03-10 04:10:00,13,2,3,2,20
2024-03-10 04:20:00,12,3,3,1,19
2024-03-10 04:30:00,14,4,2,2,22
2024-03-10 04:40:00,10,2,1,0,13
2024-03-10 04:50:00,5,0,2,1,8
2024-03-10 05:00:00,5,0,3,2,10
2024-03-10 05:10:00,9,0,3,1,13
2024-03-10 05:20:00,8,5,6,1,20
2024-03-10 05:30:00,11,1,7,1,20
2024-03-10 05:40:00,12,4,5,3,24
2024-03-10 05:50:00,7,1,1,2,11
2024-03-10 06:00:00,8,1,2,2,13
2024-03-10 06:10:00,7,0,7,1,15
2024-03-10 06:20:00,8,3,2,2,15
2024-03-10 06:30:00,2,1,3,1,7
2024-03-10 06:40:00,9,1,1,2,13
2024-03-10 06:50:00,13,1,5,4,23
2024-03-10 07:00:00,3,1,3,4,11
2024-03-10 07:10:00,5,2,2,2,11
2024-03-10 07:20:00,14,4,8,5,31
2024-03-10 07:30:00,14,3,4,4,25
2024-03-10 07:40:00,13,2,7,1,23
2024-03-10 07:50:00,12,3,6,5,26
2024-03-10 08:00:00,8,1,7,1,17
2024-03-10 08:10:00,14,3,6,0,23
2024-03-10 08:20:00,18,5,11,2,36
2024-03-10 08:30:00,22,2,9,0,33
2024-03-10 08:40:00,16,3,9,4,32
2024-03-10 08:50:00,15,6,4,1,26
2024-03-10 09:00:00,27,11,12,5,55
2024-03-10 09:10:00,19,6,10,5,40
2024-03-10 09:20:00,20,7,5,3,35
2024-03-10 09:30:00,21,7,16,3,47
2024-03-10 09:40:00,21,5,18,8,52
2024-03-10 09:50:00,39,9,23,10,81
2024-03-10 10:00:00,34,9,16,17,76
2024-03-10 10:10:00,35,12,16,9,72
2024-03-10 10:20:00,34,15,23,12,84
2024-03-10 10:30:00,31,9,20,10,70
2024-03-10 10:40:00,43,19,25,3,90
2024-03-10 10:50:00,43,12,28,12,95
2024-03-10 11:00:00,38,9,14,9,70
2024-03-10 11:10:00,40,16,25,17,98
2024-03-10 11:20:00,40,10,23,8,81
2024-03-10 11:30:00,57,13,25,12,107
2024-03-10 11:40:00,47,12,21,11,91
2024-03-10 11:50:00,52,13,25,17,107
2024-03-10 12:00:00,52,17,21,14,104
2024-03-10 12:10:00,59,19,22,11,111
2024-03-10 12:20:00,55,23,21,10,109
2024-03-10 12:30:00,48,18,31,12,109
2024-03-10 12:40:00,64,24,22,14,124
2024-03-10 12:50:00,61,25,31,14,131
2024-03-10 13:00:00,47,16,28,15,106
2024-03-10 13:10:00,65,23,31,18,137
2024-03-10 13:20:00,57,18,31,9,115
2024-03-10 13:30:00,61,16,33,11,121
2024-03-10 13:40:00,60,16,22,13,111
2024-03-10 13:50:00,59,20,31,16,126
2024-03-10 14:00:00,55,20,33,13,121
2024-03-10 14:10:00,60,21,35,19,135
2024-03-10 14:20:00,78,32,32,14,156
2024-03-10 14:30:00,73,25,35,16,149
2024-03-10 14:40:00,64,29,36,14,143
2024-03-10 14:50:00,67,19,36,19,141
2024-03-10 15:00:00,72,29,38,18,157
2024-03-10 15:10:00,59,30,34,20,143
2024-03-10 15:20:00,57,17,25,20,119
2024-03-10 15:30:00,62,24,33,21,140
2024-03-10 15:40:00,55,16,52,13,136
2024-03-10 15:50:00,66,27,29,18,140
2024-03-10 16:00:00,44,20,36,11,111
2024-03-10 16:10:00,60,19,30,14,123
2024-03-10 16:20:00,66,24,28,15,133
2024-03-10 16:30:00,62,21,29,20,132
2024-03-10 16:40:00,76,24,29,15,144
2024-03-10 16:50:00,61,26,30,12,129
2024-03-10 17:00:00,59,17,26,10,112
2024-03-10 17:10:00,54,17,36,13,120
2024-03-10 17:20:00,74,28,33,16,151
2024-03-10 17:30:00,63,27,27,12,129
2024-03-10 17:40:00,63,20,36,18,137
2024-03-10 17:50:00,69,22,29,18,138
2024-03-10 18:00:00,70,25,33,13,141
2024-03-10 18:10:00,63,28,29,14,134
2024-03-10 18:20:00,49,21,31,13,114
2024-03-10 18:30:00,64,22,32,9,127
2024-03-10 18:40:00,44,18,38,10,110
2024-03-10 18:50:00,54,22,26,11,113
2024-03-10 19:00:00,58,13,23,14,108
2024-03-10 19:10:00,45,17,25,13,100
2024-03-10 19:20:00,50,22,21,10,103
2024-03-10 19:30:00,33,11,27,13,84
2024-03-10 19:40:00,40,11,28,19,98
2024-03-10 19:50:00,28,14,27,12,81
2024-03-10 20:00:00,52,19,21,6,98
2024-03-10 20:10:00,45,16,29,15,105
2024-03-10 20:20:00,35,9,13,4,61
2024-03-10 20:30:00,34,11,14,13,72
2024-03-10 20:40:00,33,14,12,8,67
2024-03-10 20:50:00,45,19,17,7,88
2024-03-10 21:00:00,29,7,10,9,55
2024-03-10 21:10:00,34,16,16,9,75
2024-03-10 21:20:00,40,18,13,6,77
2024-03-10 21:30:00,41,12,13,10,76
2024-03-10 21:40:00,37,12,12,7,68
2024-03-10 21:50:00,30,3,14,3,50
2024-03-10 22:00:00,28,10,9,2,49
2024-03-10 22:10:00,28,6,11,8,53
2024-03-10 22:20:00,16,2,15,5,38
2024-03-10 22:30:00,25,7,11,5,48
2024-03-10 22:40:00,14,4,9,5,32
2024-03-10 22:50:00,22,3,17,7,49
2024-03-10 23:00:00,16,2,7,3,28
2024-03-10 23:10:00,19,4,10,5,38
2024-03-10 23:20:00,13,6,8,2,29
2024-03-10 23:30:00,18,6,3,5,32
2024-03-10 23:40:00,11,2,2,2,17
2024-03-10 23:50:00,9,2,7,5,23
2024-03-11 00:00:00,4,1,8,3,16
2024-03-11 00:10:00,12,1,2,1,16
2024-03-11 00:20:00,8,2,3,1,14
2024-03-11 00:30:00,5,1,3,5,14
2024-03-11 00:40:00,7,2,2,4,15
2024-03-11 00:50:00,7,2,5,0,14
2024-03-11 01:00:00,6,5,3,0,14
2024-03-11 01:10:00,6,1,1,0,8
2024-03-11 01:20:00,2,0,1,1,4
2024-03-11 01:30:00,3,0,1,1,5
2024-03-11 01:40:00,3,1,4,2,10
2024-03-11 01:50:00,4,0,0,0,4
2024-03-11 02:00:00,6,0,2,0,8
2024-03-11 02:10:00,2,0,0,0,2
2024-03-11 02:20:00,3,0,2,1,6
2024-03-11 02:30:00,4,1,5,2,12
2024-03-11 02:40:00,4,1,1,0,6
2024-03-11 02:50:00,3,0,7,1,11
2024-03-11 03:00:00,2,0,0,0,2
2024-03-11 03:10:00,0,0,1,0,1
2024-03-11 03:20:00,2,0,2,1,5
2024-03-11 03:30:00,2,0,2,0,4
2024-03-11 03:40:00,4,0,2,1,7
2024-03-11 03:50:00,5,0,1,0,6
2024-03-11 04:00:00,6,4,1,1,12
2024-03-11 04:10:00,6,2,0,1,9
2024-03-11 04:20:00,13,1,3,1,18
2024-03-11 04:30:00,8,2,1,2,13
2024-03-11 04:40:00,10,3,4,1,18
2024-03-11 04:50:00,8,2,3,0,13
2024-03-11 05:00:00,15,3,3,1,22
2024-03-11 05:10:00,20,5,7,3,35
2024-03-11 05:20:00,23,10,13,5,51
2024-03-11 05:30:00,35,23,9,4,71
2024-03-11 05:40:00,30,11,19,9,69
2024-03-11 05:50:00,38,12,16,11,77
2024-03-11 06:00:00,48,18,16,7,89
2024-03-11 06:10:00,48,19,17,16,100
2024-03-11 06:20:00,42,21,18,15,96
2024-03-11 06:30:00,57,30,28,21,136
2024-03-11 06:40:00,57,24,30,19,130
2024-03-11 06:50:00,48,25,32,19,124
2024-03-11 07:00:00,71,30,28,17,146
2024-03-11 07:10:00,62,32,42,31,167
2024-03-11 07:20:00,70,29,37,35,171
2024-03-11 07:30:00,67,40,53,45,205
2024-03-11 07:40:00,86,47,62,63,258
2024-03-11 07:50:00,74,40,49,42,205
2024-03-11 08:00:00,79,37,53,42,211
2024-03-11 08:10:00,85,45,52,39,221
2024-03-11 08:20:00,84,32,49,43,208
2024-03-11 08:30:00,73,32,55,41,201
2024-03-11 08:40:00,69,37,55,32,193
2024-03-11 08:50:00,80,46,47,32,205
2024-03-11 09:00:00,77,31,36,30,174
2024-03-11 09:10:00,63,31,40,29,163
2024-03-11 09:20:00,75,23,37,27,162
2024-03-11 09:30:00,55,15,39,33,142
2024-03-11 09:40:00,76,27,60,34,197
2024-03-11 09:50:00,66,32,38,21,157
2024-03-11 10:00:00,46,27,47,31,151
2024-03-11 10:10:00,52,21,33,24,130
2024-03-11 10:20:00,63,27,40,25,155
2024-03-11 10:30:00,52,13,39,21,125
2024-03-11 10:40:00,52,17,39,27,135
2024-03-11 10:50:00,65,22,48,27,162
2024-03-11 11:00:00,68,28,34,24,154
2024-03-11 11:10:00,57,21,40,21,139
2024-03-11 11:20:00,63,30,39,19,151
2024-03-11 11:30:00,70,32,25,20,147
2024-03-11 11:40:00,63,29,41,31,164
2024-03-11 11:50:00,76,39,32,19,166
2024-03-11 12:00:00,75,33,41,30,179
2024-03-11 12:10:00,49,27,41,27,144
2024-03-11 12:20:00,74,22,38,22,156
2024-03-11 12:30:00,60,25,34,19,138
2024-03-11 12:40:00,61,31,43,25,160
2024-03-11 12:50:00,65,24,37,30,156
2024-03-11 13:00:00,73,31,39,23,166
2024-03-11 13:10:00,85,41,54,25,205
2024-03-11 13:20:00,73,38,36,31,178
2024-03-11 13:30:00,60,30,39,26,155
2024-03-11 13:40:00,76,21,45,33,175
2024-03-11 13:50:00,77,28,35,26,166
2024-03-11 14:00:00,50,29,31,27,137
2024-03-11 14:10:00,74,36,40,24,174
2024-03-11 14:20:00,71,29,49,23,172
2024-03-11 14:30:00,75,40,29,33,177
2024-03-11 14:40:00,70,31,54,41,196
2024-03-11 14:50:00,79,30,53,21,183
2024-03-11 15:00:00,66,29,44,25,164
2024-03-11 15:10:00,70,33,48,33,184
2024-03-11 15:20:00,64,28,43,32,167
2024-03-11 15:30:00,75,44,47,40,206
2024-03-11 15:40:00,82,34,40,19,175
2024-03-11 15:50:00,61,44,50,32,187
2024-03-11 16:00:00,82,40,63,44,229
2024-03-11 16:10:00,77,44,45,35,201
2024-03-11 16:20:00,77,42,50,27,196
2024-03-11 16:30:00,72,31,54,33,190
2024-03-11 16:40:00,69,43,48,39,199
2024-03-11 16:50:00,77,37,54,36,204
2024-03-11 17:00:00,81,36,46,38,201
2024-03-11 17:10:00,83,50,49,46,228
2024-03-11 17:20:00,94,55,49,29,227
2024-03-11 17:30:00,84,39,48,34,205
2024-03-11 17:40:00,84,42,46,30,202
2024-03-11 17:50:00,67,43,42,26,178
2024-03-11 18:00:00,65,35,39,36,175
2024-03-11 18:10:00,69,39,42,24,174
2024-03-11 18:20:00,66,32,35,19,152
2024-03-11 18:30:00,52,24,40,23,139
2024-03-11 18:40:00,54,26,38,18,136
2024-03-11 18:50:00,51,32,33,17,133
2024-03-11 19:00:00,41,12,33,18,104
2024-03-11 19:10:00,67,26,30,18,141
2024-03-11 19:20:00,44,21,26,16,107
2024-03-11 19:30:00,47,22,28,19,116
2024-03-11 19:40:00,38,9,29,11,87
2024-03-11 19:50:00,43,20,23,26,112
2024-03-11 20:00:00,48,19,21,20,108
2024-03-11 20:10:00,34,11,23,13,81
2024-03-11 20:20:00,33,11,19,9,72
2024-03-11 20:30:00,40,16,25,10,91
2024-03-11 20:40:00,31,13,29,20,93
2024-03-11 20:50:00,39,14,19,8,80
2024-03-11 21:00:00,26,7,22,9,64
2024-03-11 21:10:00,32,11,12,8,63
2024-03-11 21:20:00,38,10,9,7,64
2024-03-11 21:30:00,49,18,17,8,92
2024-03-11 21:40:00,38,14,12,5,69
2024-03-11 21:50:00,33,17,16,4,70
2024-03-11 22:00:00,31,11,15,6,63
2024-03-11 22:10:00,37,11,7,8,63
2024-03-11 22:20:00,25,13,11,6,55
2024-03-11 22:30:00,29,8,10,5,52
2024-03-11 22:40:00,15,4,9,3,31
2024-03-11 22:50:00,25,7,10,4,46
2024-03-11 23:00:00,13,2,6,4,25
2024-03-11 23:10:00,15,4,11,5,35
2024-03-11 23:20:00,14,4,5,4,27
2024-03-11 23:30:00,8,2,7,4,21
2024-03-11 23:40:00,13,4,5,0,22
2024-03-11 23:50:00,8,3,8,4,23
2024-03-12 00:00:00,8,2,5,2,17
2024-03-12 00:10:00,10,1,4,3,18
2024-03-12 00:20:00,6,0,2,0,8
2024-03-12 00:30:00,10,0,2,2,14
2024-03-12 00:40:00,4,0,1,1,6
2024-03-12 00:50:00,5,3,5,1,14
2024-03-12 01:00:00,4,3,1,0,8
2024-03-12 01:10:00,3,2,3,1,9
2024-03-12 01:20:00,8,2,3,2,15
2024-03-12 01:30:00,4,1,1,1,7
2024-03-12 01:40:00,4,0,1,3,8
2024-03-12 01:50:00,4,0,2,0,6
2024-03-12 02:00:00,7,1,4,2,14
2024-03-12 02:10:00,1,0,1,1,3
2024-03-12 02:20:00,4,0,1,0,5
2024-03-12 02:30:00,4,2,1,0,7
2024-03-12 02:40:00,4,1,0,2,7
2024-03-12 02:50:00,1,0,4,0,5
2024-03-12 03:00:00,3,0,3,1,7
2024-03-12 03:10:00,3,1,0,0,4
2024-03-12 03:20:00,6,0,1,0,7
2024-03-12 03:30:00,7,1,1,0,9
2024-03-12 03:40:00,1,0,1,0,2
2024-03-12 03:50:00,8,0,3,3,14
2024-03-12 04:00:00,5,0,0,1,6
2024-03-12 04:10:00,6,2,4,2,14
2024-03-12 04:20:00,5,1,1,1,8
2024-03-12 04:30:00,9,3,3,0,15
2024-03-12 04:40:00,12,3,3,2,20
2024-03-12 04:50:00,13,4,3,1,21
2024-03-12 05:00:00,15,4,5,3,27
2024-03-12 05:10:00,19,6,5,4,34
2024-03-12 05:20:00,26,7,9,4,46
2024-03-12 05:30:00,40,17,7,6,70
2024-03-12 05:40:00,33,10,16,7,66
2024-03-12 05:50:00,33,15,19,12,79
2024-03-12 06:00:00,36,15,14,7,72
2024-03-12 06:10:00,46,14,23,22,105
2024-03-12 06:20:00,56,22,18,12,108
2024-03-12 06:30:00,63,24,35,27,149
2024-03-12 06:40:00,64,24,34,28,150
2024-03-12 06:50:00,56,29,25,24,134
2024-03-12 07:00:00,59,30,28,26,143
2024-03-12 07:10:00,71,31,47,33,182
2024-03-12 07:20:00,65,35,53,48,201
2024-03-12 07:30:00,86,36,47,43,212
2024-03-12 07:40:00,79,47,57,56,239
2024-03-12 07:50:00,89,55,63,55,262
2024-03-12 08:00:00,78,39,58,57,232
2024-03-12 08:10:00,94,43,75,53,265
2024-03-12 08:20:00,88,50,47,50,235
2024-03-12 08:30:00,82,46,68,53,249
2024-03-12 08:40:00,82,36,60,52,230
2024-03-12 08:50:00,74,36,62,46,218
2024-03-12 09:00:00,76,38,35,36,185
2024-03-12 09:10:00,64,31,64,46,205
2024-03-12 09:20:00,71,32,39,26,168
2024-03-12 09:30:00,75,32,45,42,194
2024-03-12 09:40:00,77,23,59,31,190
2024-03-12 09:50:00,64,30,39,29,162
2024-03-12 10:00:00,76,26,40,22,164
2024-03-12 10:10:00,62,16,36,18,132
2024-03-12 10:20:00,61,21,28,16,126
2024-03-12 10:30:00,61,28,40,29,158
2024-03-12 10:40:00,57,21,42,16,136
2024-03-12 10:50:00,61,30,38,26,155
2024-03-12 11:00:00,60,23,31,28,142
2024-03-12 11:10:00,62,18,40,25,145
2024-03-12 11:20:00,66,25,40,33,164
2024-03-12 11:30:00,67,29,37,17,150
2024-03-12 11:40:00,65,22,45,24,156
2024-03-12 11:50:00,59,22,30,25,136
2024-03-12 12:00:00,58,26,48,17,149
2024-03-12 12:10:00,68,25,38,21,152
2024-03-12 12:20:00,70,37,38,30,175
2024-03-12 12:30:00,61,24,32,31,148
2024-03-12 12:40:00,75,42,43,31,191
2024-03-12 12:50:00,59,26,29,27,141
2024-03-12 13:00:00,77,36,34,22,169
2024-03-12 13:10:00,85,36,50,31,202
2024-03-12 13:20:00,74,27,35,20,156
2024-03-12 13:30:00,68,33,36,21,158
2024-03-12 13:40:00,74,21,43,21,159
2024-03-12 13:50:00,76,29,44,28,177
2024-03-12 14:00:00,69,27,49,16,161
2024-03-12 14:10:00,79,38,41,33,191
2024-03-12 14:20:00,72,31,54,32,189
2024-03-12 14:30:00,61,35,40,25,161
2024-03-12 14:40:00,73,42,42,29,186
2024-03-12 14:50:00,64,27,40,27,158
2024-03-12 15:00:00,70,28,47,24,169
2024-03-12 15:10:00,86,45,45,34,210
2024-03-12 15:20:00,85,50,41,26,202
2024-03-12 15:30:00,68,38,38,41,185
2024-03-12 15:40:00,84,50,40,36,210
2024-03-12 15:50:00,76,45,47,36,204
2024-03-12 16:00:00,88,45,50,38,221
2024-03-12 16:10:00,76,47,55,57,235
2024-03-12 16:20:00,80,55,46,31,212
2024-03-12 16:30:00,69,33,49,34,185
2024-03-12 16:40:00,89,53,51,43,236
2024-03-12 16:50:00,61,40,55,41,197
2024-03-12 17:00:00,94,41,56,48,239
2024-03-12 17:10:00,85,54,58,32,229
2024-03-12 17:20:00,76,49,45,37,207
2024-03-12 17:30:00,80,56,48,42,226
2024-03-12 17:40:00,76,41,60,35,212
2024-03-12 17:50:00,79,39,51,35,204
2024-03-12 18:00:00,71,37,46,37,191
2024-03-12 18:10:00,81,38,48,32,199
2024-03-12 18:20:00,74,36,47,36,193
2024-03-12 18:30:00,61,23,43,31,158
2024-03-12 18:40:00,52,26,45,24,147
2024-03-12 18:50:00,38,12,32,17,99
2024-03-12 19:00:00,39,16,31,21,107
2024-03-12 19:10:00,52,24,32,23,131
2024-03-12 19:20:00,51,17,20,18,106
2024-03-12 19:30:00,45,18,30,19,112
2024-03-12 19:40:00,47,18,26,17,108
2024-03-12 19:50:00,44,12,27,12,95
2024-03-12 20:00:00,39,12,23,7,81
2024-03-12 20:10:00,46,15,17,14,92
2024-03-12 20:20:00,37,14,14,13,78
2024-03-12 20:30:00,34,13,18,12,77
2024-03-12 20:40:00,33,13,17,8,71
2024-03-12 20:50:00,39,13,10,6,68
2024-03-12 21:00:00,28,10,19,10,67
2024-03-12 21:10:00,47,20,18,9,94
2024-03-12 21:20:00,39,8,17,9,73
2024-03-12 21:30:00,44,22,19,8,93
2024-03-12 21:40:00,36,9,8,4,57
2024-03-12 21:50:00,45,16,12,7,80
2024-03-12 22:00:00,33,13,11,9,66
2024-03-12 22:10:00,29,4,18,5,56
2024-03-12 22:20:00,27,6,7,8,48
2024-03-12 22:30:00,28,8,9,4,49
2024-03-12 22:40:00,19,8,10,4,41
2024-03-12 22:50:00,18,3,9,4,34
2024-03-12 23:00:00,24,6,6,4,40
2024-03-12 23:10:00,12,6,8,7,33
2024-03-12 23:20:00,7,3,8,2,20
2024-03-12 23:30:00,19,6,9,5,39
2024-03-12 23:40:00,13,5,4,2,24
2024-03-12 23:50:00,6,2,8,2,18
2024-03-13 00:00:00,11,5,7,1,24
2024-03-13 00:10:00,9,1,6,2,18
2024-03-13 00:20:00,8,0,2,0,10
2024-03-13 00:30:00,13,2,4,3,22
2024-03-13 00:40:00,5,1,3,0,9
2024-03-13 00:50:00,2,1,5,3,11
2024-03-13 01:00:00,1,0,2,1,4
2024-03-13 01:10:00,4,1,4,1,10
2024-03-13 01:20:00,3,0,3,1,7
2024-03-13 01:30:00,2,0,0,0,2
2024-03-13 01:40:00,3,1,0,0,4
2024-03-13 01:50:00,8,1,1,0,10
2024-03-13 02:00:00,6,0,3,0,9
2024-03-13 02:10:00,1,1,0,1,3
2024-03-13 02:20:00,6,2,2,0,10
2024-03-13 02:30:00,6,1,1,0,8
2024-03-13 02:40:00,4,2,2,0,8
2024-03-13 02:50:00,5,2,2,1,10
2024-03-13 03:00:00,2,0,3,3,8
2024-03-13 03:10:00,1,0,4,1,6
2024-03-13 03:20:00,6,2,1,1,10
2024-03-13 03:30:00,3,1,4,1,9
2024-03-13 03:40:00,7,0,1,0,8
2024-03-13 03:50:00,1,0,3,0,4
2024-03-13 04:00:00,9,3,3,1,16
2024-03-13 04:10:00,5,3,1,1,10
2024-03-13 04:20:00,8,1,0,0,9
2024-03-13 04:30:00,10,3,1,2,16
2024-03-13 04:40:00,8,4,2,3,17
2024-03-13 04:50:00,14,4,2,0,20
2024-03-13 05:00:00,9,5,8,1,23
2024-03-13 05:10:00,20,6,6,4,36
2024-03-13 05:20:00,22,6,9,7,44
2024-03-13 05:30:00,40,11,11,6,68
2024-03-13 05:40:00,25,5,11,12,53
2024-03-13 05:50:00,35,9,15,8,67
2024-03-13 06:00:00,44,13,14,9,80
2024-03-13 06:10:00,38,18,26,12,94
2024-03-13 06:20:00,51,23,22,15,111
2024-03-13 06:30:00,51,22,22,25,120
2024-03-13 06:40:00,67,23,29,18,137
2024-03-13 06:50:00,68,29,38,34,169
2024-03-13 07:00:00,86,39,34,23,182
2024-03-13 07:10:00,68,35,44,31,178
2024-03-13 07:20:00,76,31,36,36,179
2024-03-13 07:30:00,61,33,65,53,212
2024-03-13 07:40:00,82,42,60,48,232
2024-03-13 07:50:00,86,47,55,61,249
2024-03-13 08:00:00,77,41,48,47,213
2024-03-13 08:10:00,70,40,58,37,205
2024-03-13 08:20:00,81,38,53,40,212
2024-03-13 08:30:00,89,44,70,38,241
2024-03-13 08:40:00,95,40,54,50,239
2024-03-13 08:50:00,84,37,62,46,229
2024-03-13 09:00:00,68,40,56,33,197
2024-03-13 09:10:00,61,26,56,42,185
2024-03-13 09:20:00,61,23,51,29,164
2024-03-13 09:30:00,70,34,42,26,172
2024-03-13 09:40:00,63,26,59,32,180
2024-03-13 09:50:00,51,23,53,27,154
2024-03-13 10:00:00,70,21,40,20,151
2024-03-13 10:10:00,63,23,43,18,147
2024-03-13 10:20:00,64,31,51,28,174
2024-03-13 10:30:00,50,35,47,23,155
2024-03-13 10:40:00,53,25,33,26,137
2024-03-13 10:50:00,74,36,44,35,189
2024-03-13 11:00:00,64,29,46,18,157
2024-03-13 11:10:00,62,28,38,22,150
2024-03-13 11:20:00,58,21,39,20,138
2024-03-13 11:30:00,66,22,39,24,151
2024-03-13 11:40:00,63,26,38,15,142
2024-03-13 11:50:00,74,37,30,15,156
2024-03-13 12:00:00,65,31,32,35,163
2024-03-13 12:10:00,79,41,43,21,184
2024-03-13 12:20:00,77,37,37,25,176
2024-03-13 12:30:00,61,29,31,19,140
2024-03-13 12:40:00,88,35,42,34,199
2024-03-13 12:50:00,58,31,41,31,161
2024-03-13 13:00:00,77,38,33,24,172
2024-03-13 13:10:00,78,31,42,22,173
2024-03-13 13:20:00,66,36,44,23,169
2024-03-13 13:30:00,85,48,46,24,203
2024-03-13 13:40:00,66,24,43,36,169
2024-03-13 13:50:00,83,29,43,17,172
2024-03-13 14:00:00,63,26,35,18,142
2024-03-13 14:10:00,69,26,42,23,160
2024-03-13 14:20:00,82,39,41,29,191
2024-03-13 14:30:00,70,41,40,36,187
2024-03-13 14:40:00,71,36,46,37,190
2024-03-13 14:50:00,72,25,40,29,166
2024-03-13 15:00:00,69,36,38,29,172
2024-03-13 15:10:00,81,43,39,32,195
2024-03-13 15:20:00,81,32,46,37,196
2024-03-13 15:30:00,80,41,46,30,197
2024-03-13 15:40:00,71,45,61,45,222
2024-03-13 15:50:00,80,42,46,33,201
2024-03-13 16:00:00,69,46,41,32,188
2024-03-13 16:10:00,77,45,50,41,213
2024-03-13 16:20:00,75,47,65,31,218
2024-03-13 16:30:00,82,46,51,33,212
2024-03-13 16:40:00,91,48,56,31,226
2024-03-13 16:50:00,79,45,44,38,206
2024-03-13 17:00:00,91,46,56,44,237
2024-03-13 17:10:00,79,46,58,38,221
2024-03-13 17:20:00,95,53,56,36,240
2024-03-13 17:30:00,73,40,51,44,208
2024-03-13 17:40:00,82,52,53,30,217
2024-03-13 17:50:00,77,41,43,32,193
2024-03-13 18:00:00,74,31,46,36,187
2024-03-13 18:10:00,90,44,58,34,226
2024-03-13 18:20:00,76,45,47,25,193
2024-03-13 18:30:00,56,23,46,34,159
2024-03-13 18:40:00,77,32,45,20,174
2024-03-13 18:50:00,54,23,25,13,115
2024-03-13 19:00:00,37,13,39,27,116
2024-03-13 19:10:00,70,20,18,10,118
2024-03-13 19:20:00,47,24,33,22,126
2024-03-13 19:30:00,54,23,36,22,135
2024-03-13 19:40:00,40,13,26,18,97
2024-03-13 19:50:00,40,9,21,15,85
2024-03-13 20:00:00,36,19,15,9,79
2024-03-13 20:10:00,51,23,25,9,108
2024-03-13 20:20:00,39,11,15,5,70
2024-03-13 20:30:00,30,10,31,12,83
2024-03-13 20:40:00,31,7,16,10,64
2024-03-13 20:50:00,35,15,20,10,80
2024-03-13 21:00:00,36,13,17,7,73
2024-03-13 21:10:00,43,11,17,8,79
2024-03-13 21:20:00,35,13,16,5,69
2024-03-13 21:30:00,39,12,15,8,74
2024-03-13 21:40:00,42,11,10,10,73
2024-03-13 21:50:00,35,12,19,7,73
2024-03-13 22:00:00,37,9,14,7,67
2024-03-13 22:10:00,41,11,18,9,79
2024-03-13 22:20:00,26,9,15,3,53
2024-03-13 22:30:00,36,17,12,6,71
2024-03-13 22:40:00,38,10,8,3,59
2024-03-13 22:50:00,28,7,8,5,48
2024-03-13 23:00:00,15,5,7,5,32
2024-03-13 23:10:00,27,7,9,1,44
2024-03-13 23:20:00,15,5,5,4,29
2024-03-13 23:30:00,14,6,5,3,28
2024-03-13 23:40:00,14,3,2,3,22
2024-03-13 23:50:00,10,3,4,3,20
2024-03-14 00:00:00,13,7,0,0,20
2024-03-14 00:10:00,9,4,4,1,18
2024-03-14 00:20:00,11,2,4,2,19
2024-03-14 00:30:00,8,1,1,1,11
2024-03-14 00:40:00,9,2,1,1,13
2024-03-14 00:50:00,4,2,3,0,9
2024-03-14 01:00:00,8,1,4,1,14
2024-03-14 01:10:00,8,1,1,1,11
2024-03-14 01:20:00,8,2,2,0,12
2024-03-14 01:30:00,3,0,2,2,7
2024-03-14 01:40:00,6,3,2,2,13
2024-03-14 01:50:00,5,1,3,1,10
2024-03-14 02:00:00,7,1,1,1,10
2024-03-14 02:10:00,5,0,4,1,10
2024-03-14 02:20:00,3,1,0,0,4
2024-03-14 02:30:00,3,0,1,1,5
2024-03-14 02:40:00,5,2,2,0,9
2024-03-14 02:50:00,2,0,1,1,4
2024-03-14 03:00:00,3,0,1,1,5
2024-03-14 03:10:00,1,0,4,2,7
2024-03-14 03:20:00,6,2,1,0,9
2024-03-14 03:30:00,2,1,4,1,8
2024-03-14 03:40:00,4,1,1,0,6
2024-03-14 03:50:00,2,1,2,1,6
2024-03-14 04:00:00,2,1,3,2,8
2024-03-14 04:10:00,6,1,1,2,10
2024-03-14 04:20:00,15,5,0,0,20
2024-03-14 04:30:00,9,0,2,4,15
2024-03-14 04:40:00,11,2,2,2,17
2024-03-14 04:50:00,10,3,2,1,16
2024-03-14 05:00:00,16,7,5,4,32
2024-03-14 05:10:00,13,6,4,2,25
2024-03-14 05:20:00,27,7,9,4,47
2024-03-14 05:30:00,16,7,9,4,36
2024-03-14 05:40:00,45,17,19,13,94
2024-03-14 05:50:00,30,10,20,13,73
2024-03-14 06:00:00,38,16,22,6,82
2024-03-14 06:10:00,51,22,21,17,111
2024-03-14 06:20:00,51,20,16,19,106
2024-03-14 06:30:00,46,18,24,16,104
2024-03-14 06:40:00,62,25,27,15,129
2024-03-14 06:50:00,52,23,27,26,128
2024-03-14 07:00:00,53,20,34,26,133
2024-03-14 07:10:00,63,28,39,22,152
2024-03-14 07:20:00,72,33,49,37,191
2024-03-14 07:30:00,79,33,64,41,217
2024-03-14 07:40:00,88,49,62,74,273
2024-03-14 07:50:00,82,44,49,48,223
2024-03-14 08:00:00,70,28,56,62,216
2024-03-14 08:10:00,71,37,60,48,216
2024-03-14 08:20:00,82,43,54,43,222
2024-03-14 08:30:00,77,41,62,42,222
2024-03-14 08:40:00,66,39,74,54,233
2024-03-14 08:50:00,84,30,60,45,219
2024-03-14 09:00:00,66,30,38,36,170
2024-03-14 09:10:00,59,22,46,37,164
2024-03-14 09:20:00,75,30,45,35,185
2024-03-14 09:30:00,50,19,39,25,133
2024-03-14 09:40:00,55,22,58,47,182
2024-03-14 09:50:00,50,16,43,33,142
2024-03-14 10:00:00,45,19,45,31,140
2024-03-14 10:10:00,58,23,35,18,134
2024-03-14 10:20:00,69,31,37,23,160
2024-03-14 10:30:00,57,18,37,15,127
2024-03-14 10:40:00,63,23,45,25,156
2024-03-14 10:50:00,64,22,44,23,153
2024-03-14 11:00:00,64,29,54,18,165
2024-03-14 11:10:00,54,24,33,16,127
2024-03-14 11:20:00,60,26,35,33,154
2024-03-14 11:30:00,66,29,33,35,163
2024-03-14 11:40:00,70,28,38,27,163
2024-03-14 11:50:00,70,28,25,20,143
2024-03-14 12:00:00,74,41,38,25,178
2024-03-14 12:10:00,69,30,42,25,166
2024-03-14 12:20:00,77,40,61,25,203
2024-03-14 12:30:00,70,17,30,20,137
2024-03-14 12:40:00,57,26,38,22,143
2024-03-14 12:50:00,75,21,43,31,170
2024-03-14 13:00:00,70,35,41,27,173
2024-03-14 13:10:00,60,31,45,30,166
2024-03-14 13:20:00,82,32,40,15,169
2024-03-14 13:30:00,78,38,49,29,194
2024-03-14 13:40:00,87,42,49,31,209
2024-03-14 13:50:00,70,33,54,19,176
2024-03-14 14:00:00,75,22,39,24,160
2024-03-14 14:10:00,86,26,48,32,192
2024-03-14 14:20:00,75,37,53,38,203
2024-03-14 14:30:00,83,26,43,22,174
2024-03-14 14:40:00,70,35,56,37,198
2024-03-14 14:50:00,82,47,44,34,207
2024-03-14 15:00:00,69,39,53,32,193
2024-03-14 15:10:00,76,40,49,41,206
2024-03-14 15:20:00,75,53,52,27,207
2024-03-14 15:30:00,97,55,50,30,232
2024-03-14 15:40:00,88,45,58,30,221
2024-03-14 15:50:00,81,42,54,36,213
2024-03-14 16:00:00,65,35,54,40,194
2024-03-14 16:10:00,95,53,57,38,243
2024-03-14 16:20:00,78,40,49,30,197
2024-03-14 16:30:00,90,55,63,37,245
2024-03-14 16:40:00,91,52,54,46,243
2024-03-14 16:50:00,84,37,60,39,220
2024-03-14 17:00:00,79,37,54,43,213
2024-03-14 17:10:00,105,46,43,29,223
2024-03-14 17:20:00,95,36,52,34,217
2024-03-14 17:30:00,77,49,53,39,218
2024-03-14 17:40:00,88,34,61,43,226
2024-03-14 17:50:00,94,34,51,35,214
2024-03-14 18:00:00,86,34,52,38,210
2024-03-14 18:10:00,86,48,54,33,221
2024-03-14 18:20:00,80,41,58,33,212
2024-03-14 18:30:00,64,25,38,24,151
2024-03-14 18:40:00,79,28,35,24,166
2024-03-14 18:50:00,60,27,36,19,142
2024-03-14 19:00:00,46,27,41,19,133
2024-03-14 19:10:00,52,22,33,15,122
2024-03-14 19:20:00,49,14,30,27,120
2024-03-14 19:30:00,56,13,27,18,114
2024-03-14 19:40:00,50,28,25,21,124
2024-03-14 19:50:00,48,15,32,23,118
2024-03-14 20:00:00,48,19,13,13,93
2024-03-14 20:10:00,51,22,25,11,109
2024-03-14 20:20:00,35,12,17,11,75
2024-03-14 20:30:00,27,15,21,5,68
2024-03-14 20:40:00,45,13,17,11,86
2024-03-14 20:50:00,37,18,18,4,77
2024-03-14 21:00:00,25,8,17,3,53
2024-03-14 21:10:00,45,13,21,13,92
2024-03-14 21:20:00,32,14,19,7,72
2024-03-14 21:30:00,41,20,22,3,86
2024-03-14 21:40:00,45,14,9,11,79
2024-03-14 21:50:00,26,12,17,6,61
2024-03-14 22:00:00,40,14,9,7,70
2024-03-14 22:10:00,27,13,18,8,66
2024-03-14 22:20:00,43,11,14,5,73
2024-03-14 22:30:00,30,9,13,6,58
2024-03-14 22:40:00,19,6,7,5,37
2024-03-14 22:50:00,34,9,12,5,60
2024-03-14 23:00:00,16,3,8,3,30
2024-03-14 23:10:00,27,11,11,7,56
2024-03-14 23:20:00,23,2,5,6,36
2024-03-14 23:30:00,19,7,7,2,35
2024-03-14 23:40:00,20,1,9,1,31
2024-03-14 23:50:00,12,3,4,1,20
2024-03-15 00:00:00,15,4,5,2,26
2024-03-15 00:10:00,12,5,6,4,27
2024-03-15 00:20:00,15,2,2,1,20
2024-03-15 00:30:00,6,2,8,4,20
2024-03-15 00:40:00,8,0,5,0,13
2024-03-15 00:50:00,8,1,1,1,11
2024-03-15 01:00:00,8,1,4,2,15
2024-03-15 01:10:00,8,4,4,3,19
2024-03-15 01:20:00,4,1,4,2,11
2024-03-15 01:30:00,5,1,3,1,10
2024-03-15 01:40:00,6,1,1,1,9
2024-03-15 01:50:00,7,0,1,1,9
2024-03-15 02:00:00,9,1,2,1,13
2024-03-15 02:10:00,3,1,2,1,7
2024-03-15 02:20:00,8,1,1,0,10
2024-03-15 02:30:00,2,3,2,0,7
2024-03-15 02:40:00,5,0,1,1,7
2024-03-15 02:50:00,9,0,4,4,17
2024-03-15 03:00:00,2,0,2,3,7
2024-03-15 03:10:00,3,2,2,1,8
2024-03-15 03:20:00,3,0,1,0,4
2024-03-15 03:30:00,3,0,2,1,6
2024-03-15 03:40:00,7,2,1,0,10
2024-03-15 03:50:00,6,2,1,0,9
2024-03-15 04:00:00,1,3,4,3,11
2024-03-15 04:10:00,7,2,6,1,16
2024-03-15 04:20:00,6,1,2,0,9
2024-03-15 04:30:00,5,2,3,2,12
2024-03-15 04:40:00,10,2,2,3,17
2024-03-15 04:50:00,17,4,0,0,21
2024-03-15 05:00:00,11,5,4,6,26
2024-03-15 05:10:00,10,0,5,1,16
2024-03-15 05:20:00,23,11,9,7,50
2024-03-15 05:30:00,29,8,12,7,56
2024-03-15 05:40:00,27,11,14,10,62
2024-03-15 05:50:00,34,14,16,4,68
2024-03-15 06:00:00,28,11,17,7,63
2024-03-15 06:10:00,44,19,22,18,103
2024-03-15 06:20:00,40,11,25,16,92
2024-03-15 06:30:00,51,24,27,18,120
2024-03-15 06:40:00,47,20,25,21,113
2024-03-15 06:50:00,53,23,34,20,130
2024-03-15 07:00:00,65,23,34,23,145
2024-03-15 07:10:00,52,34,31,23,140
2024-03-15 07:20:00,56,25,39,33,153
2024-03-15 07:30:00,68,30,46,35,179
2024-03-15 07:40:00,69,51,50,43,213
2024-03-15 07:50:00,69,37,54,52,212
2024-03-15 08:00:00,65,38,52,41,196
2024-03-15 08:10:00,69,34,44,35,182
2024-03-15 08:20:00,50,28,39,38,155
2024-03-15 08:30:00,68,38,47,42,195
2024-03-15 08:40:00,62,26,41,31,160
2024-03-15 08:50:00,58,16,46,30,150
2024-03-15 09:00:00,56,19,46,29,150
2024-03-15 09:10:00,60,24,46,30,160
2024-03-15 09:20:00,46,21,46,28,141
2024-03-15 09:30:00,66,24,38,20,148
2024-03-15 09:40:00,44,21,59,35,159
2024-03-15 09:50:00,55,25,35,28,143
2024-03-15 10:00:00,61,23,45,29,158
2024-03-15 10:10:00,55,29,38,20,142
2024-03-15 10:20:00,49,21,31,22,123
2024-03-15 10:30:00,67,26,53,30,176
2024-03-15 10:40:00,60,21,34,22,137
2024-03-15 10:50:00,63,20,52,31,166
2024-03-15 11:00:00,51,25,36,29,141
2024-03-15 11:10:00,69,32,29,20,150
2024-03-15 11:20:00,76,39,46,30,191
2024-03-15 11:30:00,57,25,31,27,140
2024-03-15 11:40:00,86,51,47,22,206
2024-03-15 11:50:00,66,35,36,23,160
2024-03-15 12:00:00,61,35,55,23,174
2024-03-15 12:10:00,88,42,57,25,212
2024-03-15 12:20:00,60,35,54,26,175
2024-03-15 12:30:00,61,34,47,19,161
2024-03-15 12:40:00,70,30,48,31,179
2024-03-15 12:50:00,65,38,43,49,195
2024-03-15 13:00:00,61,25,55,43,184
2024-03-15 13:10:00,81,44,49,30,204
2024-03-15 13:20:00,74,34,47,39,194
2024-03-15 13:30:00,81,39,42,25,187
2024-03-15 13:40:00,72,37,34,33,176
2024-03-15 13:50:00,70,25,32,35,162
2024-03-15 14:00:00,85,48,44,23,200
2024-03-15 14:10:00,68,33,43,27,171
2024-03-15 14:20:00,87,34,53,29,203
2024-03-15 14:30:00,81,33,37,29,180
2024-03-15 14:40:00,78,37,55,30,200
2024-03-15 14:50:00,70,30,47,27,174
2024-03-15 15:00:00,72,47,46,25,190
2024-03-15 15:10:00,86,46,45,28,205
2024-03-15 15:20:00,75,39,54,25,193
2024-03-15 15:30:00,58,29,40,27,154
2024-03-15 15:40:00,61,43,43,35,182
2024-03-15 15:50:00,63,22,46,33,164
2024-03-15 16:00:00,76,36,48,31,191
2024-03-15 16:10:00,83,38,48,24,193
2024-03-15 16:20:00,78,40,58,31,207
2024-03-15 16:30:00,73,39,47,31,190
2024-03-15 16:40:00,91,43,74,34,242
2024-03-15 16:50:00,73,38,48,31,190
2024-03-15 17:00:00,73,28,56,33,190
2024-03-15 17:10:00,66,33,36,23,158
2024-03-15 17:20:00,69,31,45,30,175
2024-03-15 17:30:00,84,37,37,29,187
2024-03-15 17:40:00,80,30,61,30,201
2024-03-15 17:50:00,86,51,46,29,212
2024-03-15 18:00:00,81,30,54,33,198
2024-03-15 18:10:00,75,30,44,31,180
2024-03-15 18:20:00,83,37,45,28,193
2024-03-15 18:30:00,75,31,44,22,172
2024-03-15 18:40:00,76,36,44,19,175
2024-03-15 18:50:00,55,30,47,15,147
2024-03-15 19:00:00,67,15,41,20,143
2024-03-15 19:10:00,66,33,38,22,159
2024-03-15 19:20:00,72,33,29,22,156
2024-03-15 19:30:00,57,20,30,15,122
2024-03-15 19:40:00,52,21,41,25,139
2024-03-15 19:50:00,58,27,29,22,136
2024-03-15 20:00:00,53,21,35,17,126
2024-03-15 20:10:00,57,21,20,14,112
2024-03-15 20:20:00,43,13,27,16,99
2024-03-15 20:30:00,43,15,27,15,100
2024-03-15 20:40:00,41,12,27,11,91
2024-03-15 20:50:00,43,18,18,3,82
2024-03-15 21:00:00,45,18,22,13,98
2024-03-15 21:10:00,50,14,21,15,100
2024-03-15 21:20:00,52,14,20,15,101
2024-03-15 21:30:00,38,15,23,16,92
2024-03-15 21:40:00,51,11,18,16,96
2024-03-15 21:50:00,41,17,10,5,73
2024-03-15 22:00:00,43,8,24,11,86
2024-03-15 22:10:00,55,14,12,10,91
2024-03-15 22:20:00,51,19,19,11,100
2024-03-15 22:30:00,50,23,14,3,90
2024-03-15 22:40:00,47,17,19,5,88
2024-03-15 22:50:00,50,19,11,8,88
2024-03-15 23:00:00,48,7,14,7,76
2024-03-15 23:10:00,43,12,17,6,78
2024-03-15 23:20:00,42,13,6,3,64
2024-03-15 23:30:00,25,10,10,6,51
2024-03-15 23:40:00,31,9,14,2,56
2024-03-15 23:50:00,21,8,10,7,46
2024-03-16 00:00:00,25,11,6,4,46
2024-03-16 00:10:00,32,10,8,5,55
2024-03-16 00:20:00,36,8,6,9,59
2024-03-16 00:30:00,21,7,13,7,48
2024-03-16 00:40:00,26,7,8,7,48
2024-03-16 00:50:00,28,4,5,3,40
2024-03-16 01:00:00,21,10,4,5,40
2024-03-16 01:10:00,18,7,11,3,39
2024-03-16 01:20:00,16,8,4,1,29
2024-03-16 01:30:00,11,2,6,2,21
2024-03-16 01:40:00,12,3,1,1,17
2024-03-16 01:50:00,9,3,5,2,19
2024-03-16 02:00:00,12,3,4,0,19
2024-03-16 02:10:00,9,2,4,0,15
2024-03-16 02:20:00,9,3,4,1,17
2024-03-16 02:30:00,14,4,3,0,21
2024-03-16 02:40:00,5,3,5,0,13
2024-03-16 02:50:00,10,0,2,2,14
2024-03-16 03:00:00,5,1,5,1,12
2024-03-16 03:10:00,9,4,4,2,19
2024-03-16 03:20:00,11,2,3,0,16
2024-03-16 03:30:00,12,2,2,2,18
2024-03-16 03:40:00,8,1,3,4,16
2024-03-16 03:50:00,4,1,6,0,11
2024-03-16 04:00:00,7,3,0,1,11
2024-03-16 04:10:00,9,3,1,1,14
2024-03-16 04:20:00,9,0,0,0,9
2024-03-16 04:30:00,12,0,7,1,20
2024-03-16 04:40:00,5,1,3,1,10
2024-03-16 04:50:00,6,0,3,2,11
2024-03-16 05:00:00,6,0,7,3,16
2024-03-16 05:10:00,8,2,7,2,19
2024-03-16 05:20:00,9,4,4,2,19
2024-03-16 05:30:00,17,1,3,4,25
2024-03-16 05:40:00,11,2,14,2,29
2024-03-16 05:50:00,13,3,3,1,20
2024-03-16 06:00:00,14,2,5,1,22
2024-03-16 06:10:00,15,2,11,8,36
2024-03-16 06:20:00,13,4,7,7,31
2024-03-16 06:30:00,15,7,9,6,37
2024-03-16 06:40:00,15,2,11,6,34
2024-03-16 06:50:00,23,8,6,2,39
2024-03-16 07:00:00,14,2,5,3,24
2024-03-16 07:10:00,15,4,10,5,34
2024-03-16 07:20:00,21,11,10,2,44
2024-03-16 07:30:00,18,7,14,12,51
2024-03-16 07:40:00,21,9,15,13,58
2024-03-16 07:50:00,14,4,17,15,50
2024-03-16 08:00:00,24,11,17,16,68
2024-03-16 08:10:00,20,4,12,4,40
2024-03-16 08:20:00,34,6,10,6,56
2024-03-16 08:30:00,30,14,16,11,71
2024-03-16 08:40:00,28,14,20,7,69
2024-03-16 08:50:00,33,11,16,6,66
2024-03-16 09:00:00,34,8,21,12,75
2024-03-16 09:10:00,31,13,22,9,75
2024-03-16 09:20:00,40,16,27,15,98
2024-03-16 09:30:00,47,22,24,10,103
2024-03-16 09:40:00,48,14,50,28,140
2024-03-16 09:50:00,41,16,39,24,120
2024-03-16 10:00:00,50,16,26,13,105
2024-03-16 10:10:00,44,13,21,18,96
2024-03-16 10:20:00,44,13,38,10,105
2024-03-16 10:30:00,40,15,39,21,115
2024-03-16 10:40:00,61,26,47,20,154
2024-03-16 10:50:00,57,22,45,14,138
2024-03-16 11:00:00,54,19,41,20,134
2024-03-16 11:10:00,56,22,45,13,136
2024-03-16 11:20:00,59,24,38,20,141
2024-03-16 11:30:00,51,20,43,20,134
2024-03-16 11:40:00,52,28,45,20,145
2024-03-16 11:50:00,56,21,34,20,131
2024-03-16 12:00:00,75,26,54,26,181
2024-03-16 12:10:00,57,26,41,19,143
2024-03-16 12:20:00,64,40,40,20,164
2024-03-16 12:30:00,55,23,45,14,137
2024-03-16 12:40:00,76,33,48,28,185
2024-03-16 12:50:00,67,31,56,35,189
2024-03-16 13:00:00,66,34,42,24,166
2024-03-16 13:10:00,77,33,50,16,176
2024-03-16 13:20:00,64,27,49,20,160
2024-03-16 13:30:00,66,37,50,31,184
2024-03-16 13:40:00,67,30,42,31,170
2024-03-16 13:50:00,62,31,54,31,178
2024-03-16 14:00:00,65,33,63,41,202
2024-03-16 14:10:00,69,37,48,37,191
2024-03-16 14:20:00,70,26,46,18,160
2024-03-16 14:30:00,62,27,52,25,166
2024-03-16 14:40:00,69,27,55,21,172
2024-03-16 14:50:00,75,33,45,17,170
2024-03-16 15:00:00,68,38,46,23,175
2024-03-16 15:10:00,57,28,38,18,141
2024-03-16 15:20:00,58,31,38,22,149
2024-03-16 15:30:00,60,22,37,23,142
2024-03-16 15:40:00,59,18,46,13,136
2024-03-16 15:50:00,66,34,39,15,154
2024-03-16 16:00:00,63,30,33,22,148
2024-03-16 16:10:00,80,39,24,18,161
2024-03-16 16:20:00,68,29,38,23,158
2024-03-16 16:30:00,79,31,29,16,155
2024-03-16 16:40:00,83,32,29,17,161
2024-03-16 16:50:00,65,29,32,18,144
2024-03-16 17:00:00,58,29,46,19,152
2024-03-16 17:10:00,67,33,39,20,159
2024-03-16 17:20:00,71,36,57,15,179
2024-03-16 17:30:00,72,41,49,16,178
2024-03-16 17:40:00,69,31,31,23,154
2024-03-16 17:50:00,94,43,47,25,209
2024-03-16 18:00:00,82,42,45,14,183
2024-03-16 18:10:00,82,45,43,20,190
2024-03-16 18:20:00,105,43,29,12,189
2024-03-16 18:30:00,78,43,40,18,179
2024-03-16 18:40:00,61,29,45,12,147
2024-03-16 18:50:00,52,22,40,21,135
2024-03-16 19:00:00,57,22,35,25,139
2024-03-16 19:10:00,51,23,25,11,110
2024-03-16 19:20:00,62,26,32,16,136
2024-03-16 19:30:00,61,28,26,12,127
2024-03-16 19:40:00,50,21,28,16,115
2024-03-16 19:50:00,55,26,32,28,141
2024-03-16 20:00:00,53,22,32,12,119
2024-03-16 20:10:00,65,33,28,12,138
2024-03-16 20:20:00,50,18,30,17,115
2024-03-16 20:30:00,50,18,24,10,102
2024-03-16 20:40:00,36,11,28,6,81
2024-03-16 20:50:00,56,22,20,8,106
2024-03-16 21:00:00,48,18,15,13,94
2024-03-16 21:10:00,47,16,23,9,95
2024-03-16 21:20:00,44,14,20,16,94
2024-03-16 21:30:00,59,24,16,10,109
2024-03-16 21:40:00,52,22,23,16,113
2024-03-16 21:50:00,55,23,25,14,117
2024-03-16 22:00:00,43,14,19,11,87
2024-03-16 22:10:00,50,18,21,12,101
2024-03-16 22:20:00,48,16,20,11,95
2024-03-16 22:30:00,40,13,18,9,80
2024-03-16 22:40:00,49,21,24,6,100
2024-03-16 22:50:00,40,11,21,5,77
2024-03-16 23:00:00,40,14,23,7,84
2024-03-16 23:10:00,32,9,16,6,63
2024-03-16 23:20:00,39,16,15,4,74
2024-03-16 23:30:00,35,12,20,8,75
2024-03-16 23:40:00,38,15,9,5,67
2024-03-16 23:50:00,28,9,8,3,48
2024-03-17 00:00:00,22,7,10,7,46
2024-03-17 00:10:00,30,4,15,5,54
2024-03-17 00:20:00,32,19,9,9,69
2024-03-17 00:30:00,25,6,9,5,45
2024-03-17 00:40:00,28,7,8,6,49
2024-03-17 00:50:00,29,11,13,6,59
2024-03-17 01:00:00,26,9,7,2,44
2024-03-17 01:10:00,27,9,8,3,47
2024-03-17 01:20:00,24,10,12,3,49
2024-03-17 01:30:00,21,8,4,2,35
2024-03-17 01:40:00,18,3,9,3,33
2024-03-17 01:50:00,14,2,6,2,24
2024-03-17 02:00:00,16,10,6,2,34
2024-03-17 02:10:00,10,2,5,3,20
2024-03-17 02:20:00,14,3,3,1,21
2024-03-17 02:30:00,11,4,4,2,21
2024-03-17 02:40:00,14,9,4,3,30
2024-03-17 02:50:00,13,5,3,1,22
2024-03-17 03:00:00,9,1,5,4,19
2024-03-17 03:10:00,8,2,1,2,13
2024-03-17 03:20:00,8,3,3,2,16
2024-03-17 03:30:00,7,4,2,0,13
2024-03-17 03:40:00,8,1,2,2,13
2024-03-17 03:50:00,17,8,4,0,29
2024-03-17 04:00:00,4,2,1,1,8
2024-03-17 04:10:00,10,4,1,0,15
2024-03-17 04:20:00,12,3,4,1,20
2024-03-17 04:30:00,9,3,2,0,14
2024-03-17 04:40:00,6,2,2,0,10
2024-03-17 04:50:00,8,1,3,2,14
2024-03-17 05:00:00,8,1,4,0,13
2024-03-17 05:10:00,10,1,1,1,13
2024-03-17 05:20:00,9,2,4,2,17
2024-03-17 05:30:00,10,2,3,4,19
2024-03-17 05:40:00,6,5,4,2,17
2024-03-17 05:50:00,9,1,2,4,16
2024-03-17 06:00:00,9,6,7,1,23
2024-03-17 06:10:00,4,1,5,1,11
2024-03-17 06:20:00,15,5,2,6,28
2024-03-17 06:30:00,11,2,4,2,19
2024-03-17 06:40:00,10,2,3,1,16
2024-03-17 06:50:00,7,2,1,0,10
2024-03-17 07:00:00,11,4,4,4,23
2024-03-17 07:10:00,14,2,1,4,21
2024-03-17 07:20:00,7,1,6,6,20
2024-03-17 07:30:00,6,1,4,2,13
2024-03-17 07:40:00,13,3,8,8,32
2024-03-17 07:50:00,12,2,7,5,26
2024-03-17 08:00:00,14,4,3,4,25
2024-03-17 08:10:00,20,8,4,3,35
2024-03-17 08:20:00,21,3,5,1,30
2024-03-17 08:30:00,21,3,12,2,38
2024-03-17 08:40:00,20,2,13,4,39
2024-03-17 08:50:00,16,8,7,6,37
2024-03-17 09:00:00,16,4,12,4,36
2024-03-17 09:10:00,22,7,8,7,44
2024-03-17 09:20:00,29,7,8,2,46
2024-03-17 09:30:00,23,8,19,6,56
2024-03-17 09:40:00,34,17,17,8,76
2024-03-17 09:50:00,26,11,19,10,66
2024-03-17 10:00:00,39,14,19,3,75
2024-03-17 10:10:00,35,10,16,13,74
2024-03-17 10:20:00,32,15,9,6,62
2024-03-17 10:30:00,40,10,21,6,77
2024-03-17 10:40:00,40,17,27,5,89
2024-03-17 10:50:00,41,11,14,6,72
2024-03-17 11:00:00,37,16,25,15,93
2024-03-17 11:10:00,50,14,23,9,96
2024-03-17 11:20:00,47,12,9,7,75
2024-03-17 11:30:00,51,11,21,8,91
2024-03-17 11:40:00,47,13,20,10,90
2024-03-17 11:50:00,50,19,26,14,109
2024-03-17 12:00:00,65,23,21,7,116
2024-03-17 12:10:00,59,21,24,15,119
2024-03-17 12:20:00,54,13,32,8,107
2024-03-17 12:30:00,41,21,21,8,91
2024-03-17 12:40:00,48,19,28,10,105
2024-03-17 12:50:00,39,11,25,15,90
2024-03-17 13:00:00,54,23,33,16,126
2024-03-17 13:10:00,52,23,24,17,116
2024-03-17 13:20:00,55,19,33,11,118
2024-03-17 13:30:00,71,25,27,11,134
2024-03-17 13:40:00,46,19,24,18,107
2024-03-17 13:50:00,53,25,20,11,109
2024-03-17 14:00:00,69,14,18,5,106
2024-03-17 14:10:00,61,20,24,19,124
2024-03-17 14:20:00,67,26,36,15,144
2024-03-17 14:30:00,67,24,32,13,136
2024-03-17 14:40:00,61,23,38,17,139
2024-03-17 14:50:00,59,11,41,17,128
2024-03-17 15:00:00,59,17,31,26,133
2024-03-17 15:10:00,55,22,28,19,124
2024-03-17 15:20:00,64,20,29,21,134
2024-03-17 15:30:00,57,18,29,14,118
2024-03-17 15:40:00,51,17,29,18,115
2024-03-17 15:50:00,57,18,27,12,114
2024-03-17 16:00:00,58,20,35,16,129
2024-03-17 16:10:00,70,24,23,15,132
2024-03-17 16:20:00,55,20,26,12,113
2024-03-17 16:30:00,52,25,17,10,104
2024-03-17 16:40:00,66,33,33,14,146
2024-03-17 16:50:00,48,21,19,13,101
2024-03-17 17:00:00,67,26,32,16,141
2024-03-17 17:10:00,66,19,35,12,132
2024-03-17 17:20:00,57,20,32,18,127
2024-03-17 17:30:00,53,25,37,16,131
2024-03-17 17:40:00,59,32,35,20,146
2024-03-17 17:50:00,57,19,38,20,134
2024-03-17 18:00:00,55,22,26,17,120
2024-03-17 18:10:00,55,25,28,20,128
2024-03-17 18:20:00,65,19,33,19,136
2024-03-17 18:30:00,45,10,38,14,107
2024-03-17 18:40:00,53,14,21,8,96
2024-03-17 18:50:00,37,11,22,6,76
2024-03-17 19:00:00,48,11,21,9,89
2024-03-17 19:10:00,39,10,20,9,78
2024-03-17 19:20:00,52,24,20,12,108
2024-03-17 19:30:00,51,20,25,8,104
2024-03-17 19:40:00,45,16,21,9,91
2024-03-17 19:50:00,43,16,17,15,91
2024-03-17 20:00:00,53,20,19,10,102
2024-03-17 20:10:00,41,13,28,9,91
2024-03-17 20:20:00,49,21,19,2,91
2024-03-17 20:30:00,46,20,23,12,101
2024-03-17 20:40:00,34,12,23,6,75
2024-03-17 20:50:00,29,12,25,10,76
2024-03-17 21:00:00,36,11,22,7,76
2024-03-17 21:10:00,37,12,15,4,68
2024-03-17 21:20:00,50,14,13,4,81
2024-03-17 21:30:00,28,8,18,6,60
2024-03-17 21:40:00,37,12,15,5,69
2024-03-17 21:50:00,34,10,10,5,59
2024-03-17 22:00:00,33,9,11,4,57
2024-03-17 22:10:00,35,12,6,0,53
2024-03-17 22:20:00,28,6,11,2,47
2024-03-17 22:30:00,29,8,14,4,55
2024-03-17 22:40:00,23,7,8,7,45
2024-03-17 22:50:00,24,9,9,2,44
2024-03-17 23:00:00,17,6,10,5,38
2024-03-17 23:10:00,17,6,5,4,32
2024-03-17 23:20:00,16,8,5,3,32
2024-03-17 23:30:00,13,4,6,3,26
2024-03-17 23:40:00,8,4,4,3,19
2024-03-17 23:50:00,12,2,7,4,25
2024-03-18 00:00:00,6,0,5,2,13
2024-03-18 00:10:00,15,5,3,2,25
2024-03-18 00:20:00,4,1,4,3,12
2024-03-18 00:30:00,8,3,2,1,14
2024-03-18 00:40:00,8,1,1,0,10
2024-03-18 00:50:00,4,0,2,0,6
2024-03-18 01:00:00,4,1,2,0,7
2024-03-18 01:10:00,3,2,0,0,5
2024-03-18 01:20:00,6,2,0,1,9
2024-03-18 01:30:00,7,2,4,2,15
2024-03-18 01:40:00,5,0,3,1,9
2024-03-18 01:50:00,2,0,2,0,4
2024-03-18 02:00:00,5,0,2,0,7
2024-03-18 02:10:00,5,1,1,0,7
2024-03-18 02:20:00,3,0,0,0,3
2024-03-18 02:30:00,3,2,0,0,5
2024-03-18 02:40:00,4,1,2,0,7
2024-03-18 02:50:00,2,0,3,1,6
2024-03-18 03:00:00,2,1,1,1,5
2024-03-18 03:10:00,2,0,1,0,3
2024-03-18 03:20:00,3,0,1,0,4
2024-03-18 03:30:00,3,0,3,0,6
2024-03-18 03:40:00,7,1,0,1,9
2024-03-18 03:50:00,6,1,1,1,9
2024-03-18 04:00:00,3,1,2,1,7
2024-03-18 04:10:00,6,3,3,1,13
2024-03-18 04:20:00,12,2,1,0,15
2024-03-18 04:30:00,9,0,2,1,12
2024-03-18 04:40:00,8,3,10,5,26
2024-03-18 04:50:00,19,3,4,1,27
2024-03-18 05:00:00,18,5,4,2,29
2024-03-18 05:10:00,23,9,5,2,39
2024-03-18 05:20:00,34,9,10,9,62
2024-03-18 05:30:00,22,7,10,5,44
2024-03-18 05:40:00,32,15,16,10,73
2024-03-18 05:50:00,30,14,14,10,68
2024-03-18 06:00:00,47,14,22,12,95
2024-03-18 06:10:00,47,19,19,17,102
2024-03-18 06:20:00,57,18,21,13,109
2024-03-18 06:30:00,59,33,25,12,129
2024-03-18 06:40:00,53,18,35,25,131
2024-03-18 06:50:00,47,23,26,34,130
2024-03-18 07:00:00,67,29,27,19,142
2024-03-18 07:10:00,70,34,32,18,154
2024-03-18 07:20:00,67,34,42,37,180
2024-03-18 07:30:00,60,29,49,45,183
2024-03-18 07:40:00,81,59,53,46,239
2024-03-18 07:50:00,86,28,61,49,224
2024-03-18 08:00:00,73,40,47,41,201
2024-03-18 08:10:00,88,41,54,60,243
2024-03-18 08:20:00,84,46,52,43,225
2024-03-18 08:30:00,70,40,53,35,198
2024-03-18 08:40:00,78,39,50,41,208
2024-03-18 08:50:00,70,43,42,28,183
2024-03-18 09:00:00,67,35,42,32,176
2024-03-18 09:10:00,71,28,39,26,164
2024-03-18 09:20:00,68,24,37,29,158
2024-03-18 09:30:00,80,29,57,28,194
2024-03-18 09:40:00,62,23,42,29,156
2024-03-18 09:50:00,65,33,46,27,171
2024-03-18 10:00:00,65,31,43,33,172
2024-03-18 10:10:00,64,31,41,25,161
2024-03-18 10:20:00,55,27,53,22,157
2024-03-18 10:30:00,64,19,45,30,158
2024-03-18 10:40:00,57,24,52,28,161
2024-03-18 10:50:00,57,21,41,24,143
2024-03-18 11:00:00,55,19,36,15,125
2024-03-18 11:10:00,68,35,38,23,164
2024-03-18 11:20:00,66,32,40,27,165
2024-03-18 11:30:00,65,33,45,26,169
2024-03-18 11:40:00,62,39,36,24,161
2024-03-18 11:50:00,55,32,36,27,150
2024-03-18 12:00:00,67,44,40,22,173
2024-03-18 12:10:00,44,27,35,21,127
2024-03-18 12:20:00,67,31,56,28,182
2024-03-18 12:30:00,76,34,38,22,170
2024-03-18 12:40:00,70,44,54,29,197
2024-03-18 12:50:00,80,43,48,25,196
2024-03-18 13:00:00,66,38,39,26,169
2024-03-18 13:10:00,71,29,42,30,172
2024-03-18 13:20:00,78,33,32,19,162
2024-03-18 13:30:00,70,34,40,32,176
2024-03-18 13:40:00,57,36,24,25,142
2024-03-18 13:50:00,70,25,46,30,171
2024-03-18 14:00:00,81,38,48,29,196
2024-03-18 14:10:00,75,28,40,31,174
2024-03-18 14:20:00,76,33,33,27,169
2024-03-18 14:30:00,110,41,39,25,215
2024-03-18 14:40:00,74,29,42,22,167
2024-03-18 14:50:00,82,42,57,34,215
2024-03-18 15:00:00,75,34,47,26,182
2024-03-18 15:10:00,86,44,57,35,222
2024-03-18 15:20:00,75,43,47,31,196
2024-03-18 15:30:00,64,32,43,25,164
2024-03-18 15:40:00,80,50,47,22,199
2024-03-18 15:50:00,70,43,53,30,196
2024-03-18 16:00:00,82,44,50,42,218
2024-03-18 16:10:00,94,48,47,33,222
2024-03-18 16:20:00,97,46,35,25,203
2024-03-18 16:30:00,69,42,55,28,194
2024-03-18 16:40:00,86,44,40,27,197
2024-03-18 16:50:00,89,47,51,32,219
2024-03-18 17:00:00,87,48,47,21,203
2024-03-18 17:10:00,83,45,61,45,234
2024-03-18 17:20:00,86,48,42,30,206
2024-03-18 17:30:00,79,45,33,27,184
2024-03-18 17:40:00,73,43,46,31,193
2024-03-18 17:50:00,81,38,51,32,202
2024-03-18 18:00:00,74,32,48,38,192
2024-03-18 18:10:00,84,45,42,26,197
2024-03-18 18:20:00,69,33,33,25,160
2024-03-18 18:30:00,67,26,35,18,146
2024-03-18 18:40:00,69,33,30,22,154
2024-03-18 18:50:00,45,24,34,21,124
2024-03-18 19:00:00,62,31,28,19,140
2024-03-18 19:10:00,67,32,25,22,146
2024-03-18 19:20:00,51,17,36,19,123
2024-03-18 19:30:00,47,21,22,17,107
2024-03-18 19:40:00,48,20,27,11,106
2024-03-18 19:50:00,43,19,20,22,104
2024-03-18 20:00:00,38,6,28,22,94
2024-03-18 20:10:00,49,17,20,14,100
2024-03-18 20:20:00,43,15,24,12,94
2024-03-18 20:30:00,42,18,26,11,97
2024-03-18 20:40:00,35,10,22,13,80
2024-03-18 20:50:00,37,16,18,8,79
2024-03-18 21:00:00,24,16,15,11,66
2024-03-18 21:10:00,32,15,11,6,64
2024-03-18 21:20:00,38,17,18,9,82
2024-03-18 21:30:00,44,17,17,7,85
2024-03-18 21:40:00,27,14,14,6,61
2024-03-18 21:50:00,38,22,16,7,83
2024-03-18 22:00:00,32,9,10,6,57
2024-03-18 22:10:00,32,9,13,12,66
2024-03-18 22:20:00,30,10,13,8,61
2024-03-18 22:30:00,17,7,13,5,42
2024-03-18 22:40:00,21,6,9,4,40
2024-03-18 22:50:00,20,6,5,4,35
2024-03-18 23:00:00,25,8,7,4,44
2024-03-18 23:10:00,24,5,11,3,43
2024-03-18 23:20:00,18,4,5,1,28
2024-03-18 23:30:00,13,4,12,2,31
2024-03-18 23:40:00,11,1,6,3,21
2024-03-18 23:50:00,15,3,8,3,29
2024-03-19 00:00:00,11,2,2,0,15
2024-03-19 00:10:00,11,5,2,0,18
2024-03-19 00:20:00,6,1,4,0,11
2024-03-19 00:30:00,9,4,0,1,14
2024-03-19 00:40:00,3,0,3,0,6
2024-03-19 00:50:00,6,4,2,0,12
2024-03-19 01:00:00,7,4,5,0,16
2024-03-19 01:10:00,5,0,2,1,8
2024-03-19 01:20:00,4,1,0,0,5
2024-03-19 01:30:00,8,3,0,1,12
2024-03-19 01:40:00,4,1,2,1,8
2024-03-19 01:50:00,6,0,2,3,11
2024-03-19 02:00:00,5,2,1,1,9
2024-03-19 02:10:00,2,0,0,0,2
2024-03-19 02:20:00,5,0,2,0,7
2024-03-19 02:30:00,7,1,3,1,12
2024-03-19 02:40:00,2,0,1,0,3
2024-03-19 02:50:00,5,0,1,0,6
2024-03-19 03:00:00,2,2,0,0,4
2024-03-19 03:10:00,3,0,2,2,7
2024-03-19 03:20:00,4,0,2,0,6
2024-03-19 03:30:00,8,2,2,0,12
2024-03-19 03:40:00,5,2,1,1,9
2024-03-19 03:50:00,3,1,3,2,9
2024-03-19 04:00:00,0,0,2,0,2
2024-03-19 04:10:00,9,6,1,0,16
2024-03-19 04:20:00,9,1,3,1,14
2024-03-19 04:30:00,8,0,3,1,12
2024-03-19 04:40:00,3,2,6,2,13
2024-03-19 04:50:00,13,3,4,0,20
2024-03-19 05:00:00,11,2,5,3,21
2024-03-19 05:10:00,22,4,6,0,32
2024-03-19 05:20:00,30,7,6,5,48
2024-03-19 05:30:00,30,14,8,8,60
2024-03-19 05:40:00,50,23,17,10,100
2024-03-19 05:50:00,29,10,17,6,62
2024-03-19 06:00:00,42,18,22,14,96
2024-03-19 06:10:00,54,17,18,12,101
2024-03-19 06:20:00,49,22,18,18,107
2024-03-19 06:30:00,51,28,27,21,127
2024-03-19 06:40:00,72,34,29,18,153
2024-03-19 06:50:00,70,35,23,20,148
2024-03-19 07:00:00,64,32,31,20,147
2024-03-19 07:10:00,83,30,43,26,182
2024-03-19 07:20:00,64,37,47,35,183
2024-03-19 07:30:00,62,27,53,51,193
2024-03-19 07:40:00,74,40,63,50,227
2024-03-19 07:50:00,86,47,66,50,249
2024-03-19 08:00:00,82,47,51,52,232
2024-03-19 08:10:00,92,45,58,56,251
2024-03-19 08:20:00,78,38,42,36,194
2024-03-19 08:30:00,81,50,54,53,238
2024-03-19 08:40:00,67,37,61,41,206
2024-03-19 08:50:00,71,38,48,36,193
2024-03-19 09:00:00,62,30,35,22,149
2024-03-19 09:10:00,62,29,49,29,169
2024-03-19 09:20:00,60,31,37,18,146
2024-03-19 09:30:00,68,35,37,22,162
2024-03-19 09:40:00,63,36,36,30,165
2024-03-19 09:50:00,71,28,33,25,157
2024-03-19 10:00:00,62,17,50,29,158
2024-03-19 10:10:00,62,28,43,30,163
2024-03-19 10:20:00,55,25,44,28,152
2024-03-19 10:30:00,27,9,39,25,100
2024-03-19 10:40:00,61,23,43,22,149
2024-03-19 10:50:00,56,29,41,24,150
2024-03-19 11:00:00,74,30,42,29,175
2024-03-19 11:10:00,61,41,41,33,176
2024-03-19 11:20:00,53,22,36,22,133
2024-03-19 11:30:00,74,35,36,23,168
2024-03-19 11:40:00,55,18,44,27,144
2024-03-19 11:50:00,69,38,40,20,167
2024-03-19 12:00:00,79,39,33,24,175
2024-03-19 12:10:00,95,44,30,20,189
2024-03-19 12:20:00,85,49,43,24,201
2024-03-19 12:30:00,62,25,51,29,167
2024-03-19 12:40:00,84,47,36,26,193
2024-03-19 12:50:00,75,39,40,20,174
2024-03-19 13:00:00,60,36,36,22,154
2024-03-19 13:10:00,84,41,37,28,190
2024-03-19 13:20:00,66,36,34,25,161
2024-03-19 13:30:00,78,35,42,22,177
2024-03-19 13:40:00,58,27,42,24,151
2024-03-19 13:50:00,77,48,46,30,201
2024-03-19 14:00:00,73,28,41,28,170
2024-03-19 14:10:00,77,36,39,31,183
2024-03-19 14:20:00,73,36,55,43,207
2024-03-19 14:30:00,77,38,35,22,172
2024-03-19 14:40:00,83,41,53,31,208
2024-03-19 14:50:00,65,32,46,32,175
2024-03-19 15:00:00,75,32,48,37,192
2024-03-19 15:10:00,82,42,48,36,208
2024-03-19 15:20:00,89,43,42,31,205
2024-03-19 15:30:00,70,43,45,25,183
2024-03-19 15:40:00,91,53,61,29,234
2024-03-19 15:50:00,82,44,55,30,211
2024-03-19 16:00:00,89,44,55,38,226
2024-03-19 16:10:00,89,48,59,41,237
2024-03-19 16:20:00,85,47,60,30,222
2024-03-19 16:30:00,104,60,57,35,256
2024-03-19 16:40:00,79,52,58,35,224
2024-03-19 16:50:00,76,37,55,39,207
2024-03-19 17:00:00,80,50,60,36,226
2024-03-19 17:10:00,83,36,52,40,211
2024-03-19 17:20:00,80,47,63,36,226
2024-03-19 17:30:00,82,48,51,45,226
2024-03-19 17:40:00,93,53,60,44,250
2024-03-19 17:50:00,84,38,57,33,212
2024-03-19 18:00:00,89,48,44,50,231
2024-03-19 18:10:00,89,42,50,33,214
2024-03-19 18:20:00,86,49,39,34,208
2024-03-19 18:30:00,67,28,38,32,165
2024-03-19 18:40:00,63,35,44,26,168
2024-03-19 18:50:00,73,32,44,27,176
2024-03-19 19:00:00,54,20,39,23,136
2024-03-19 19:10:00,63,26,26,21,136
2024-03-19 19:20:00,54,25,28,16,123
2024-03-19 19:30:00,57,24,26,18,125
2024-03-19 19:40:00,40,12,28,19,99
2024-03-19 19:50:00,49,20,23,16,108
2024-03-19 20:00:00,53,25,23,19,120
2024-03-19 20:10:00,58,20,28,15,121
2024-03-19 20:20:00,49,22,10,9,90
2024-03-19 20:30:00,43,18,17,12,90
2024-03-19 20:40:00,45,20,14,11,90
2024-03-19 20:50:00,42,11,26,12,91
2024-03-19 21:00:00,48,23,16,11,98
2024-03-19 21:10:00,41,18,16,11,86
2024-03-19 21:20:00,44,14,25,8,91
2024-03-19 21:30:00,40,22,16,10,88
2024-03-19 21:40:00,57,15,13,10,95
2024-03-19 21:50:00,46,20,12,5,83
2024-03-19 22:00:00,39,20,14,6,79
2024-03-19 22:10:00,29,10,11,10,60
2024-03-19 22:20:00,33,9,16,5,63
2024-03-19 22:30:00,26,8,16,8,58
2024-03-19 22:40:00,28,6,16,3,53
2024-03-19 22:50:00,22,6,18,8,54
2024-03-19 23:00:00,23,8,6,4,41
2024-03-19 23:10:00,18,4,7,5,34
2024-03-19 23:20:00,14,4,6,2,26
2024-03-19 23:30:00,11,4,7,1,23
2024-03-19 23:40:00,9,2,9,5,25
2024-03-19 23:50:00,7,3,4,1,15
2024-03-20 00:00:00,12,2,5,0,19
2024-03-20 00:10:00,6,2,2,1,11
2024-03-20 00:20:00,9,2,4,2,17
2024-03-20 00:30:00,5,3,1,0,9
2024-03-20 00:40:00,6,2,8,1,17
2024-03-20 00:50:00,7,2,2,1,12
2024-03-20 01:00:00,5,0,2,0,7
2024-03-20 01:10:00,7,2,4,2,15
2024-03-20 01:20:00,7,4,0,0,11
2024-03-20 01:30:00,8,2,3,0,13
2024-03-20 01:40:00,6,3,1,2,12
2024-03-20 01:50:00,1,0,1,1,3
2024-03-20 02:00:00,2,0,0,0,2
2024-03-20 02:10:00,7,3,3,2,15
2024-03-20 02:20:00,6,0,6,1,13
2024-03-20 02:30:00,3,1,3,1,8
2024-03-20 02:40:00,4,0,3,3,10
2024-03-20 02:50:00,3,0,2,1,6
2024-03-20 03:00:00,5,0,1,0,6
2024-03-20 03:10:00,2,1,0,0,3
2024-03-20 03:20:00,5,1,2,2,10
2024-03-20 03:30:00,4,0,2,0,6
2024-03-20 03:40:00,6,1,3,1,11
2024-03-20 03:50:00,5,0,2,1,8
2024-03-20 04:00:00,3,2,0,0,5
2024-03-20 04:10:00,8,3,3,0,14
2024-03-20 04:20:00,13,1,2,0,16
2024-03-20 04:30:00,8,3,3,1,15
2024-03-20 04:40:00,9,4,7,4,24
2024-03-20 04:50:00,8,1,6,2,17
2024-03-20 05:00:00,15,3,2,3,23
2024-03-20 05:10:00,16,6,3,0,25
2024-03-20 05:20:00,28,8,10,5,51
2024-03-20 05:30:00,41,17,13,9,80
2024-03-20 05:40:00,29,13,16,9,67
2024-03-20 05:50:00,32,10,14,4,60
2024-03-20 06:00:00,36,18,15,16,85
2024-03-20 06:10:00,46,19,21,16,102
2024-03-20 06:20:00,53,18,22,13,106
2024-03-20 06:30:00,52,22,27,17,118
2024-03-20 06:40:00,68,36,35,25,164
2024-03-20 06:50:00,68,29,23,22,142
2024-03-20 07:00:00,76,34,27,26,163
2024-03-20 07:10:00,89,40,36,27,192
2024-03-20 07:20:00,73,34,48,31,186
2024-03-20 07:30:00,83,47,43,37,210
2024-03-20 07:40:00,79,53,62,61,255
2024-03-20 07:50:00,88,58,60,55,261
2024-03-20 08:00:00,92,45,62,46,245
2024-03-20 08:10:00,65,44,40,37,186
2024-03-20 08:20:00,89,45,44,43,221
2024-03-20 08:30:00,83,47,58,51,239
2024-03-20 08:40:00,78,48,60,39,225
2024-03-20 08:50:00,81,48,48,42,219
2024-03-20 09:00:00,78,37,56,33,204
2024-03-20 09:10:00,79,36,45,39,199
2024-03-20 09:20:00,75,30,44,24,173
2024-03-20 09:30:00,67,30,49,31,177
2024-03-20 09:40:00,72,34,52,24,182
2024-03-20 09:50:00,70,36,40,33,179
2024-03-20 10:00:00,68,29,39,15,151
2024-03-20 10:10:00,66,36,43,28,173
2024-03-20 10:20:00,53,27,52,26,158
2024-03-20 10:30:00,62,34,33,16,145
2024-03-20 10:40:00,64,27,44,26,161
2024-03-20 10:50:00,60,27,46,27,160
2024-03-20 11:00:00,62,19,36,24,141
2024-03-20 11:10:00,68,35,35,26,164
2024-03-20 11:20:00,65,30,41,18,154
2024-03-20 11:30:00,72,23,35,19,149
2024-03-20 11:40:00,86,36,30,17,169
2024-03-20 11:50:00,66,31,29,21,147
2024-03-20 12:00:00,82,42,38,23,185
2024-03-20 12:10:00,69,44,50,23,186
2024-03-20 12:20:00,80,37,35,26,178
2024-03-20 12:30:00,83,49,45,30,207
2024-03-20 12:40:00,71,40,43,31,185
2024-03-20 12:50:00,80,37,45,24,186
2024-03-20 13:00:00,77,36,38,27,178
2024-03-20 13:10:00,50,36,49,31,166
2024-03-20 13:20:00,86,42,48,18,194
2024-03-20 13:30:00,77,44,41,21,183
2024-03-20 13:40:00,65,33,48,33,179
2024-03-20 13:50:00,64,27,41,26,158
2024-03-20 14:00:00,69,26,47,30,172
2024-03-20 14:10:00,78,48,39,23,188
2024-03-20 14:20:00,83,39,54,20,196
2024-03-20 14:30:00,77,41,47,35,200
2024-03-20 14:40:00,78,37,65,38,218
2024-03-20 14:50:00,91,45,57,30,223
2024-03-20 15:00:00,79,40,46,25,190
2024-03-20 15:10:00,74,40,56,25,195
2024-03-20 15:20:00,80,46,60,29,215
2024-03-20 15:30:00,85,40,70,45,240
2024-03-20 15:40:00,97,53,63,35,248
2024-03-20 15:50:00,101,47,54,28,230
2024-03-20 16:00:00,90,54,63,41,248
2024-03-20 16:10:00,77,42,51,55,225
2024-03-20 16:20:00,82,42,57,39,220
2024-03-20 16:30:00,92,52,61,26,231
2024-03-20 16:40:00,91,57,59,39,246
2024-03-20 16:50:00,73,39,70,49,231
2024-03-20 17:00:00,68,32,63,54,217
2024-03-20 17:10:00,99,68,62,47,276
2024-03-20 17:20:00,92,55,68,39,254
2024-03-20 17:30:00,82,46,45,35,208
2024-03-20 17:40:00,72,41,55,28,196
2024-03-20 17:50:00,76,41,52,29,198
2024-03-20 18:00:00,90,39,58,37,224
2024-03-20 18:10:00,79,45,52,32,208
2024-03-20 18:20:00,75,37,58,27,197
2024-03-20 18:30:00,85,36,46,24,191
2024-03-20 18:40:00,75,42,43,36,196
2024-03-20 18:50:00,65,33,33,29,160
2024-03-20 19:00:00,73,31,27,19,150
2024-03-20 19:10:00,62,21,22,19,124
2024-03-20 19:20:00,48,21,28,18,115
2024-03-20 19:30:00,55,12,28,19,114
2024-03-20 19:40:00,47,29,34,19,129
2024-03-20 19:50:00,61,32,26,20,139
2024-03-20 20:00:00,67,22,26,12,127
2024-03-20 20:10:00,52,28,25,11,116
2024-03-20 20:20:00,37,18,19,9,83
2024-03-20 20:30:00,43,18,22,16,99
2024-03-20 20:40:00,35,13,23,16,87
2024-03-20 20:50:00,53,20,15,12,100
2024-03-20 21:00:00,32,7,21,10,70
2024-03-20 21:10:00,34,16,14,4,68
2024-03-20 21:20:00,43,19,15,5,82
2024-03-20 21:30:00,42,15,10,12,79
2024-03-20 21:40:00,44,15,13,4,76
2024-03-20 21:50:00,35,14,23,3,75
2024-03-20 22:00:00,39,12,9,4,64
2024-03-20 22:10:00,26,12,18,13,69
2024-03-20 22:20:00,34,14,15,8,71
2024-03-20 22:30:00,27,9,16,4,56
2024-03-20 22:40:00,23,8,9,3,43
2024-03-20 22:50:00,26,5,9,3,43
2024-03-20 23:00:00,19,7,8,5,39
2024-03-20 23:10:00,25,8,9,3,45
2024-03-20 23:20:00,27,9,8,2,46
2024-03-20 23:30:00,18,5,9,4,36
2024-03-20 23:40:00,10,4,6,3,23
2024-03-20 23:50:00,14,5,5,4,28
2024-03-21 00:00:00,11,3,3,3,20
2024-03-21 00:10:00,10,1,4,2,17
2024-03-21 00:20:00,12,7,3,2,24
2024-03-21 00:30:00,7,6,2,2,17
2024-03-21 00:40:00,6,3,2,1,12
2024-03-21 00:50:00,9,0,2,1,12
2024-03-21 01:00:00,3,1,3,1,8
2024-03-21 01:10:00,4,1,0,0,5
2024-03-21 01:20:00,6,1,2,0,9
2024-03-21 01:30:00,4,1,4,0,9
2024-03-21 01:40:00,6,0,3,0,9
2024-03-21 01:50:00,0,0,2,1,3
2024-03-21 02:00:00,7,2,6,5,20
2024-03-21 02:10:00,3,0,2,1,6
2024-03-21 02:20:00,9,1,2,0,12
2024-03-21 02:30:00,4,0,3,0,7
2024-03-21 02:40:00,3,1,1,0,5
2024-03-21 02:50:00,3,0,5,2,10
2024-03-21 03:00:00,4,0,0,2,6
2024-03-21 03:10:00,4,0,1,0,5
2024-03-21 03:20:00,4,1,1,0,6
2024-03-21 03:30:00,2,0,0,1,3
2024-03-21 03:40:00,5,1,1,0,7
2024-03-21 03:50:00,0,1,4,2,7
2024-03-21 04:00:00,5,1,2,0,8
2024-03-21 04:10:00,4,0,3,1,8
2024-03-21 04:20:00,7,2,2,0,11
2024-03-21 04:30:00,11,4,2,0,17
2024-03-21 04:40:00,11,3,4,3,21
2024-03-21 04:50:00,9,0,9,3,21
2024-03-21 05:00:00,17,5,4,3,29
2024-03-21 05:10:00,14,6,5,3,28
2024-03-21 05:20:00,24,7,12,4,47
2024-03-21 05:30:00,33,18,6,9,66
2024-03-21 05:40:00,32,7,21,14,74
2024-03-21 05:50:00,33,17,8,8,66
2024-03-21 06:00:00,41,13,14,8,76
2024-03-21 06:10:00,40,16,16,21,93
2024-03-21 06:20:00,42,17,16,9,84
2024-03-21 06:30:00,51,30,19,13,113
2024-03-21 06:40:00,64,27,28,26,145
2024-03-21 06:50:00,75,35,29,20,159
2024-03-21 07:00:00,75,36,27,16,154
2024-03-21 07:10:00,66,33,34,26,159
2024-03-21 07:20:00,67,45,35,34,181
2024-03-21 07:30:00,74,36,51,43,204
2024-03-21 07:40:00,91,46,55,58,250
2024-03-21 07:50:00,72,51,64,58,245
2024-03-21 08:00:00,77,49,67,51,244
2024-03-21 08:10:00,78,40,52,47,217
2024-03-21 08:20:00,78,52,59,49,238
2024-03-21 08:30:00,78,37,53,47,215
2024-03-21 08:40:00,70,42,56,43,211
2024-03-21 08:50:00,68,40,48,25,181
2024-03-21 09:00:00,70,39,38,27,174
2024-03-21 09:10:00,66,29,35,29,159
2024-03-21 09:20:00,69,32,44,33,178
2024-03-21 09:30:00,63,33,48,29,173
2024-03-21 09:40:00,63,37,39,30,169
2024-03-21 09:50:00,68,27,53,35,183
2024-03-21 10:00:00,63,20,41,34,158
2024-03-21 10:10:00,46,31,48,31,156
2024-03-21 10:20:00,64,27,39,19,149
2024-03-21 10:30:00,54,25,33,31,143
2024-03-21 10:40:00,53,33,50,34,170
2024-03-21 10:50:00,63,36,51,20,170
2024-03-21 11:00:00,60,36,27,20,143
2024-03-21 11:10:00,72,37,35,23,167
2024-03-21 11:20:00,57,24,33,26,140
2024-03-21 11:30:00,66,45,41,24,176
2024-03-21 11:40:00,72,36,34,24,166
2024-03-21 11:50:00,70,30,52,40,192
2024-03-21 12:00:00,65,29,51,31,176
2024-03-21 12:10:00,80,31,36,31,178
2024-03-21 12:20:00,58,38,50,25,171
2024-03-21 12:30:00,59,37,32,16,144
2024-03-21 12:40:00,77,38,37,16,168
2024-03-21 12:50:00,65,32,36,16,149
2024-03-21 13:00:00,79,47,45,30,201
2024-03-21 13:10:00,79,39,35,31,184
2024-03-21 13:20:00,75,27,42,33,177
2024-03-21 13:30:00,76,48,47,32,203
2024-03-21 13:40:00,76,32,42,16,166
2024-03-21 13:50:00,61,38,37,19,155
2024-03-21 14:00:00,78,34,44,34,190
2024-03-21 14:10:00,76,39,53,34,202
2024-03-21 14:20:00,77,45,51,29,202
2024-03-21 14:30:00,78,35,47,33,193
2024-03-21 14:40:00,73,44,57,37,211
2024-03-21 14:50:00,62,37,51,32,182
2024-03-21 15:00:00,88,39,54,45,226
2024-03-21 15:10:00,92,50,45,45,232
2024-03-21 15:20:00,70,40,54,40,204
2024-03-21 15:30:00,82,55,60,43,240
2024-03-21 15:40:00,93,55,50,36,234
2024-03-21 15:50:00,92,34,58,39,223
2024-03-21 16:00:00,96,61,59,35,251
2024-03-21 16:10:00,90,50,75,44,259
2024-03-21 16:20:00,82,44,53,28,207
2024-03-21 16:30:00,78,43,47,31,199
2024-03-21 16:40:00,90,55,59,26,230
2024-03-21 16:50:00,94,65,64,42,265
2024-03-21 17:00:00,96,53,60,32,241
2024-03-21 17:10:00,93,46,57,32,228
2024-03-21 17:20:00,89,38,56,37,220
2024-03-21 17:30:00,66,39,52,43,200
2024-03-21 17:40:00,78,38,56,32,204
2024-03-21 17:50:00,70,37,60,40,207
2024-03-21 18:00:00,82,41,47,39,209
2024-03-21 18:10:00,113,56,58,36,263
2024-03-21 18:20:00,82,48,48,28,206
2024-03-21 18:30:00,70,42,35,33,180
2024-03-21 18:40:00,70,36,35,26,167
2024-03-21 18:50:00,76,36,36,22,170
2024-03-21 19:00:00,57,21,29,20,127
2024-03-21 19:10:00,56,25,30,12,123
2024-03-21 19:20:00,54,29,33,12,128
2024-03-21 19:30:00,55,27,32,15,129
2024-03-21 19:40:00,45,22,27,17,111
2024-03-21 19:50:00,49,22,20,19,110
2024-03-21 20:00:00,50,17,22,9,98
2024-03-21 20:10:00,59,24,25,17,125
2024-03-21 20:20:00,47,20,18,8,93
2024-03-21 20:30:00,47,19,21,17,104
2024-03-21 20:40:00,35,9,18,12,74
2024-03-21 20:50:00,54,13,21,9,97
2024-03-21 21:00:00,35,16,16,10,77
2024-03-21 21:10:00,39,12,18,11,80
2024-03-21 21:20:00,37,18,21,10,86
2024-03-21 21:30:00,44,17,13,9,83
2024-03-21 21:40:00,42,18,16,5,81
2024-03-21 21:50:00,49,15,12,8,84
2024-03-21 22:00:00,38,14,16,11,79
2024-03-21 22:10:00,36,16,14,6,72
2024-03-21 22:20:00,31,12,13,13,69
2024-03-21 22:30:00,32,18,18,4,72
2024-03-21 22:40:00,27,7,18,4,56
2024-03-21 22:50:00,32,3,15,7,57
2024-03-21 23:00:00,22,8,8,6,44
2024-03-21 23:10:00,29,8,11,5,53
2024-03-21 23:20:00,23,6,5,3,37
2024-03-21 23:30:00,21,4,8,4,37
2024-03-21 23:40:00,24,5,8,6,43
2024-03-21 23:50:00,12,6,4,1,23
2024-03-22 00:00:00,16,5,6,1,28
2024-03-22 00:10:00,11,4,4,4,23
2024-03-22 00:20:00,12,6,0,0,18
2024-03-22 00:30:00,13,2,2,2,19
2024-03-22 00:40:00,8,2,5,1,16
2024-03-22 00:50:00,7,1,0,0,8
2024-03-22 01:00:00,12,4,4,2,22
2024-03-22 01:10:00,5,1,4,0,10
2024-03-22 01:20:00,5,2,1,2,10
2024-03-22 01:30:00,9,3,2,3,17
2024-03-22 01:40:00,6,1,2,3,12
2024-03-22 01:50:00,6,1,2,2,11
2024-03-22 02:00:00,5,3,1,0,9
2024-03-22 02:10:00,6,2,0,0,8
2024-03-22 02:20:00,4,1,2,0,7
2024-03-22 02:30:00,3,1,2,2,8
2024-03-22 02:40:00,8,1,2,1,12
2024-03-22 02:50:00,3,0,0,2,5
2024-03-22 03:00:00,3,1,1,0,5
2024-03-22 03:10:00,3,0,1,0,4
2024-03-22 03:20:00,5,1,2,0,8
2024-03-22 03:30:00,7,1,4,1,13
2024-03-22 03:40:00,4,0,0,1,5
2024-03-22 03:50:00,1,0,5,3,9
2024-03-22 04:00:00,4,3,3,1,11
2024-03-22 04:10:00,9,1,2,2,14
2024-03-22 04:20:00,8,0,4,1,13
2024-03-22 04:30:00,8,3,4,3,18
2024-03-22 04:40:00,12,4,7,3,26
2024-03-22 04:50:00,14,3,2,3,22
2024-03-22 05:00:00,13,3,4,2,22
2024-03-22 05:10:00,10,2,7,5,24
2024-03-22 05:20:00,26,11,10,2,49
2024-03-22 05:30:00,32,13,11,10,66
2024-03-22 05:40:00,34,14,16,8,72
2024-03-22 05:50:00,31,15,13,8,67
2024-03-22 06:00:00,39,9,13,9,70
2024-03-22 06:10:00,41,16,22,11,90
2024-03-22 06:20:00,45,15,21,8,89
2024-03-22 06:30:00,53,24,23,17,117
2024-03-22 06:40:00,57,20,23,19,119
2024-03-22 06:50:00,58,21,24,15,118
2024-03-22 07:00:00,69,30,30,21,150
2024-03-22 07:10:00,48,37,40,27,152
2024-03-22 07:20:00,60,25,32,32,149
2024-03-22 07:30:00,77,29,43,38,187
2024-03-22 07:40:00,71,34,47,39,191
2024-03-22 07:50:00,74,47,47,35,203
2024-03-22 08:00:00,53,32,53,31,169
2024-03-22 08:10:00,67,33,41,28,169
2024-03-22 08:20:00,72,35,40,34,181
2024-03-22 08:30:00,64,29,55,39,187
2024-03-22 08:40:00,51,22,51,29,153
2024-03-22 08:50:00,66,24,43,31,164
2024-03-22 09:00:00,74,30,44,31,179
2024-03-22 09:10:00,65,30,39,22,156
2024-03-22 09:20:00,58,33,30,17,138
2024-03-22 09:30:00,58,25,44,22,149
2024-03-22 09:40:00,66,39,51,35,191
2024-03-22 09:50:00,41,34,37,23,135
2024-03-22 10:00:00,58,23,48,22,151
2024-03-22 10:10:00,54,23,41,27,145
2024-03-22 10:20:00,59,14,38,16,127
2024-03-22 10:30:00,69,25,39,29,162
2024-03-22 10:40:00,66,29,41,24,160
2024-03-22 10:50:00,85,31,41,27,184
2024-03-22 11:00:00,73,30,39,21,163
2024-03-22 11:10:00,61,23,46,19,149
2024-03-22 11:20:00,65,27,35,23,150
2024-03-22 11:30:00,73,41,38,14,166
2024-03-22 11:40:00,68,33,42,31,174
2024-03-22 11:50:00,64,31,36,22,153
2024-03-22 12:00:00,81,42,35,20,178
2024-03-22 12:10:00,74,34,49,24,181
2024-03-22 12:20:00,62,30,45,29,166
2024-03-22 12:30:00,70,25,49,23,167
2024-03-22 12:40:00,74,28,54,32,188
2024-03-22 12:50:00,82,36,44,38,200
2024-03-22 13:00:00,67,38,53,33,191
2024-03-22 13:10:00,71,44,34,25,174
2024-03-22 13:20:00,72,36,40,23,171
2024-03-22 13:30:00,92,46,40,21,199
2024-03-22 13:40:00,64,32,37,39,172
2024-03-22 13:50:00,76,38,36,15,165
2024-03-22 14:00:00,76,33,39,32,180
2024-03-22 14:10:00,86,31,41,34,192
2024-03-22 14:20:00,83,46,40,29,198
2024-03-22 14:30:00,83,50,46,28,207
2024-03-22 14:40:00,70,30,54,34,188
2024-03-22 14:50:00,74,30,68,36,208
2024-03-22 15:00:00,57,29,57,42,185
2024-03-22 15:10:00,78,33,78,35,224
2024-03-22 15:20:00,89,33,80,49,251
2024-03-22 15:30:00,83,31,66,41,221
2024-03-22 15:40:00,65,36,69,38,208
2024-03-22 15:50:00,89,42,71,33,235
2024-03-22 16:00:00,66,25,64,39,194
2024-03-22 16:10:00,73,32,44,27,176
2024-03-22 16:20:00,83,39,41,35,198
2024-03-22 16:30:00,55,27,45,27,154
2024-03-22 16:40:00,79,35,54,35,203
2024-03-22 16:50:00,81,44,44,26,195
2024-03-22 17:00:00,71,21,47,19,158
2024-03-22 17:10:00,84,38,46,35,203
2024-03-22 17:20:00,81,40,45,23,189
2024-03-22 17:30:00,80,33,44,22,179
2024-03-22 17:40:00,75,36,50,36,197
2024-03-22 17:50:00,61,27,58,27,173
2024-03-22 18:00:00,76,32,47,30,185
2024-03-22 18:10:00,79,39,48,28,194
2024-03-22 18:20:00,66,30,39,20,155
2024-03-22 18:30:00,47,15,21,16,99
2024-03-22 18:40:00,28,15,23,10,76
2024-03-22 18:50:00,36,11,18,9,74
2024-03-22 19:00:00,53,26,38,18,135
2024-03-22 19:10:00,76,30,27,20,153
2024-03-22 19:20:00,64,17,28,11,120
2024-03-22 19:30:00,52,30,25,9,116
2024-03-22 19:40:00,44,21,28,17,110
2024-03-22 19:50:00,50,19,32,21,122
2024-03-22 20:00:00,47,21,29,16,113
2024-03-22 20:10:00,54,20,25,18,117
2024-03-22 20:20:00,55,23,24,9,111
2024-03-22 20:30:00,47,21,21,15,104
2024-03-22 20:40:00,40,24,26,11,101
2024-03-22 20:50:00,49,13,32,12,106
2024-03-22 21:00:00,29,10,18,6,63
2024-03-22 21:10:00,41,15,12,8,76
2024-03-22 21:20:00,48,20,26,10,104
2024-03-22 21:30:00,29,15,18,8,70
2024-03-22 21:40:00,41,19,15,7,82
2024-03-22 21:50:00,43,16,20,7,86
2024-03-22 22:00:00,59,22,18,9,108
2024-03-22 22:10:00,43,17,19,9,88
2024-03-22 22:20:00,41,15,15,12,83
2024-03-22 22:30:00,28,10,18,8,64
2024-03-22 22:40:00,27,7,11,8,53
2024-03-22 22:50:00,33,10,21,7,71
2024-03-22 23:00:00,36,13,10,3,62
2024-03-22 23:10:00,36,12,14,4,66
2024-03-22 23:20:00,27,7,16,5,55
2024-03-22 23:30:00,23,8,12,3,46
2024-03-22 23:40:00,32,3,17,5,57
2024-03-22 23:50:00,28,9,10,9,56
2024-03-23 00:00:00,29,8,16,3,56
2024-03-23 00:10:00,25,2,9,7,43
2024-03-23 00:20:00,18,5,6,2,31
2024-03-23 00:30:00,24,10,10,4,48
2024-03-23 00:40:00,22,8,10,5,45
2024-03-23 00:50:00,27,6,7,3,43
2024-03-23 01:00:00,17,5,5,1,28
2024-03-23 01:10:00,13,1,5,6,25
2024-03-23 01:20:00,12,1,8,0,21
2024-03-23 01:30:00,15,1,5,0,21
2024-03-23 01:40:00,14,5,3,1,23
2024-03-23 01:50:00,13,3,8,2,26
2024-03-23 02:00:00,11,6,14,3,34
2024-03-23 02:10:00,17,2,6,3,28
2024-03-23 02:20:00,14,5,2,0,21
2024-03-23 02:30:00,4,0,6,2,12
2024-03-23 02:40:00,14,4,2,1,21
2024-03-23 02:50:00,6,4,2,2,14
2024-03-23 03:00:00,8,2,4,2,16
2024-03-23 03:10:00,9,2,4,2,17
2024-03-23 03:20:00,8,1,2,0,11
2024-03-23 03:30:00,10,1,4,2,17
2024-03-23 03:40:00,4,3,2,0,9
2024-03-23 03:50:00,12,2,0,0,14
2024-03-23 04:00:00,6,1,0,1,8
2024-03-23 04:10:00,6,2,2,0,10
2024-03-23 04:20:00,6,2,6,1,15
2024-03-23 04:30:00,10,2,3,3,18
2024-03-23 04:40:00,9,2,2,1,14
2024-03-23 04:50:00,7,4,7,4,22
2024-03-23 05:00:00,6,1,2,2,11
2024-03-23 05:10:00,15,5,2,1,23
2024-03-23 05:20:00,13,4,3,4,24
2024-03-23 05:30:00,14,5,6,3,28
2024-03-23 05:40:00,18,2,8,5,33
2024-03-23 05:50:00,10,2,4,2,18
2024-03-23 06:00:00,18,4,7,4,33
2024-03-23 06:10:00,13,1,5,2,21
2024-03-23 06:20:00,18,4,7,4,33
2024-03-23 06:30:00,17,3,13,3,36
2024-03-23 06:40:00,16,5,7,4,32
2024-03-23 06:50:00,23,6,11,6,46
2024-03-23 07:00:00,26,8,9,3,46
2024-03-23 07:10:00,18,5,4,1,28
2024-03-23 07:20:00,18,6,11,3,38
2024-03-23 07:30:00,13,5,6,7,31
2024-03-23 07:40:00,26,5,9,7,47
2024-03-23 07:50:00,19,8,13,17,57
2024-03-23 08:00:00,21,4,15,4,44
2024-03-23 08:10:00,15,7,15,6,43
2024-03-23 08:20:00,28,12,14,4,58
2024-03-23 08:30:00,23,12,17,10,62
2024-03-23 08:40:00,29,4,17,8,58
2024-03-23 08:50:00,24,12,14,5,55
2024-03-23 09:00:00,24,9,19,7,59
2024-03-23 09:10:00,42,12,22,10,86
2024-03-23 09:20:00,35,19,17,14,85
2024-03-23 09:30:00,43,13,29,21,106
2024-03-23 09:40:00,39,15,25,22,101
2024-03-23 09:50:00,48,16,44,25,133
2024-03-23 10:00:00,45,17,39,19,120
2024-03-23 10:10:00,42,18,30,14,104
2024-03-23 10:20:00,49,22,38,24,133
2024-03-23 10:30:00,51,18,40,15,124
2024-03-23 10:40:00,58,26,39,20,143
2024-03-23 10:50:00,51,21,42,17,131
2024-03-23 11:00:00,59,17,40,18,134
2024-03-23 11:10:00,54,26,36,19,135
2024-03-23 11:20:00,58,28,48,17,151
2024-03-23 11:30:00,57,24,45,18,144
2024-03-23 11:40:00,58,27,44,24,153
2024-03-23 11:50:00,60,24,44,15,143
2024-03-23 12:00:00,64,24,46,32,166
2024-03-23 12:10:00,57,31,41,17,146
2024-03-23 12:20:00,65,30,49,21,165
2024-03-23 12:30:00,62,30,51,28,171
2024-03-23 12:40:00,76,39,50,29,194
2024-03-23 12:50:00,56,32,37,20,145
2024-03-23 13:00:00,55,30,29,11,125
2024-03-23 13:10:00,61,25,52,27,165
2024-03-23 13:20:00,64,30,37,22,153
2024-03-23 13:30:00,55,27,40,25,147
2024-03-23 13:40:00,69,26,51,24,170
2024-03-23 13:50:00,68,27,40,21,156
2024-03-23 14:00:00,75,31,45,22,173
2024-03-23 14:10:00,74,29,39,28,170
2024-03-23 14:20:00,79,32,45,26,182
2024-03-23 14:30:00,69,28,50,21,168
2024-03-23 14:40:00,78,38,46,22,184
2024-03-23 14:50:00,64,26,46,15,151
2024-03-23 15:00:00,74,41,36,15,166
2024-03-23 15:10:00,57,28,39,21,145
2024-03-23 15:20:00,49,21,37,14,121
2024-03-23 15:30:00,45,18,31,15,109
2024-03-23 15:40:00,63,31,43,27,164
2024-03-23 15:50:00,59,19,35,13,126
2024-03-23 16:00:00,53,24,46,19,142
2024-03-23 16:10:00,70,34,39,20,163
2024-03-23 16:20:00,66,24,46,18,154
2024-03-23 16:30:00,67,34,44,22,167
2024-03-23 16:40:00,56,20,41,22,139
2024-03-23 16:50:00,60,22,29,16,127
2024-03-23 17:00:00,71,37,41,18,167
2024-03-23 17:10:00,63,35,35,8,141
2024-03-23 17:20:00,79,28,43,19,169
2024-03-23 17:30:00,68,27,39,19,153
2024-03-23 17:40:00,57,19,44,17,137
2024-03-23 17:50:00,72,34,42,20,168
2024-03-23 18:00:00,66,33,41,21,161
2024-03-23 18:10:00,78,37,30,14,159
2024-03-23 18:20:00,68,27,53,15,163
2024-03-23 18:30:00,50,24,47,24,145
2024-03-23 18:40:00,58,22,41,15,136
2024-03-23 18:50:00,40,18,28,16,102
2024-03-23 19:00:00,62,25,26,15,128
2024-03-23 19:10:00,54,21,26,16,117
2024-03-23 19:20:00,60,20,34,13,127
2024-03-23 19:30:00,39,22,26,8,95
2024-03-23 19:40:00,53,25,41,22,141
2024-03-23 19:50:00,51,19,37,20,127
2024-03-23 20:00:00,54,27,28,17,126
2024-03-23 20:10:00,62,22,23,13,120
2024-03-23 20:20:00,50,14,25,18,107
2024-03-23 20:30:00,46,20,19,10,95
2024-03-23 20:40:00,35,10,16,4,65
2024-03-23 20:50:00,39,14,19,11,83
2024-03-23 21:00:00,42,24,14,9,89
2024-03-23 21:10:00,36,15,18,13,82
2024-03-23 21:20:00,31,12,21,13,77
2024-03-23 21:30:00,23,6,18,12,59
2024-03-23 21:40:00,36,7,18,8,69
2024-03-23 21:50:00,50,14,11,4,79
2024-03-23 22:00:00,37,13,13,5,68
2024-03-23 22:10:00,41,9,19,3,72
2024-03-23 22:20:00,43,18,21,8,90
2024-03-23 22:30:00,43,10,26,7,86
2024-03-23 22:40:00,47,23,16,8,94
2024-03-23 22:50:00,52,21,18,5,96
2024-03-23 23:00:00,43,19,22,9,93
2024-03-23 23:10:00,41,23,13,9,86
2024-03-23 23:20:00,56,19,17,3,95
2024-03-23 23:30:00,51,26,15,5,97
2024-03-23 23:40:00,52,22,12,5,91
2024-03-23 23:50:00,44,15,15,4,78
2024-03-24 00:00:00,37,8,11,4,60
2024-03-24 00:10:00,37,11,14,6,68
2024-03-24 00:20:00,34,10,7,4,55
2024-03-24 00:30:00,22,5,8,5,40
2024-03-24 00:40:00,26,10,6,3,45
2024-03-24 00:50:00,29,7,12,4,52
2024-03-24 01:00:00,17,3,9,6,35
2024-03-24 01:10:00,22,8,7,0,37
2024-03-24 01:20:00,9,4,8,2,23
2024-03-24 01:30:00,13,2,2,4,21
2024-03-24 01:40:00,14,6,6,2,28
2024-03-24 01:50:00,17,4,5,4,30
2024-03-24 02:00:00,20,6,6,3,35
2024-03-24 02:10:00,11,4,3,4,22
2024-03-24 02:20:00,13,4,5,2,24
2024-03-24 02:30:00,11,4,3,4,22
2024-03-24 02:40:00,13,4,4,2,23
2024-03-24 02:50:00,13,5,7,2,27
2024-03-24 03:00:00,10,4,4,0,18
2024-03-24 03:10:00,9,6,2,1,18
2024-03-24 03:20:00,18,5,3,0,26
2024-03-24 03:30:00,10,2,3,2,17
2024-03-24 03:40:00,4,1,3,0,8
2024-03-24 03:50:00,9,1,4,1,15
2024-03-24 04:00:00,9,4,3,1,17
2024-03-24 04:10:00,8,2,1,1,12
2024-03-24 04:20:00,4,2,1,0,7
2024-03-24 04:30:00,9,0,2,0,11
2024-03-24 04:40:00,10,4,4,1,19
2024-03-24 04:50:00,5,2,3,1,11
2024-03-24 05:00:00,8,0,2,1,11
2024-03-24 05:10:00,4,3,2,3,12
2024-03-24 05:20:00,8,2,5,1,16
2024-03-24 05:30:00,5,1,4,4,14
2024-03-24 05:40:00,11,1,4,5,21
2024-03-24 05:50:00,7,2,4,1,14
2024-03-24 06:00:00,7,5,4,1,17
2024-03-24 06:10:00,2,2,4,2,10
2024-03-24 06:20:00,15,3,5,3,26
2024-03-24 06:30:00,12,3,5,0,20
2024-03-24 06:40:00,8,2,2,1,13
2024-03-24 06:50:00,11,0,4,2,17
2024-03-24 07:00:00,6,1,5,0,12
2024-03-24 07:10:00,6,1,7,1,15
2024-03-24 07:20:00,11,2,3,0,16
2024-03-24 07:30:00,7,1,4,1,13
2024-03-24 07:40:00,4,1,2,1,8
2024-03-24 07:50:00,11,0,8,1,20
2024-03-24 08:00:00,11,3,6,1,21
2024-03-24 08:10:00,13,3,4,3,23
2024-03-24 08:20:00,9,3,8,4,24
2024-03-24 08:30:00,11,5,5,2,23
2024-03-24 08:40:00,15,1,10,2,28
2024-03-24 08:50:00,23,9,6,4,42
2024-03-24 09:00:00,21,4,11,1,37
2024-03-24 09:10:00,26,9,8,4,47
2024-03-24 09:20:00,28,9,10,6,53
2024-03-24 09:30:00,29,11,10,4,54
2024-03-24 09:40:00,29,12,19,2,62
2024-03-24 09:50:00,25,14,21,7,67
2024-03-24 10:00:00,31,10,14,0,55
2024-03-24 10:10:00,36,6,24,7,73
2024-03-24 10:20:00,32,10,17,5,64
2024-03-24 10:30:00,37,10,19,5,71
2024-03-24 10:40:00,33,19,18,7,77
2024-03-24 10:50:00,36,13,16,11,76
2024-03-24 11:00:00,55,17,19,9,100
2024-03-24 11:10:00,51,22,18,11,102
2024-03-24 11:20:00,41,10,23,7,81
2024-03-24 11:30:00,38,12,26,18,94
2024-03-24 11:40:00,52,16,22,20,110
2024-03-24 11:50:00,47,10,31,11,99
2024-03-24 12:00:00,43,17,29,16,105
2024-03-24 12:10:00,41,14,31,10,96
2024-03-24 12:20:00,39,20,25,14,98
2024-03-24 12:30:00,41,13,22,15,91
2024-03-24 12:40:00,41,16,19,9,85
2024-03-24 12:50:00,44,17,27,12,100
2024-03-24 13:00:00,43,16,28,9,96
2024-03-24 13:10:00,50,19,20,16,105
2024-03-24 13:20:00,52,15,27,11,105
2024-03-24 13:30:00,60,20,30,12,122
2024-03-24 13:40:00,53,25,27,7,112
2024-03-24 13:50:00,54,21,32,11,118
2024-03-24 14:00:00,71,20,41,15,147
2024-03-24 14:10:00,54,14,36,10,114
2024-03-24 14:20:00,63,21,36,17,137
2024-03-24 14:30:00,57,20,32,21,130
2024-03-24 14:40:00,54,24,29,18,125
2024-03-24 14:50:00,55,19,31,7,112
2024-03-24 15:00:00,54,19,31,18,122
2024-03-24 15:10:00,54,18,24,11,107
2024-03-24 15:20:00,51,19,25,10,105
2024-03-24 15:30:00,51,13,25,9,98
2024-03-24 15:40:00,37,13,24,24,98
2024-03-24 15:50:00,45,27,27,13,112
2024-03-24 16:00:00,42,14,16,5,77
2024-03-24 16:10:00,73,22,21,6,122
2024-03-24 16:20:00,45,19,24,15,103
2024-03-24 16:30:00,67,24,28,17,136
2024-03-24 16:40:00,54,27,34,10,125
2024-03-24 16:50:00,44,18,28,20,110
2024-03-24 17:00:00,52,21,33,23,129
2024-03-24 17:10:00,42,14,37,12,105
2024-03-24 17:20:00,67,29,26,15,137
2024-03-24 17:30:00,70,40,41,16,167
2024-03-24 17:40:00,61,20,41,19,141
2024-03-24 17:50:00,83,29,24,8,144
2024-03-24 18:00:00,70,21,35,21,147
2024-03-24 18:10:00,50,22,31,12,115
2024-03-24 18:20:00,42,18,36,11,107
2024-03-24 18:30:00,61,18,31,15,125
2024-03-24 18:40:00,28,11,24,24,87
2024-03-24 18:50:00,47,14,19,8,88
2024-03-24 19:00:00,32,11,26,16,85
2024-03-24 19:10:00,40,17,18,2,77
2024-03-24 19:20:00,39,15,25,12,91
2024-03-24 19:30:00,50,14,25,7,96
2024-03-24 19:40:00,47,14,18,11,90
2024-03-24 19:50:00,28,11,22,14,75
2024-03-24 20:00:00,52,18,20,13,103
2024-03-24 20:10:00,49,15,24,8,96
2024-03-24 20:20:00,51,23,21,9,104
2024-03-24 20:30:00,39,14,13,6,72
2024-03-24 20:40:00,54,18,18,12,102
2024-03-24 20:50:00,39,18,20,6,83
2024-03-24 21:00:00,47,9,15,7,78
2024-03-24 21:10:00,31,9,21,7,68
2024-03-24 21:20:00,33,12,15,8,68
2024-03-24 21:30:00,31,22,15,9,77
2024-03-24 21:40:00,37,21,14,10,82
2024-03-24 21:50:00,35,14,9,3,61
2024-03-24 22:00:00,30,12,17,14,73
2024-03-24 22:10:00,39,14,12,8,73
2024-03-24 22:20:00,35,7,11,5,58
2024-03-24 22:30:00,16,4,3,6,29
2024-03-24 22:40:00,23,6,16,8,53
2024-03-24 22:50:00,25,6,8,5,44
2024-03-24 23:00:00,19,7,9,0,35
2024-03-24 23:10:00,17,7,12,5,41
2024-03-24 23:20:00,20,10,9,2,41
2024-03-24 23:30:00,16,4,5,0,25
2024-03-24 23:40:00,10,3,9,3,25
2024-03-24 23:50:00,10,4,7,3,24
2024-03-25 00:00:00,19,8,4,1,32
2024-03-25 00:10:00,12,3,3,0,18
2024-03-25 00:20:00,15,2,1,2,20
2024-03-25 00:30:00,9,0,4,4,17
2024-03-25 00:40:00,7,2,7,0,16
2024-03-25 00:50:00,4,2,0,1,7
2024-03-25 01:00:00,7,2,4,0,13
2024-03-25 01:10:00,7,2,1,2,12
2024-03-25 01:20:00,3,1,2,2,8
2024-03-25 01:30:00,4,0,0,0,4
2024-03-25 01:40:00,7,0,7,3,17
2024-03-25 01:50:00,2,0,2,1,5
2024-03-25 02:00:00,6,1,0,1,8
2024-03-25 02:10:00,2,1,3,0,6
2024-03-25 02:20:00,5,2,0,0,7
2024-03-25 02:30:00,4,0,1,1,6
2024-03-25 02:40:00,5,1,2,1,9
2024-03-25 02:50:00,4,0,2,2,8
2024-03-25 03:00:00,2,1,2,0,5
2024-03-25 03:10:00,3,1,0,0,4
2024-03-25 03:20:00,3,0,3,1,7
2024-03-25 03:30:00,6,2,1,0,9
2024-03-25 03:40:00,8,0,1,0,9
2024-03-25 03:50:00,7,2,3,2,14
2024-03-25 04:00:00,6,2,4,1,13
2024-03-25 04:10:00,5,2,5,2,14
2024-03-25 04:20:00,13,2,3,1,19
2024-03-25 04:30:00,8,1,4,1,14
2024-03-25 04:40:00,14,9,3,1,27
2024-03-25 04:50:00,10,1,4,2,17
2024-03-25 05:00:00,17,5,7,4,33
2024-03-25 05:10:00,22,4,7,1,34
2024-03-25 05:20:00,29,8,5,5,47
2024-03-25 05:30:00,31,11,9,13,64
2024-03-25 05:40:00,29,8,13,12,62
2024-03-25 05:50:00,35,8,15,7,65
2024-03-25 06:00:00,35,19,21,13,88
2024-03-25 06:10:00,47,19,18,11,95
2024-03-25 06:20:00,53,20,24,13,110
2024-03-25 06:30:00,54,23,27,18,122
2024-03-25 06:40:00,51,19,27,20,117
2024-03-25 06:50:00,66,31,26,15,138
2024-03-25 07:00:00,53,24,19,13,109
2024-03-25 07:10:00,46,26,38,22,132
2024-03-25 07:20:00,57,24,37,17,135
2024-03-25 07:30:00,64,33,58,36,191
2024-03-25 07:40:00,64,28,46,41,179
2024-03-25 07:50:00,83,51,40,30,204
2024-03-25 08:00:00,54,21,52,35,162
2024-03-25 08:10:00,73,33,30,24,160
2024-03-25 08:20:00,65,28,37,34,164
2024-03-25 08:30:00,67,35,45,36,183
2024-03-25 08:40:00,65,30,46,40,181
2024-03-25 08:50:00,77,36,44,38,195
2024-03-25 09:00:00,50,13,33,30,126
2024-03-25 09:10:00,65,28,35,17,145
2024-03-25 09:20:00,65,20,30,25,140
2024-03-25 09:30:00,65,26,42,38,171
2024-03-25 09:40:00,64,27,41,25,157
2024-03-25 09:50:00,58,23,39,20,140
2024-03-25 10:00:00,81,36,43,30,190
2024-03-25 10:10:00,69,25,42,16,152
2024-03-25 10:20:00,70,30,42,16,158
2024-03-25 10:30:00,58,24,43,21,146
2024-03-25 10:40:00,57,24,47,22,150
2024-03-25 10:50:00,69,31,51,21,172
2024-03-25 11:00:00,63,17,39,18,137
2024-03-25 11:10:00,61,21,41,22,145
2024-03-25 11:20:00,58,25,49,21,153
2024-03-25 11:30:00,59,23,33,18,133
2024-03-25 11:40:00,71,25,35,26,157
2024-03-25 11:50:00,60,28,44,26,158
2024-03-25 12:00:00,62,33,41,28,164
2024-03-25 12:10:00,68,31,37,20,156
2024-03-25 12:20:00,69,30,36,17,152
2024-03-25 12:30:00,47,26,33,24,130
2024-03-25 12:40:00,66,28,23,20,137
2024-03-25 12:50:00,52,26,28,19,125
2024-03-25 13:00:00,61,31,27,19,138
2024-03-25 13:10:00,57,26,41,17,141
2024-03-25 13:20:00,61,20,45,21,147
2024-03-25 13:30:00,64,16,36,20,136
2024-03-25 13:40:00,62,22,48,28,160
2024-03-25 13:50:00,75,32,44,26,177
2024-03-25 14:00:00,63,22,36,18,139
2024-03-25 14:10:00,80,34,44,25,183
2024-03-25 14:20:00,71,26,34,24,155
2024-03-25 14:30:00,59,31,52,29,171
2024-03-25 14:40:00,82,34,43,38,197
2024-03-25 14:50:00,55,28,48,34,165
2024-03-25 15:00:00,63,24,39,30,156
2024-03-25 15:10:00,93,42,30,20,185
2024-03-25 15:20:00,77,41,55,26,199
2024-03-25 15:30:00,67,36,40,29,172
2024-03-25 15:40:00,79,49,56,27,211
2024-03-25 15:50:00,79,32,56,33,200
2024-03-25 16:00:00,74,38,47,41,200
2024-03-25 16:10:00,78,43,50,27,198
2024-03-25 16:20:00,78,42,39,32,191
2024-03-25 16:30:00,85,41,62,30,218
2024-03-25 16:40:00,91,44,53,33,221
2024-03-25 16:50:00,70,35,50,24,179
2024-03-25 17:00:00,63,32,56,31,182
2024-03-25 17:10:00,93,42,35,25,195
2024-03-25 17:20:00,77,42,46,24,189
2024-03-25 17:30:00,71,41,45,28,185
2024-03-25 17:40:00,79,39,56,25,199
2024-03-25 17:50:00,67,34,46,23,170
2024-03-25 18:00:00,63,31,44,23,161
2024-03-25 18:10:00,63,29,55,22,169
2024-03-25 18:20:00,84,37,44,23,188
2024-03-25 18:30:00,66,30,37,24,157
2024-03-25 18:40:00,57,26,36,18,137
2024-03-25 18:50:00,55,35,46,23,159
2024-03-25 19:00:00,49,17,34,18,118
2024-03-25 19:10:00,56,17,29,13,115
2024-03-25 19:20:00,39,17,33,20,109
2024-03-25 19:30:00,35,14,23,17,89
2024-03-25 19:40:00,52,26,28,11,117
2024-03-25 19:50:00,34,12,30,13,89
2024-03-25 20:00:00,43,20,18,12,93
2024-03-25 20:10:00,37,16,29,13,95
2024-03-25 20:20:00,35,17,17,8,77
2024-03-25 20:30:00,32,10,21,8,71
2024-03-25 20:40:00,31,9,21,7,68
2024-03-25 20:50:00,23,7,17,9,56
2024-03-25 21:00:00,28,10,21,11,70
2024-03-25 21:10:00,34,14,15,5,68
2024-03-25 21:20:00,41,15,10,9,75
2024-03-25 21:30:00,33,13,13,5,64
2024-03-25 21:40:00,34,21,13,6,74
2024-03-25 21:50:00,37,15,16,9,77
2024-03-25 22:00:00,27,11,17,9,64
2024-03-25 22:10:00,35,14,15,7,71
2024-03-25 22:20:00,31,7,16,11,65
2024-03-25 22:30:00,24,8,12,2,46
2024-03-25 22:40:00,21,3,5,2,31
2024-03-25 22:50:00,23,10,12,4,49
2024-03-25 23:00:00,51,19,10,3,83
2024-03-25 23:10:00,58,30,10,3,101
2024-03-25 23:20:00,37,22,7,4,70
2024-03-25 23:30:00,24,13,5,6,48
2024-03-25 23:40:00,11,3,7,3,24
2024-03-25 23:50:00,9,4,3,1,17
2024-03-26 00:00:00,8,1,7,3,19
2024-03-26 00:10:00,12,2,5,2,21
2024-03-26 00:20:00,7,1,3,1,12
2024-03-26 00:30:00,13,3,7,2,25
2024-03-26 00:40:00,9,1,1,1,12
2024-03-26 00:50:00,4,0,4,2,10
2024-03-26 01:00:00,10,2,1,0,13
2024-03-26 01:10:00,8,3,3,1,15
2024-03-26 01:20:00,8,0,0,1,9
2024-03-26 01:30:00,7,0,5,3,15
2024-03-26 01:40:00,1,1,1,0,3
2024-03-26 01:50:00,8,1,2,0,11
2024-03-26 02:00:00,8,2,0,1,11
2024-03-26 02:10:00,5,1,1,1,8
2024-03-26 02:20:00,4,0,2,2,8
2024-03-26 02:30:00,4,1,0,1,6
2024-03-26 02:40:00,5,0,1,1,7
2024-03-26 02:50:00,7,2,4,0,13
2024-03-26 03:00:00,2,0,3,1,6
2024-03-26 03:10:00,2,0,1,0,3
2024-03-26 03:20:00,3,0,2,0,5
2024-03-26 03:30:00,3,2,0,0,5
2024-03-26 03:40:00,3,1,3,0,7
2024-03-26 03:50:00,6,1,1,0,8
2024-03-26 04:00:00,8,2,0,0,10
2024-03-26 04:10:00,3,3,1,1,8
2024-03-26 04:20:00,13,4,4,2,23
2024-03-26 04:30:00,7,2,2,0,11
2024-03-26 04:40:00,11,5,3,2,21
2024-03-26 04:50:00,10,3,8,3,24
2024-03-26 05:00:00,15,6,5,6,32
2024-03-26 05:10:00,19,7,3,1,30
2024-03-26 05:20:00,22,2,7,4,35
2024-03-26 05:30:00,21,10,7,8,46
2024-03-26 05:40:00,33,17,16,10,76
2024-03-26 05:50:00,28,13,21,9,71
2024-03-26 06:00:00,42,17,13,9,81
2024-03-26 06:10:00,44,19,25,17,105
2024-03-26 06:20:00,43,29,16,7,95
2024-03-26 06:30:00,46,20,33,21,120
2024-03-26 06:40:00,61,22,25,19,127
2024-03-26 06:50:00,54,24,28,17,123
2024-03-26 07:00:00,41,27,33,23,124
2024-03-26 07:10:00,65,34,20,22,141
2024-03-26 07:20:00,62,31,42,28,163
2024-03-26 07:30:00,58,28,43,38,167
2024-03-26 07:40:00,74,32,54,51,211
2024-03-26 07:50:00,69,36,36,40,181
2024-03-26 08:00:00,67,37,38,27,169
2024-03-26 08:10:00,62,28,41,33,164
2024-03-26 08:20:00,72,38,48,42,200
2024-03-26 08:30:00,56,26,43,34,159
2024-03-26 08:40:00,85,40,51,34,210
2024-03-26 08:50:00,72,30,48,33,183
2024-03-26 09:00:00,65,42,35,28,170
2024-03-26 09:10:00,71,38,38,19,166
2024-03-26 09:20:00,66,36,45,29,176
2024-03-26 09:30:00,66,35,37,31,169
2024-03-26 09:40:00,67,26,40,21,154
2024-03-26 09:50:00,53,18,43,21,135
2024-03-26 10:00:00,66,28,50,31,175
2024-03-26 10:10:00,62,16,48,17,143
2024-03-26 10:20:00,69,38,40,22,169
2024-03-26 10:30:00,57,27,41,18,143
2024-03-26 10:40:00,68,38,38,26,170
2024-03-26 10:50:00,67,28,41,27,163
2024-03-26 11:00:00,60,19,36,29,144
2024-03-26 11:10:00,77,22,49,20,168
2024-03-26 11:20:00,61,21,34,16,132
2024-03-26 11:30:00,74,23,40,24,161
2024-03-26 11:40:00,68,29,52,30,179
2024-03-26 11:50:00,76,39,28,19,162
2024-03-26 12:00:00,52,32,45,32,161
2024-03-26 12:10:00,64,22,35,19,140
2024-03-26 12:20:00,63,22,35,22,142
2024-03-26 12:30:00,55,26,42,23,146
2024-03-26 12:40:00,70,26,33,23,152
2024-03-26 12:50:00,59,33,37,20,149
2024-03-26 13:00:00,69,25,37,18,149
2024-03-26 13:10:00,73,38,36,25,172
2024-03-26 13:20:00,67,32,37,19,155
2024-03-26 13:30:00,67,36,52,23,178
2024-03-26 13:40:00,51,16,47,24,138
2024-03-26 13:50:00,68,30,35,24,157
2024-03-26 14:00:00,52,24,47,20,143
2024-03-26 14:10:00,61,22,50,31,164
2024-03-26 14:20:00,71,41,41,20,173
2024-03-26 14:30:00,79,42,41,23,185
2024-03-26 14:40:00,76,37,53,31,197
2024-03-26 14:50:00,68,26,50,26,170
2024-03-26 15:00:00,64,41,40,21,166
2024-03-26 15:10:00,73,34,46,18,171
2024-03-26 15:20:00,66,38,51,31,186
2024-03-26 15:30:00,66,28,37,24,155
2024-03-26 15:40:00,91,46,68,27,232
2024-03-26 15:50:00,84,46,43,32,205
2024-03-26 16:00:00,76,36,57,32,201
2024-03-26 16:10:00,78,49,52,35,214
2024-03-26 16:20:00,84,32,50,35,201
2024-03-26 16:30:00,84,45,46,38,213
2024-03-26 16:40:00,77,49,49,30,205
2024-03-26 16:50:00,81,35,40,26,182
2024-03-26 17:00:00,79,45,37,33,194
2024-03-26 17:10:00,82,36,50,32,200
2024-03-26 17:20:00,81,45,48,30,204
2024-03-26 17:30:00,70,40,54,32,196
2024-03-26 17:40:00,81,45,68,40,234
2024-03-26 17:50:00,56,22,48,28,154
2024-03-26 18:00:00,74,32,51,26,183
2024-03-26 18:10:00,88,51,49,26,214
2024-03-26 18:20:00,71,34,37,23,165
2024-03-26 18:30:00,54,29,43,32,158
2024-03-26 18:40:00,61,32,44,27,164
2024-03-26 18:50:00,60,26,30,26,142
2024-03-26 19:00:00,50,17,24,17,108
2024-03-26 19:10:00,52,17,21,16,106
2024-03-26 19:20:00,49,20,25,12,106
2024-03-26 19:30:00,44,14,28,7,93
2024-03-26 19:40:00,40,13,17,18,88
2024-03-26 19:50:00,50,20,25,12,107
2024-03-26 20:00:00,43,28,19,16,106
2024-03-26 20:10:00,42,16,28,25,111
2024-03-26 20:20:00,31,11,15,15,72
2024-03-26 20:30:00,43,15,22,14,94
2024-03-26 20:40:00,32,12,17,8,69
2024-03-26 20:50:00,40,9,17,8,74
2024-03-26 21:00:00,35,16,16,8,75
2024-03-26 21:10:00,34,14,11,7,66
2024-03-26 21:20:00,34,18,13,13,78
2024-03-26 21:30:00,33,9,10,9,61
2024-03-26 21:40:00,47,19,14,6,86
2024-03-26 21:50:00,28,16,13,14,71
2024-03-26 22:00:00,40,16,15,8,79
2024-03-26 22:10:00,20,11,10,5,46
2024-03-26 22:20:00,28,10,13,5,56
2024-03-26 22:30:00,22,11,9,8,50
2024-03-26 22:40:00,23,6,5,6,40
2024-03-26 22:50:00,23,10,13,8,54
2024-03-26 23:00:00,19,9,17,5,50
2024-03-26 23:10:00,13,6,3,2,24
2024-03-26 23:20:00,28,4,15,3,50
2024-03-26 23:30:00,30,12,6,2,50
2024-03-26 23:40:00,19,7,9,0,35
2024-03-26 23:50:00,9,1,5,2,17
2024-03-27 00:00:00,12,4,2,3,21
2024-03-27 00:10:00,12,2,8,1,23
2024-03-27 00:20:00,14,6,8,2,30
2024-03-27 00:30:00,15,5,5,2,27
2024-03-27 00:40:00,10,1,1,0,12
2024-03-27 00:50:00,3,0,3,2,8
2024-03-27 01:00:00,8,2,4,2,16
2024-03-27 01:10:00,7,3,5,2,17
2024-03-27 01:20:00,5,3,3,3,14
2024-03-27 01:30:00,5,1,3,0,9
2024-03-27 01:40:00,4,1,2,2,9
2024-03-27 01:50:00,2,0,1,0,3
2024-03-27 02:00:00,4,2,1,1,8
2024-03-27 02:10:00,5,2,5,2,14
2024-03-27 02:20:00,4,1,2,1,8
2024-03-27 02:30:00,6,3,2,0,11
2024-03-27 02:40:00,5,0,1,0,6
2024-03-27 02:50:00,5,2,1,1,9
2024-03-27 03:00:00,2,1,2,1,6
2024-03-27 03:10:00,9,3,1,0,13
2024-03-27 03:20:00,7,3,0,0,10
2024-03-27 03:30:00,3,2,0,0,5
2024-03-27 03:40:00,2,0,2,0,4
2024-03-27 03:50:00,3,1,3,2,9
2024-03-27 04:00:00,3,0,2,1,6
2024-03-27 04:10:00,8,3,3,2,16
2024-03-27 04:20:00,4,1,2,2,9
2024-03-27 04:30:00,10,2,3,1,16
2024-03-27 04:40:00,13,4,4,2,23
2024-03-27 04:50:00,12,1,4,1,18
2024-03-27 05:00:00,14,4,4,1,23
2024-03-27 05:10:00,13,6,2,0,21
2024-03-27 05:20:00,37,10,13,5,65
2024-03-27 05:30:00,32,12,7,8,59
2024-03-27 05:40:00,31,13,16,8,68
2024-03-27 05:50:00,30,13,20,8,71
2024-03-27 06:00:00,50,14,19,11,94
2024-03-27 06:10:00,47,22,20,14,103
2024-03-27 06:20:00,44,16,20,15,95
2024-03-27 06:30:00,47,21,28,22,118
2024-03-27 06:40:00,65,26,39,25,155
2024-03-27 06:50:00,60,24,25,21,130
2024-03-27 07:00:00,61,31,27,18,137
2024-03-27 07:10:00,45,26,27,22,120
2024-03-27 07:20:00,68,30,32,19,149
2024-03-27 07:30:00,71,29,43,36,179
2024-03-27 07:40:00,62,30,50,31,173
2024-03-27 07:50:00,66,39,45,36,186
2024-03-27 08:00:00,67,29,27,25,148
2024-03-27 08:10:00,51,25,36,28,140
2024-03-27 08:20:00,77,41,37,33,188
2024-03-27 08:30:00,68,34,45,36,183
2024-03-27 08:40:00,83,41,40,43,207
2024-03-27 08:50:00,70,38,36,29,173
2024-03-27 09:00:00,73,26,39,27,165
2024-03-27 09:10:00,63,24,36,33,156
2024-03-27 09:20:00,69,26,44,29,168
2024-03-27 09:30:00,70,24,44,36,174
2024-03-27 09:40:00,53,20,43,25,141
2024-03-27 09:50:00,54,25,44,21,144
2024-03-27 10:00:00,61,26,34,23,144
2024-03-27 10:10:00,55,31,48,26,160
2024-03-27 10:20:00,50,17,36,20,123
2024-03-27 10:30:00,50,32,55,33,170
2024-03-27 10:40:00,65,28,47,24,164
2024-03-27 10:50:00,66,32,40,26,164
2024-03-27 11:00:00,62,22,37,24,145
2024-03-27 11:10:00,55,24,30,25,134
2024-03-27 11:20:00,58,22,36,33,149
2024-03-27 11:30:00,66,28,43,31,168
2024-03-27 11:40:00,61,37,35,20,153
2024-03-27 11:50:00,58,25,39,17,139
2024-03-27 12:00:00,64,32,43,21,160
2024-03-27 12:10:00,55,26,42,16,139
2024-03-27 12:20:00,71,29,46,21,167
2024-03-27 12:30:00,60,33,33,18,144
2024-03-27 12:40:00,68,19,45,36,168
2024-03-27 12:50:00,66,35,33,20,154
2024-03-27 13:00:00,68,34,39,28,169
2024-03-27 13:10:00,63,25,45,26,159
2024-03-27 13:20:00,66,27,48,31,172
2024-03-27 13:30:00,70,39,35,19,163
2024-03-27 13:40:00,70,31,46,26,173
2024-03-27 13:50:00,74,34,44,16,168
2024-03-27 14:00:00,59,26,40,32,157
2024-03-27 14:10:00,71,38,45,30,184
2024-03-27 14:20:00,83,43,38,24,188
2024-03-27 14:30:00,63,28,45,27,163
2024-03-27 14:40:00,70,26,48,31,175
2024-03-27 14:50:00,65,39,44,18,166
2024-03-27 15:00:00,74,43,48,29,194
2024-03-27 15:10:00,76,33,49,26,184
2024-03-27 15:20:00,78,50,53,30,211
2024-03-27 15:30:00,74,36,62,34,206
2024-03-27 15:40:00,88,38,59,34,219
2024-03-27 15:50:00,81,37,51,31,200
2024-03-27 16:00:00,75,51,51,30,207
2024-03-27 16:10:00,87,47,51,31,216
2024-03-27 16:20:00,80,45,45,40,210
2024-03-27 16:30:00,91,39,51,35,216
2024-03-27 16:40:00,94,56,49,41,240
2024-03-27 16:50:00,76,37,63,33,209
2024-03-27 17:00:00,70,39,54,30,193
2024-03-27 17:10:00,86,43,50,36,215
2024-03-27 17:20:00,85,38,63,46,232
2024-03-27 17:30:00,69,33,44,35,181
2024-03-27 17:40:00,70,42,46,33,191
2024-03-27 17:50:00,58,24,68,38,188
2024-03-27 18:00:00,71,32,61,32,196
2024-03-27 18:10:00,78,36,40,23,177
2024-03-27 18:20:00,89,31,48,30,198
2024-03-27 18:30:00,70,24,45,32,171
2024-03-27 18:40:00,72,40,37,26,175
2024-03-27 18:50:00,62,21,40,25,148
2024-03-27 19:00:00,49,18,21,17,105
2024-03-27 19:10:00,43,24,23,11,101
2024-03-27 19:20:00,58,27,24,11,120
2024-03-27 19:30:00,47,19,19,9,94
2024-03-27 19:40:00,53,20,31,14,118
2024-03-27 19:50:00,54,15,31,12,112
2024-03-27 20:00:00,55,22,19,12,108
2024-03-27 20:10:00,45,15,22,16,98
2024-03-27 20:20:00,40,11,23,14,88
2024-03-27 20:30:00,37,14,22,16,89
2024-03-27 20:40:00,31,12,20,12,75
2024-03-27 20:50:00,29,15,11,9,64
2024-03-27 21:00:00,36,12,13,5,66
2024-03-27 21:10:00,28,12,20,8,68
2024-03-27 21:20:00,53,16,13,7,89
2024-03-27 21:30:00,37,18,20,8,83
2024-03-27 21:40:00,36,18,15,4,73
2024-03-27 21:50:00,40,16,9,9,74
2024-03-27 22:00:00,37,15,14,10,76
2024-03-27 22:10:00,38,10,15,8,71
2024-03-27 22:20:00,19,3,14,11,47
2024-03-27 22:30:00,28,15,16,6,65
2024-03-27 22:40:00,18,4,11,5,38
2024-03-27 22:50:00,29,11,14,5,59
2024-03-27 23:00:00,36,7,14,6,63
2024-03-27 23:10:00,20,7,4,2,33
2024-03-27 23:20:00,22,10,12,5,49
2024-03-27 23:30:00,20,11,5,4,40
2024-03-27 23:40:00,12,4,3,1,20
2024-03-27 23:50:00,9,6,6,4,25
2024-03-28 00:00:00,13,3,3,1,20
2024-03-28 00:10:00,13,3,8,3,27
2024-03-28 00:20:00,10,2,7,1,20
2024-03-28 00:30:00,10,2,3,0,15
2024-03-28 00:40:00,12,1,2,3,18
2024-03-28 00:50:00,11,0,2,1,14
2024-03-28 01:00:00,7,1,1,0,9
2024-03-28 01:10:00,4,1,2,0,7
2024-03-28 01:20:00,8,2,1,2,13
2024-03-28 01:30:00,9,2,2,0,13
2024-03-28 01:40:00,4,0,4,2,10
2024-03-28 01:50:00,5,1,2,1,9
2024-03-28 02:00:00,4,1,2,1,8
2024-03-28 02:10:00,3,0,4,2,9
2024-03-28 02:20:00,7,0,0,1,8
2024-03-28 02:30:00,4,1,2,0,7
2024-03-28 02:40:00,6,2,1,0,9
2024-03-28 02:50:00,1,0,1,2,4
2024-03-28 03:00:00,3,0,1,2,6
2024-03-28 03:10:00,3,1,1,0,5
2024-03-28 03:20:00,6,1,1,1,9
2024-03-28 03:30:00,6,2,3,0,11
2024-03-28 03:40:00,3,0,5,0,8
2024-03-28 03:50:00,3,3,2,1,9
2024-03-28 04:00:00,6,2,1,2,11
2024-03-28 04:10:00,6,1,5,0,12
2024-03-28 04:20:00,8,1,3,2,14
2024-03-28 04:30:00,11,2,4,0,17
2024-03-28 04:40:00,9,2,2,2,15
2024-03-28 04:50:00,9,1,2,3,15
2024-03-28 05:00:00,19,6,5,2,32
2024-03-28 05:10:00,19,4,7,3,33
2024-03-28 05:20:00,26,7,10,8,51
2024-03-28 05:30:00,26,8,6,7,47
2024-03-28 05:40:00,33,10,19,9,71
2024-03-28 05:50:00,32,10,12,6,60
2024-03-28 06:00:00,29,8,15,10,62
2024-03-28 06:10:00,50,17,20,7,94
2024-03-28 06:20:00,45,16,22,20,103
2024-03-28 06:30:00,46,17,23,21,107
2024-03-28 06:40:00,50,19,29,18,116
2024-03-28 06:50:00,57,21,24,12,114
2024-03-28 07:00:00,53,19,31,17,120
2024-03-28 07:10:00,46,15,30,28,119
2024-03-28 07:20:00,51,28,31,27,137
2024-03-28 07:30:00,65,20,45,27,157
2024-03-28 07:40:00,59,29,46,32,166
2024-03-28 07:50:00,56,30,48,42,176
2024-03-28 08:00:00,44,26,33,28,131
2024-03-28 08:10:00,57,22,42,27,148
2024-03-28 08:20:00,66,32,39,26,163
2024-03-28 08:30:00,68,32,40,32,172
2024-03-28 08:40:00,71,36,44,36,187
2024-03-28 08:50:00,73,26,42,28,169
2024-03-28 09:00:00,68,32,51,27,178
2024-03-28 09:10:00,75,32,49,26,182
2024-03-28 09:20:00,59,26,41,18,144
2024-03-28 09:30:00,53,24,49,32,158
2024-03-28 09:40:00,61,24,43,28,156
2024-03-28 09:50:00,62,21,56,26,165
2024-03-28 10:00:00,55,20,36,32,143
2024-03-28 10:10:00,74,23,44,28,169
2024-03-28 10:20:00,66,41,39,27,173
2024-03-28 10:30:00,48,26,46,33,153
2024-03-28 10:40:00,73,35,48,21,177
2024-03-28 10:50:00,61,20,49,28,158
2024-03-28 11:00:00,60,23,45,28,156
2024-03-28 11:10:00,65,17,57,34,173
2024-03-28 11:20:00,63,34,38,27,162
2024-03-28 11:30:00,61,31,51,30,173
2024-03-28 11:40:00,69,35,47,29,180
2024-03-28 11:50:00,74,26,46,19,165
2024-03-28 12:00:00,64,31,41,26,162
2024-03-28 12:10:00,73,24,37,19,153
2024-03-28 12:20:00,70,32,46,33,181
2024-03-28 12:30:00,67,28,39,32,166
2024-03-28 12:40:00,67,40,47,31,185
2024-03-28 12:50:00,77,31,40,25,173
2024-03-28 13:00:00,70,20,34,42,166
2024-03-28 13:10:00,79,34,47,31,191
2024-03-28 13:20:00,63,22,44,28,157
2024-03-28 13:30:00,89,35,46,27,197
2024-03-28 13:40:00,74,32,38,34,178
2024-03-28 13:50:00,70,35,45,27,177
2024-03-28 14:00:00,71,40,45,22,178
2024-03-28 14:10:00,81,45,52,33,211
2024-03-28 14:20:00,85,30,49,24,188
2024-03-28 14:30:00,81,37,52,20,190
2024-03-28 14:40:00,83,35,55,21,194
2024-03-28 14:50:00,64,29,58,34,185
2024-03-28 15:00:00,74,38,47,31,190
2024-03-28 15:10:00,73,37,52,32,194
2024-03-28 15:20:00,82,45,45,28,200
2024-03-28 15:30:00,75,36,47,25,183
2024-03-28 15:40:00,95,54,50,34,233
2024-03-28 15:50:00,81,31,69,40,221
2024-03-28 16:00:00,68,29,54,33,184
2024-03-28 16:10:00,84,30,56,43,213
2024-03-28 16:20:00,85,46,46,40,217
2024-03-28 16:30:00,75,31,40,33,179
2024-03-28 16:40:00,75,41,50,38,204
2024-03-28 16:50:00,75,46,53,29,203
2024-03-28 17:00:00,86,38,42,27,193
2024-03-28 17:10:00,74,36,63,36,209
2024-03-28 17:20:00,94,47,53,27,221
2024-03-28 17:30:00,82,29,56,25,192
2024-03-28 17:40:00,75,40,44,32,191
2024-03-28 17:50:00,88,44,49,24,205
2024-03-28 18:00:00,81,37,45,27,190
2024-03-28 18:10:00,81,40,49,26,196
2024-03-28 18:20:00,76,35,46,33,190
2024-03-28 18:30:00,69,30,37,22,158
2024-03-28 18:40:00,63,29,37,19,148
2024-03-28 18:50:00,54,30,38,26,148
2024-03-28 19:00:00,59,19,28,18,124
2024-03-28 19:10:00,68,28,35,18,149
2024-03-28 19:20:00,50,22,36,16,124
2024-03-28 19:30:00,60,23,31,6,120
2024-03-28 19:40:00,42,23,29,16,110
2024-03-28 19:50:00,49,16,23,18,106
2024-03-28 20:00:00,51,25,23,9,108
2024-03-28 20:10:00,56,19,18,16,109
2024-03-28 20:20:00,46,19,31,16,112
2024-03-28 20:30:00,49,17,28,19,113
2024-03-28 20:40:00,54,19,32,16,121
2024-03-28 20:50:00,39,11,24,10,84
2024-03-28 21:00:00,32,11,24,8,75
2024-03-28 21:10:00,40,19,16,10,85
2024-03-28 21:20:00,39,18,17,7,81
2024-03-28 21:30:00,46,14,19,18,97
2024-03-28 21:40:00,33,14,16,8,71
2024-03-28 21:50:00,44,17,15,13,89
2024-03-28 22:00:00,47,11,19,10,87
2024-03-28 22:10:00,37,13,22,16,88
2024-03-28 22:20:00,45,15,21,9,90
2024-03-28 22:30:00,36,12,15,12,75
2024-03-28 22:40:00,30,6,17,12,65
2024-03-28 22:50:00,36,13,25,6,80
2024-03-28 23:00:00,25,9,13,5,52
2024-03-28 23:10:00,21,7,10,5,43
2024-03-28 23:20:00,21,6,8,2,37
2024-03-28 23:30:00,33,8,9,1,51
2024-03-28 23:40:00,19,9,7,5,40
2024-03-28 23:50:00,15,5,10,4,34
2024-03-29 00:00:00,28,8,11,4,51
2024-03-29 00:10:00,18,5,8,3,34
2024-03-29 00:20:00,26,5,6,3,40
2024-03-29 00:30:00,18,3,7,4,32
2024-03-29 00:40:00,22,6,5,2,35
2024-03-29 00:50:00,16,3,7,5,31
2024-03-29 01:00:00,19,6,5,8,38
2024-03-29 01:10:00,15,4,4,1,24
2024-03-29 01:20:00,11,3,4,1,19
2024-03-29 01:30:00,8,2,7,3,20
2024-03-29 01:40:00,11,4,4,1,20
2024-03-29 01:50:00,13,6,4,5,28
2024-03-29 02:00:00,7,1,1,0,9
2024-03-29 02:10:00,6,2,3,1,12
2024-03-29 02:20:00,12,4,5,4,25
2024-03-29 02:30:00,9,3,3,1,16
2024-03-29 02:40:00,3,2,4,1,10
2024-03-29 02:50:00,8,1,1,1,11
2024-03-29 03:00:00,4,1,1,1,7
2024-03-29 03:10:00,7,2,0,1,10
2024-03-29 03:20:00,10,1,0,1,12
2024-03-29 03:30:00,13,3,4,3,23
2024-03-29 03:40:00,10,2,1,1,14
2024-03-29 03:50:00,4,1,3,1,9
2024-03-29 04:00:00,6,0,2,1,9
2024-03-29 04:10:00,6,0,1,2,9
2024-03-29 04:20:00,11,2,4,2,19
2024-03-29 04:30:00,10,1,3,2,16
2024-03-29 04:40:00,9,1,3,0,13
2024-03-29 04:50:00,7,1,2,1,11
2024-03-29 05:00:00,8,3,1,0,12
2024-03-29 05:10:00,5,0,2,4,11
2024-03-29 05:20:00,8,3,2,1,14
2024-03-29 05:30:00,6,4,1,2,13
2024-03-29 05:40:00,12,2,3,3,20
2024-03-29 05:50:00,15,2,8,1,26
2024-03-29 06:00:00,6,2,5,4,17
2024-03-29 06:10:00,5,1,7,3,16
2024-03-29 06:20:00,11,3,5,3,22
2024-03-29 06:30:00,4,2,1,2,9
2024-03-29 06:40:00,12,1,3,1,17
2024-03-29 06:50:00,7,1,4,3,15
2024-03-29 07:00:00,12,5,0,3,20
2024-03-29 07:10:00,4,1,3,3,11
2024-03-29 07:20:00,16,7,4,4,31
2024-03-29 07:30:00,8,1,4,2,15
2024-03-29 07:40:00,14,2,7,1,24
2024-03-29 07:50:00,10,3,3,1,17
2024-03-29 08:00:00,14,2,3,1,20
2024-03-29 08:10:00,13,5,2,3,23
2024-03-29 08:20:00,20,12,2,6,40
2024-03-29 08:30:00,19,4,8,2,33
2024-03-29 08:40:00,17,2,6,2,27
2024-03-29 08:50:00,17,5,7,1,30
2024-03-29 09:00:00,27,6,5,1,39
2024-03-29 09:10:00,18,3,8,0,29
2024-03-29 09:20:00,24,10,5,1,40
2024-03-29 09:30:00,21,8,17,3,49
2024-03-29 09:40:00,22,9,14,6,51
2024-03-29 09:50:00,17,5,6,3,31
2024-03-29 10:00:00,28,10,14,7,59
2024-03-29 10:10:00,34,9,16,10,69
2024-03-29 10:20:00,27,8,15,5,55
2024-03-29 10:30:00,33,11,15,4,63
2024-03-29 10:40:00,39,8,17,8,72
2024-03-29 10:50:00,34,12,8,9,63
2024-03-29 11:00:00,31,6,20,7,64
2024-03-29 11:10:00,33,13,15,6,67
2024-03-29 11:20:00,24,4,24,8,60
2024-03-29 11:30:00,36,12,19,6,73
2024-03-29 11:40:00,36,7,18,11,72
2024-03-29 11:50:00,49,21,22,11,103
2024-03-29 12:00:00,47,13,21,13,94
2024-03-29 12:10:00,50,20,20,11,101
2024-03-29 12:20:00,43,9,20,12,84
2024-03-29 12:30:00,42,11,19,12,84
2024-03-29 12:40:00,47,19,24,7,97
2024-03-29 12:50:00,52,16,23,12,103
2024-03-29 13:00:00,45,12,25,17,99
2024-03-29 13:10:00,49,18,22,13,102
2024-03-29 13:20:00,62,20,17,11,110
2024-03-29 13:30:00,37,9,23,16,85
2024-03-29 13:40:00,47,19,20,9,95
2024-03-29 13:50:00,48,19,18,14,99
2024-03-29 14:00:00,57,18,28,18,121
2024-03-29 14:10:00,58,24,25,13,120
2024-03-29 14:20:00,50,17,20,16,103
2024-03-29 14:30:00,53,24,29,10,116
2024-03-29 14:40:00,54,24,22,10,110
2024-03-29 14:50:00,47,15,28,15,105
2024-03-29 15:00:00,57,17,36,12,122
2024-03-29 15:10:00,42,15,26,14,97
2024-03-29 15:20:00,67,20,26,21,134
2024-03-29 15:30:00,43,14,29,11,97
2024-03-29 15:40:00,48,20,21,11,100
2024-03-29 15:50:00,48,21,26,11,106
2024-03-29 16:00:00,33,16,21,11,81
2024-03-29 16:10:00,56,25,24,14,119
2024-03-29 16:20:00,57,20,26,18,121
2024-03-29 16:30:00,45,13,25,11,94
2024-03-29 16:40:00,46,24,31,15,116
2024-03-29 16:50:00,41,13,18,6,78
2024-03-29 17:00:00,49,18,25,11,103
2024-03-29 17:10:00,41,13,24,18,96
2024-03-29 17:20:00,55,20,12,7,94
2024-03-29 17:30:00,59,28,27,17,131
2024-03-29 17:40:00,49,20,35,21,125
2024-03-29 17:50:00,45,22,34,13,114
2024-03-29 18:00:00,55,11,38,18,122
2024-03-29 18:10:00,52,15,26,15,108
2024-03-29 18:20:00,54,18,31,18,121
2024-03-29 18:30:00,52,21,38,26,137
2024-03-29 18:40:00,36,15,30,19,100
2024-03-29 18:50:00,51,14,24,12,101
2024-03-29 19:00:00,45,20,21,15,101
2024-03-29 19:10:00,59,13,24,8,104
2024-03-29 19:20:00,58,32,18,12,120
2024-03-29 19:30:00,48,11,19,6,84
2024-03-29 19:40:00,45,13,23,10,91
2024-03-29 19:50:00,46,19,16,9,90
2024-03-29 20:00:00,41,12,23,7,83
2024-03-29 20:10:00,38,8,14,16,76
2024-03-29 20:20:00,39,9,24,13,85
2024-03-29 20:30:00,51,8,19,18,96
2024-03-29 20:40:00,35,10,12,10,67
2024-03-29 20:50:00,37,17,18,8,80
2024-03-29 21:00:00,33,10,21,12,76
2024-03-29 21:10:00,22,9,20,6,57
2024-03-29 21:20:00,32,13,24,10,79
2024-03-29 21:30:00,49,26,20,14,109
2024-03-29 21:40:00,35,16,12,6,69
2024-03-29 21:50:00,42,15,13,7,77
2024-03-29 22:00:00,41,13,15,7,76
2024-03-29 22:10:00,45,18,16,9,88
2024-03-29 22:20:00,36,16,13,9,74
2024-03-29 22:30:00,35,11,20,7,73
2024-03-29 22:40:00,29,11,15,6,61
2024-03-29 22:50:00,34,15,25,10,84
2024-03-29 23:00:00,25,5,9,4,43
2024-03-29 23:10:00,34,10,13,6,63
2024-03-29 23:20:00,22,6,15,8,51
2024-03-29 23:30:00,31,6,10,4,51
2024-03-29 23:40:00,23,7,11,7,48
2024-03-29 23:50:00,25,7,10,5,47
2024-03-30 00:00:00,13,5,9,6,33
2024-03-30 00:10:00,18,5,6,5,34
2024-03-30 00:20:00,15,0,6,2,23
2024-03-30 00:30:00,16,3,4,3,26
2024-03-30 00:40:00,15,5,4,4,28
2024-03-30 00:50:00,19,2,3,1,25
2024-03-30 01:00:00,12,1,14,7,34
2024-03-30 01:10:00,7,1,2,1,11
2024-03-30 01:20:00,18,4,2,0,24
2024-03-30 01:30:00,12,7,2,2,23
2024-03-30 01:40:00,13,6,7,2,28
2024-03-30 01:50:00,13,1,4,0,18
2024-03-30 02:00:00,8,2,2,0,12
2024-03-30 02:10:00,5,1,3,2,11
2024-03-30 02:20:00,9,0,2,2,13
2024-03-30 02:30:00,10,4,5,2,21
2024-03-30 02:40:00,4,2,4,2,12
2024-03-30 02:50:00,8,1,3,1,13
2024-03-30 03:00:00,7,0,5,1,13
2024-03-30 03:10:00,5,1,3,1,10
2024-03-30 03:20:00,3,0,2,2,7
2024-03-30 03:30:00,6,2,2,0,10
2024-03-30 03:40:00,11,3,5,3,22
2024-03-30 03:50:00,6,1,1,0,8
2024-03-30 04:00:00,6,2,2,3,13
2024-03-30 04:10:00,8,2,2,0,12
2024-03-30 04:20:00,8,2,6,0,16
2024-03-30 04:30:00,6,0,7,1,14
2024-03-30 04:40:00,6,2,3,2,13
2024-03-30 04:50:00,8,1,5,1,15
2024-03-30 05:00:00,11,1,2,1,15
2024-03-30 05:10:00,7,4,7,1,19
2024-03-30 05:20:00,7,3,1,2,13
2024-03-30 05:30:00,15,5,5,2,27
2024-03-30 05:40:00,6,4,8,7,25
2024-03-30 05:50:00,13,3,7,3,26
2024-03-30 06:00:00,8,2,5,5,20
2024-03-30 06:10:00,13,2,9,5,29
2024-03-30 06:20:00,14,7,5,3,29
2024-03-30 06:30:00,17,3,10,3,33
2024-03-30 06:40:00,19,4,6,2,31
2024-03-30 06:50:00,18,4,12,2,36
2024-03-30 07:00:00,12,2,4,4,22
2024-03-30 07:10:00,14,5,5,2,26
2024-03-30 07:20:00,18,1,7,5,31
2024-03-30 07:30:00,21,3,8,4,36
2024-03-30 07:40:00,12,0,12,7,31
2024-03-30 07:50:00,14,2,6,3,25
2024-03-30 08:00:00,21,3,8,2,34
2024-03-30 08:10:00,15,3,12,8,38
2024-03-30 08:20:00,22,5,11,10,48
2024-03-30 08:30:00,34,7,17,7,65
2024-03-30 08:40:00,31,10,14,2,57
2024-03-30 08:50:00,24,6,15,9,54
2024-03-30 09:00:00,31,19,18,13,81
2024-03-30 09:10:00,28,11,18,12,69
2024-03-30 09:20:00,45,17,30,9,101
2024-03-30 09:30:00,48,16,31,12,107
2024-03-30 09:40:00,41,22,41,13,117
2024-03-30 09:50:00,39,16,32,19,106
2024-03-30 10:00:00,47,18,36,16,117
2024-03-30 10:10:00,41,9,42,20,112
2024-03-30 10:20:00,56,15,45,15,131
2024-03-30 10:30:00,55,24,42,16,137
2024-03-30 10:40:00,54,21,40,12,127
2024-03-30 10:50:00,59,15,40,22,136
2024-03-30 11:00:00,53,26,36,22,137
2024-03-30 11:10:00,72,22,47,25,166
2024-03-30 11:20:00,57,31,45,18,151
2024-03-30 11:30:00,68,24,45,22,159
2024-03-30 11:40:00,55,18,50,27,150
2024-03-30 11:50:00,70,27,47,17,161
2024-03-30 12:00:00,59,23,42,18,142
2024-03-30 12:10:00,61,28,42,21,152
2024-03-30 12:20:00,70,31,49,19,169
2024-03-30 12:30:00,69,25,41,23,158
2024-03-30 12:40:00,59,26,43,18,146
2024-03-30 12:50:00,69,32,35,22,158
2024-03-30 13:00:00,59,21,38,25,143
2024-03-30 13:10:00,70,22,38,26,156
2024-03-30 13:20:00,63,40,47,23,173
2024-03-30 13:30:00,68,30,47,25,170
2024-03-30 13:40:00,64,18,44,25,151
2024-03-30 13:50:00,63,25,41,13,142
2024-03-30 14:00:00,79,33,44,27,183
2024-03-30 14:10:00,74,24,41,27,166
2024-03-30 14:20:00,80,35,36,26,177
2024-03-30 14:30:00,83,39,38,13,173
2024-03-30 14:40:00,76,24,38,29,167
2024-03-30 14:50:00,58,26,34,28,146
2024-03-30 15:00:00,73,28,43,22,166
2024-03-30 15:10:00,72,30,49,26,177
2024-03-30 15:20:00,67,29,45,24,165
2024-03-30 15:30:00,65,31,29,23,148
2024-03-30 15:40:00,79,34,45,18,176
2024-03-30 15:50:00,69,29,62,18,178
2024-03-30 16:00:00,64,27,41,18,150
2024-03-30 16:10:00,63,19,37,14,133
2024-03-30 16:20:00,56,20,32,11,119
2024-03-30 16:30:00,53,28,43,21,145
2024-03-30 16:40:00,62,25,32,12,131
2024-03-30 16:50:00,69,21,30,17,137
2024-03-30 17:00:00,68,32,46,21,167
2024-03-30 17:10:00,74,32,42,20,168
2024-03-30 17:20:00,66,35,30,20,151
2024-03-30 17:30:00,47,19,31,17,114
2024-03-30 17:40:00,63,34,35,21,153
2024-03-30 17:50:00,64,22,39,18,143
2024-03-30 18:00:00,65,26,36,17,144
2024-03-30 18:10:00,74,35,26,23,158
2024-03-30 18:20:00,52,29,30,16,127
2024-03-30 18:30:00,65,28,38,13,144
2024-03-30 18:40:00,52,15,37,15,119
2024-03-30 18:50:00,67,32,37,7,143
2024-03-30 19:00:00,49,18,25,7,99
2024-03-30 19:10:00,34,14,32,18,98
2024-03-30 19:20:00,51,12,33,9,105
2024-03-30 19:30:00,52,11,31,10,104
2024-03-30 19:40:00,50,19,24,15,108
2024-03-30 19:50:00,48,16,23,6,93
2024-03-30 20:00:00,46,17,21,19,103
2024-03-30 20:10:00,53,19,26,20,118
2024-03-30 20:20:00,51,20,26,14,111
2024-03-30 20:30:00,49,16,26,20,111
2024-03-30 20:40:00,41,14,21,4,80
2024-03-30 20:50:00,32,11,18,10,71
2024-03-30 21:00:00,38,15,17,8,78
2024-03-30 21:10:00,42,8,29,17,96
2024-03-30 21:20:00,39,16,24,6,85
2024-03-30 21:30:00,41,13,27,7,88
2024-03-30 21:40:00,46,13,18,10,87
2024-03-30 21:50:00,30,20,21,4,75
2024-03-30 22:00:00,45,16,14,11,86
2024-03-30 22:10:00,34,9,15,7,65
2024-03-30 22:20:00,46,18,24,14,102
2024-03-30 22:30:00,42,16,18,6,82
2024-03-30 22:40:00,47,14,26,11,98
2024-03-30 22:50:00,39,15,17,7,78
2024-03-30 23:00:00,32,7,14,4,57
2024-03-30 23:10:00,26,7,12,6,51
2024-03-30 23:20:00,32,7,6,2,47
2024-03-30 23:30:00,25,4,17,7,53
2024-03-30 23:40:00,28,11,8,2,49
2024-03-30 23:50:00,31,10,10,8,59
2024-03-31 00:00:00,25,9,10,4,48
2024-03-31 00:10:00,23,7,11,7,48
2024-03-31 00:20:00,18,5,10,4,37
2024-03-31 00:30:00,25,6,5,3,39
2024-03-31 00:40:00,25,11,3,3,42
2024-03-31 00:50:00,25,5,13,4,47
2024-03-31 01:00:00,23,6,12,9,50
2024-03-31 01:10:00,14,0,10,4,28
2024-03-31 01:20:00,8,3,1,3,15
2024-03-31 01:30:00,11,3,9,3,26
2024-03-31 01:40:00,22,5,12,6,45
2024-03-31 01:50:00,9,2,4,4,19
2024-03-31 02:00:00,0,0,0,0,0
2024-03-31 02:10:00,0,0,0,0,0
2024-03-31 02:20:00,0,0,0,0,0
2024-03-31 02:30:00,0,0,0,0,0
2024-03-31 02:40:00,0,0,0,0,0
2024-03-31 02:50:00,0,0,0,0,0
2024-03-31 03:00:00,12,5,6,2,25
2024-03-31 03:10:00,11,4,4,1,20
2024-03-31 03:20:00,14,2,6,3,25
2024-03-31 03:30:00,14,6,4,5,29
2024-03-31 03:40:00,8,4,3,3,18
2024-03-31 03:50:00,6,2,3,2,13
2024-03-31 04:00:00,11,6,5,4,26
2024-03-31 04:10:00,14,3,2,0,19
2024-03-31 04:20:00,11,4,2,1,18
2024-03-31 04:30:00,10,1,2,2,15
2024-03-31 04:40:00,6,1,6,0,13
2024-03-31 04:50:00,9,2,5,5,21
2024-03-31 05:00:00,14,2,3,1,20
2024-03-31 05:10:00,8,2,3,3,16
2024-03-31 05:20:00,9,4,3,2,18
2024-03-31 05:30:00,15,6,2,4,27
2024-03-31 05:40:00,11,4,7,6,28
2024-03-31 05:50:00,9,2,4,3,18
2024-03-31 06:00:00,13,4,2,0,19
2024-03-31 06:10:00,11,4,3,5,23
2024-03-31 06:20:00,11,4,3,1,19
2024-03-31 06:30:00,11,2,5,3,21
2024-03-31 06:40:00,11,4,2,2,19
2024-03-31 06:50:00,13,3,4,1,21
2024-03-31 07:00:00,7,2,0,3,12
2024-03-31 07:10:00,8,3,2,1,14
2024-03-31 07:20:00,7,1,4,1,13
2024-03-31 07:30:00,7,2,7,3,19
2024-03-31 07:40:00,8,2,3,2,15
2024-03-31 07:50:00,9,4,2,3,18
2024-03-31 08:00:00,8,2,5,2,17
2024-03-31 08:10:00,10,1,9,4,24
2024-03-31 08:20:00,14,2,4,1,21
2024-03-31 08:30:00,14,2,4,3,23
2024-03-31 08:40:00,18,5,3,1,27
2024-03-31 08:50:00,14,6,1,4,25
2024-03-31 09:00:00,17,3,6,1,27
2024-03-31 09:10:00,18,3,9,0,30
2024-03-31 09:20:00,17,7,7,3,34
2024-03-31 09:30:00,22,11,11,4,48
2024-03-31 09:40:00,28,9,13,5,55
2024-03-31 09:50:00,31,8,14,7,60
2024-03-31 10:00:00,26,16,10,3,55
2024-03-31 10:10:00,29,9,16,4,58
2024-03-31 10:20:00,50,14,23,5,92
2024-03-31 10:30:00,37,12,21,11,81
2024-03-31 10:40:00,47,15,17,7,86
2024-03-31 10:50:00,45,18,19,8,90
2024-03-31 11:00:00,36,15,16,10,77
2024-03-31 11:10:00,37,11,20,11,79
2024-03-31 11:20:00,51,13,20,5,89
2024-03-31 11:30:00,40,11,25,13,89
2024-03-31 11:40:00,54,21,28,10,113
2024-03-31 11:50:00,58,22,36,9,125
2024-03-31 12:00:00,51,23,29,12,115
2024-03-31 12:10:00,53,23,26,12,114
2024-03-31 12:20:00,47,16,27,14,104
2024-03-31 12:30:00,61,16,25,8,110
2024-03-31 12:40:00,54,20,29,15,118
2024-03-31 12:50:00,51,22,19,5,97
2024-03-31 13:00:00,37,13,28,24,102
2024-03-31 13:10:00,54,24,24,10,112
2024-03-31 13:20:00,29,7,37,10,83
2024-03-31 13:30:00,53,20,28,11,112
2024-03-31 13:40:00,56,16,28,12,112
2024-03-31 13:50:00,49,21,22,11,103
2024-03-31 14:00:00,60,18,21,7,106
2024-03-31 14:10:00,40,15,21,17,93
2024-03-31 14:20:00,54,22,34,15,125
2024-03-31 14:30:00,52,22,24,12,110
2024-03-31 14:40:00,62,19,39,13,133
2024-03-31 14:50:00,55,23,32,11,121
2024-03-31 15:00:00,43,14,25,15,97
2024-03-31 15:10:00,56,25,24,16,121
2024-03-31 15:20:00,63,17,24,15,119
2024-03-31 15:30:00,45,15,27,14,101
2024-03-31 15:40:00,48,16,20,13,97
2024-03-31 15:50:00,59,16,14,8,97
2024-03-31 16:00:00,60,19,14,9,102
2024-03-31 16:10:00,41,16,27,10,94
2024-03-31 16:20:00,56,20,24,8,108
2024-03-31 16:30:00,49,18,22,15,104
2024-03-31 16:40:00,56,24,30,19,129
2024-03-31 16:50:00,51,25,30,12,118
2024-03-31 17:00:00,48,16,34,11,109
2024-03-31 17:10:00,54,17,30,19,120
2024-03-31 17:20:00,61,28,25,13,127
2024-03-31 17:30:00,65,37,33,15,150
2024-03-31 17:40:00,74,26,30,17,147
2024-03-31 17:50:00,61,17,29,11,118
2024-03-31 18:00:00,59,21,28,15,123
2024-03-31 18:10:00,46,19,34,12,111
2024-03-31 18:20:00,51,18,29,10,108
2024-03-31 18:30:00,55,12,28,14,109
2024-03-31 18:40:00,48,22,34,15,119
2024-03-31 18:50:00,63,25,46,15,149
2024-03-31 19:00:00,51,24,32,11,118
2024-03-31 19:10:00,56,20,36,19,131
2024-03-31 19:20:00,52,16,40,14,122
2024-03-31 19:30:00,53,21,35,14,123
2024-03-31 19:40:00,46,17,29,15,107
2024-03-31 19:50:00,50,19,37,11,117
2024-03-31 20:00:00,53,20,16,7,96
2024-03-31 20:10:00,46,15,12,10,83
2024-03-31 20:20:00,52,13,26,9,100
2024-03-31 20:30:00,43,11,24,11,89
2024-03-31 20:40:00,45,19,16,13,93
2024-03-31 20:50:00,45,19,23,7,94
2024-03-31 21:00:00,43,18,20,16,97
2024-03-31 21:10:00,51,25,26,12,114
2024-03-31 21:20:00,49,10,31,15,105
2024-03-31 21:30:00,63,28,28,15,134
2024-03-31 21:40:00,56,14,22,13,105
2024-03-31 21:50:00,48,12,19,10,89
2024-03-31 22:00:00,35,8,25,7,75
2024-03-31 22:10:00,35,12,16,8,71
2024-03-31 22:20:00,37,13,18,15,83
2024-03-31 22:30:00,27,8,24,7,66
2024-03-31 22:40:00,37,12,17,6,72
2024-03-31 22:50:00,29,13,12,5,59
2024-03-31 23:00:00,37,16,15,7,75
2024-03-31 23:10:00,34,7,17,6,64
2024-03-31 23:20:00,28,7,9,5,49
2024-03-31 23:30:00,18,2,13,3,36
2024-03-31 23:40:00,28,7,12,4,51
2024-03-31 23:50:00,16,7,8,7,38
2024-04-01 00:00:00,20,10,7,3,40
2024-04-01 00:10:00,18,6,6,4,34
2024-04-01 00:20:00,11,2,6,1,20
2024-04-01 00:30:00,14,3,5,1,23
2024-04-01 00:40:00,13,3,10,8,34
2024-04-01 00:50:00,11,1,9,3,24
2024-04-01 01:00:00,16,7,5,2,30
2024-04-01 01:10:00,17,2,3,1,23
2024-04-01 01:20:00,11,3,7,6,27
2024-04-01 01:30:00,9,8,5,3,25
2024-04-01 01:40:00,11,5,6,3,25
2024-04-01 01:50:00,7,3,10,5,25
2024-04-01 02:00:00,4,1,3,0,8
2024-04-01 02:10:00,12,5,5,1,23
2024-04-01 02:20:00,12,5,6,3,26
2024-04-01 02:30:00,8,3,8,2,21
2024-04-01 02:40:00,7,3,3,1,14
2024-04-01 02:50:00,15,1,6,0,22
2024-04-01 03:00:00,7,1,5,0,13
2024-04-01 03:10:00,8,4,3,1,16
2024-04-01 03:20:00,10,2,4,2,18
2024-04-01 03:30:00,4,1,6,0,11
2024-04-01 03:40:00,4,1,3,1,9
2024-04-01 03:50:00,6,4,1,3,14
2024-04-01 04:00:00,5,0,3,2,10
2024-04-01 04:10:00,5,1,2,0,8
2024-04-01 04:20:00,6,1,3,6,16
2024-04-01 04:30:00,5,3,3,2,13
2024-04-01 04:40:00,6,0,2,2,10
2024-04-01 04:50:00,7,0,1,2,10
2024-04-01 05:00:00,8,0,2,3,13
2024-04-01 05:10:00,8,2,1,0,11
2024-04-01 05:20:00,6,1,4,1,12
2024-04-01 05:30:00,7,4,2,5,18
2024-04-01 05:40:00,8,3,8,3,22
2024-04-01 05:50:00,5,2,3,3,13
2024-04-01 06:00:00,5,2,6,3,16
2024-04-01 06:10:00,13,3,4,8,28
2024-04-01 06:20:00,9,1,5,2,17
2024-04-01 06:30:00,6,0,5,5,16
2024-04-01 06:40:00,11,1,5,3,20
2024-04-01 06:50:00,6,1,3,1,11
2024-04-01 07:00:00,7,1,2,3,13
2024-04-01 07:10:00,9,2,1,1,13
2024-04-01 07:20:00,4,2,3,0,9
2024-04-01 07:30:00,12,2,4,2,20
2024-04-01 07:40:00,7,0,3,1,11
2024-04-01 07:50:00,9,2,2,0,13
2024-04-01 08:00:00,7,1,4,2,14
2024-04-01 08:10:00,12,3,2,2,19
2024-04-01 08:20:00,14,1,3,1,19
2024-04-01 08:30:00,16,1,5,3,25
2024-04-01 08:40:00,15,6,5,6,32
2024-04-01 08:50:00,16,4,5,3,28
2024-04-01 09:00:00,20,2,4,1,27
2024-04-01 09:10:00,10,4,5,3,22
2024-04-01 09:20:00,18,2,5,4,29
2024-04-01 09:30:00,32,12,10,2,56
2024-04-01 09:40:00,27,10,8,4,49
2024-04-01 09:50:00,22,7,24,9,62
2024-04-01 10:00:00,29,12,13,7,61
2024-04-01 10:10:00,28,7,13,3,51
2024-04-01 10:20:00,20,8,11,6,45
2024-04-01 10:30:00,28,11,11,5,55
2024-04-01 10:40:00,27,11,23,7,68
2024-04-01 10:50:00,48,17,26,14,105
2024-04-01 11:00:00,44,20,10,5,79
2024-04-01 11:10:00,51,14,22,8,95
2024-04-01 11:20:00,41,18,25,6,90
2024-04-01 11:30:00,53,8,15,7,83
2024-04-01 11:40:00,40,16,31,13,100
2024-04-01 11:50:00,49,17,21,11,98
2024-04-01 12:00:00,46,13,23,13,95
2024-04-01 12:10:00,50,20,31,17,118
2024-04-01 12:20:00,51,14,29,13,107
2024-04-01 12:30:00,51,16,28,13,108
2024-04-01 12:40:00,45,16,26,16,103
2024-04-01 12:50:00,44,17,28,12,101
2024-04-01 13:00:00,44,13,26,17,100
2024-04-01 13:10:00,68,20,14,16,118
2024-04-01 13:20:00,49,20,21,15,105
2024-04-01 13:30:00,52,17,24,12,105
2024-04-01 13:40:00,44,18,35,11,108
2024-04-01 13:50:00,57,18,23,14,112
2024-04-01 14:00:00,65,23,30,12,130
2024-04-01 14:10:00,53,27,34,19,133
2024-04-01 14:20:00,64,27,30,11,132
2024-04-01 14:30:00,58,16,28,14,116
2024-04-01 14:40:00,52,21,37,7,117
2024-04-01 14:50:00,66,24,40,12,142
2024-04-01 15:00:00,61,32,35,20,148
2024-04-01 15:10:00,58,23,36,14,131
2024-04-01 15:20:00,56,13,39,12,120
2024-04-01 15:30:00,52,16,39,19,126
2024-04-01 15:40:00,58,15,27,12,112
2024-04-01 15:50:00,55,19,30,14,118
2024-04-01 16:00:00,66,20,26,14,126
2024-04-01 16:10:00,63,27,25,10,125
2024-04-01 16:20:00,64,19,22,13,118
2024-04-01 16:30:00,74,25,33,17,149
2024-04-01 16:40:00,63,23,31,10,127
2024-04-01 16:50:00,55,19,21,11,106
2024-04-01 17:00:00,72,32,42,21,167
2024-04-01 17:10:00,60,23,39,20,142
2024-04-01 17:20:00,51,21,29,13,114
2024-04-01 17:30:00,68,28,29,12,137
2024-04-01 17:40:00,66,23,41,13,143
2024-04-01 17:50:00,64,18,27,14,123
2024-04-01 18:00:00,57,17,29,18,121
2024-04-01 18:10:00,58,23,27,18,126
2024-04-01 18:20:00,49,26,34,22,131
2024-04-01 18:30:00,61,20,28,14,123
2024-04-01 18:40:00,53,24,29,13,119
2024-04-01 18:50:00,60,11,30,13,114
2024-04-01 19:00:00,49,19,37,13,118
2024-04-01 19:10:00,52,16,38,22,128
2024-04-01 19:20:00,80,32,30,25,167
2024-04-01 19:30:00,52,14,31,16,113
2024-04-01 19:40:00,62,14,36,23,135
2024-04-01 19:50:00,57,25,32,18,132
2024-04-01 20:00:00,54,14,19,9,96
2024-04-01 20:10:00,39,9,14,5,67
2024-04-01 20:20:00,28,14,27,10,79
2024-04-01 20:30:00,37,14,12,8,71
2024-04-01 20:40:00,45,11,18,16,90
2024-04-01 20:50:00,48,19,21,6,94
2024-04-01 21:00:00,39,8,13,5,65
2024-04-01 21:10:00,43,17,20,13,93
2024-04-01 21:20:00,52,20,23,16,111
2024-04-01 21:30:00,28,9,28,19,84
2024-04-01 21:40:00,36,17,14,6,73
2024-04-01 21:50:00,43,15,21,5,84
2024-04-01 22:00:00,27,8,15,10,60
2024-04-01 22:10:00,25,8,15,10,58
2024-04-01 22:20:00,30,11,15,11,67
2024-04-01 22:30:00,39,18,20,6,83
2024-04-01 22:40:00,30,6,9,12,57
2024-04-01 22:50:00,22,8,13,5,48
2024-04-01 23:00:00,20,5,16,6,47
2024-04-01 23:10:00,27,7,8,3,45
2024-04-01 23:20:00,22,5,16,8,51
2024-04-01 23:30:00,28,7,7,2,44
2024-04-01 23:40:00,22,10,6,1,39
2024-04-01 23:50:00,9,5,7,4,25
2024-04-02 00:00:00,15,8,9,3,35
2024-04-02 00:10:00,14,6,2,4,26
2024-04-02 00:20:00,15,9,7,3,34
2024-04-02 00:30:00,9,5,3,1,18
2024-04-02 00:40:00,14,3,3,1,21
2024-04-02 00:50:00,9,3,3,1,16
2024-04-02 01:00:00,9,3,5,1,18
2024-04-02 01:10:00,7,2,7,5,21
2024-04-02 01:20:00,4,3,1,1,9
2024-04-02 01:30:00,5,1,3,1,10
2024-04-02 01:40:00,10,1,4,2,17
2024-04-02 01:50:00,10,4,3,1,18
2024-04-02 02:00:00,5,1,3,1,10
2024-04-02 02:10:00,3,0,3,0,6
2024-04-02 02:20:00,3,0,2,0,5
2024-04-02 02:30:00,4,1,0,0,5
2024-04-02 02:40:00,9,4,0,1,14
2024-04-02 02:50:00,7,1,3,1,12
2024-04-02 03:00:00,3,0,3,2,8
2024-04-02 03:10:00,5,1,3,1,10
2024-04-02 03:20:00,4,0,3,0,7
2024-04-02 03:30:00,4,2,1,1,8
2024-04-02 03:40:00,6,1,1,0,8
2024-04-02 03:50:00,5,0,6,4,15
2024-04-02 04:00:00,4,3,4,2,13
2024-04-02 04:10:00,6,2,0,2,10
2024-04-02 04:20:00,10,1,5,1,17
2024-04-02 04:30:00,12,2,1,2,17
2024-04-02 04:40:00,15,6,5,7,33
2024-04-02 04:50:00,18,2,4,4,28
2024-04-02 05:00:00,20,6,9,0,35
2024-04-02 05:10:00,10,3,6,1,20
2024-04-02 05:20:00,34,12,7,7,60
2024-04-02 05:30:00,28,9,5,3,45
2024-04-02 05:40:00,29,10,13,6,58
2024-04-02 05:50:00,30,13,11,8,62
2024-04-02 06:00:00,43,18,14,10,85
2024-04-02 06:10:00,46,22,17,17,102
2024-04-02 06:20:00,58,21,19,6,104
2024-04-02 06:30:00,40,13,21,18,92
2024-04-02 06:40:00,55,17,26,7,105
2024-04-02 06:50:00,57,22,26,16,121
2024-04-02 07:00:00,69,27,27,14,137
2024-04-02 07:10:00,60,29,37,27,153
2024-04-02 07:20:00,63,28,33,23,147
2024-04-02 07:30:00,75,30,42,29,176
2024-04-02 07:40:00,64,42,54,38,198
2024-04-02 07:50:00,72,35,50,29,186
2024-04-02 08:00:00,61,29,47,40,177
2024-04-02 08:10:00,61,32,44,34,171
2024-04-02 08:20:00,73,27,43,23,166
2024-04-02 08:30:00,72,35,35,30,172
2024-04-02 08:40:00,70,36,51,32,189
2024-04-02 08:50:00,67,29,47,32,175
2024-04-02 09:00:00,69,28,48,26,171
2024-04-02 09:10:00,67,31,30,27,155
2024-04-02 09:20:00,67,27,37,19,150
2024-04-02 09:30:00,71,24,50,27,172
2024-04-02 09:40:00,61,24,44,17,146
2024-04-02 09:50:00,78,26,57,29,190
2024-04-02 10:00:00,57,23,47,19,146
2024-04-02 10:10:00,49,19,43,23,134
2024-04-02 10:20:00,74,31,44,26,175
2024-04-02 10:30:00,78,32,40,15,165
2024-04-02 10:40:00,67,29,44,27,167
2024-04-02 10:50:00,76,33,44,18,171
2024-04-02 11:00:00,59,23,50,27,159
2024-04-02 11:10:00,74,35,41,25,175
2024-04-02 11:20:00,61,27,48,22,158
2024-04-02 11:30:00,66,31,43,19,159
2024-04-02 11:40:00,60,27,49,27,163
2024-04-02 11:50:00,68,22,42,26,158
2024-04-02 12:00:00,66,18,46,22,152
2024-04-02 12:10:00,64,29,38,18,149
2024-04-02 12:20:00,62,18,38,27,145
2024-04-02 12:30:00,54,27,37,44,162
2024-04-02 12:40:00,74,18,36,29,157
2024-04-02 12:50:00,75,28,42,14,159
2024-04-02 13:00:00,63,25,45,23,156
2024-04-02 13:10:00,78,26,36,29,169
2024-04-02 13:20:00,86,34,44,23,187
2024-04-02 13:30:00,82,37,42,23,184
2024-04-02 13:40:00,64,35,50,23,172
2024-04-02 13:50:00,75,27,50,24,176
2024-04-02 14:00:00,66,31,51,27,175
2024-04-02 14:10:00,64,27,51,15,157
2024-04-02 14:20:00,72,31,43,31,177
2024-04-02 14:30:00,78,35,51,23,187
2024-04-02 14:40:00,80,32,48,31,191
2024-04-02 14:50:00,66,34,33,28,161
2024-04-02 15:00:00,74,30,58,24,186
2024-04-02 15:10:00,84,38,49,33,204
2024-04-02 15:20:00,78,39,46,25,188
2024-04-02 15:30:00,76,31,56,35,198
2024-04-02 15:40:00,86,39,62,36,223
2024-04-02 15:50:00,89,46,55,42,232
2024-04-02 16:00:00,83,41,53,34,211
2024-04-02 16:10:00,88,33,57,40,218
2024-04-02 16:20:00,73,37,56,34,200
2024-04-02 16:30:00,77,38,56,40,211
2024-04-02 16:40:00,95,52,58,36,241
2024-04-02 16:50:00,70,39,58,33,200
2024-04-02 17:00:00,68,35,52,36,191
2024-04-02 17:10:00,106,49,69,29,253
2024-04-02 17:20:00,77,45,58,36,216
2024-04-02 17:30:00,66,36,45,33,180
2024-04-02 17:40:00,79,42,44,26,191
2024-04-02 17:50:00,76,32,43,24,175
2024-04-02 18:00:00,66,26,56,28,176
2024-04-02 18:10:00,71,39,37,29,176
2024-04-02 18:20:00,72,33,47,26,178
2024-04-02 18:30:00,63,31,41,21,156
2024-04-02 18:40:00,58,21,24,16,119
2024-04-02 18:50:00,73,35,31,23,162
2024-04-02 19:00:00,58,24,40,20,142
2024-04-02 19:10:00,46,11,34,24,115
2024-04-02 19:20:00,61,21,27,17,126
2024-04-02 19:30:00,53,19,22,12,106
2024-04-02 19:40:00,49,15,28,15,107
2024-04-02 19:50:00,35,10,22,13,80
2024-04-02 20:00:00,50,26,21,8,105
2024-04-02 20:10:00,49,27,23,10,109
2024-04-02 20:20:00,34,13,10,13,70
2024-04-02 20:30:00,31,13,16,14,74
2024-04-02 20:40:00,31,12,18,11,72
2024-04-02 20:50:00,35,16,20,8,79
2024-04-02 21:00:00,38,16,9,7,70
2024-04-02 21:10:00,29,16,18,6,69
2024-04-02 21:20:00,43,11,24,16,94
2024-04-02 21:30:00,26,17,14,6,63
2024-04-02 21:40:00,25,20,15,6,66
2024-04-02 21:50:00,20,7,16,10,53
2024-04-02 22:00:00,28,7,13,7,55
2024-04-02 22:10:00,35,14,14,9,72
2024-04-02 22:20:00,33,16,17,5,71
2024-04-02 22:30:00,14,7,8,6,35
2024-04-02 22:40:00,25,6,5,4,40
2024-04-02 22:50:00,27,9,5,5,46
2024-04-02 23:00:00,10,2,9,4,25
2024-04-02 23:10:00,26,6,11,3,46
2024-04-02 23:20:00,15,5,10,3,33
2024-04-02 23:30:00,11,3,2,3,19
2024-04-02 23:40:00,13,4,5,1,23
2024-04-02 23:50:00,15,6,4,4,29
2024-04-03 00:00:00,8,5,6,1,20
2024-04-03 00:10:00,11,3,3,4,21
2024-04-03 00:20:00,8,6,3,0,17
2024-04-03 00:30:00,5,1,4,2,12
2024-04-03 00:40:00,10,0,4,2,16
2024-04-03 00:50:00,10,4,1,0,15
2024-04-03 01:00:00,12,0,6,0,18
2024-04-03 01:10:00,7,2,3,1,13
2024-04-03 01:20:00,5,2,4,4,15
2024-04-03 01:30:00,9,4,1,2,16
2024-04-03 01:40:00,4,1,3,2,10
2024-04-03 01:50:00,7,3,4,0,14
2024-04-03 02:00:00,10,2,1,2,15
2024-04-03 02:10:00,7,3,3,2,15
2024-04-03 02:20:00,5,1,1,0,7
2024-04-03 02:30:00,4,1,0,0,5
2024-04-03 02:40:00,7,0,0,0,7
2024-04-03 02:50:00,5,0,3,1,9
2024-04-03 03:00:00,5,2,4,2,13
2024-04-03 03:10:00,0,0,1,0,1
2024-04-03 03:20:00,3,0,4,1,8
2024-04-03 03:30:00,3,1,2,2,8
2024-04-03 03:40:00,6,0,2,1,9
2024-04-03 03:50:00,6,2,0,1,9
2024-04-03 04:00:00,7,3,3,0,13
2024-04-03 04:10:00,12,0,6,1,19
2024-04-03 04:20:00,8,2,3,0,13
2024-04-03 04:30:00,6,3,2,0,11
2024-04-03 04:40:00,15,6,3,1,25
2024-04-03 04:50:00,6,1,10,2,19
2024-04-03 05:00:00,23,5,3,1,32
2024-04-03 05:10:00,10,4,6,3,23
2024-04-03 05:20:00,33,9,9,2,53
2024-04-03 05:30:00,28,15,7,6,56
2024-04-03 05:40:00,34,14,16,13,77
2024-04-03 05:50:00,31,6,11,7,55
2024-04-03 06:00:00,33,13,12,9,67
2024-04-03 06:10:00,45,17,18,10,90
2024-04-03 06:20:00,44,19,18,10,91
2024-04-03 06:30:00,50,15,22,13,100
2024-04-03 06:40:00,46,19,30,18,113
2024-04-03 06:50:00,51,25,18,11,105
2024-04-03 07:00:00,49,21,23,18,111
2024-04-03 07:10:00,57,23,28,25,133
2024-04-03 07:20:00,72,31,32,25,160
2024-04-03 07:30:00,71,37,46,25,179
2024-04-03 07:40:00,66,26,56,41,189
2024-04-03 07:50:00,81,38,51,41,211
2024-04-03 08:00:00,67,33,39,27,166
2024-04-03 08:10:00,64,25,36,29,154
2024-04-03 08:20:00,62,28,35,34,159
2024-04-03 08:30:00,54,24,52,37,167
2024-04-03 08:40:00,71,34,50,32,187
2024-04-03 08:50:00,63,32,37,38,170
2024-04-03 09:00:00,70,36,38,25,169
2024-04-03 09:10:00,49,20,32,21,122
2024-04-03 09:20:00,53,23,35,25,136
2024-04-03 09:30:00,53,32,45,26,156
2024-04-03 09:40:00,57,30,49,30,166
2024-04-03 09:50:00,59,24,44,23,150
2024-04-03 10:00:00,64,31,41,27,163
2024-04-03 10:10:00,48,18,39,29,134
2024-04-03 10:20:00,61,27,35,19,142
2024-04-03 10:30:00,64,30,42,25,161
2024-04-03 10:40:00,47,26,41,33,147
2024-04-03 10:50:00,49,17,42,22,130
2024-04-03 11:00:00,55,18,26,17,116
2024-04-03 11:10:00,64,29,25,19,137
2024-04-03 11:20:00,71,26,30,18,145
2024-04-03 11:30:00,58,15,35,17,125
2024-04-03 11:40:00,53,19,41,24,137
2024-04-03 11:50:00,73,35,51,26,185
2024-04-03 12:00:00,63,29,48,19,159
2024-04-03 12:10:00,84,24,32,17,157
2024-04-03 12:20:00,65,35,29,29,158
2024-04-03 12:30:00,63,23,33,23,142
2024-04-03 12:40:00,80,21,39,21,161
2024-04-03 12:50:00,82,29,32,18,161
2024-04-03 13:00:00,60,19,34,15,128
2024-04-03 13:10:00,71,27,31,24,153
2024-04-03 13:20:00,70,26,39,14,149
2024-04-03 13:30:00,82,31,34,15,162
2024-04-03 13:40:00,57,18,39,20,134
2024-04-03 13:50:00,73,22,45,16,156
2024-04-03 14:00:00,65,30,44,24,163
2024-04-03 14:10:00,55,16,44,32,147
2024-04-03 14:20:00,70,33,46,27,176
2024-04-03 14:30:00,71,23,30,16,140
2024-04-03 14:40:00,81,42,48,35,206
2024-04-03 14:50:00,66,23,40,23,152
2024-04-03 15:00:00,72,29,55,31,187
2024-04-03 15:10:00,80,42,45,24,191
2024-04-03 15:20:00,63,35,54,43,195
2024-04-03 15:30:00,62,35,46,29,172
2024-04-03 15:40:00,86,52,52,30,220
2024-04-03 15:50:00,65,38,58,33,194
2024-04-03 16:00:00,73,37,55,43,208
2024-04-03 16:10:00,85,45,54,36,220
2024-04-03 16:20:00,75,35,59,31,200
2024-04-03 16:30:00,95,43,52,32,222
2024-04-03 16:40:00,73,32,53,32,190
2024-04-03 16:50:00,73,42,53,34,202
2024-04-03 17:00:00,79,39,51,37,206
2024-04-03 17:10:00,88,44,68,41,241
2024-04-03 17:20:00,73,36,61,34,204
2024-04-03 17:30:00,68,24,58,35,185
2024-04-03 17:40:00,85,42,62,35,224
2024-04-03 17:50:00,79,34,60,21,194
2024-04-03 18:00:00,63,32,42,28,165
2024-04-03 18:10:00,60,23,52,30,165
2024-04-03 18:20:00,77,34,43,22,176
2024-04-03 18:30:00,72,36,33,19,160
2024-04-03 18:40:00,54,31,33,30,148
2024-04-03 18:50:00,68,29,38,12,147
2024-04-03 19:00:00,55,26,35,26,142
2024-04-03 19:10:00,41,16,33,17,107
2024-04-03 19:20:00,56,22,37,15,130
2024-04-03 19:30:00,46,17,29,19,111
2024-04-03 19:40:00,53,26,26,14,119
2024-04-03 19:50:00,46,14,25,12,97
2024-04-03 20:00:00,45,22,18,12,97
2024-04-03 20:10:00,39,13,28,17,97
2024-04-03 20:20:00,47,17,20,7,91
2024-04-03 20:30:00,28,10,17,7,62
2024-04-03 20:40:00,36,21,23,9,89
2024-04-03 20:50:00,47,15,17,9,88
2024-04-03 21:00:00,39,10,15,17,81
2024-04-03 21:10:00,40,15,22,12,89
2024-04-03 21:20:00,33,10,16,8,67
2024-04-03 21:30:00,32,11,21,11,75
2024-04-03 21:40:00,37,16,23,8,84
2024-04-03 21:50:00,30,12,16,8,66
2024-04-03 22:00:00,29,10,18,5,62
2024-04-03 22:10:00,28,8,12,9,57
2024-04-03 22:20:00,27,5,18,9,59
2024-04-03 22:30:00,31,13,7,4,55
2024-04-03 22:40:00,39,10,13,9,71
2024-04-03 22:50:00,25,13,12,8,58
2024-04-03 23:00:00,20,2,9,6,37
2024-04-03 23:10:00,27,10,14,3,54
2024-04-03 23:20:00,21,4,15,9,49
2024-04-03 23:30:00,25,9,7,1,42
2024-04-03 23:40:00,19,4,3,2,28
2024-04-03 23:50:00,13,4,2,6,25
2024-04-04 00:00:00,16,4,2,1,23
2024-04-04 00:10:00,14,0,5,2,21
2024-04-04 00:20:00,12,8,5,2,27
2024-04-04 00:30:00,14,3,9,3,29
2024-04-04 00:40:00,13,1,4,2,20
2024-04-04 00:50:00,3,0,2,0,5
2024-04-04 01:00:00,12,3,0,0,15
2024-04-04 01:10:00,6,2,3,2,13
2024-04-04 01:20:00,4,2,4,4,14
2024-04-04 01:30:00,4,0,3,3,10
2024-04-04 01:40:00,6,1,1,0,8
2024-04-04 01:50:00,10,1,2,1,14
2024-04-04 02:00:00,2,1,2,2,7
2024-04-04 02:10:00,6,0,6,0,12
2024-04-04 02:20:00,10,2,1,2,15
2024-04-04 02:30:00,5,0,3,1,9
2024-04-04 02:40:00,8,2,2,3,15
2024-04-04 02:50:00,5,0,3,1,9
2024-04-04 03:00:00,1,0,2,1,4
2024-04-04 03:10:00,2,0,1,1,4
2024-04-04 03:20:00,4,2,1,2,9
2024-04-04 03:30:00,2,0,3,3,8
2024-04-04 03:40:00,6,0,1,1,8
2024-04-04 03:50:00,2,2,2,3,9
2024-04-04 04:00:00,5,0,3,1,9
2024-04-04 04:10:00,6,3,1,0,10
2024-04-04 04:20:00,8,1,4,1,14
2024-04-04 04:30:00,12,4,5,2,23
2024-04-04 04:40:00,12,5,4,5,26
2024-04-04 04:50:00,11,2,2,2,17
2024-04-04 05:00:00,10,2,5,2,19
2024-04-04 05:10:00,15,6,6,3,30
2024-04-04 05:20:00,26,8,4,1,39
2024-04-04 05:30:00,32,11,9,8,60
2024-04-04 05:40:00,22,10,13,7,52
2024-04-04 05:50:00,26,11,11,9,57
2024-04-04 06:00:00,35,12,16,8,71
2024-04-04 06:10:00,39,17,24,11,91
2024-04-04 06:20:00,54,25,17,5,101
2024-04-04 06:30:00,36,12,24,20,92
2024-04-04 06:40:00,51,13,25,16,105
2024-04-04 06:50:00,56,27,30,19,132
2024-04-04 07:00:00,50,21,29,20,120
2024-04-04 07:10:00,64,30,39,20,153
2024-04-04 07:20:00,49,19,34,24,126
2024-04-04 07:30:00,71,33,41,32,177
2024-04-04 07:40:00,65,36,44,33,178
2024-04-04 07:50:00,62,33,54,34,183
2024-04-04 08:00:00,54,30,34,24,142
2024-04-04 08:10:00,72,30,45,33,180
2024-04-04 08:20:00,66,26,30,22,144
2024-04-04 08:30:00,52,29,38,29,148
2024-04-04 08:40:00,55,27,46,25,153
2024-04-04 08:50:00,66,31,42,26,165
2024-04-04 09:00:00,58,21,49,33,161
2024-04-04 09:10:00,61,15,34,26,136
2024-04-04 09:20:00,65,34,36,21,156
2024-04-04 09:30:00,55,25,39,21,140
2024-04-04 09:40:00,48,18,48,25,139
2024-04-04 09:50:00,67,22,43,27,159
2024-04-04 10:00:00,55,21,37,22,135
2024-04-04 10:10:00,57,21,36,22,136
2024-04-04 10:20:00,69,30,38,20,157
2024-04-04 10:30:00,53,17,45,26,141
2024-04-04 10:40:00,59,17,45,24,145
2024-04-04 10:50:00,55,37,41,15,148
2024-04-04 11:00:00,74,30,30,15,149
2024-04-04 11:10:00,63,22,36,19,140
2024-04-04 11:20:00,52,25,30,13,120
2024-04-04 11:30:00,57,20,36,32,145
2024-04-04 11:40:00,61,18,32,31,142
2024-04-04 11:50:00,56,33,36,23,148
2024-04-04 12:00:00,69,23,49,32,173
2024-04-04 12:10:00,59,21,42,21,143
2024-04-04 12:20:00,65,35,33,20,153
2024-04-04 12:30:00,55,21,37,17,130
2024-04-04 12:40:00,68,30,41,19,158
2024-04-04 12:50:00,71,25,41,23,160
2024-04-04 13:00:00,68,27,48,23,166
2024-04-04 13:10:00,81,31,40,29,181
2024-04-04 13:20:00,70,30,42,21,163
2024-04-04 13:30:00,60,24,41,23,148
2024-04-04 13:40:00,67,24,48,25,164
2024-04-04 13:50:00,79,33,36,32,180
2024-04-04 14:00:00,63,24,41,34,162
2024-04-04 14:10:00,78,32,40,18,168
2024-04-04 14:20:00,68,28,36,25,157
2024-04-04 14:30:00,71,35,41,39,186
2024-04-04 14:40:00,68,36,65,32,201
2024-04-04 14:50:00,60,21,51,34,166
2024-04-04 15:00:00,61,35,43,25,164
2024-04-04 15:10:00,64,33,44,26,167
2024-04-04 15:20:00,81,36,58,30,205
2024-04-04 15:30:00,77,41,43,26,187
2024-04-04 15:40:00,68,47,50,35,200
2024-04-04 15:50:00,76,48,48,28,200
2024-04-04 16:00:00,68,36,53,24,181
2024-04-04 16:10:00,78,39,48,30,195
2024-04-04 16:20:00,92,47,51,28,218
2024-04-04 16:30:00,74,25,54,39,192
2024-04-04 16:40:00,76,38,54,43,211
2024-04-04 16:50:00,72,44,59,35,210
2024-04-04 17:00:00,73,32,51,34,190
2024-04-04 17:10:00,91,49,62,40,242
2024-04-04 17:20:00,82,36,35,29,182
2024-04-04 17:30:00,56,33,63,28,180
2024-04-04 17:40:00,80,36,53,38,207
2024-04-04 17:50:00,69,29,47,19,164
2024-04-04 18:00:00,69,43,60,34,206
2024-04-04 18:10:00,67,30,47,33,177
2024-04-04 18:20:00,70,43,50,31,194
2024-04-04 18:30:00,64,33,51,32,180
2024-04-04 18:40:00,61,22,40,24,147
2024-04-04 18:50:00,70,35,32,17,154
2024-04-04 19:00:00,60,18,29,23,130
2024-04-04 19:10:00,59,31,34,18,142
2024-04-04 19:20:00,63,29,34,24,150
2024-04-04 19:30:00,55,14,22,11,102
2024-04-04 19:40:00,41,22,29,19,111
2024-04-04 19:50:00,45,17,20,14,96
2024-04-04 20:00:00,42,22,27,11,102
2024-04-04 20:10:00,42,24,20,22,108
2024-04-04 20:20:00,34,8,18,16,76
2024-04-04 20:30:00,27,9,20,9,65
2024-04-04 20:40:00,31,12,20,8,71
2024-04-04 20:50:00,32,10,15,9,66
2024-04-04 21:00:00,27,8,20,11,66
2024-04-04 21:10:00,36,12,16,4,68
2024-04-04 21:20:00,31,10,14,17,72
2024-04-04 21:30:00,30,11,27,10,78
2024-04-04 21:40:00,41,21,25,21,108
2024-04-04 21:50:00,31,15,17,8,71
2024-04-04 22:00:00,37,12,20,8,77
2024-04-04 22:10:00,33,14,22,11,80
2024-04-04 22:20:00,25,6,17,3,51
2024-04-04 22:30:00,32,8,12,9,61
2024-04-04 22:40:00,27,7,13,8,55
2024-04-04 22:50:00,19,9,10,6,44
2024-04-04 23:00:00,22,3,9,5,39
2024-04-04 23:10:00,22,6,15,7,50
2024-04-04 23:20:00,25,4,10,5,44
2024-04-04 23:30:00,18,4,10,4,36
2024-04-04 23:40:00,16,6,7,4,33
2024-04-04 23:50:00,12,6,6,2,26
2024-04-05 00:00:00,8,5,10,5,28
2024-04-05 00:10:00,14,7,4,5,30
2024-04-05 00:20:00,9,1,5,1,16
2024-04-05 00:30:00,11,1,8,5,25
2024-04-05 00:40:00,16,3,5,2,26
2024-04-05 00:50:00,7,1,2,1,11
2024-04-05 01:00:00,9,3,2,1,15
2024-04-05 01:10:00,10,2,5,1,18
2024-04-05 01:20:00,9,2,0,0,11
2024-04-05 01:30:00,7,2,3,2,14
2024-04-05 01:40:00,7,0,0,0,7
2024-04-05 01:50:00,4,1,0,0,5
2024-04-05 02:00:00,1,1,1,0,3
