datetime,D21Z,V22Z,D51Z,V52Z,D81Z,V82Z,D111Z,V112Z,Total
2024-03-01 01:00:00,1,1,0,6,1,1,5,4,19
2024-03-01 01:10:00,0,0,0,3,1,1,3,5,13
2024-03-01 01:20:00,0,0,1,6,1,1,4,7,20
2024-03-01 01:30:00,0,0,0,1,0,0,6,6,13
2024-03-01 01:40:00,4,1,0,2,1,0,1,1,10
2024-03-01 01:50:00,0,0,1,7,1,1,3,3,16
2024-03-01 02:00:00,0,0,0,2,0,0,5,6,13
2024-03-01 02:10:00,1,1,0,2,0,0,5,5,14
2024-03-01 02:20:00,1,0,1,3,0,0,5,6,16
2024-03-01 02:30:00,0,0,0,3,0,0,1,2,6
2024-03-01 02:40:00,0,0,0,8,1,1,1,2,13
2024-03-01 02:50:00,0,0,1,2,0,0,4,5,12
2024-03-01 03:00:00,0,0,0,5,0,0,2,2,9
2024-03-01 03:10:00,0,0,0,0,0,0,1,1,2
2024-03-01 03:20:00,0,0,0,4,0,0,3,3,10
2024-03-01 03:30:00,1,0,0,2,2,1,7,7,20
2024-03-01 03:40:00,0,0,1,8,1,1,3,4,18
2024-03-01 03:50:00,1,0,1,5,0,0,1,2,10
2024-03-01 04:00:00,1,1,0,2,0,0,1,1,6
2024-03-01 04:10:00,0,0,0,7,1,1,1,1,11
2024-03-01 04:20:00,0,0,1,10,2,2,1,2,18
2024-03-01 04:30:00,0,0,1,7,1,1,0,0,10
2024-03-01 04:40:00,0,0,3,12,0,0,5,6,26
2024-03-01 04:50:00,0,0,5,15,3,3,4,3,33
2024-03-01 05:00:00,0,0,5,23,2,2,4,9,45
2024-03-01 05:10:00,1,1,8,19,2,4,9,9,53
2024-03-01 05:20:00,0,0,8,33,5,3,10,11,70
2024-03-01 05:30:00,0,0,24,48,1,2,5,6,86
2024-03-01 05:40:00,2,1,19,60,7,6,7,8,110
2024-03-01 05:50:00,2,2,20,61,3,4,8,8,108
2024-03-01 06:00:00,2,2,9,49,5,6,9,12,94
2024-03-01 06:10:00,0,0,24,53,9,9,17,18,130
2024-03-01 06:20:00,8,8,18,70,5,5,26,28,168
2024-03-01 06:30:00,4,2,21,66,5,5,32,27,162
2024-03-01 06:40:00,5,3,15,83,11,9,26,23,175
2024-03-01 06:50:00,1,1,14,74,9,11,35,28,173
2024-03-01 07:00:00,7,6,19,90,14,12,43,23,214
2024-03-01 07:10:00,8,4,19,91,14,10,25,19,190
2024-03-01 07:20:00,7,2,24,91,17,9,45,28,223
2024-03-01 07:30:00,10,8,20,91,14,9,30,23,205
2024-03-01 07:40:00,5,4,34,83,20,15,45,20,226
2024-03-01 07:50:00,12,7,20,82,19,6,52,19,217
2024-03-01 08:00:00,15,10,11,66,23,4,36,26,191
2024-03-01 08:10:00,17,9,20,73,21,9,43,26,218
2024-03-01 08:20:00,19,11,16,87,18,8,47,15,221
2024-03-01 08:30:00,17,10,21,67,23,10,41,21,210
2024-03-01 08:40:00,19,12,25,72,20,14,31,24,217
2024-03-01 08:50:00,11,6,19,67,14,9,49,21,196
2024-03-01 09:00:00,12,7,6,72,25,10,39,21,192
2024-03-01 09:10:00,14,7,18,72,15,13,38,27,204
2024-03-01 09:20:00,12,5,14,71,9,8,42,35,196
2024-03-01 09:30:00,13,11,27,65,27,13,33,20,209
2024-03-01 09:40:00,22,11,43,53,14,12,52,38,245
2024-03-01 09:50:00,17,9,30,45,15,5,35,26,182
2024-03-01 10:00:00,17,9,36,52,16,10,58,34,232
2024-03-01 10:10:00,12,10,28,56,15,8,44,27,200
2024-03-01 10:20:00,11,8,30,56,10,8,56,42,221
2024-03-01 10:30:00,11,7,30,52,13,9,38,28,188
2024-03-01 10:40:00,15,8,31,64,19,15,39,28,219
2024-03-01 10:50:00,18,7,25,55,16,8,48,26,203
2024-03-01 11:00:00,15,8,24,43,15,6,63,31,205
2024-03-01 11:10:00,11,6,33,60,20,12,50,34,226
2024-03-01 11:20:00,13,7,29,49,13,9,63,33,216
2024-03-01 11:30:00,17,8,17,52,13,9,68,41,225
2024-03-01 11:40:00,14,5,29,46,8,6,60,33,201
2024-03-01 11:50:00,17,12,24,53,12,10,80,36,244
2024-03-01 12:00:00,12,9,33,53,16,6,58,34,221
2024-03-01 12:10:00,10,5,19,58,14,10,92,33,241
2024-03-01 12:20:00,19,9,33,54,19,11,67,23,235
2024-03-01 12:30:00,20,7,14,67,10,9,94,35,256
2024-03-01 12:40:00,19,12,22,62,21,12,61,31,240
2024-03-01 12:50:00,11,8,18,76,15,12,88,35,263
2024-03-01 13:00:00,19,10,10,51,12,9,93,25,229
2024-03-01 13:10:00,5,5,8,55,9,3,62,16,163
2024-03-01 13:20:00,22,13,11,57,13,8,104,24,252
2024-03-01 13:30:00,10,6,20,61,16,10,93,25,241
2024-03-01 13:40:00,20,7,17,66,10,9,78,31,238
2024-03-01 13:50:00,16,7,12,70,13,10,102,28,258
2024-03-01 14:00:00,16,6,12,79,18,10,69,29,239
2024-03-01 14:10:00,13,11,12,58,20,7,112,39,272
2024-03-01 14:20:00,18,4,11,62,13,4,119,34,265
2024-03-01 14:30:00,12,9,15,61,13,10,102,30,252
2024-03-01 14:40:00,19,9,19,66,16,12,92,25,258
2024-03-01 14:50:00,15,7,21,72,13,11,116,34,289
2024-03-01 15:00:00,11,9,9,79,19,7,80,37,251
2024-03-01 15:10:00,20,8,13,89,14,12,124,32,312
2024-03-01 15:20:00,19,6,23,61,13,9,91,14,236
2024-03-01 15:30:00,26,7,16,73,16,7,97,22,264
2024-03-01 15:40:00,23,7,33,62,14,12,103,26,280
2024-03-01 15:50:00,10,4,9,56,13,12,88,20,212
2024-03-01 16:00:00,14,4,8,43,10,9,72,24,184
2024-03-01 16:10:00,15,7,10,59,19,9,88,23,230
2024-03-01 16:20:00,12,6,9,54,15,7,95,32,230
2024-03-01 16:30:00,21,8,10,67,20,12,75,24,237
2024-03-01 16:40:00,12,8,24,70,18,10,75,25,242
2024-03-01 16:50:00,9,5,11,58,20,14,103,31,251
2024-03-01 17:00:00,14,8,8,68,22,13,96,50,279
2024-03-01 17:10:00,13,9,9,73,23,16,76,35,254
2024-03-01 17:20:00,6,4,11,54,9,6,67,25,182
2024-03-01 17:30:00,13,5,9,65,20,13,79,29,233
2024-03-01 17:40:00,8,5,19,68,15,7,77,30,229
2024-03-01 17:50:00,14,8,11,82,14,8,86,25,248
2024-03-01 18:00:00,10,5,11,59,21,15,92,27,240
2024-03-01 18:10:00,15,7,14,82,22,18,71,22,251
2024-03-01 18:20:00,9,6,12,65,16,11,95,30,244
2024-03-01 18:30:00,6,5,9,80,18,15,59,27,219
2024-03-01 18:40:00,12,10,10,73,14,8,63,28,218
2024-03-01 18:50:00,9,6,12,81,22,12,63,26,231
2024-03-01 19:00:00,5,2,7,70,16,8,62,40,210
2024-03-01 19:10:00,5,2,4,67,20,10,55,25,188
2024-03-01 19:20:00,5,4,18,80,11,6,69,33,226
2024-03-01 19:30:00,13,4,10,56,16,13,56,36,204
2024-03-01 19:40:00,7,7,9,71,8,7,57,29,195
2024-03-01 19:50:00,10,5,4,41,8,5,52,37,162
2024-03-01 20:00:00,4,4,3,39,11,7,45,31,144
2024-03-01 20:10:00,3,2,9,43,12,11,47,32,159
2024-03-01 20:20:00,7,5,12,33,9,6,61,34,167
2024-03-01 20:30:00,6,1,14,36,12,13,32,29,143
2024-03-01 20:40:00,11,6,11,37,8,8,39,26,146
2024-03-01 20:50:00,5,2,10,29,10,9,36,24,125
2024-03-01 21:00:00,8,4,12,37,4,2,38,29,134
2024-03-01 21:10:00,2,3,10,29,6,6,34,34,124
2024-03-01 21:20:00,5,4,13,36,7,6,49,28,148
2024-03-01 21:30:00,10,7,14,29,11,8,36,29,144
2024-03-01 21:40:00,8,4,10,31,9,5,42,33,142
2024-03-01 21:50:00,4,2,3,27,11,12,46,26,131
2024-03-01 22:00:00,5,1,8,33,11,11,38,32,139
2024-03-01 22:10:00,4,3,4,31,5,3,44,40,134
2024-03-01 22:20:00,6,2,5,27,4,7,39,40,130
2024-03-01 22:30:00,10,6,13,29,6,4,29,19,116
2024-03-01 22:40:00,12,4,6,29,7,9,32,23,122
2024-03-01 22:50:00,3,1,8,27,3,4,38,29,113
2024-03-01 23:00:00,4,4,6,26,3,2,29,22,96
2024-03-01 23:10:00,6,4,2,11,1,2,38,27,91
2024-03-01 23:20:00,2,2,2,15,0,0,41,35,97
2024-03-01 23:30:00,11,0,2,13,3,3,37,29,98
2024-03-01 23:40:00,2,1,5,20,3,3,29,24,87
2024-03-01 23:50:00,2,0,2,14,3,6,26,24,77
2024-03-02 00:00:00,3,0,4,18,5,2,17,14,63
2024-03-02 00:10:00,0,0,0,11,3,2,16,17,49
2024-03-02 00:20:00,1,0,3,8,3,3,27,22,67
2024-03-02 00:30:00,1,1,3,13,4,4,18,15,59
2024-03-02 00:40:00,0,0,2,9,5,4,10,13,43
2024-03-02 00:50:00,5,3,3,12,2,2,12,10,49
2024-03-02 01:00:00,3,1,2,19,2,0,23,15,65
2024-03-02 01:10:00,4,1,1,5,2,2,8,7,30
2024-03-02 01:20:00,1,0,1,6,0,0,10,15,33
2024-03-02 01:30:00,1,1,1,14,1,1,5,8,32
2024-03-02 01:40:00,0,0,0,4,0,0,6,7,17
2024-03-02 01:50:00,0,0,1,9,2,2,8,10,32
2024-03-02 02:00:00,1,1,2,5,2,1,12,12,36
2024-03-02 02:10:00,0,0,1,6,0,0,3,3,13
2024-03-02 02:20:00,0,0,2,9,3,4,13,15,46
2024-03-02 02:30:00,0,0,2,6,2,1,7,10,28
2024-03-02 02:40:00,1,1,0,7,5,7,7,9,37
2024-03-02 02:50:00,0,0,0,3,2,3,9,9,26
2024-03-02 03:00:00,3,0,1,6,1,0,8,9,28
2024-03-02 03:10:00,0,0,1,4,0,0,6,6,17
2024-03-02 03:20:00,0,0,1,7,2,1,5,3,19
2024-03-02 03:30:00,0,0,0,4,1,2,6,6,19
2024-03-02 03:40:00,2,1,0,5,1,1,8,9,27
2024-03-02 03:50:00,0,0,0,10,1,1,6,7,25
2024-03-02 04:00:00,0,0,1,7,1,1,5,6,21
2024-03-02 04:10:00,1,1,3,9,0,0,2,2,18
2024-03-02 04:20:00,0,0,0,5,0,0,9,9,23
2024-03-02 04:30:00,1,0,1,11,1,1,5,6,26
2024-03-02 04:40:00,0,0,0,7,0,0,0,0,7
2024-03-02 04:50:00,0,0,0,10,0,0,2,2,14
2024-03-02 05:00:00,0,0,3,9,2,7,1,1,23
2024-03-02 05:10:00,0,0,3,15,2,3,6,8,37
2024-03-02 05:20:00,1,0,5,20,2,2,11,11,52
2024-03-02 05:30:00,1,1,4,29,2,1,8,12,58
2024-03-02 05:40:00,0,0,4,22,3,3,9,10,51
2024-03-02 05:50:00,2,2,1,10,3,5,5,5,33
2024-03-02 06:00:00,0,0,3,18,4,3,6,5,39
2024-03-02 06:10:00,2,2,6,25,1,1,4,5,46
2024-03-02 06:20:00,4,3,5,23,3,1,8,7,54
2024-03-02 06:30:00,2,2,7,21,1,1,11,10,55
2024-03-02 06:40:00,4,4,7,22,0,0,9,14,60
2024-03-02 06:50:00,5,5,6,20,2,1,12,13,64
2024-03-02 07:00:00,2,2,7,12,1,1,7,9,41
2024-03-02 07:10:00,2,1,5,17,4,5,9,11,54
2024-03-02 07:20:00,0,0,10,18,2,2,9,9,50
2024-03-02 07:30:00,1,0,17,27,8,6,10,9,78
2024-03-02 07:40:00,5,1,12,28,8,4,10,10,78
2024-03-02 07:50:00,6,1,12,27,2,4,7,7,66
2024-03-02 08:00:00,1,1,15,19,6,6,16,15,79
2024-03-02 08:10:00,3,1,16,28,3,3,13,11,78
2024-03-02 08:20:00,3,2,11,20,11,8,14,12,81
2024-03-02 08:30:00,2,2,22,25,8,11,21,17,108
2024-03-02 08:40:00,6,6,16,36,6,6,23,20,119
2024-03-02 08:50:00,5,2,18,38,6,6,17,16,108
2024-03-02 09:00:00,5,3,20,37,7,8,15,15,110
2024-03-02 09:10:00,11,2,19,51,10,5,27,19,144
2024-03-02 09:20:00,5,1,28,45,7,8,25,22,141
2024-03-02 09:30:00,12,4,26,38,12,7,30,25,154
2024-03-02 09:40:00,2,1,27,65,17,12,33,26,183
2024-03-02 09:50:00,17,11,27,43,12,9,37,31,187
2024-03-02 10:00:00,9,3,33,44,20,10,24,21,164
2024-03-02 10:10:00,11,4,32,51,13,7,38,33,189
2024-03-02 10:20:00,1,1,30,48,10,6,35,29,160
2024-03-02 10:30:00,2,2,29,46,12,8,34,30,163
2024-03-02 10:40:00,12,4,24,51,14,9,39,30,183
2024-03-02 10:50:00,7,3,29,45,16,11,37,27,175
2024-03-02 11:00:00,5,1,25,46,17,12,44,36,186
2024-03-02 11:10:00,7,6,32,58,9,6,35,27,180
2024-03-02 11:20:00,3,1,31,61,16,15,39,31,197
2024-03-02 11:30:00,11,6,33,59,23,13,34,25,204
2024-03-02 11:40:00,10,8,31,57,9,11,43,32,201
2024-03-02 11:50:00,7,4,35,64,17,31,64,41,263
2024-03-02 12:00:00,8,5,24,55,21,16,44,38,211
2024-03-02 12:10:00,14,6,33,52,15,8,58,34,220
2024-03-02 12:20:00,6,3,33,62,25,15,74,29,247
2024-03-02 12:30:00,11,7,29,63,8,10,61,39,228
2024-03-02 12:40:00,6,4,30,56,16,10,76,49,247
2024-03-02 12:50:00,9,3,30,65,17,10,63,30,227
2024-03-02 13:00:00,9,4,32,68,20,11,57,31,232
2024-03-02 13:10:00,13,8,26,60,23,13,70,35,248
2024-03-02 13:20:00,11,5,26,63,20,9,68,33,235
2024-03-02 13:30:00,16,10,44,73,25,17,60,42,287
2024-03-02 13:40:00,11,5,27,51,19,12,66,38,229
2024-03-02 13:50:00,8,2,26,38,23,15,64,29,205
2024-03-02 14:00:00,23,13,41,64,20,12,77,35,285
2024-03-02 14:10:00,16,6,24,17,19,14,87,30,213
2024-03-02 14:20:00,17,6,41,59,20,14,70,36,263
2024-03-02 14:30:00,16,6,34,50,20,12,76,34,248
2024-03-02 14:40:00,13,10,26,77,21,10,77,25,259
2024-03-02 14:50:00,15,5,35,59,21,17,73,32,257
2024-03-02 15:00:00,10,4,35,80,23,14,73,26,265
2024-03-02 15:10:00,7,3,30,56,14,11,68,33,222
2024-03-02 15:20:00,10,5,35,52,14,12,91,27,246
2024-03-02 15:30:00,8,3,22,59,13,10,64,28,207
2024-03-02 15:40:00,8,2,32,63,17,14,60,28,224
2024-03-02 15:50:00,15,9,38,52,20,10,70,33,247
2024-03-02 16:00:00,11,4,22,42,17,23,62,39,220
2024-03-02 16:10:00,12,3,21,45,14,12,57,25,189
2024-03-02 16:20:00,10,4,19,48,19,9,66,33,208
2024-03-02 16:30:00,12,5,15,49,10,8,60,33,192
2024-03-02 16:40:00,15,5,27,55,20,12,79,26,239
2024-03-02 16:50:00,6,4,18,77,11,11,65,35,227
2024-03-02 17:00:00,15,6,32,52,17,10,70,40,242
2024-03-02 17:10:00,12,7,20,62,19,10,104,30,264
2024-03-02 17:20:00,12,9,19,49,17,11,72,20,209
2024-03-02 17:30:00,11,5,19,56,27,10,61,29,218
2024-03-02 17:40:00,7,3,22,45,32,16,73,32,230
2024-03-02 17:50:00,13,6,22,68,31,10,100,23,273
2024-03-02 18:00:00,8,7,28,47,23,15,88,30,246
2024-03-02 18:10:00,10,6,22,53,16,11,93,34,245
2024-03-02 18:20:00,12,6,16,57,15,8,74,21,209
2024-03-02 18:30:00,15,4,32,49,8,8,91,35,242
2024-03-02 18:40:00,33,7,30,71,12,10,59,30,252
2024-03-02 18:50:00,5,3,29,65,14,13,80,25,234
2024-03-02 19:00:00,12,6,12,76,10,13,57,31,217
2024-03-02 19:10:00,7,6,23,56,14,14,62,31,213
2024-03-02 19:20:00,8,4,19,66,10,13,55,29,204
2024-03-02 19:30:00,5,4,8,59,7,12,59,28,182
2024-03-02 19:40:00,2,2,16,45,10,10,53,19,157
2024-03-02 19:50:00,4,1,13,40,8,9,50,34,159
2024-03-02 20:00:00,2,1,13,39,13,11,49,19,147
2024-03-02 20:10:00,3,0,11,43,9,9,44,29,148
2024-03-02 20:20:00,12,2,13,41,8,8,44,31,159
2024-03-02 20:30:00,4,0,11,44,10,10,53,20,152
2024-03-02 20:40:00,6,1,11,31,11,7,42,28,137
2024-03-02 20:50:00,5,5,15,35,8,6,36,24,134
2024-03-02 21:00:00,4,2,22,31,8,4,30,18,119
2024-03-02 21:10:00,1,1,6,25,11,12,37,23,116
2024-03-02 21:20:00,5,3,5,27,4,6,47,25,122
2024-03-02 21:30:00,2,1,9,22,5,6,37,27,109
2024-03-02 21:40:00,1,1,5,31,8,9,38,41,134
2024-03-02 21:50:00,5,4,8,28,8,6,42,32,133
2024-03-02 22:00:00,5,4,6,18,4,2,37,21,97
2024-03-02 22:10:00,2,1,9,30,5,7,40,30,124
2024-03-02 22:20:00,2,0,5,27,7,7,47,23,118
2024-03-02 22:30:00,1,1,5,20,4,7,34,24,96
2024-03-02 22:40:00,3,1,3,20,6,4,42,23,102
2024-03-02 22:50:00,0,0,5,28,3,3,36,25,100
2024-03-02 23:00:00,1,1,4,22,4,2,48,20,102
2024-03-02 23:10:00,5,6,3,28,3,3,34,29,111
2024-03-02 23:20:00,3,2,9,35,3,4,28,27,111
2024-03-02 23:30:00,1,1,5,17,5,8,28,26,91
2024-03-02 23:40:00,2,0,5,21,2,2,31,27,90
2024-03-02 23:50:00,0,0,5,27,5,3,40,21,101
2024-03-03 00:00:00,2,2,4,31,5,8,28,27,107
2024-03-03 00:10:00,0,0,2,18,3,4,23,22,72
2024-03-03 00:20:00,2,1,1,15,4,6,17,12,58
2024-03-03 00:30:00,5,1,1,12,2,1,11,16,49
2024-03-03 00:40:00,6,6,1,13,4,1,25,21,77
2024-03-03 00:50:00,6,2,2,21,9,4,25,21,90
2024-03-03 01:00:00,1,0,0,11,1,1,25,26,65
2024-03-03 01:10:00,4,2,0,7,3,2,17,17,52
2024-03-03 01:20:00,0,0,2,14,1,1,9,12,39
2024-03-03 01:30:00,2,1,1,9,1,1,12,11,38
2024-03-03 01:40:00,1,0,0,14,3,4,14,16,52
2024-03-03 01:50:00,0,0,3,15,2,3,15,18,56
2024-03-03 02:00:00,1,1,0,7,1,1,12,13,36
2024-03-03 02:10:00,0,0,1,10,1,1,8,9,30
2024-03-03 02:20:00,2,2,2,13,2,0,12,11,44
2024-03-03 02:30:00,1,1,0,5,0,0,5,6,18
2024-03-03 02:40:00,1,1,0,9,0,0,10,10,31
2024-03-03 02:50:00,1,1,0,12,1,1,3,6,25
2024-03-03 03:00:00,0,0,2,4,1,0,4,3,14
2024-03-03 03:10:00,1,0,0,4,1,2,4,5,17
2024-03-03 03:20:00,0,0,0,7,1,0,4,4,16
2024-03-03 03:30:00,1,2,0,6,2,2,7,6,26
2024-03-03 03:40:00,1,1,0,1,1,2,3,3,12
2024-03-03 03:50:00,0,0,2,8,0,0,4,4,18
2024-03-03 04:00:00,0,0,2,4,0,0,4,7,17
2024-03-03 04:10:00,0,0,1,8,0,0,7,10,26
2024-03-03 04:20:00,1,1,0,8,3,5,4,4,26
2024-03-03 04:30:00,0,0,0,8,1,1,6,8,24
2024-03-03 04:40:00,0,0,0,8,0,0,2,2,12
2024-03-03 04:50:00,0,0,2,10,1,2,5,7,27
2024-03-03 05:00:00,0,0,1,7,2,2,3,3,18
2024-03-03 05:10:00,0,0,1,12,1,1,3,4,22
2024-03-03 05:20:00,1,0,4,11,2,1,9,11,39
2024-03-03 05:30:00,3,0,6,14,2,2,4,4,35
2024-03-03 05:40:00,5,5,2,13,2,2,3,3,35
2024-03-03 05:50:00,0,0,2,14,1,1,5,6,29
2024-03-03 06:00:00,1,1,2,9,1,0,9,10,33
2024-03-03 06:10:00,5,5,5,19,2,1,7,7,51
2024-03-03 06:20:00,2,2,1,6,1,1,4,3,20
2024-03-03 06:30:00,4,3,1,9,0,0,8,9,34
2024-03-03 06:40:00,2,2,2,8,0,0,8,9,31
2024-03-03 06:50:00,4,1,5,10,4,5,5,5,39
2024-03-03 07:00:00,1,1,2,12,2,2,6,6,32
2024-03-03 07:10:00,1,0,1,4,1,0,2,2,11
2024-03-03 07:20:00,0,0,1,6,2,3,9,8,29
2024-03-03 07:30:00,1,1,1,7,2,2,6,6,26
2024-03-03 07:40:00,0,0,2,8,3,3,9,9,34
2024-03-03 07:50:00,4,1,3,6,6,3,7,6,36
2024-03-03 08:00:00,2,0,5,16,6,7,5,5,46
2024-03-03 08:10:00,2,1,9,18,2,2,9,10,53
2024-03-03 08:20:00,2,0,14,19,4,6,15,14,74
2024-03-03 08:30:00,6,4,8,14,5,2,13,10,62
2024-03-03 08:40:00,2,0,8,23,6,4,17,13,73
2024-03-03 08:50:00,7,2,8,10,9,7,11,14,68
2024-03-03 09:00:00,3,1,14,25,6,7,8,11,75
2024-03-03 09:10:00,2,1,7,22,9,10,20,19,90
2024-03-03 09:20:00,6,3,8,21,4,3,16,17,78
2024-03-03 09:30:00,5,1,17,28,16,11,17,16,111
2024-03-03 09:40:00,3,2,21,34,14,14,24,20,132
2024-03-03 09:50:00,13,6,27,34,8,10,27,20,145
2024-03-03 10:00:00,8,6,29,32,20,16,27,24,162
2024-03-03 10:10:00,14,6,19,44,11,10,21,22,147
2024-03-03 10:20:00,8,5,18,45,11,9,21,13,130
2024-03-03 10:30:00,7,6,23,52,8,7,30,28,161
2024-03-03 10:40:00,13,7,23,47,14,17,32,32,185
2024-03-03 10:50:00,7,5,26,45,16,16,31,32,178
2024-03-03 11:00:00,13,6,20,44,25,16,43,35,202
2024-03-03 11:10:00,13,10,25,39,19,18,41,33,198
2024-03-03 11:20:00,12,7,16,52,22,18,38,27,192
2024-03-03 11:30:00,23,12,24,46,11,17,26,24,183
2024-03-03 11:40:00,10,4,24,39,11,14,39,35,176
2024-03-03 11:50:00,10,3,33,55,20,12,39,31,203
2024-03-03 12:00:00,18,8,20,39,15,18,23,26,167
2024-03-03 12:10:00,11,3,27,49,41,24,46,30,231
2024-03-03 12:20:00,11,7,38,56,16,19,33,25,205
2024-03-03 12:30:00,6,5,26,60,23,17,47,35,219
2024-03-03 12:40:00,14,10,30,45,28,18,51,28,224
2024-03-03 12:50:00,12,5,34,54,15,39,44,26,229
2024-03-03 13:00:00,14,3,19,52,20,36,54,29,227
2024-03-03 13:10:00,14,4,38,48,22,19,76,33,254
2024-03-03 13:20:00,15,6,26,56,12,14,61,42,232
2024-03-03 13:30:00,11,8,24,58,16,12,51,41,221
2024-03-03 13:40:00,22,12,35,51,23,17,61,29,250
2024-03-03 13:50:00,11,5,36,45,15,17,45,31,205
2024-03-03 14:00:00,15,7,23,56,19,13,64,38,235
2024-03-03 14:10:00,19,6,17,40,38,16,62,31,229
2024-03-03 14:20:00,12,6,30,65,16,16,56,33,234
2024-03-03 14:30:00,25,9,29,57,25,15,56,28,244
2024-03-03 14:40:00,15,5,33,62,28,15,58,34,250
2024-03-03 14:50:00,19,6,33,63,21,21,56,32,251
2024-03-03 15:00:00,14,5,31,49,23,23,62,36,243
2024-03-03 15:10:00,20,8,28,53,26,16,54,29,234
2024-03-03 15:20:00,6,6,17,64,20,18,48,38,217
2024-03-03 15:30:00,13,8,26,38,24,20,70,34,233
2024-03-03 15:40:00,13,9,33,48,43,16,49,33,244
2024-03-03 15:50:00,15,6,29,61,26,17,50,27,231
2024-03-03 16:00:00,16,5,31,80,24,19,36,20,231
2024-03-03 16:10:00,23,9,28,45,27,21,53,27,233
2024-03-03 16:20:00,23,10,32,50,19,11,54,25,224
2024-03-03 16:30:00,27,11,21,58,18,11,47,27,220
2024-03-03 16:40:00,12,6,32,55,21,13,64,32,235
2024-03-03 16:50:00,11,7,38,66,16,11,52,38,239
2024-03-03 17:00:00,12,4,25,58,24,13,50,54,240
2024-03-03 17:10:00,20,10,21,48,24,12,59,40,234
2024-03-03 17:20:00,11,6,30,60,25,10,64,35,241
2024-03-03 17:30:00,15,7,16,73,20,15,51,30,227
2024-03-03 17:40:00,17,9,22,56,25,12,54,33,228
2024-03-03 17:50:00,11,4,24,54,19,11,47,23,193
2024-03-03 18:00:00,19,6,20,55,19,26,52,29,226
2024-03-03 18:10:00,11,7,29,72,17,14,53,24,227
2024-03-03 18:20:00,13,11,20,57,20,13,42,25,201
2024-03-03 18:30:00,8,2,17,40,5,4,44,25,145
2024-03-03 18:40:00,10,7,29,47,15,13,54,33,208
2024-03-03 18:50:00,6,7,16,65,11,10,40,18,173
2024-03-03 19:00:00,15,3,18,40,13,14,36,21,160
2024-03-03 19:10:00,5,4,23,70,5,6,33,31,177
2024-03-03 19:20:00,4,4,19,50,7,5,32,23,144
2024-03-03 19:30:00,11,6,23,45,8,6,33,30,162
2024-03-03 19:40:00,4,4,16,30,11,11,37,20,133
2024-03-03 19:50:00,8,4,10,52,10,12,40,29,165
2024-03-03 20:00:00,7,5,19,66,8,15,43,25,188
2024-03-03 20:10:00,8,5,15,34,4,4,38,27,135
2024-03-03 20:20:00,7,2,6,34,12,10,25,20,116
2024-03-03 20:30:00,3,2,8,33,7,6,35,23,117
2024-03-03 20:40:00,5,5,6,33,8,7,27,24,115
2024-03-03 20:50:00,6,2,8,23,7,8,30,25,109
2024-03-03 21:00:00,5,3,10,38,4,7,36,24,127
2024-03-03 21:10:00,6,4,3,21,8,12,12,13,79
2024-03-03 21:20:00,4,3,4,34,10,13,24,20,112
2024-03-03 21:30:00,2,1,4,26,3,2,16,17,71
2024-03-03 21:40:00,0,0,4,20,4,6,26,27,87
2024-03-03 21:50:00,6,3,7,27,4,2,19,20,88
2024-03-03 22:00:00,0,0,5,32,2,2,39,31,111
2024-03-03 22:10:00,2,2,5,22,2,1,36,28,98
2024-03-03 22:20:00,4,3,3,19,3,1,22,23,78
2024-03-03 22:30:00,1,1,1,19,2,1,21,19,65
2024-03-03 22:40:00,0,0,2,15,3,3,16,21,60
2024-03-03 22:50:00,0,0,3,21,4,4,30,19,81
2024-03-03 23:00:00,1,0,1,13,1,1,14,12,43
2024-03-03 23:10:00,0,0,1,8,0,0,8,10,27
2024-03-03 23:20:00,0,0,1,8,5,5,9,10,38
2024-03-03 23:30:00,1,0,1,11,1,0,7,5,26
2024-03-03 23:40:00,1,0,0,3,5,5,11,10,35
2024-03-03 23:50:00,4,3,1,6,1,1,13,15,44
2024-03-04 00:00:00,0,0,0,10,0,0,8,10,28
2024-03-04 00:10:00,1,2,0,6,0,0,14,14,37
2024-03-04 00:20:00,0,0,0,5,2,4,4,5,20
2024-03-04 00:30:00,0,0,1,6,2,1,4,4,18
2024-03-04 00:40:00,0,0,1,7,0,0,2,2,12
2024-03-04 00:50:00,0,0,0,5,1,1,5,6,18
2024-03-04 01:00:00,1,0,1,2,0,0,0,0,4
2024-03-04 01:10:00,0,0,1,2,0,0,2,3,8
2024-03-04 01:20:00,0,0,1,3,1,2,4,4,15
2024-03-04 01:30:00,2,1,0,5,2,1,3,3,17
2024-03-04 01:40:00,0,0,0,7,1,1,3,3,15
2024-03-04 01:50:00,0,0,0,5,0,0,4,4,13
2024-03-04 02:00:00,0,0,1,2,0,1,3,4,11
2024-03-04 02:10:00,0,0,0,3,0,1,0,0,4
2024-03-04 02:20:00,0,0,0,2,0,0,2,3,7
2024-03-04 02:30:00,0,0,0,3,0,0,0,0,3
2024-03-04 02:40:00,0,0,1,5,0,0,3,4,13
2024-03-04 02:50:00,0,0,0,4,0,0,3,4,11
2024-03-04 03:00:00,0,0,0,5,0,0,2,3,10
2024-03-04 03:10:00,0,0,0,3,0,0,3,3,9
2024-03-04 03:20:00,0,0,1,6,0,0,2,3,12
2024-03-04 03:30:00,1,1,0,4,1,2,0,0,9
2024-03-04 03:40:00,0,0,0,1,1,1,2,2,7
2024-03-04 03:50:00,0,0,0,7,0,0,2,2,11
2024-03-04 04:00:00,0,0,0,6,1,1,5,6,19
2024-03-04 04:10:00,0,0,1,4,0,0,2,2,9
2024-03-04 04:20:00,0,0,1,10,3,3,4,4,25
2024-03-04 04:30:00,0,0,1,8,1,1,1,1,13
2024-03-04 04:40:00,0,0,3,20,2,2,2,3,32
2024-03-04 04:50:00,0,0,4,16,1,2,4,6,33
2024-03-04 05:00:00,0,0,1,23,1,1,4,3,33
2024-03-04 05:10:00,0,0,9,32,3,3,5,8,60
2024-03-04 05:20:00,1,0,9,29,4,6,5,6,60
2024-03-04 05:30:00,1,1,20,49,3,3,5,6,88
2024-03-04 05:40:00,1,0,29,67,4,4,9,14,128
2024-03-04 05:50:00,2,1,34,55,3,3,6,7,111
2024-03-04 06:00:00,6,2,15,43,4,5,23,17,115
2024-03-04 06:10:00,2,1,21,59,5,7,17,14,126
2024-03-04 06:20:00,3,3,28,64,6,6,22,19,151
2024-03-04 06:30:00,9,3,18,84,13,7,27,26,187
2024-03-04 06:40:00,7,4,13,83,14,17,20,17,175
2024-03-04 06:50:00,3,2,17,98,8,9,28,19,184
2024-03-04 07:00:00,4,2,25,94,26,16,35,27,229
2024-03-04 07:10:00,9,6,25,82,15,10,43,24,214
2024-03-04 07:20:00,13,7,27,100,18,13,41,23,242
2024-03-04 07:30:00,11,5,22,78,26,9,36,28,215
2024-03-04 07:40:00,12,6,30,106,31,12,54,26,277
2024-03-04 07:50:00,13,7,23,104,24,11,43,27,252
2024-03-04 08:00:00,10,6,26,95,30,7,50,27,251
2024-03-04 08:10:00,15,8,30,75,19,8,25,22,202
2024-03-04 08:20:00,12,5,22,102,20,11,54,28,254
2024-03-04 08:30:00,12,7,27,81,24,18,39,20,228
2024-03-04 08:40:00,14,8,34,94,19,7,52,35,263
2024-03-04 08:50:00,15,8,33,80,21,7,40,26,230
2024-03-04 09:00:00,14,7,30,76,13,10,50,31,231
2024-03-04 09:10:00,11,5,26,70,17,13,38,18,198
2024-03-04 09:20:00,14,4,7,86,11,10,50,33,215
2024-03-04 09:30:00,17,8,17,68,15,13,54,30,222
2024-03-04 09:40:00,13,11,18,55,27,13,44,34,215
2024-03-04 09:50:00,15,11,50,59,18,13,42,26,234
2024-03-04 10:00:00,19,12,26,57,120,10,39,37,320
2024-03-04 10:10:00,15,10,33,57,18,10,48,32,223
2024-03-04 10:20:00,15,6,24,48,11,7,53,31,195
2024-03-04 10:30:00,17,9,28,64,13,12,47,34,224
2024-03-04 10:40:00,8,4,35,47,18,6,50,28,196
2024-03-04 10:50:00,13,9,18,54,21,12,41,29,197
2024-03-04 11:00:00,15,6,26,58,13,17,48,30,213
2024-03-04 11:10:00,17,8,30,54,13,11,41,27,201
2024-03-04 11:20:00,11,8,30,49,14,9,61,33,215
2024-03-04 11:30:00,17,7,25,45,14,10,60,29,207
2024-03-04 11:40:00,15,8,22,42,14,11,58,30,200
2024-03-04 11:50:00,10,2,28,41,9,8,67,41,206
2024-03-04 12:00:00,17,8,18,45,10,13,54,20,185
2024-03-04 12:10:00,21,11,32,42,11,6,65,35,223
2024-03-04 12:20:00,8,8,18,46,16,11,60,41,208
2024-03-04 12:30:00,13,9,27,51,9,9,69,37,224
2024-03-04 12:40:00,13,8,21,49,16,9,64,43,223
2024-03-04 12:50:00,17,11,21,46,13,10,54,39,211
2024-03-04 13:00:00,15,7,22,57,18,7,66,29,221
2024-03-04 13:10:00,13,8,33,45,64,10,59,31,263
2024-03-04 13:20:00,13,7,27,41,14,14,78,31,225
2024-03-04 13:30:00,13,10,17,48,12,10,67,36,213
2024-03-04 13:40:00,14,6,28,57,7,5,59,25,201
2024-03-04 13:50:00,16,10,16,46,16,9,72,37,222
2024-03-04 14:00:00,23,12,33,50,12,7,74,30,241
2024-03-04 14:10:00,16,7,18,46,11,7,72,42,219
2024-03-04 14:20:00,25,13,23,48,21,13,85,35,263
2024-03-04 14:30:00,21,10,26,52,22,7,86,28,252
2024-03-04 14:40:00,19,12,28,39,13,7,98,40,256
2024-03-04 14:50:00,22,12,25,57,20,12,107,28,283
2024-03-04 15:00:00,24,16,11,44,5,6,117,42,265
2024-03-04 15:10:00,23,12,23,66,18,13,96,32,283
2024-03-04 15:20:00,22,10,18,69,13,7,119,34,292
2024-03-04 15:30:00,18,8,15,54,24,10,111,26,266
2024-03-04 15:40:00,28,12,9,54,14,8,116,11,252
2024-03-04 15:50:00,20,9,15,38,9,8,114,14,227
2024-03-04 16:00:00,25,12,10,54,15,5,116,22,259
2024-03-04 16:10:00,21,8,13,58,14,8,127,24,273
2024-03-04 16:20:00,19,9,8,59,10,8,116,25,254
2024-03-04 16:30:00,23,10,17,54,17,13,113,25,272
2024-03-04 16:40:00,18,9,21,60,15,12,112,20,267
2024-03-04 16:50:00,17,7,14,73,17,7,118,25,278
2024-03-04 17:00:00,17,8,5,57,18,10,114,16,245
2024-03-04 17:10:00,20,8,6,46,16,13,104,28,241
2024-03-04 17:20:00,17,9,8,63,14,8,110,38,267
2024-03-04 17:30:00,15,10,12,49,229,10,106,26,457
2024-03-04 17:40:00,21,12,10,54,16,10,101,27,251
2024-03-04 17:50:00,17,7,10,58,14,12,80,28,226
2024-03-04 18:00:00,13,10,9,56,12,12,91,29,232
2024-03-04 18:10:00,18,10,8,51,26,16,73,24,226
2024-03-04 18:20:00,7,5,12,39,15,11,79,18,186
2024-03-04 18:30:00,13,11,3,52,15,13,82,32,221
2024-03-04 18:40:00,14,7,12,52,15,7,63,24,194
2024-03-04 18:50:00,6,3,12,52,8,57,51,36,225
2024-03-04 19:00:00,8,2,1,36,12,10,61,21,151
2024-03-04 19:10:00,11,6,9,49,23,7,57,25,187
2024-03-04 19:20:00,9,5,4,48,14,15,57,27,179
2024-03-04 19:30:00,7,4,9,45,12,11,33,26,147
2024-03-04 19:40:00,12,6,2,37,9,11,35,34,146
2024-03-04 19:50:00,10,7,1,34,13,7,36,24,132
2024-03-04 20:00:00,12,9,8,24,4,7,32,29,125
2024-03-04 20:10:00,5,4,1,25,8,5,34,23,105
2024-03-04 20:20:00,6,7,7,29,13,6,30,23,121
2024-03-04 20:30:00,6,4,10,28,7,14,38,33,140
2024-03-04 20:40:00,7,6,6,23,11,8,26,26,113
2024-03-04 20:50:00,1,1,9,28,5,3,31,21,99
2024-03-04 21:00:00,5,4,7,16,6,6,18,16,78
2024-03-04 21:10:00,11,7,7,26,12,7,25,31,126
2024-03-04 21:20:00,10,8,6,31,4,5,25,29,118
2024-03-04 21:30:00,6,3,2,15,2,3,13,16,60
2024-03-04 21:40:00,4,6,4,19,3,2,14,12,64
2024-03-04 21:50:00,5,3,2,18,4,2,20,21,75
2024-03-04 22:00:00,4,4,3,19,3,4,18,22,77
2024-03-04 22:10:00,6,3,2,23,3,4,24,18,83
2024-03-04 22:20:00,5,3,2,13,3,2,22,25,75
2024-03-04 22:30:00,0,0,3,16,2,4,28,29,82
2024-03-04 22:40:00,4,2,0,3,3,3,12,13,40
2024-03-04 22:50:00,2,0,3,8,3,2,17,24,59
2024-03-04 23:00:00,0,0,2,11,5,6,14,10,48
2024-03-04 23:10:00,0,0,0,7,0,0,12,14,33
2024-03-04 23:20:00,2,2,0,8,3,4,12,15,46
2024-03-04 23:30:00,0,0,0,4,1,2,8,10,25
2024-03-04 23:40:00,1,1,0,5,0,0,3,3,13
2024-03-04 23:50:00,0,0,0,7,1,0,11,13,32
2024-03-05 00:00:00,1,0,1,7,3,2,9,9,32
2024-03-05 00:10:00,0,0,0,10,0,0,6,9,25
2024-03-05 00:20:00,0,0,1,4,1,1,2,2,11
2024-03-05 00:30:00,0,0,0,3,0,0,3,3,9
2024-03-05 00:40:00,1,1,0,2,1,2,1,1,9
2024-03-05 00:50:00,0,0,0,1,1,2,3,4,11
2024-03-05 01:00:00,0,0,0,1,1,2,3,4,11
2024-03-05 01:10:00,0,0,0,3,1,0,3,4,11
2024-03-05 01:20:00,0,0,0,6,2,3,3,3,17
2024-03-05 01:30:00,0,0,0,6,1,1,1,1,10
2024-03-05 01:40:00,4,2,0,3,0,0,2,3,14
2024-03-05 01:50:00,0,0,1,2,1,1,3,4,12
2024-03-05 02:00:00,0,0,1,4,0,0,1,1,7
2024-03-05 02:10:00,0,0,1,2,0,0,0,0,3
2024-03-05 02:20:00,0,0,1,3,0,0,1,1,6
2024-03-05 02:30:00,0,0,0,2,0,0,1,2,5
2024-03-05 02:40:00,0,0,1,11,1,1,3,4,21
2024-03-05 02:50:00,0,0,0,4,0,0,3,4,11
2024-03-05 03:00:00,0,0,0,4,0,0,2,2,8
2024-03-05 03:10:00,0,0,0,2,0,0,1,2,5
2024-03-05 03:20:00,0,0,0,2,1,1,2,2,8
2024-03-05 03:30:00,0,0,0,2,2,2,5,6,17
2024-03-05 03:40:00,0,0,0,5,2,1,3,3,14
2024-03-05 03:50:00,0,0,1,5,0,0,5,7,18
2024-03-05 04:00:00,0,0,0,3,0,0,2,4,9
2024-03-05 04:10:00,0,0,1,7,2,3,0,0,13
2024-03-05 04:20:00,0,0,2,11,0,0,3,3,19
2024-03-05 04:30:00,0,0,0,8,1,1,2,2,14
2024-03-05 04:40:00,0,0,2,18,0,0,6,6,32
2024-03-05 04:50:00,0,0,5,16,1,1,1,1,25
2024-03-05 05:00:00,0,0,11,20,3,4,8,8,54
2024-03-05 05:10:00,0,0,8,33,1,1,5,6,54
2024-03-05 05:20:00,0,0,13,40,5,7,9,13,87
2024-03-05 05:30:00,2,1,12,63,2,2,6,8,96
2024-03-05 05:40:00,1,1,19,63,5,4,4,5,102
2024-03-05 05:50:00,4,1,32,65,6,7,8,7,130
2024-03-05 06:00:00,2,0,6,63,3,2,12,10,98
2024-03-05 06:10:00,2,0,21,80,4,3,19,18,147
2024-03-05 06:20:00,5,4,20,90,9,7,20,19,174
2024-03-05 06:30:00,7,6,20,88,7,5,26,22,181
2024-03-05 06:40:00,8,7,13,88,10,8,39,23,196
2024-03-05 06:50:00,4,2,17,70,14,10,38,30,185
2024-03-05 07:00:00,7,3,23,72,15,9,31,24,184
2024-03-05 07:10:00,7,5,29,88,14,9,29,17,198
2024-03-05 07:20:00,9,9,25,94,19,11,45,27,239
2024-03-05 07:30:00,13,5,28,94,20,12,34,25,231
2024-03-05 07:40:00,15,7,31,81,23,16,27,18,218
2024-03-05 07:50:00,14,6,29,97,22,12,57,25,262
2024-03-05 08:00:00,9,7,30,98,26,11,42,26,249
2024-03-05 08:10:00,8,5,31,89,22,10,43,25,233
2024-03-05 08:20:00,9,6,29,98,20,6,31,24,223
2024-03-05 08:30:00,15,8,31,81,25,12,48,29,249
2024-03-05 08:40:00,15,8,27,89,21,6,45,28,239
2024-03-05 08:50:00,20,9,31,85,19,7,50,28,249
2024-03-05 09:00:00,16,8,23,79,18,14,42,19,219
2024-03-05 09:10:00,13,9,19,81,22,13,34,27,218
2024-03-05 09:20:00,15,8,26,89,19,8,33,19,217
2024-03-05 09:30:00,14,8,29,92,18,8,47,34,250
2024-03-05 09:40:00,19,10,40,50,13,8,39,32,211
2024-03-05 09:50:00,22,10,31,58,16,12,53,27,229
2024-03-05 10:00:00,23,9,27,49,15,8,43,30,204
2024-03-05 10:10:00,9,5,26,57,8,8,60,37,210
2024-03-05 10:20:00,16,8,25,48,16,16,59,22,210
2024-03-05 10:30:00,16,6,31,60,23,14,43,31,224
2024-03-05 10:40:00,16,5,35,59,15,14,63,30,237
2024-03-05 10:50:00,16,9,23,49,16,11,44,33,201
2024-03-05 11:00:00,10,7,31,53,15,12,61,44,233
2024-03-05 11:10:00,15,9,24,48,20,12,54,33,215
2024-03-05 11:20:00,12,10,17,55,21,10,64,44,233
2024-03-05 11:30:00,15,8,20,42,18,14,63,37,217
2024-03-05 11:40:00,16,5,34,45,14,11,64,34,223
2024-03-05 11:50:00,19,10,23,55,23,11,56,36,233
2024-03-05 12:00:00,17,8,28,51,13,4,72,28,221
2024-03-05 12:10:00,16,5,13,53,14,21,82,29,233
2024-03-05 12:20:00,9,8,16,35,11,10,63,36,188
2024-03-05 12:30:00,14,10,48,74,10,8,75,33,272
2024-03-05 12:40:00,17,10,32,44,14,13,74,32,236
2024-03-05 12:50:00,12,6,31,47,11,7,76,27,217
2024-03-05 13:00:00,13,10,17,39,13,11,67,39,209
2024-03-05 13:10:00,19,10,28,47,20,14,75,35,248
2024-03-05 13:20:00,20,8,30,52,10,6,87,30,243
2024-03-05 13:30:00,17,12,35,51,16,15,56,38,240
2024-03-05 13:40:00,18,12,21,42,16,12,85,21,227
2024-03-05 13:50:00,13,9,30,36,13,9,70,32,212
2024-03-05 14:00:00,24,9,29,64,6,12,75,29,248
2024-03-05 14:10:00,21,10,37,58,16,14,81,31,268
2024-03-05 14:20:00,18,5,30,62,15,10,89,38,267
2024-03-05 14:30:00,13,5,17,49,11,7,80,31,213
2024-03-05 14:40:00,16,12,29,56,11,12,92,34,262
2024-03-05 14:50:00,20,14,28,55,18,15,103,33,286
2024-03-05 15:00:00,24,12,19,60,19,6,89,38,267
2024-03-05 15:10:00,23,12,12,54,16,5,101,41,264
2024-03-05 15:20:00,20,7,21,56,15,11,122,31,283
2024-03-05 15:30:00,18,11,7,60,12,9,121,36,274
2024-03-05 15:40:00,20,14,15,53,15,6,131,19,273
2024-03-05 15:50:00,22,7,19,68,11,6,116,22,271
2024-03-05 16:00:00,26,14,6,54,11,8,121,5,245
2024-03-05 16:10:00,22,13,12,62,20,10,127,7,273
2024-03-05 16:20:00,20,9,13,54,12,6,112,6,232
2024-03-05 16:30:00,30,10,21,64,17,10,123,5,280
2024-03-05 16:40:00,14,8,9,56,14,8,128,25,262
2024-03-05 16:50:00,16,7,10,44,11,10,101,21,220
2024-03-05 17:00:00,12,6,8,58,18,9,106,12,229
2024-03-05 17:10:00,16,7,11,66,13,10,120,8,251
2024-03-05 17:20:00,21,8,14,61,22,9,105,20,260
2024-03-05 17:30:00,17,11,13,62,11,10,102,21,247
2024-03-05 17:40:00,21,11,16,67,16,5,91,29,256
2024-03-05 17:50:00,6,5,10,49,19,13,105,23,230
2024-03-05 18:00:00,12,11,7,52,14,14,92,26,228
2024-03-05 18:10:00,12,11,6,67,17,11,108,27,259
2024-03-05 18:20:00,5,5,6,53,14,7,82,20,192
2024-03-05 18:30:00,11,10,9,43,18,16,70,39,216
2024-03-05 18:40:00,7,6,12,61,19,11,62,36,214
2024-03-05 18:50:00,9,3,7,45,10,9,74,29,186
2024-03-05 19:00:00,9,5,3,45,13,14,72,34,195
2024-03-05 19:10:00,6,1,6,48,12,8,51,27,159
2024-03-05 19:20:00,12,7,5,54,10,10,64,25,187
2024-03-05 19:30:00,15,8,2,41,17,14,41,22,160
2024-03-05 19:40:00,11,6,9,36,9,9,46,33,159
2024-03-05 19:50:00,13,7,1,35,11,8,55,32,162
2024-03-05 20:00:00,7,3,5,30,12,8,49,35,149
2024-03-05 20:10:00,12,6,1,30,11,10,38,24,132
2024-03-05 20:20:00,8,4,8,31,9,8,40,28,136
2024-03-05 20:30:00,2,3,3,25,6,6,26,26,97
2024-03-05 20:40:00,8,6,6,24,4,3,22,22,95
2024-03-05 20:50:00,6,5,8,28,9,4,24,21,105
2024-03-05 21:00:00,9,2,9,23,5,3,24,18,93
2024-03-05 21:10:00,5,3,4,23,6,5,20,18,84
2024-03-05 21:20:00,5,3,2,29,6,8,34,25,112
2024-03-05 21:30:00,8,4,6,24,2,0,17,24,85
2024-03-05 21:40:00,3,1,2,14,6,4,31,25,86
2024-03-05 21:50:00,3,0,6,28,8,10,30,31,116
2024-03-05 22:00:00,2,1,7,20,5,5,30,26,96
2024-03-05 22:10:00,3,3,2,20,11,6,26,25,96
2024-03-05 22:20:00,3,2,2,11,3,4,24,26,75
2024-03-05 22:30:00,7,2,6,21,7,4,22,20,89
2024-03-05 22:40:00,5,2,2,8,3,7,17,16,60
2024-03-05 22:50:00,1,0,2,12,4,2,20,16,57
2024-03-05 23:00:00,3,0,4,11,2,4,14,14,52
2024-03-05 23:10:00,0,0,0,11,7,6,16,16,56
2024-03-05 23:20:00,2,2,1,5,3,1,20,17,51
2024-03-05 23:30:00,1,1,0,8,3,3,9,8,33
2024-03-05 23:40:00,2,1,0,5,2,3,8,12,33
2024-03-05 23:50:00,0,0,2,12,3,3,10,10,40
2024-03-06 00:00:00,0,0,3,14,3,3,7,7,37
2024-03-06 00:10:00,2,2,1,3,1,1,4,7,21
2024-03-06 00:20:00,1,1,1,4,1,2,5,7,22
2024-03-06 00:30:00,0,0,0,2,37,1,2,3,45
2024-03-06 00:40:00,1,0,1,5,0,0,2,2,11
2024-03-06 00:50:00,0,0,1,4,0,0,4,5,14
2024-03-06 01:00:00,0,0,0,3,2,2,2,4,13
2024-03-06 01:10:00,0,0,0,1,4,5,2,3,15
2024-03-06 01:20:00,1,0,1,4,0,0,1,1,8
2024-03-06 01:30:00,0,0,0,5,2,2,2,3,14
2024-03-06 01:40:00,0,0,1,3,0,0,2,2,8
2024-03-06 01:50:00,1,1,0,0,2,1,3,3,11
2024-03-06 02:00:00,0,0,0,4,0,0,0,0,4
2024-03-06 02:10:00,0,0,1,2,0,0,3,5,11
2024-03-06 02:20:00,0,0,0,3,1,1,1,1,7
2024-03-06 02:30:00,0,0,0,1,0,0,1,1,3
2024-03-06 02:40:00,1,1,1,4,0,0,1,1,9
2024-03-06 02:50:00,0,0,0,2,0,0,3,4,9
2024-03-06 03:00:00,0,0,2,6,0,0,4,3,15
2024-03-06 03:10:00,0,0,2,5,1,1,1,1,11
2024-03-06 03:20:00,0,0,0,3,1,1,2,4,11
2024-03-06 03:30:00,1,1,0,3,2,2,2,2,13
2024-03-06 03:40:00,0,0,0,1,1,1,3,4,10
2024-03-06 03:50:00,0,0,1,6,0,0,3,4,14
2024-03-06 04:00:00,0,0,0,9,0,0,2,2,13
2024-03-06 04:10:00,0,0,4,15,4,4,4,5,36
2024-03-06 04:20:00,0,0,2,12,2,1,2,3,22
2024-03-06 04:30:00,0,0,3,13,1,1,4,6,28
2024-03-06 04:40:00,0,0,6,16,1,2,5,4,34
2024-03-06 04:50:00,0,0,2,13,3,3,0,0,21
2024-03-06 05:00:00,1,1,2,19,1,1,4,4,33
2024-03-06 05:10:00,0,0,7,23,3,2,14,19,68
2024-03-06 05:20:00,0,0,17,37,3,3,6,6,72
2024-03-06 05:30:00,0,0,21,44,3,4,7,9,88
2024-03-06 05:40:00,1,1,25,55,2,2,5,7,98
2024-03-06 05:50:00,8,2,26,48,5,2,12,9,112
2024-03-06 06:00:00,1,0,10,60,9,6,12,16,114
2024-03-06 06:10:00,2,0,21,68,9,5,21,17,143
2024-03-06 06:20:00,4,2,18,83,10,10,22,24,173
2024-03-06 06:30:00,2,1,16,84,7,6,28,28,172
2024-03-06 06:40:00,6,4,11,74,10,5,35,24,169
2024-03-06 06:50:00,7,3,16,67,20,11,43,24,191
2024-03-06 07:00:00,2,1,25,83,13,12,30,22,188
2024-03-06 07:10:00,6,4,24,89,12,11,33,18,197
2024-03-06 07:20:00,6,4,28,97,18,10,28,24,215
2024-03-06 07:30:00,15,5,29,79,20,11,35,22,216
2024-03-06 07:40:00,8,4,40,83,31,13,50,16,245
2024-03-06 07:50:00,15,8,25,102,21,12,46,25,254
2024-03-06 08:00:00,13,8,42,83,29,12,42,30,259
2024-03-06 08:10:00,17,12,16,93,17,9,34,14,212
2024-03-06 08:20:00,11,2,31,89,24,9,40,25,231
2024-03-06 08:30:00,25,14,30,63,16,8,48,33,237
2024-03-06 08:40:00,13,6,24,88,22,10,31,21,215
2024-03-06 08:50:00,16,10,21,83,24,13,41,22,230
2024-03-06 09:00:00,11,6,22,67,20,7,38,25,196
2024-03-06 09:10:00,12,6,29,71,29,23,29,27,226
2024-03-06 09:20:00,18,9,24,79,13,7,52,28,230
2024-03-06 09:30:00,13,9,26,54,20,15,38,28,203
2024-03-06 09:40:00,18,10,26,66,17,9,46,35,227
2024-03-06 09:50:00,11,5,26,51,19,9,45,28,194
2024-03-06 10:00:00,9,6,40,63,17,13,49,33,230
2024-03-06 10:10:00,16,9,30,57,14,12,31,22,191
2024-03-06 10:20:00,8,6,33,66,16,8,62,39,238
2024-03-06 10:30:00,18,9,42,49,14,8,47,41,228
2024-03-06 10:40:00,14,6,26,45,19,9,39,30,188
2024-03-06 10:50:00,21,12,29,49,19,14,44,30,218
2024-03-06 11:00:00,17,6,29,52,17,11,63,41,236
2024-03-06 11:10:00,7,5,21,49,22,13,53,33,203
2024-03-06 11:20:00,14,6,17,45,21,15,60,28,206
2024-03-06 11:30:00,15,10,24,47,18,10,63,31,218
2024-03-06 11:40:00,10,4,31,51,13,9,53,35,206
2024-03-06 11:50:00,13,7,29,58,15,11,55,39,227
2024-03-06 12:00:00,12,6,20,48,12,11,57,33,199
2024-03-06 12:10:00,16,10,22,52,18,11,69,27,225
2024-03-06 12:20:00,22,8,31,42,15,7,72,32,229
2024-03-06 12:30:00,9,5,25,66,11,8,76,36,236
2024-03-06 12:40:00,13,9,31,49,8,11,70,25,216
2024-03-06 12:50:00,22,11,22,54,13,7,66,31,226
2024-03-06 13:00:00,13,8,29,63,10,4,58,30,215
2024-03-06 13:10:00,13,5,29,47,16,8,73,33,224
2024-03-06 13:20:00,13,9,19,48,11,11,82,29,222
2024-03-06 13:30:00,16,9,38,46,14,10,73,36,242
2024-03-06 13:40:00,15,9,25,36,16,9,83,25,218
2024-03-06 13:50:00,10,6,36,53,12,8,82,32,239
2024-03-06 14:00:00,19,6,19,53,13,10,82,29,231
2024-03-06 14:10:00,19,10,25,43,15,14,76,26,228
2024-03-06 14:20:00,14,8,21,46,11,13,86,49,248
2024-03-06 14:30:00,24,9,22,55,18,11,91,38,268
2024-03-06 14:40:00,25,13,24,36,15,11,90,21,235
2024-03-06 14:50:00,10,6,26,61,20,11,119,35,288
2024-03-06 15:00:00,13,4,14,48,13,35,106,48,281
2024-03-06 15:10:00,23,11,10,57,19,9,129,25,283
2024-03-06 15:20:00,27,12,10,42,13,9,109,44,266
2024-03-06 15:30:00,29,15,17,51,15,6,96,25,254
2024-03-06 15:40:00,23,7,11,56,14,8,111,16,246
2024-03-06 15:50:00,16,10,9,63,10,9,117,19,253
2024-03-06 16:00:00,30,14,9,52,12,8,108,4,237
2024-03-06 16:10:00,21,10,12,48,10,10,121,20,252
2024-03-06 16:20:00,26,8,18,60,19,10,116,21,278
2024-03-06 16:30:00,14,5,11,50,11,10,123,25,249
2024-03-06 16:40:00,13,12,13,60,17,10,110,20,255
2024-03-06 16:50:00,23,10,18,65,15,7,117,30,285
2024-03-06 17:00:00,16,8,20,63,26,10,99,22,264
2024-03-06 17:10:00,23,9,17,70,16,10,99,32,276
2024-03-06 17:20:00,11,6,10,67,21,9,97,29,250
2024-03-06 17:30:00,20,8,18,60,24,18,90,19,257
2024-03-06 17:40:00,17,7,15,69,14,7,92,30,251
2024-03-06 17:50:00,13,7,12,67,13,7,109,24,252
2024-03-06 18:00:00,12,6,13,48,18,15,163,18,293
2024-03-06 18:10:00,10,8,3,53,17,12,106,26,235
2024-03-06 18:20:00,14,6,9,57,19,12,113,26,256
2024-03-06 18:30:00,16,11,6,69,11,7,100,28,248
2024-03-06 18:40:00,8,3,12,65,20,17,67,27,219
2024-03-06 18:50:00,9,5,5,54,11,6,76,25,191
2024-03-06 19:00:00,12,6,6,62,15,8,70,33,212
2024-03-06 19:10:00,6,5,8,55,16,8,46,20,164
2024-03-06 19:20:00,7,5,10,35,10,7,59,31,164
2024-03-06 19:30:00,10,2,3,35,11,7,54,19,141
2024-03-06 19:40:00,11,7,3,52,11,5,29,22,140
2024-03-06 19:50:00,4,5,9,48,13,4,59,25,167
2024-03-06 20:00:00,12,5,10,52,13,10,51,35,188
2024-03-06 20:10:00,6,2,12,43,15,11,38,24,151
2024-03-06 20:20:00,3,2,3,30,13,9,32,25,117
2024-03-06 20:30:00,8,2,7,26,10,8,35,25,121
2024-03-06 20:40:00,3,0,6,36,3,3,38,26,115
2024-03-06 20:50:00,3,2,9,24,2,2,29,24,95
2024-03-06 21:00:00,4,1,4,25,9,7,22,19,91
2024-03-06 21:10:00,3,1,7,27,6,6,34,26,110
2024-03-06 21:20:00,8,4,4,16,8,5,38,28,111
2024-03-06 21:30:00,9,6,6,19,6,5,26,22,99
2024-03-06 21:40:00,4,1,5,21,7,3,16,19,76
2024-03-06 21:50:00,5,3,7,14,3,3,28,23,86
2024-03-06 22:00:00,6,3,2,20,5,5,14,16,71
2024-03-06 22:10:00,8,4,6,27,5,4,33,29,116
2024-03-06 22:20:00,3,3,0,16,7,7,29,27,92
2024-03-06 22:30:00,0,0,3,20,8,8,20,13,72
2024-03-06 22:40:00,4,2,1,17,5,4,17,18,68
2024-03-06 22:50:00,1,2,8,20,6,6,18,18,79
2024-03-06 23:00:00,0,0,1,16,4,4,14,13,52
2024-03-06 23:10:00,3,2,0,14,3,3,16,15,56
2024-03-06 23:20:00,3,1,2,15,1,1,12,12,47
2024-03-06 23:30:00,2,1,4,7,2,4,11,14,45
2024-03-06 23:40:00,1,0,1,8,2,1,10,14,37
2024-03-06 23:50:00,0,0,3,9,2,0,16,19,49
2024-03-07 00:00:00,0,0,1,5,1,2,6,6,21
2024-03-07 00:10:00,0,0,0,4,0,0,8,12,24
2024-03-07 00:20:00,0,0,1,7,3,3,9,12,35
2024-03-07 00:30:00,1,0,1,8,0,0,4,5,19
2024-03-07 00:40:00,0,0,0,2,0,0,2,2,6
2024-03-07 00:50:00,0,0,0,1,0,0,4,6,11
2024-03-07 01:00:00,0,0,1,3,0,0,0,0,4
2024-03-07 01:10:00,1,0,0,6,5,1,3,4,20
2024-03-07 01:20:00,0,0,0,7,1,1,4,6,19
2024-03-07 01:30:00,0,0,0,4,2,2,2,1,11
2024-03-07 01:40:00,3,1,0,1,1,1,1,1,9
2024-03-07 01:50:00,0,0,1,9,0,0,1,1,12
2024-03-07 02:00:00,1,1,0,3,2,2,5,7,21
2024-03-07 02:10:00,0,0,1,6,1,1,1,2,12
2024-03-07 02:20:00,0,0,0,1,0,0,1,1,3
2024-03-07 02:30:00,0,0,0,4,1,1,1,1,8
2024-03-07 02:40:00,0,0,0,3,0,0,1,1,5
2024-03-07 02:50:00,0,0,1,4,0,0,2,3,10
2024-03-07 03:00:00,0,0,0,5,1,1,2,2,11
2024-03-07 03:10:00,0,0,1,7,2,2,4,5,21
2024-03-07 03:20:00,0,0,1,3,0,0,4,4,12
2024-03-07 03:30:00,1,1,0,3,1,1,1,2,10
2024-03-07 03:40:00,1,1,0,4,0,0,4,4,14
2024-03-07 03:50:00,0,0,0,2,0,0,4,5,11
2024-03-07 04:00:00,0,0,2,3,0,0,7,8,20
2024-03-07 04:10:00,0,0,2,13,1,1,5,5,27
2024-03-07 04:20:00,0,0,2,9,1,1,1,3,17
2024-03-07 04:30:00,1,0,2,10,1,1,0,0,15
2024-03-07 04:40:00,0,0,3,9,1,1,3,3,20
2024-03-07 04:50:00,0,0,0,11,2,2,3,4,22
2024-03-07 05:00:00,0,0,4,19,1,1,8,7,40
2024-03-07 05:10:00,0,0,7,26,3,4,10,15,65
2024-03-07 05:20:00,0,0,8,37,2,2,5,5,59
2024-03-07 05:30:00,1,0,13,55,3,3,8,10,93
2024-03-07 05:40:00,2,2,24,67,3,3,4,4,109
2024-03-07 05:50:00,2,1,19,58,5,5,7,6,103
2024-03-07 06:00:00,3,3,7,59,4,0,17,16,109
2024-03-07 06:10:00,0,0,22,64,8,8,20,17,139
2024-03-07 06:20:00,2,3,16,82,8,7,16,11,145
2024-03-07 06:30:00,6,3,9,77,7,5,21,18,146
2024-03-07 06:40:00,7,3,12,62,14,8,32,18,156
2024-03-07 06:50:00,7,3,18,100,13,10,43,28,222
2024-03-07 07:00:00,5,3,20,87,13,9,36,28,201
2024-03-07 07:10:00,8,4,25,97,17,13,34,25,223
2024-03-07 07:20:00,10,4,32,94,15,9,38,28,230
2024-03-07 07:30:00,6,4,30,91,17,12,37,16,213
2024-03-07 07:40:00,11,3,28,89,29,9,28,14,211
2024-03-07 07:50:00,10,4,27,92,26,9,50,26,244
2024-03-07 08:00:00,16,7,30,83,19,10,38,33,236
2024-03-07 08:10:00,11,7,25,95,20,10,42,18,228
2024-03-07 08:20:00,19,7,23,107,26,10,32,18,242
2024-03-07 08:30:00,22,9,26,88,18,11,40,25,239
2024-03-07 08:40:00,15,11,37,89,20,27,38,29,266
2024-03-07 08:50:00,10,5,29,79,19,7,47,24,220
2024-03-07 09:00:00,13,6,22,77,14,8,49,26,215
2024-03-07 09:10:00,13,7,27,83,15,27,39,24,235
2024-03-07 09:20:00,12,4,24,76,13,9,60,31,229
2024-03-07 09:30:00,13,10,51,79,17,10,36,30,246
2024-03-07 09:40:00,11,8,34,58,22,12,50,37,232
2024-03-07 09:50:00,11,8,40,79,17,11,50,30,246
2024-03-07 10:00:00,15,11,23,75,19,9,45,31,228
2024-03-07 10:10:00,17,9,24,59,11,10,51,31,212
2024-03-07 10:20:00,11,4,20,70,17,24,55,36,237
2024-03-07 10:30:00,20,9,22,73,15,21,50,36,246
2024-03-07 10:40:00,22,7,32,53,16,8,53,26,217
2024-03-07 10:50:00,18,9,29,53,13,8,49,39,218
2024-03-07 11:00:00,8,4,24,59,10,8,57,30,200
2024-03-07 11:10:00,18,5,21,61,17,16,67,39,244
2024-03-07 11:20:00,15,13,30,59,18,8,43,27,213
2024-03-07 11:30:00,11,11,32,60,10,7,55,34,220
2024-03-07 11:40:00,18,9,38,62,13,29,61,42,272
2024-03-07 11:50:00,15,9,20,48,14,11,63,36,216
2024-03-07 12:00:00,13,6,22,51,9,4,62,33,200
2024-03-07 12:10:00,14,6,28,72,13,9,62,37,241
2024-03-07 12:20:00,23,9,47,79,15,13,73,36,295
2024-03-07 12:30:00,13,5,26,64,10,14,75,31,238
2024-03-07 12:40:00,13,9,30,57,24,12,79,38,262
2024-03-07 12:50:00,10,5,34,61,14,15,65,25,229
2024-03-07 13:00:00,14,6,24,53,18,15,71,35,236
2024-03-07 13:10:00,11,7,26,55,18,18,82,38,255
2024-03-07 13:20:00,16,7,28,75,12,4,78,39,259
2024-03-07 13:30:00,13,6,26,75,20,9,69,30,248
2024-03-07 13:40:00,19,9,36,48,22,15,74,28,251
2024-03-07 13:50:00,18,9,32,51,16,9,76,30,241
2024-03-07 14:00:00,16,9,26,63,10,8,90,32,254
2024-03-07 14:10:00,25,13,19,37,15,8,76,30,223
2024-03-07 14:20:00,25,15,26,71,16,19,68,35,275
2024-03-07 14:30:00,21,7,14,60,17,14,85,29,247
2024-03-07 14:40:00,14,6,25,52,16,9,103,25,250
2024-03-07 14:50:00,21,9,35,65,10,8,98,23,269
2024-03-07 15:00:00,17,7,12,49,17,12,101,32,247
2024-03-07 15:10:00,22,9,13,126,14,9,113,30,336
2024-03-07 15:20:00,21,7,14,61,13,9,85,1,211
2024-03-07 15:30:00,22,8,10,88,16,11,116,7,278
2024-03-07 15:40:00,23,9,18,57,15,9,93,10,234
2024-03-07 15:50:00,16,7,9,48,16,10,64,4,174
2024-03-07 16:00:00,24,14,8,43,17,11,101,1,219
2024-03-07 16:10:00,20,9,17,53,20,6,80,1,206
2024-03-07 16:20:00,11,7,12,62,15,8,87,1,203
2024-03-07 16:30:00,23,11,14,57,19,7,128,10,269
2024-03-07 16:40:00,24,15,17,57,11,15,102,13,254
2024-03-07 16:50:00,16,10,15,49,18,7,125,15,255
2024-03-07 17:00:00,17,8,16,50,15,12,107,20,245
2024-03-07 17:10:00,15,10,10,69,14,9,127,24,278
2024-03-07 17:20:00,19,9,19,69,21,8,123,34,302
2024-03-07 17:30:00,15,10,6,68,16,8,100,33,256
2024-03-07 17:40:00,23,13,11,61,24,10,111,30,283
2024-03-07 17:50:00,20,7,13,50,15,10,98,28,241
2024-03-07 18:00:00,12,5,11,62,20,10,96,34,250
2024-03-07 18:10:00,17,15,12,72,23,17,90,26,272
2024-03-07 18:20:00,13,5,9,81,25,11,101,30,275
2024-03-07 18:30:00,16,10,4,64,20,9,106,27,256
2024-03-07 18:40:00,9,3,17,50,23,14,88,39,243
2024-03-07 18:50:00,10,5,5,77,24,16,89,24,250
2024-03-07 19:00:00,11,5,4,59,28,13,67,19,206
2024-03-07 19:10:00,10,5,9,50,18,13,67,31,203
2024-03-07 19:20:00,11,6,6,58,16,10,61,32,200
2024-03-07 19:30:00,13,7,3,53,9,9,73,26,193
2024-03-07 19:40:00,10,3,2,35,8,6,45,28,137
2024-03-07 19:50:00,11,6,7,48,17,10,40,21,160
2024-03-07 20:00:00,6,6,14,28,10,7,38,31,140
2024-03-07 20:10:00,12,8,3,25,10,9,36,24,127
2024-03-07 20:20:00,3,3,4,26,9,7,40,19,111
2024-03-07 20:30:00,7,3,9,34,8,9,48,35,153
2024-03-07 20:40:00,12,8,2,26,15,9,26,29,127
2024-03-07 20:50:00,6,3,8,37,4,5,35,30,128
2024-03-07 21:00:00,12,8,11,24,14,10,30,25,134
2024-03-07 21:10:00,12,5,2,11,5,2,43,27,107
2024-03-07 21:20:00,3,3,5,19,6,4,26,20,86
2024-03-07 21:30:00,6,4,4,15,8,3,23,19,82
2024-03-07 21:40:00,10,7,3,11,1,1,34,29,96
2024-03-07 21:50:00,6,4,2,18,8,3,24,22,87
2024-03-07 22:00:00,8,6,8,31,9,6,35,30,133
2024-03-07 22:10:00,3,2,1,14,3,3,22,20,68
2024-03-07 22:20:00,6,3,4,19,5,5,32,19,93
2024-03-07 22:30:00,2,1,4,29,3,3,27,27,96
2024-03-07 22:40:00,6,2,5,13,6,6,21,16,75
2024-03-07 22:50:00,4,2,6,18,2,1,23,33,89
2024-03-07 23:00:00,10,8,7,18,1,1,19,17,81
2024-03-07 23:10:00,0,0,0,10,6,3,13,11,43
2024-03-07 23:20:00,5,1,0,14,2,1,11,13,47
2024-03-07 23:30:00,6,2,4,15,2,1,10,11,51
2024-03-07 23:40:00,0,0,0,4,1,1,3,5,14
2024-03-07 23:50:00,5,3,1,8,3,1,11,12,44
2024-03-08 00:00:00,3,2,1,5,8,5,8,6,38
2024-03-08 00:10:00,1,0,1,8,3,3,7,7,30
2024-03-08 00:20:00,2,2,0,7,2,1,10,12,36
2024-03-08 00:30:00,0,0,1,5,0,0,2,2,10
2024-03-08 00:40:00,1,0,0,1,1,1,2,3,9
2024-03-08 00:50:00,1,0,0,0,1,1,6,7,16
2024-03-08 01:00:00,0,0,1,1,0,0,2,2,6
2024-03-08 01:10:00,1,1,0,3,1,1,4,5,16
2024-03-08 01:20:00,1,1,2,5,2,2,2,4,19
2024-03-08 01:30:00,1,0,0,2,1,1,4,5,14
2024-03-08 01:40:00,0,0,0,2,1,2,0,0,5
2024-03-08 01:50:00,0,0,0,1,1,1,0,0,3
2024-03-08 02:00:00,0,0,0,6,2,2,1,1,12
2024-03-08 02:10:00,2,0,0,6,0,0,2,2,12
2024-03-08 02:20:00,0,0,0,7,1,1,0,0,9
2024-03-08 02:30:00,0,0,0,0,1,1,0,0,2
2024-03-08 02:40:00,0,0,2,5,0,0,2,2,11
2024-03-08 02:50:00,0,0,1,4,0,0,3,3,11
2024-03-08 03:00:00,1,1,0,3,0,0,3,3,11
2024-03-08 03:10:00,2,1,0,4,2,2,2,3,16
2024-03-08 03:20:00,0,0,0,2,3,3,3,3,14
2024-03-08 03:30:00,1,0,1,2,0,0,0,0,4
2024-03-08 03:40:00,1,1,0,5,2,3,2,3,17
2024-03-08 03:50:00,0,0,0,3,0,0,3,3,9
2024-03-08 04:00:00,0,0,0,8,1,2,1,1,13
2024-03-08 04:10:00,0,0,1,4,0,0,5,6,16
2024-03-08 04:20:00,0,0,0,6,0,0,1,1,8
2024-03-08 04:30:00,0,0,1,5,1,1,2,2,12
2024-03-08 04:40:00,0,0,0,16,2,4,6,6,34
2024-03-08 04:50:00,0,0,2,12,2,3,3,5,27
2024-03-08 05:00:00,1,1,2,15,2,2,4,4,31
2024-03-08 05:10:00,0,0,9,24,2,4,10,12,61
2024-03-08 05:20:00,0,0,12,33,2,3,6,6,62
2024-03-08 05:30:00,0,0,21,52,2,0,8,9,92
2024-03-08 05:40:00,1,1,21,58,4,4,6,5,100
2024-03-08 05:50:00,6,5,10,44,4,2,5,5,81
2024-03-08 06:00:00,2,1,12,37,5,5,15,15,92
2024-03-08 06:10:00,3,1,6,62,7,9,21,20,129
2024-03-08 06:20:00,1,1,20,67,7,5,15,14,130
2024-03-08 06:30:00,1,1,12,77,13,10,32,33,179
2024-03-08 06:40:00,3,1,8,81,8,7,22,19,149
2024-03-08 06:50:00,3,2,13,84,7,3,29,22,163
2024-03-08 07:00:00,4,3,16,74,12,7,33,18,167
2024-03-08 07:10:00,10,4,30,78,12,6,28,20,188
2024-03-08 07:20:00,8,4,24,105,17,27,37,27,249
2024-03-08 07:30:00,4,3,27,85,13,9,39,26,206
2024-03-08 07:40:00,13,4,36,79,27,9,33,23,224
2024-03-08 07:50:00,12,7,26,83,17,22,43,30,240
2024-03-08 08:00:00,5,1,23,73,11,5,37,28,183
2024-03-08 08:10:00,9,2,22,94,17,10,37,18,209
2024-03-08 08:20:00,11,4,19,88,11,6,45,27,211
2024-03-08 08:30:00,16,4,28,70,21,24,45,19,227
2024-03-08 08:40:00,7,4,18,85,22,8,40,28,212
2024-03-08 08:50:00,10,3,27,67,17,11,38,22,195
2024-03-08 09:00:00,18,7,15,67,18,14,46,34,219
2024-03-08 09:10:00,12,8,30,82,20,6,46,23,227
2024-03-08 09:20:00,10,4,15,63,17,8,43,32,192
2024-03-08 09:30:00,14,6,19,77,19,12,42,41,230
2024-03-08 09:40:00,18,10,41,56,21,15,44,38,243
2024-03-08 09:50:00,10,6,35,76,15,15,47,27,231
2024-03-08 10:00:00,22,7,23,67,21,14,53,48,255
2024-03-08 10:10:00,8,5,46,73,17,9,52,25,235
2024-03-08 10:20:00,12,11,23,67,16,12,49,39,229
2024-03-08 10:30:00,10,5,24,74,18,19,55,39,244
2024-03-08 10:40:00,14,5,43,66,18,14,58,40,258
2024-03-08 10:50:00,18,5,29,84,28,14,53,35,266
2024-03-08 11:00:00,11,0,18,59,13,13,70,49,233
2024-03-08 11:10:00,11,0,19,77,13,12,68,54,254
2024-03-08 11:20:00,11,0,14,93,16,13,67,42,256
2024-03-08 11:30:00,7,5,32,87,16,16,57,52,272
2024-03-08 11:40:00,16,6,25,71,15,11,76,26,246
2024-03-08 11:50:00,12,7,22,77,20,20,66,44,268
2024-03-08 12:00:00,7,3,42,84,13,20,73,38,280
2024-03-08 12:10:00,12,7,34,59,16,12,95,25,260
2024-03-08 12:20:00,20,9,21,93,19,12,86,38,298
2024-03-08 12:30:00,15,5,16,92,20,14,94,32,288
2024-03-08 12:40:00,5,4,20,120,17,17,75,40,298
2024-03-08 12:50:00,15,4,17,81,12,25,103,40,297
2024-03-08 13:00:00,18,7,8,97,22,33,96,28,309
2024-03-08 13:10:00,17,7,13,114,6,6,100,37,300
2024-03-08 13:20:00,19,8,8,103,15,12,88,29,282
2024-03-08 13:30:00,184,5,15,61,14,6,94,37,416
2024-03-08 13:40:00,23,8,10,64,5,6,102,36,254
2024-03-08 13:50:00,8,5,11,75,8,9,92,40,248
2024-03-08 14:00:00,15,7,11,63,14,10,93,40,253
2024-03-08 14:10:00,18,5,20,82,13,4,96,41,279
2024-03-08 14:20:00,17,8,8,76,15,15,93,28,260
2024-03-08 14:30:00,22,8,13,76,14,9,106,44,292
2024-03-08 14:40:00,13,5,23,98,18,9,108,38,312
2024-03-08 14:50:00,11,4,16,77,19,18,76,33,254
2024-03-08 15:00:00,19,4,9,102,19,9,103,24,289
2024-03-08 15:10:00,20,5,20,91,17,28,110,34,325
2024-03-08 15:20:00,18,11,7,103,17,13,100,46,315
2024-03-08 15:30:00,18,10,22,113,17,19,99,33,331
2024-03-08 15:40:00,20,8,12,66,18,14,120,28,286
2024-03-08 15:50:00,18,9,10,62,24,12,109,41,285
2024-03-08 16:00:00,14,12,24,66,23,16,95,29,279
2024-03-08 16:10:00,21,7,12,62,19,17,85,34,257
2024-03-08 16:20:00,10,4,12,71,16,11,100,46,270
2024-03-08 16:30:00,12,5,18,74,12,7,92,42,262
2024-03-08 16:40:00,8,7,15,75,20,7,87,38,257
2024-03-08 16:50:00,17,7,14,76,18,20,94,39,285
2024-03-08 17:00:00,15,5,17,69,20,10,108,77,321
2024-03-08 17:10:00,14,8,18,77,22,13,98,40,290
2024-03-08 17:20:00,16,8,14,83,18,11,93,30,273
2024-03-08 17:30:00,18,9,15,71,18,9,86,28,254
2024-03-08 17:40:00,10,8,14,66,17,10,82,36,243
2024-03-08 17:50:00,20,12,25,74,18,11,84,27,271
2024-03-08 18:00:00,13,6,6,60,21,12,124,16,258
2024-03-08 18:10:00,18,8,9,73,25,13,81,29,256
2024-03-08 18:20:00,9,3,11,90,17,12,61,32,235
2024-03-08 18:30:00,16,10,11,71,12,10,89,15,234
2024-03-08 18:40:00,16,11,21,81,18,12,78,25,262
2024-03-08 18:50:00,11,4,16,74,13,7,69,29,223
2024-03-08 19:00:00,12,6,10,72,16,10,72,20,218
2024-03-08 19:10:00,3,1,12,71,17,10,63,34,211
2024-03-08 19:20:00,7,4,4,58,11,7,85,34,210
2024-03-08 19:30:00,11,5,5,64,15,9,49,25,183
2024-03-08 19:40:00,7,6,6,52,9,8,51,26,165
2024-03-08 19:50:00,6,6,9,65,9,4,56,35,190
2024-03-08 20:00:00,7,3,5,28,10,7,44,28,132
2024-03-08 20:10:00,4,5,10,51,18,10,54,26,178
2024-03-08 20:20:00,14,7,10,47,12,6,37,29,162
2024-03-08 20:30:00,8,5,13,48,4,5,40,33,156
2024-03-08 20:40:00,3,3,11,51,6,5,30,25,134
2024-03-08 20:50:00,4,1,14,48,13,10,33,24,147
2024-03-08 21:00:00,6,3,9,38,9,6,43,30,144
2024-03-08 21:10:00,4,1,3,30,9,6,29,17,99
2024-03-08 21:20:00,5,1,10,41,10,10,41,28,146
2024-03-08 21:30:00,10,5,6,25,8,7,40,19,120
2024-03-08 21:40:00,7,4,4,31,5,6,30,24,111
2024-03-08 21:50:00,5,2,9,27,8,8,34,35,128
2024-03-08 22:00:00,4,2,11,32,9,7,37,31,133
2024-03-08 22:10:00,4,1,7,25,11,8,44,27,127
2024-03-08 22:20:00,2,0,8,23,6,5,55,31,130
2024-03-08 22:30:00,5,1,9,27,9,8,49,35,143
2024-03-08 22:40:00,1,1,8,21,11,12,40,25,119
2024-03-08 22:50:00,3,3,3,19,5,6,36,34,109
2024-03-08 23:00:00,5,2,8,26,10,8,47,23,129
2024-03-08 23:10:00,4,1,2,20,3,2,36,25,93
2024-03-08 23:20:00,1,0,4,23,1,1,33,21,84
2024-03-08 23:30:00,2,2,5,25,2,2,27,20,85
2024-03-08 23:40:00,3,0,2,17,8,3,15,17,65
2024-03-08 23:50:00,1,0,1,15,4,3,25,23,72
2024-03-09 00:00:00,0,0,3,28,4,3,16,16,70
2024-03-09 00:10:00,0,0,4,14,4,2,16,16,56
2024-03-09 00:20:00,4,1,3,13,1,2,15,14,53
2024-03-09 00:30:00,0,0,1,19,1,2,19,18,60
2024-03-09 00:40:00,1,1,0,13,4,4,23,20,66
2024-03-09 00:50:00,4,2,1,14,4,4,11,10,50
2024-03-09 01:00:00,0,0,0,11,2,2,10,7,32
2024-03-09 01:10:00,1,0,2,13,1,1,8,14,40
2024-03-09 01:20:00,1,1,0,8,2,3,13,13,41
2024-03-09 01:30:00,0,0,0,8,1,1,14,15,39
2024-03-09 01:40:00,2,0,1,7,2,2,13,17,44
2024-03-09 01:50:00,0,0,4,10,0,0,13,14,41
2024-03-09 02:00:00,1,0,0,19,3,3,6,7,39
2024-03-09 02:10:00,1,0,1,4,2,2,5,6,21
2024-03-09 02:20:00,0,0,1,6,1,0,6,8,22
2024-03-09 02:30:00,0,0,0,6,0,0,2,2,10
2024-03-09 02:40:00,1,1,0,2,1,1,5,9,20
2024-03-09 02:50:00,2,0,0,3,2,3,9,10,29
2024-03-09 03:00:00,2,1,1,8,0,0,9,13,34
2024-03-09 03:10:00,0,0,0,1,2,3,5,5,16
2024-03-09 03:20:00,1,0,2,7,0,0,5,5,20
2024-03-09 03:30:00,0,0,1,5,4,3,6,8,27
2024-03-09 03:40:00,1,0,0,9,1,1,5,4,21
2024-03-09 03:50:00,0,0,1,2,3,3,8,10,27
2024-03-09 04:00:00,0,0,0,6,1,1,7,11,26
2024-03-09 04:10:00,1,0,1,14,3,2,4,5,30
2024-03-09 04:20:00,0,0,0,10,1,2,0,0,13
2024-03-09 04:30:00,0,0,0,4,1,0,3,4,12
2024-03-09 04:40:00,0,0,0,3,2,1,7,8,21
2024-03-09 04:50:00,0,0,0,12,0,0,4,4,20
2024-03-09 05:00:00,0,0,4,11,2,4,8,6,35
2024-03-09 05:10:00,1,0,0,10,0,0,6,8,25
2024-03-09 05:20:00,0,0,6,17,6,7,8,7,51
2024-03-09 05:30:00,3,1,5,24,1,0,2,2,38
2024-03-09 05:40:00,1,1,7,17,1,1,5,8,41
2024-03-09 05:50:00,2,1,4,12,4,7,7,7,44
2024-03-09 06:00:00,2,2,4,17,3,3,9,9,49
2024-03-09 06:10:00,0,0,5,20,2,2,9,12,50
2024-03-09 06:20:00,0,0,8,27,0,0,9,9,53
2024-03-09 06:30:00,2,0,3,18,4,4,11,13,55
2024-03-09 06:40:00,1,1,6,18,1,1,14,10,52
2024-03-09 06:50:00,1,1,4,14,3,2,8,6,39
2024-03-09 07:00:00,3,2,6,27,2,2,10,8,60
2024-03-09 07:10:00,1,1,1,12,3,4,8,8,38
2024-03-09 07:20:00,0,0,11,26,7,3,7,8,62
2024-03-09 07:30:00,3,1,15,31,2,1,12,11,76
2024-03-09 07:40:00,2,2,13,26,5,4,11,11,74
2024-03-09 07:50:00,1,1,15,33,7,4,9,9,79
2024-03-09 08:00:00,1,0,16,32,2,2,14,12,79
2024-03-09 08:10:00,2,3,6,23,11,7,18,15,85
2024-03-09 08:20:00,2,0,20,42,9,8,14,12,107
2024-03-09 08:30:00,8,5,16,32,9,9,16,13,108
2024-03-09 08:40:00,5,3,14,40,10,7,29,27,135
2024-03-09 08:50:00,2,1,34,38,10,6,19,15,125
2024-03-09 09:00:00,7,3,18,42,11,10,24,24,139
2024-03-09 09:10:00,6,2,33,54,12,9,16,12,144
2024-03-09 09:20:00,2,0,22,50,13,8,25,21,141
2024-03-09 09:30:00,4,2,22,47,19,13,23,21,151
2024-03-09 09:40:00,14,9,46,58,11,11,32,28,209
2024-03-09 09:50:00,11,8,32,66,19,14,36,28,214
2024-03-09 10:00:00,8,8,23,65,18,13,25,29,189
2024-03-09 10:10:00,7,5,30,57,10,9,38,40,196
2024-03-09 10:20:00,10,6,29,61,12,11,29,30,188
2024-03-09 10:30:00,9,8,20,66,10,8,35,30,186
2024-03-09 10:40:00,5,5,20,58,14,30,37,32,201
2024-03-09 10:50:00,11,8,32,50,16,13,40,23,193
2024-03-09 11:00:00,8,3,26,46,13,12,35,31,174
2024-03-09 11:10:00,5,4,28,60,19,12,37,31,196
2024-03-09 11:20:00,7,6,22,44,12,48,42,39,220
2024-03-09 11:30:00,18,9,29,60,17,12,56,41,242
2024-03-09 11:40:00,5,5,34,49,17,16,48,39,213
2024-03-09 11:50:00,2,2,25,60,11,10,55,48,213
2024-03-09 12:00:00,10,4,33,58,14,10,47,31,207
2024-03-09 12:10:00,10,5,32,66,15,20,54,38,240
2024-03-09 12:20:00,7,4,24,55,19,15,66,47,237
2024-03-09 12:30:00,8,3,42,76,19,16,61,36,261
2024-03-09 12:40:00,9,8,37,49,21,9,60,37,230
2024-03-09 12:50:00,18,3,34,82,23,29,69,38,296
2024-03-09 13:00:00,8,4,29,57,12,10,70,40,230
2024-03-09 13:10:00,4,2,31,64,19,31,74,39,264
2024-03-09 13:20:00,6,4,24,69,16,13,79,28,239
2024-03-09 13:30:00,9,4,40,74,11,11,74,47,270
2024-03-09 13:40:00,8,0,32,73,14,21,65,51,264
2024-03-09 13:50:00,16,6,39,68,18,16,58,42,263
2024-03-09 14:00:00,13,3,20,55,13,7,84,43,238
2024-03-09 14:10:00,14,5,29,75,12,7,76,35,253
2024-03-09 14:20:00,13,4,29,71,11,21,84,38,271
2024-03-09 14:30:00,13,4,33,66,23,18,77,39,273
2024-03-09 14:40:00,6,1,33,65,25,39,82,25,276
2024-03-09 14:50:00,16,10,31,65,14,13,101,34,284
2024-03-09 15:00:00,12,6,28,67,17,11,88,41,270
2024-03-09 15:10:00,14,1,24,53,19,10,77,39,237
2024-03-09 15:20:00,11,7,33,59,18,9,67,42,246
2024-03-09 15:30:00,13,7,25,67,23,24,74,38,271
2024-03-09 15:40:00,7,7,22,61,14,9,66,28,214
2024-03-09 15:50:00,18,11,22,62,24,8,76,25,246
2024-03-09 16:00:00,12,8,23,35,17,16,70,34,215
2024-03-09 16:10:00,13,12,27,47,19,12,73,37,240
2024-03-09 16:20:00,15,3,26,57,17,10,92,31,251
2024-03-09 16:30:00,6,4,12,57,14,11,79,38,221
2024-03-09 16:40:00,17,8,29,39,15,8,65,33,214
2024-03-09 16:50:00,8,7,27,56,21,10,67,28,224
2024-03-09 17:00:00,2,4,24,52,17,11,56,40,206
2024-03-09 17:10:00,11,6,20,48,17,12,85,36,235
2024-03-09 17:20:00,9,5,22,62,15,9,67,37,226
2024-03-09 17:30:00,14,6,31,46,13,11,79,36,236
2024-03-09 17:40:00,11,6,18,57,9,5,62,29,197
2024-03-09 17:50:00,9,7,26,59,16,7,64,27,215
2024-03-09 18:00:00,8,6,25,48,12,12,64,35,210
2024-03-09 18:10:00,12,7,22,41,13,9,74,36,214
2024-03-09 18:20:00,10,8,24,61,12,6,61,33,215
2024-03-09 18:30:00,8,3,27,45,14,10,59,22,188
2024-03-09 18:40:00,7,4,30,60,10,8,64,34,217
2024-03-09 18:50:00,3,0,24,67,11,12,61,25,203
2024-03-09 19:00:00,8,6,18,39,14,13,49,35,182
2024-03-09 19:10:00,6,3,17,56,12,10,46,30,180
2024-03-09 19:20:00,5,3,14,42,10,11,47,34,166
2024-03-09 19:30:00,4,2,5,52,11,11,46,25,156
2024-03-09 19:40:00,2,1,19,50,11,11,44,28,166
2024-03-09 19:50:00,2,1,16,44,16,12,45,23,159
2024-03-09 20:00:00,10,7,12,57,6,5,53,29,179
2024-03-09 20:10:00,5,5,19,45,10,12,46,24,166
2024-03-09 20:20:00,11,7,14,42,14,9,41,25,163
2024-03-09 20:30:00,3,1,14,54,3,5,42,27,149
2024-03-09 20:40:00,4,1,4,49,6,7,35,22,128
2024-03-09 20:50:00,3,1,11,32,10,11,35,23,126
2024-03-09 21:00:00,6,2,8,31,4,4,40,33,128
2024-03-09 21:10:00,10,5,10,31,4,5,42,30,137
2024-03-09 21:20:00,5,1,4,29,4,4,21,13,81
2024-03-09 21:30:00,5,4,5,35,3,4,39,29,124
2024-03-09 21:40:00,3,1,3,52,9,11,42,33,154
2024-03-09 21:50:00,8,3,6,29,6,4,39,25,120
2024-03-09 22:00:00,4,3,4,40,10,7,32,26,126
2024-03-09 22:10:00,3,3,11,27,6,5,39,27,121
2024-03-09 22:20:00,5,2,8,36,7,6,28,26,118
2024-03-09 22:30:00,6,1,1,29,4,5,38,26,110
2024-03-09 22:40:00,1,1,5,23,4,5,46,24,109
2024-03-09 22:50:00,3,3,3,32,8,6,52,34,141
2024-03-09 23:00:00,1,1,3,21,2,1,58,26,113
2024-03-09 23:10:00,5,4,2,32,3,3,45,25,119
2024-03-09 23:20:00,1,0,2,24,4,5,31,22,89
2024-03-09 23:30:00,6,1,2,19,1,0,27,26,82
2024-03-09 23:40:00,0,0,4,22,1,1,30,29,87
2024-03-09 23:50:00,2,1,3,22,4,3,37,26,98
2024-03-10 00:00:00,5,4,3,22,4,3,17,20,78
2024-03-10 00:10:00,0,0,2,13,3,0,23,18,59
2024-03-10 00:20:00,4,0,0,16,5,4,22,19,70
2024-03-10 00:30:00,5,1,1,17,1,1,18,24,68
2024-03-10 00:40:00,1,1,0,14,2,0,17,17,52
2024-03-10 00:50:00,1,0,1,15,1,1,17,17,53
2024-03-10 01:00:00,2,2,3,19,3,1,22,24,76
2024-03-10 01:10:00,0,0,0,6,4,4,12,12,38
2024-03-10 01:20:00,1,0,0,11,6,5,9,10,42
2024-03-10 01:30:00,2,2,2,6,1,0,12,12,37
2024-03-10 01:40:00,2,2,1,7,1,1,13,11,38
2024-03-10 01:50:00,0,0,0,5,2,3,17,21,48
2024-03-10 02:00:00,4,1,1,12,2,2,6,5,33
2024-03-10 02:10:00,1,0,2,7,1,2,16,18,47
2024-03-10 02:20:00,4,0,0,6,0,0,9,7,26
2024-03-10 02:30:00,0,0,0,12,5,5,12,13,47
2024-03-10 02:40:00,0,0,0,4,4,1,7,7,23
2024-03-10 02:50:00,0,0,1,8,1,0,11,10,31
2024-03-10 03:00:00,0,0,0,8,0,0,5,5,18
2024-03-10 03:10:00,1,0,2,10,1,0,6,8,28
2024-03-10 03:20:00,0,0,1,8,2,1,8,9,29
2024-03-10 03:30:00,0,0,1,5,0,0,4,5,15
2024-03-10 03:40:00,0,0,1,7,1,1,11,16,37
2024-03-10 03:50:00,0,0,0,9,0,0,9,11,29
2024-03-10 04:00:00,1,0,1,9,1,2,7,7,28
2024-03-10 04:10:00,0,0,2,8,0,0,6,6,22
2024-03-10 04:20:00,0,0,2,8,1,0,6,6,23
2024-03-10 04:30:00,0,0,1,5,1,1,7,7,22
2024-03-10 04:40:00,0,0,1,5,1,1,3,4,15
2024-03-10 04:50:00,0,0,0,8,2,1,6,5,22
2024-03-10 05:00:00,0,0,1,8,2,1,2,3,17
2024-03-10 05:10:00,2,0,1,16,0,0,4,4,27
2024-03-10 05:20:00,0,0,1,9,3,2,5,6,26
2024-03-10 05:30:00,1,1,3,14,1,0,4,4,28
2024-03-10 05:40:00,0,0,3,13,3,3,10,17,49
2024-03-10 05:50:00,2,1,0,9,2,0,3,3,20
2024-03-10 06:00:00,1,0,1,8,1,1,6,8,26
2024-03-10 06:10:00,3,0,6,10,1,1,9,7,37
2024-03-10 06:20:00,1,0,1,14,0,0,5,9,30
2024-03-10 06:30:00,1,0,0,9,3,3,10,14,40
2024-03-10 06:40:00,0,0,3,4,0,2,9,10,28
2024-03-10 06:50:00,1,0,0,4,1,2,5,5,18
2024-03-10 07:00:00,0,0,4,286,0,0,7,7,304
2024-03-10 07:10:00,0,0,2,8,1,1,4,4,20
2024-03-10 07:20:00,1,1,4,9,0,0,8,8,31
2024-03-10 07:30:00,1,0,2,13,2,2,4,4,28
2024-03-10 07:40:00,2,1,1,10,3,1,9,9,36
2024-03-10 07:50:00,2,1,1,6,5,3,8,7,33
2024-03-10 08:00:00,0,0,3,7,2,3,9,9,33
2024-03-10 08:10:00,0,1,7,19,1,1,14,12,55
2024-03-10 08:20:00,5,2,6,17,3,5,0,0,38
2024-03-10 08:30:00,1,0,8,26,3,1,8,8,55
2024-03-10 08:40:00,1,0,3,11,8,5,8,8,44
2024-03-10 08:50:00,2,1,6,23,6,15,13,13,79
2024-03-10 09:00:00,3,1,7,34,8,5,7,7,72
2024-03-10 09:10:00,7,4,11,26,7,5,12,12,84
2024-03-10 09:20:00,3,2,9,34,13,8,19,19,107
2024-03-10 09:30:00,5,3,8,17,7,6,13,10,69
2024-03-10 09:40:00,6,2,14,41,9,4,15,17,108
2024-03-10 09:50:00,4,3,19,35,14,10,15,15,115
2024-03-10 10:00:00,5,1,12,76,13,12,15,13,147
2024-03-10 10:10:00,6,2,16,76,8,7,23,19,157
2024-03-10 10:20:00,7,2,13,58,7,8,25,17,137
2024-03-10 10:30:00,6,1,20,46,13,11,18,16,131
2024-03-10 10:40:00,5,2,16,64,9,7,27,17,147
2024-03-10 10:50:00,6,5,21,36,9,7,32,25,141
2024-03-10 11:00:00,2,2,18,44,16,12,23,19,136
2024-03-10 11:10:00,6,4,22,35,12,5,20,16,120
2024-03-10 11:20:00,12,4,24,46,12,9,32,25,164
2024-03-10 11:30:00,17,7,14,30,9,7,29,20,133
2024-03-10 11:40:00,7,2,19,44,11,9,46,23,161
2024-03-10 11:50:00,3,4,27,33,10,9,37,25,148
2024-03-10 12:00:00,10,7,23,47,15,11,39,27,179
2024-03-10 12:10:00,11,7,17,57,16,11,40,24,183
2024-03-10 12:20:00,6,3,25,43,20,16,40,24,177
2024-03-10 12:30:00,9,3,20,40,13,10,41,27,163
2024-03-10 12:40:00,6,2,30,55,27,19,45,27,211
2024-03-10 12:50:00,11,6,28,46,13,6,41,30,181
2024-03-10 13:00:00,9,6,14,42,11,5,53,34,174
2024-03-10 13:10:00,10,3,27,34,7,4,37,26,148
2024-03-10 13:20:00,9,3,23,58,13,10,52,32,200
2024-03-10 13:30:00,9,6,19,62,14,14,54,34,212
2024-03-10 13:40:00,7,2,30,57,11,8,53,41,209
2024-03-10 13:50:00,23,10,32,57,20,11,54,34,241
2024-03-10 14:00:00,9,5,23,47,16,12,52,29,193
2024-03-10 14:10:00,15,9,22,40,9,9,55,33,192
2024-03-10 14:20:00,13,6,29,57,18,12,54,33,222
2024-03-10 14:30:00,7,5,25,54,21,16,63,29,220
2024-03-10 14:40:00,13,10,28,61,14,14,48,31,219
2024-03-10 14:50:00,13,11,20,43,21,11,60,23,202
2024-03-10 15:00:00,10,2,25,45,16,12,45,27,182
2024-03-10 15:10:00,9,7,17,49,23,16,46,26,193
2024-03-10 15:20:00,6,4,27,40,16,10,41,28,172
2024-03-10 15:30:00,11,9,20,33,15,14,54,26,182
2024-03-10 15:40:00,12,9,28,56,21,13,50,26,215
2024-03-10 15:50:00,11,6,17,47,19,15,49,30,194
2024-03-10 16:00:00,7,4,21,50,20,9,55,40,206
2024-03-10 16:10:00,7,4,18,53,19,13,44,22,180
2024-03-10 16:20:00,6,3,16,51,21,12,39,30,178
2024-03-10 16:30:00,8,5,26,54,23,15,45,25,201
2024-03-10 16:40:00,6,3,26,55,4,5,38,28,165
2024-03-10 16:50:00,9,2,28,52,10,8,52,35,196
2024-03-10 17:00:00,7,4,28,45,11,6,58,26,185
2024-03-10 17:10:00,5,7,36,73,10,11,55,36,233
2024-03-10 17:20:00,7,5,20,73,19,17,47,33,221
2024-03-10 17:30:00,12,8,32,57,18,15,57,27,226
2024-03-10 17:40:00,10,5,24,46,19,11,43,22,180
2024-03-10 17:50:00,9,4,23,42,15,13,40,27,173
2024-03-10 18:00:00,14,9,28,42,16,11,46,28,194
2024-03-10 18:10:00,8,4,19,48,18,16,50,33,196
2024-03-10 18:20:00,11,5,15,39,13,8,41,19,151
2024-03-10 18:30:00,6,4,23,41,16,8,47,26,171
2024-03-10 18:40:00,6,4,16,41,6,4,50,26,153
2024-03-10 18:50:00,6,7,12,43,11,11,37,37,164
2024-03-10 19:00:00,4,4,11,40,14,10,41,30,154
2024-03-10 19:10:00,7,4,21,48,14,13,27,22,156
2024-03-10 19:20:00,7,5,18,43,12,6,35,17,143
2024-03-10 19:30:00,5,2,12,38,8,12,35,28,140
2024-03-10 19:40:00,1,0,11,36,9,6,38,25,126
2024-03-10 19:50:00,3,2,19,36,9,5,52,27,153
2024-03-10 20:00:00,5,1,13,30,9,7,28,27,120
2024-03-10 20:10:00,6,3,4,25,7,5,39,26,115
2024-03-10 20:20:00,5,3,14,37,8,8,43,27,145
2024-03-10 20:30:00,1,1,6,24,8,9,33,28,110
2024-03-10 20:40:00,3,0,7,32,7,3,33,25,110
2024-03-10 20:50:00,5,1,3,19,4,6,35,22,95
2024-03-10 21:00:00,4,5,1,24,4,4,21,21,84
2024-03-10 21:10:00,3,1,2,19,4,4,23,24,80
2024-03-10 21:20:00,3,2,7,19,5,7,51,30,124
2024-03-10 21:30:00,2,0,6,18,4,2,40,29,101
2024-03-10 21:40:00,1,1,2,25,3,2,31,35,100
2024-03-10 21:50:00,1,1,3,19,3,4,37,20,88
2024-03-10 22:00:00,3,1,6,24,3,2,25,22,86
2024-03-10 22:10:00,1,0,4,18,1,1,26,19,70
2024-03-10 22:20:00,0,0,4,12,2,1,12,14,45
2024-03-10 22:30:00,1,1,0,13,8,7,18,9,57
2024-03-10 22:40:00,1,1,1,9,1,1,8,8,30
2024-03-10 22:50:00,0,0,4,10,4,4,17,12,51
2024-03-10 23:00:00,4,3,2,11,1,1,13,10,45
2024-03-10 23:10:00,1,1,0,8,3,3,7,6,29
2024-03-10 23:20:00,2,1,1,9,2,2,6,6,29
2024-03-10 23:30:00,0,0,1,6,1,1,11,8,28
2024-03-10 23:40:00,0,0,3,11,3,3,6,5,31
2024-03-10 23:50:00,0,0,2,11,0,0,16,10,39
2024-03-11 00:00:00,0,0,0,6,1,2,12,11,32
2024-03-11 00:10:00,0,0,0,6,0,0,8,7,21
2024-03-11 00:20:00,1,0,1,4,1,1,7,11,26
2024-03-11 00:30:00,0,0,0,4,2,2,1,1,10
2024-03-11 00:40:00,0,0,1,4,0,0,3,3,11
2024-03-11 00:50:00,0,0,0,1,1,1,3,2,8
2024-03-11 01:00:00,0,0,0,1,0,0,2,2,5
2024-03-11 01:10:00,0,0,0,1,0,0,3,4,8
2024-03-11 01:20:00,0,0,0,1,0,0,4,3,8
2024-03-11 01:30:00,0,0,0,1,2,2,1,1,7
2024-03-11 01:40:00,0,0,0,4,0,0,4,3,11
2024-03-11 01:50:00,1,1,1,4,0,0,1,1,9
2024-03-11 02:00:00,0,0,0,3,0,0,3,4,10
2024-03-11 02:10:00,0,0,0,2,0,0,1,1,4
2024-03-11 02:20:00,0,0,1,2,0,0,0,0,3
2024-03-11 02:30:00,0,0,0,4,0,0,0,0,4
2024-03-11 02:40:00,0,0,0,7,1,1,3,3,15
2024-03-11 02:50:00,0,0,1,2,1,1,5,4,14
2024-03-11 03:00:00,0,0,0,2,0,0,2,2,6
2024-03-11 03:10:00,0,0,0,4,1,1,3,2,11
2024-03-11 03:20:00,0,0,0,3,0,0,4,5,12
2024-03-11 03:30:00,0,0,0,3,2,1,0,0,6
2024-03-11 03:40:00,0,0,1,7,0,0,1,2,11
2024-03-11 03:50:00,0,0,1,2,0,0,2,2,7
2024-03-11 04:00:00,0,0,2,13,0,0,3,4,22
2024-03-11 04:10:00,0,0,1,6,1,2,2,3,15
2024-03-11 04:20:00,0,0,2,16,1,1,0,0,20
2024-03-11 04:30:00,0,0,2,6,0,0,4,5,17
2024-03-11 04:40:00,0,0,1,10,1,1,1,1,15
2024-03-11 04:50:00,0,0,3,18,2,2,3,4,32
2024-03-11 05:00:00,0,0,4,30,4,5,5,7,55
2024-03-11 05:10:00,0,0,5,30,0,0,5,6,46
2024-03-11 05:20:00,1,1,11,35,9,7,10,8,82
2024-03-11 05:30:00,0,0,25,48,2,2,4,4,85
2024-03-11 05:40:00,2,1,41,61,1,1,8,5,120
2024-03-11 05:50:00,6,4,21,73,12,8,5,4,133
2024-03-11 06:00:00,2,2,12,55,5,3,13,8,100
2024-03-11 06:10:00,7,5,24,77,6,4,20,15,158
2024-03-11 06:20:00,4,4,29,64,2,2,15,15,135
2024-03-11 06:30:00,1,1,17,59,14,11,21,11,135
2024-03-11 06:40:00,10,8,16,76,8,7,30,20,175
2024-03-11 06:50:00,5,5,29,81,11,7,28,15,181
2024-03-11 07:00:00,7,5,9,80,22,10,38,17,188
2024-03-11 07:10:00,7,5,37,75,16,11,37,26,214
2024-03-11 07:20:00,7,4,28,88,17,10,42,24,220
2024-03-11 07:30:00,6,4,28,87,18,10,29,18,200
2024-03-11 07:40:00,13,10,43,70,14,9,47,24,230
2024-03-11 07:50:00,19,10,25,91,28,8,46,28,255
2024-03-11 08:00:00,17,7,44,72,26,9,43,30,248
2024-03-11 08:10:00,12,6,20,100,22,8,30,22,220
2024-03-11 08:20:00,15,8,29,86,22,17,48,31,256
2024-03-11 08:30:00,24,6,30,92,26,9,45,28,260
2024-03-11 08:40:00,24,6,32,82,23,12,42,23,244
2024-03-11 08:50:00,11,7,18,79,18,8,40,15,196
2024-03-11 09:00:00,9,8,20,80,17,8,52,20,214
2024-03-11 09:10:00,9,6,22,63,21,13,44,26,204
2024-03-11 09:20:00,12,9,20,72,15,12,37,23,200
2024-03-11 09:30:00,8,7,22,69,22,12,39,24,203
2024-03-11 09:40:00,9,6,36,69,14,13,38,22,207
2024-03-11 09:50:00,13,9,28,75,13,8,59,37,242
2024-03-11 10:00:00,11,8,38,52,16,10,55,31,221
2024-03-11 10:10:00,7,3,21,68,10,8,36,27,180
2024-03-11 10:20:00,7,4,25,51,9,11,50,35,192
2024-03-11 10:30:00,11,6,31,54,11,9,54,33,209
2024-03-11 10:40:00,12,7,18,57,21,11,50,27,203
2024-03-11 10:50:00,11,4,27,57,11,11,50,36,207
2024-03-11 11:00:00,16,10,25,44,14,10,44,33,196
2024-03-11 11:10:00,15,6,23,95,11,12,63,42,267
2024-03-11 11:20:00,22,8,23,55,14,19,57,30,228
2024-03-11 11:30:00,17,8,29,58,18,12,55,32,229
2024-03-11 11:40:00,8,4,25,51,16,10,55,42,211
2024-03-11 11:50:00,19,8,21,68,13,16,64,30,239
2024-03-11 12:00:00,11,8,11,48,18,9,47,33,185
2024-03-11 12:10:00,16,6,27,84,11,8,57,36,245
2024-03-11 12:20:00,22,8,33,64,16,8,59,30,240
2024-03-11 12:30:00,12,7,21,26,13,19,68,29,195
2024-03-11 12:40:00,16,2,32,43,8,11,73,23,208
2024-03-11 12:50:00,15,8,32,37,8,8,61,38,207
2024-03-11 13:00:00,13,9,32,62,17,11,70,28,242
2024-03-11 13:10:00,14,11,37,54,10,13,76,25,240
2024-03-11 13:20:00,8,7,36,44,13,17,84,36,245
2024-03-11 13:30:00,19,12,32,66,10,12,67,26,244
2024-03-11 13:40:00,18,7,18,39,13,6,68,29,198
2024-03-11 13:50:00,19,9,28,37,17,8,58,31,207
2024-03-11 14:00:00,12,5,24,44,18,8,87,29,227
2024-03-11 14:10:00,22,8,30,54,19,9,88,43,273
2024-03-11 14:20:00,15,6,26,32,16,11,101,31,238
2024-03-11 14:30:00,15,9,29,30,13,8,94,29,227
2024-03-11 14:40:00,11,3,21,57,17,9,89,24,231
2024-03-11 14:50:00,15,10,26,42,13,11,95,31,243
2024-03-11 15:00:00,14,7,19,78,16,7,102,35,278
2024-03-11 15:10:00,29,11,20,46,21,12,102,38,279
2024-03-11 15:20:00,24,8,9,69,12,8,133,37,300
2024-03-11 15:30:00,15,7,7,48,16,12,115,27,247
2024-03-11 15:40:00,20,10,14,64,18,9,128,19,282
2024-03-11 15:50:00,26,9,7,44,13,7,118,23,247
2024-03-11 16:00:00,19,7,9,62,15,11,120,33,276
2024-03-11 16:10:00,24,8,4,33,19,15,118,24,245
2024-03-11 16:20:00,15,7,8,0,17,11,103,23,184
2024-03-11 16:30:00,27,16,17,16,16,9,124,18,243
2024-03-11 16:40:00,14,9,12,44,14,9,110,46,258
2024-03-11 16:50:00,18,10,13,55,11,9,110,27,253
2024-03-11 17:00:00,25,10,10,59,15,7,99,18,243
2024-03-11 17:10:00,18,12,7,52,18,27,126,28,288
2024-03-11 17:20:00,17,9,8,56,17,12,112,20,251
2024-03-11 17:30:00,18,11,17,59,25,13,107,41,291
2024-03-11 17:40:00,11,5,10,47,18,20,69,21,201
2024-03-11 17:50:00,13,6,9,72,23,10,99,33,265
2024-03-11 18:00:00,9,4,6,55,17,14,86,24,215
2024-03-11 18:10:00,16,7,4,40,18,16,65,25,191
2024-03-11 18:20:00,9,5,3,56,9,6,75,30,193
2024-03-11 18:30:00,11,10,1,42,15,11,66,27,183
2024-03-11 18:40:00,14,5,8,40,10,12,63,25,177
2024-03-11 18:50:00,7,4,9,31,15,6,66,27,165
2024-03-11 19:00:00,11,5,7,50,14,11,56,32,186
2024-03-11 19:10:00,15,8,8,36,9,3,53,28,160
2024-03-11 19:20:00,5,3,5,42,18,6,43,22,144
2024-03-11 19:30:00,14,7,1,49,10,9,34,17,141
2024-03-11 19:40:00,8,6,4,35,13,6,41,21,134
2024-03-11 19:50:00,8,6,3,31,8,5,36,30,127
2024-03-11 20:00:00,5,4,8,40,4,5,39,32,137
2024-03-11 20:10:00,11,9,8,25,15,9,37,21,135
2024-03-11 20:20:00,4,2,4,29,8,6,38,25,116
2024-03-11 20:30:00,5,5,12,36,6,3,32,23,122
2024-03-11 20:40:00,7,5,11,26,6,6,25,19,105
2024-03-11 20:50:00,9,4,4,26,2,1,26,21,93
2024-03-11 21:00:00,7,3,7,25,8,5,27,24,106
2024-03-11 21:10:00,3,2,3,19,4,2,29,21,83
2024-03-11 21:20:00,12,7,5,33,5,7,24,21,114
2024-03-11 21:30:00,6,3,3,21,7,4,29,20,93
2024-03-11 21:40:00,3,5,11,20,5,3,30,21,98
2024-03-11 21:50:00,5,3,0,14,5,5,22,20,74
2024-03-11 22:00:00,3,3,4,20,6,7,32,29,104
2024-03-11 22:10:00,3,2,1,11,3,3,28,28,79
2024-03-11 22:20:00,5,2,6,18,7,5,21,15,79
2024-03-11 22:30:00,1,1,4,17,4,2,19,21,69
2024-03-11 22:40:00,2,2,1,2,2,1,11,11,32
2024-03-11 22:50:00,5,2,3,16,3,4,16,9,58
2024-03-11 23:00:00,0,0,1,7,6,4,14,13,45
2024-03-11 23:10:00,2,1,1,7,3,12,12,9,47
2024-03-11 23:20:00,1,0,2,9,3,0,9,13,37
2024-03-11 23:30:00,4,2,2,4,0,1,4,7,24
2024-03-11 23:40:00,0,0,1,11,3,2,9,10,36
2024-03-11 23:50:00,0,0,2,5,3,6,14,19,49
2024-03-12 00:00:00,0,0,4,13,4,3,6,6,36
2024-03-12 00:10:00,0,0,1,6,1,2,7,9,26
2024-03-12 00:20:00,0,0,1,8,2,1,8,7,27
2024-03-12 00:30:00,0,0,0,2,0,0,3,3,8
2024-03-12 00:40:00,0,0,1,2,2,11,1,1,18
2024-03-12 00:50:00,1,1,0,1,1,2,4,3,13
2024-03-12 01:00:00,0,0,0,2,0,0,6,6,14
2024-03-12 01:10:00,0,0,0,2,1,2,1,2,8
2024-03-12 01:20:00,0,0,0,0,1,1,1,1,4
2024-03-12 01:30:00,0,0,1,3,1,1,1,2,9
2024-03-12 01:40:00,1,1,0,4,0,0,3,3,12
2024-03-12 01:50:00,0,0,0,1,0,0,6,4,11
2024-03-12 02:00:00,0,0,0,2,0,0,2,2,6
2024-03-12 02:10:00,0,0,0,6,0,0,0,0,6
2024-03-12 02:20:00,0,0,0,3,0,0,0,0,3
2024-03-12 02:30:00,0,0,0,1,0,0,2,2,5
2024-03-12 02:40:00,0,0,0,5,2,3,1,2,13
2024-03-12 02:50:00,0,0,0,2,1,1,2,2,8
2024-03-12 03:00:00,1,0,0,2,1,1,1,2,8
2024-03-12 03:10:00,0,0,0,1,0,0,3,4,8
2024-03-12 03:20:00,0,0,0,2,1,1,1,1,6
2024-03-12 03:30:00,0,0,0,3,0,0,2,2,7
2024-03-12 03:40:00,0,0,0,3,1,2,1,1,8
2024-03-12 03:50:00,0,0,0,2,0,0,4,5,11
2024-03-12 04:00:00,0,0,1,8,0,0,1,1,11
2024-03-12 04:10:00,0,0,2,9,0,0,1,1,13
2024-03-12 04:20:00,0,0,0,9,5,5,0,0,19
2024-03-12 04:30:00,0,0,0,6,1,2,4,3,16
2024-03-12 04:40:00,0,0,2,11,3,4,1,2,23
2024-03-12 04:50:00,0,0,2,11,3,4,2,2,24
2024-03-12 05:00:00,3,1,9,22,0,0,4,4,43
2024-03-12 05:10:00,0,0,9,30,1,1,8,9,58
2024-03-12 05:20:00,0,0,14,47,5,5,8,11,90
2024-03-12 05:30:00,0,0,19,50,2,1,7,5,84
2024-03-12 05:40:00,0,0,25,65,4,3,6,9,112
2024-03-12 05:50:00,2,1,35,75,11,7,10,11,152
2024-03-12 06:00:00,1,0,8,48,7,8,12,8,92
2024-03-12 06:10:00,6,1,19,68,8,6,20,13,141
2024-03-12 06:20:00,4,2,20,70,11,5,26,20,158
2024-03-12 06:30:00,3,0,9,73,7,6,31,26,155
2024-03-12 06:40:00,4,3,12,74,12,7,33,23,168
2024-03-12 06:50:00,4,2,15,95,12,8,40,26,202
2024-03-12 07:00:00,8,6,12,76,17,7,33,25,184
2024-03-12 07:10:00,4,3,19,74,16,13,29,22,180
2024-03-12 07:20:00,17,6,35,105,13,11,41,19,247
2024-03-12 07:30:00,9,7,32,125,23,12,36,24,268
2024-03-12 07:40:00,16,8,29,90,24,8,33,17,225
2024-03-12 07:50:00,12,3,39,83,25,10,51,30,253
2024-03-12 08:00:00,20,6,34,94,27,9,49,34,273
2024-03-12 08:10:00,11,5,28,81,27,11,37,28,228
2024-03-12 08:20:00,12,7,37,96,22,10,51,24,259
2024-03-12 08:30:00,8,6,25,94,17,10,47,28,235
2024-03-12 08:40:00,19,10,30,85,27,4,51,29,255
2024-03-12 08:50:00,19,11,27,91,27,13,57,27,272
2024-03-12 09:00:00,18,10,26,99,21,11,39,22,246
2024-03-12 09:10:00,9,7,36,73,23,12,51,27,238
2024-03-12 09:20:00,16,6,23,74,13,8,61,29,230
2024-03-12 09:30:00,11,5,16,41,9,7,32,14,135
2024-03-12 09:40:00,8,8,31,41,15,8,39,27,177
2024-03-12 09:50:00,14,4,25,62,10,7,43,26,191
2024-03-12 10:00:00,12,7,31,51,13,6,45,28,193
2024-03-12 10:10:00,9,8,21,61,10,7,53,32,201
2024-03-12 10:20:00,18,9,26,51,19,13,35,27,198
2024-03-12 10:30:00,16,10,24,51,17,11,47,23,199
2024-03-12 10:40:00,13,4,38,63,14,11,64,36,243
2024-03-12 10:50:00,10,5,22,49,17,8,40,35,186
2024-03-12 11:00:00,15,8,26,46,17,12,60,40,224
2024-03-12 11:10:00,14,4,14,87,15,7,75,36,252
2024-03-12 11:20:00,7,4,23,73,13,9,58,35,222
2024-03-12 11:30:00,15,10,35,45,9,5,57,36,212
2024-03-12 11:40:00,18,7,20,63,13,11,46,32,210
2024-03-12 11:50:00,13,6,30,63,13,9,66,35,235
2024-03-12 12:00:00,10,5,25,53,17,10,63,35,218
2024-03-12 12:10:00,13,6,21,52,15,8,72,31,218
2024-03-12 12:20:00,10,8,32,51,19,12,70,35,237
2024-03-12 12:30:00,13,11,22,42,7,8,60,26,189
2024-03-12 12:40:00,19,13,26,53,19,11,82,26,249
2024-03-12 12:50:00,18,8,29,54,17,10,72,35,243
2024-03-12 13:00:00,11,7,29,51,18,9,68,43,236
2024-03-12 13:10:00,13,4,33,51,26,13,86,35,261
2024-03-12 13:20:00,13,8,21,52,14,9,99,35,251
2024-03-12 13:30:00,11,6,25,41,9,10,62,33,197
2024-03-12 13:40:00,14,8,74,49,28,16,64,32,285
2024-03-12 13:50:00,27,8,33,41,20,10,77,37,253
2024-03-12 14:00:00,16,12,14,41,12,7,72,26,200
2024-03-12 14:10:00,21,8,26,33,12,13,83,29,225
2024-03-12 14:20:00,34,7,30,44,15,13,106,37,286
2024-03-12 14:30:00,20,4,22,44,21,15,104,34,264
2024-03-12 14:40:00,14,11,24,44,17,11,96,33,250
2024-03-12 14:50:00,27,14,33,47,15,5,105,27,273
2024-03-12 15:00:00,23,8,17,52,14,17,93,39,263
2024-03-12 15:10:00,18,9,17,59,15,8,103,32,261
2024-03-12 15:20:00,16,5,13,61,21,12,103,41,272
2024-03-12 15:30:00,24,11,9,60,15,6,129,29,283
2024-03-12 15:40:00,16,7,18,49,14,5,117,27,253
2024-03-12 15:50:00,16,8,9,59,10,7,126,20,255
2024-03-12 16:00:00,36,9,7,51,13,10,104,22,252
2024-03-12 16:10:00,19,7,10,55,21,8,100,23,243
2024-03-12 16:20:00,16,8,11,55,13,6,131,26,266
2024-03-12 16:30:00,17,9,17,64,11,5,131,13,267
2024-03-12 16:40:00,20,12,13,62,13,10,79,25,234
2024-03-12 16:50:00,19,9,14,46,12,9,142,25,276
2024-03-12 17:00:00,16,9,7,46,12,11,109,11,221
2024-03-12 17:10:00,18,8,9,61,12,9,133,6,256
2024-03-12 17:20:00,19,11,21,60,14,7,122,12,266
2024-03-12 17:30:00,10,4,12,69,13,8,97,25,238
2024-03-12 17:40:00,16,9,15,50,15,13,113,21,252
2024-03-12 17:50:00,12,6,6,55,22,13,109,34,257
2024-03-12 18:00:00,18,10,17,45,21,11,103,34,259
2024-03-12 18:10:00,8,3,4,52,21,14,111,31,244
2024-03-12 18:20:00,15,10,7,48,10,8,89,16,203
2024-03-12 18:30:00,12,4,9,57,13,9,91,21,216
2024-03-12 18:40:00,5,3,10,34,12,13,66,37,180
2024-03-12 18:50:00,17,10,5,53,18,9,59,28,199
2024-03-12 19:00:00,14,5,4,42,21,7,57,30,180
2024-03-12 19:10:00,13,6,4,46,17,5,52,27,170
2024-03-12 19:20:00,4,3,10,48,17,11,49,25,167
2024-03-12 19:30:00,7,4,3,30,9,7,42,25,127
2024-03-12 19:40:00,4,3,4,33,18,9,41,20,132
2024-03-12 19:50:00,2,1,6,37,14,7,52,24,143
2024-03-12 20:00:00,8,6,6,40,9,5,39,29,142
2024-03-12 20:10:00,3,1,5,27,14,10,47,45,152
2024-03-12 20:20:00,8,5,5,30,12,10,49,20,139
2024-03-12 20:30:00,11,8,7,33,8,8,32,18,125
2024-03-12 20:40:00,12,8,11,38,12,10,31,21,143
2024-03-12 20:50:00,12,8,10,26,6,6,30,12,110
2024-03-12 21:00:00,6,3,4,22,10,7,44,25,121
2024-03-12 21:10:00,2,2,7,30,5,2,42,16,106
2024-03-12 21:20:00,7,4,1,15,7,6,34,15,89
2024-03-12 21:30:00,7,4,7,22,7,2,35,18,102
2024-03-12 21:40:00,5,4,0,22,8,6,24,18,87
2024-03-12 21:50:00,6,4,6,22,7,7,28,16,96
2024-03-12 22:00:00,3,3,6,15,7,5,25,16,80
2024-03-12 22:10:00,5,4,3,17,11,7,29,14,90
2024-03-12 22:20:00,3,1,7,20,3,5,18,11,68
2024-03-12 22:30:00,1,1,2,10,3,2,10,8,37
2024-03-12 22:40:00,7,4,0,7,4,3,20,10,55
2024-03-12 22:50:00,2,1,3,20,0,0,20,16,62
2024-03-12 23:00:00,2,1,3,7,5,2,14,13,47
2024-03-12 23:10:00,0,0,2,15,2,1,17,10,47
2024-03-12 23:20:00,0,0,3,14,0,2,14,12,45
2024-03-12 23:30:00,2,1,1,6,5,3,11,8,37
2024-03-12 23:40:00,3,1,0,10,3,3,11,8,39
2024-03-12 23:50:00,2,1,2,13,4,3,7,7,39
2024-03-13 00:00:00,1,0,4,8,2,3,10,9,37
2024-03-13 00:10:00,0,0,0,3,2,2,5,6,18
2024-03-13 00:20:00,0,0,2,4,2,2,4,6,20
2024-03-13 00:30:00,0,0,0,12,0,0,4,4,20
2024-03-13 00:40:00,1,0,1,1,0,0,3,3,9
2024-03-13 00:50:00,0,0,0,3,0,0,5,5,13
2024-03-13 01:00:00,0,0,0,2,0,0,2,2,6
2024-03-13 01:10:00,0,0,0,4,1,1,4,4,14
2024-03-13 01:20:00,0,0,1,2,1,1,2,2,9
2024-03-13 01:30:00,1,0,1,4,1,2,3,3,15
2024-03-13 01:40:00,2,2,3,7,1,0,4,4,23
2024-03-13 01:50:00,1,0,1,5,0,0,3,3,13
2024-03-13 02:00:00,0,0,1,4,0,0,2,2,9
2024-03-13 02:10:00,0,0,0,4,1,1,1,1,8
2024-03-13 02:20:00,0,0,0,2,0,0,1,1,4
2024-03-13 02:30:00,0,0,1,1,2,1,4,6,15
2024-03-13 02:40:00,0,0,1,3,2,2,1,1,10
2024-03-13 02:50:00,0,0,1,2,0,0,2,2,7
2024-03-13 03:00:00,0,0,0,3,0,0,0,0,3
2024-03-13 03:10:00,0,0,0,3,1,1,2,2,9
2024-03-13 03:20:00,0,0,0,1,1,1,2,2,7
2024-03-13 03:30:00,0,0,1,4,1,1,1,1,9
2024-03-13 03:40:00,0,0,1,3,0,0,1,1,6
2024-03-13 03:50:00,0,0,1,7,0,0,3,3,14
2024-03-13 04:00:00,0,0,5,12,0,0,3,4,24
2024-03-13 04:10:00,0,0,0,5,3,2,0,0,10
2024-03-13 04:20:00,0,0,1,15,0,0,3,3,22
2024-03-13 04:30:00,0,0,0,4,2,2,1,1,10
2024-03-13 04:40:00,2,1,2,15,3,3,4,3,33
2024-03-13 04:50:00,0,0,1,21,2,2,3,3,32
2024-03-13 05:00:00,0,0,7,19,0,0,4,4,34
2024-03-13 05:10:00,1,1,10,25,0,1,6,6,50
2024-03-13 05:20:00,0,0,16,44,2,2,8,10,82
2024-03-13 05:30:00,1,0,23,54,3,3,6,3,93
2024-03-13 05:40:00,3,3,28,57,5,2,5,6,109
2024-03-13 05:50:00,3,1,27,56,5,3,10,9,114
2024-03-13 06:00:00,0,0,12,64,2,1,9,10,98
2024-03-13 06:10:00,3,2,16,79,8,10,22,15,155
2024-03-13 06:20:00,5,4,18,75,10,12,19,14,157
2024-03-13 06:30:00,3,1,17,68,9,5,21,14,138
2024-03-13 06:40:00,5,5,16,73,10,9,29,21,168
2024-03-13 06:50:00,6,5,11,89,13,8,37,18,187
2024-03-13 07:00:00,4,4,25,91,14,10,38,22,208
2024-03-13 07:10:00,3,3,35,103,13,8,34,21,220
2024-03-13 07:20:00,9,5,27,104,23,12,44,24,248
2024-03-13 07:30:00,11,5,20,94,19,9,35,23,216
2024-03-13 07:40:00,15,8,31,106,29,13,40,23,265
2024-03-13 07:50:00,9,4,33,81,36,3,43,25,234
2024-03-13 08:00:00,15,6,27,73,31,2,44,31,229
2024-03-13 08:10:00,15,8,20,73,35,6,45,22,224
2024-03-13 08:20:00,12,5,31,88,22,11,35,22,226
2024-03-13 08:30:00,13,9,22,94,29,11,50,24,252
2024-03-13 08:40:00,18,12,19,90,24,10,43,29,245
2024-03-13 08:50:00,11,4,22,73,23,11,45,19,208
2024-03-13 09:00:00,17,7,19,98,23,11,51,25,251
2024-03-13 09:10:00,9,4,12,99,15,9,37,24,209
2024-03-13 09:20:00,12,6,12,67,9,7,60,27,200
2024-03-13 09:30:00,3,2,28,81,14,7,37,33,205
2024-03-13 09:40:00,15,13,31,75,15,10,49,30,238
2024-03-13 09:50:00,23,10,30,66,17,14,49,29,238
2024-03-13 10:00:00,11,8,32,61,16,18,45,24,215
2024-03-13 10:10:00,10,5,28,45,10,9,45,25,177
2024-03-13 10:20:00,20,10,35,44,18,13,48,31,219
2024-03-13 10:30:00,14,7,19,56,15,9,58,29,207
2024-03-13 10:40:00,11,6,26,42,29,12,44,30,200
2024-03-13 10:50:00,13,7,18,68,13,7,42,29,197
2024-03-13 11:00:00,14,9,24,41,23,47,65,45,268
2024-03-13 11:10:00,16,10,30,44,16,9,56,27,208
2024-03-13 11:20:00,11,6,22,53,143,14,49,29,327
2024-03-13 11:30:00,15,8,27,51,20,11,58,28,218
2024-03-13 11:40:00,8,4,19,46,14,7,57,35,190
2024-03-13 11:50:00,12,6,28,41,15,21,63,34,220
2024-03-13 12:00:00,15,6,20,51,14,14,39,20,179
2024-03-13 12:10:00,13,8,21,50,18,12,69,36,227
2024-03-13 12:20:00,14,7,27,43,19,15,70,35,230
2024-03-13 12:30:00,7,5,28,46,10,6,61,26,189
2024-03-13 12:40:00,16,12,34,32,17,6,81,22,220
2024-03-13 12:50:00,14,6,23,44,11,15,59,22,194
2024-03-13 13:00:00,20,9,24,41,22,16,80,35,247
2024-03-13 13:10:00,13,10,26,51,19,9,77,21,226
2024-03-13 13:20:00,7,3,17,53,9,7,79,35,210
2024-03-13 13:30:00,12,11,19,45,10,7,63,41,208
2024-03-13 13:40:00,7,3,21,40,15,10,65,42,203
2024-03-13 13:50:00,13,10,16,41,17,12,71,30,210
2024-03-13 14:00:00,18,11,23,39,15,8,60,29,203
2024-03-13 14:10:00,17,9,24,39,12,9,92,40,242
2024-03-13 14:20:00,18,8,20,30,19,12,77,40,224
2024-03-13 14:30:00,12,6,23,48,18,10,95,38,250
2024-03-13 14:40:00,11,7,36,48,14,31,93,23,263
2024-03-13 14:50:00,12,10,23,37,18,11,97,28,236
2024-03-13 15:00:00,20,13,10,54,13,7,83,40,240
2024-03-13 15:10:00,23,13,16,77,19,33,118,42,341
2024-03-13 15:20:00,18,10,14,69,17,8,106,33,275
2024-03-13 15:30:00,21,12,13,45,8,5,103,34,241
2024-03-13 15:40:00,15,7,12,49,22,13,111,16,245
2024-03-13 15:50:00,22,11,14,63,13,9,103,8,243
2024-03-13 16:00:00,21,10,11,42,15,11,106,14,230
2024-03-13 16:10:00,25,10,14,59,21,10,117,8,264
2024-03-13 16:20:00,19,8,18,56,10,11,117,15,254
2024-03-13 16:30:00,21,9,21,60,11,5,93,21,241
2024-03-13 16:40:00,27,14,21,71,6,6,114,18,277
2024-03-13 16:50:00,19,6,17,54,18,10,105,21,250
2024-03-13 17:00:00,16,8,5,53,16,11,100,26,235
2024-03-13 17:10:00,13,7,10,52,19,6,97,21,225
2024-03-13 17:20:00,13,6,22,61,19,34,124,31,310
2024-03-13 17:30:00,26,9,9,52,17,9,110,33,265
2024-03-13 17:40:00,17,7,16,56,17,7,112,20,252
2024-03-13 17:50:00,12,5,8,62,18,9,88,28,230
2024-03-13 18:00:00,14,7,10,62,19,8,106,29,255
2024-03-13 18:10:00,11,5,13,55,16,10,91,31,232
2024-03-13 18:20:00,10,5,15,62,10,11,98,23,234
2024-03-13 18:30:00,19,9,6,49,16,13,72,33,217
2024-03-13 18:40:00,13,5,12,51,22,17,73,17,210
2024-03-13 18:50:00,11,5,8,49,14,13,62,30,192
2024-03-13 19:00:00,3,3,5,37,14,7,77,32,178
2024-03-13 19:10:00,8,6,6,53,18,11,57,30,189
2024-03-13 19:20:00,12,7,4,55,14,15,62,29,198
2024-03-13 19:30:00,9,4,7,47,13,5,49,23,157
2024-03-13 19:40:00,3,5,3,33,15,5,42,27,133
2024-03-13 19:50:00,13,5,7,39,16,13,53,31,177
2024-03-13 20:00:00,5,3,4,41,7,5,54,32,151
2024-03-13 20:10:00,5,4,3,26,6,7,37,23,111
2024-03-13 20:20:00,5,1,11,22,7,8,34,19,107
2024-03-13 20:30:00,7,5,2,25,9,9,29,30,116
2024-03-13 20:40:00,4,1,4,25,15,4,39,27,119
2024-03-13 20:50:00,6,4,11,32,8,6,37,28,132
2024-03-13 21:00:00,4,2,7,28,11,8,35,26,121
2024-03-13 21:10:00,7,3,4,19,9,6,57,25,130
2024-03-13 21:20:00,11,5,10,26,6,8,36,23,125
2024-03-13 21:30:00,7,3,5,29,4,6,25,29,108
2024-03-13 21:40:00,9,3,10,25,8,6,40,34,135
2024-03-13 21:50:00,1,0,0,24,8,8,34,21,96
2024-03-13 22:00:00,1,1,9,21,3,4,28,30,97
2024-03-13 22:10:00,1,1,3,28,9,9,34,23,108
2024-03-13 22:20:00,2,2,5,20,11,11,32,18,101
2024-03-13 22:30:00,2,2,6,15,9,9,25,25,93
2024-03-13 22:40:00,3,1,0,10,2,2,25,18,61
2024-03-13 22:50:00,1,0,4,22,4,4,32,20,87
2024-03-13 23:00:00,2,1,3,18,7,6,25,23,85
2024-03-13 23:10:00,4,2,3,10,4,2,20,14,59
2024-03-13 23:20:00,4,1,1,10,4,5,15,14,54
2024-03-13 23:30:00,0,0,3,13,2,1,9,10,38
2024-03-13 23:40:00,0,0,0,8,0,0,9,12,29
2024-03-13 23:50:00,2,1,1,10,4,3,9,9,39
2024-03-14 00:00:00,0,0,0,6,1,1,7,7,22
2024-03-14 00:10:00,0,0,2,5,0,0,5,8,20
2024-03-14 00:20:00,0,0,0,10,1,1,9,10,31
2024-03-14 00:30:00,0,0,1,6,0,0,3,3,13
2024-03-14 00:40:00,2,0,1,7,3,1,8,11,33
2024-03-14 00:50:00,0,0,0,6,1,0,8,7,22
2024-03-14 01:00:00,0,0,1,4,1,1,4,7,18
2024-03-14 01:10:00,0,0,0,0,0,0,4,5,9
2024-03-14 01:20:00,1,0,0,3,1,2,1,1,9
2024-03-14 01:30:00,0,0,1,3,0,0,6,6,16
2024-03-14 01:40:00,1,1,0,2,3,2,2,2,13
2024-03-14 01:50:00,0,0,0,6,0,0,2,2,10
2024-03-14 02:00:00,0,0,1,7,1,0,4,6,19
2024-03-14 02:10:00,0,0,1,2,0,0,2,2,7
2024-03-14 02:20:00,0,0,1,6,0,0,2,2,11
2024-03-14 02:30:00,0,0,0,2,0,0,1,1,4
2024-03-14 02:40:00,0,0,0,5,2,1,2,2,12
2024-03-14 02:50:00,0,0,0,2,1,2,4,4,13
2024-03-14 03:00:00,0,0,0,1,1,1,1,1,5
2024-03-14 03:10:00,0,0,0,2,0,0,2,2,6
2024-03-14 03:20:00,0,0,0,3,0,0,2,4,9
2024-03-14 03:30:00,0,0,2,5,0,0,0,0,7
2024-03-14 03:40:00,0,0,0,3,2,2,3,4,14
2024-03-14 03:50:00,0,0,0,4,0,0,3,6,13
2024-03-14 04:00:00,0,0,0,6,2,1,1,1,11
2024-03-14 04:10:00,0,0,1,8,1,1,1,1,13
2024-03-14 04:20:00,0,0,4,12,0,0,1,1,18
2024-03-14 04:30:00,0,0,2,11,2,2,1,1,19
2024-03-14 04:40:00,0,0,4,10,1,1,3,4,23
2024-03-14 04:50:00,0,0,1,18,3,1,3,1,27
2024-03-14 05:00:00,0,0,5,19,0,0,3,3,30
2024-03-14 05:10:00,0,0,7,26,2,3,7,10,55
2024-03-14 05:20:00,0,0,11,44,2,2,10,17,86
2024-03-14 05:30:00,0,0,15,48,3,3,8,6,83
2024-03-14 05:40:00,2,1,27,62,5,6,6,7,116
2024-03-14 05:50:00,1,2,28,65,5,5,8,9,123
2024-03-14 06:00:00,4,0,18,52,4,4,14,11,107
2024-03-14 06:10:00,2,2,10,59,11,11,22,25,142
2024-03-14 06:20:00,3,2,23,53,8,5,22,21,137
2024-03-14 06:30:00,3,6,15,85,9,5,23,21,167
2024-03-14 06:40:00,5,2,20,74,9,5,23,13,151
2024-03-14 06:50:00,5,3,12,83,8,5,32,30,178
2024-03-14 07:00:00,2,5,14,75,16,14,38,25,189
2024-03-14 07:10:00,7,3,29,95,15,7,36,28,220
2024-03-14 07:20:00,5,4,33,88,13,12,30,21,206
2024-03-14 07:30:00,7,5,28,84,17,10,52,25,228
2024-03-14 07:40:00,11,6,36,97,32,7,42,29,260
2024-03-14 07:50:00,15,9,40,85,31,5,58,27,270
2024-03-14 08:00:00,12,9,21,85,32,13,37,25,234
2024-03-14 08:10:00,9,4,22,65,35,6,34,19,194
2024-03-14 08:20:00,17,8,32,86,24,11,46,36,260
2024-03-14 08:30:00,9,5,16,101,18,9,47,31,236
2024-03-14 08:40:00,18,8,26,86,27,15,42,20,242
2024-03-14 08:50:00,19,9,28,70,18,11,45,24,224
2024-03-14 09:00:00,18,4,40,56,22,13,42,29,224
2024-03-14 09:10:00,9,4,28,81,29,11,52,22,236
2024-03-14 09:20:00,13,7,23,70,15,8,36,24,196
2024-03-14 09:30:00,14,9,36,56,9,11,41,21,197
2024-03-14 09:40:00,21,13,35,56,17,7,42,36,227
2024-03-14 09:50:00,11,9,25,61,10,14,47,35,212
2024-03-14 10:00:00,13,9,40,58,18,9,46,38,231
2024-03-14 10:10:00,9,6,26,54,24,15,38,26,198
2024-03-14 10:20:00,15,14,24,47,16,12,52,36,216
2024-03-14 10:30:00,14,7,23,51,18,29,56,39,237
2024-03-14 10:40:00,16,8,22,48,13,28,46,52,233
2024-03-14 10:50:00,7,6,26,61,20,18,39,30,207
2024-03-14 11:00:00,18,10,28,51,13,8,56,42,226
2024-03-14 11:10:00,6,7,21,60,16,17,59,34,220
2024-03-14 11:20:00,10,5,30,54,13,11,49,35,207
2024-03-14 11:30:00,9,9,20,52,14,15,61,45,225
2024-03-14 11:40:00,6,3,31,46,14,12,50,34,196
2024-03-14 11:50:00,9,5,20,67,19,13,59,39,231
2024-03-14 12:00:00,20,10,25,41,15,9,44,35,199
2024-03-14 12:10:00,17,9,26,42,10,12,63,38,217
2024-03-14 12:20:00,11,7,25,51,22,15,62,35,228
2024-03-14 12:30:00,17,9,24,35,18,9,79,26,217
2024-03-14 12:40:00,18,7,23,52,14,9,67,27,217
2024-03-14 12:50:00,16,7,34,61,20,18,77,31,264
2024-03-14 13:00:00,24,9,15,37,9,5,71,38,208
2024-03-14 13:10:00,17,8,35,53,15,8,87,33,256
2024-03-14 13:20:00,13,7,29,40,22,15,89,33,248
2024-03-14 13:30:00,22,7,34,49,11,13,68,35,239
2024-03-14 13:40:00,20,8,21,57,21,12,71,39,249
2024-03-14 13:50:00,18,5,25,55,19,8,64,33,227
2024-03-14 14:00:00,20,10,25,45,23,15,87,36,261
2024-03-14 14:10:00,13,6,21,46,9,8,91,37,231
2024-03-14 14:20:00,16,11,20,46,16,7,79,27,222
2024-03-14 14:30:00,13,5,29,51,13,7,93,36,247
2024-03-14 14:40:00,18,11,37,42,21,9,88,30,256
2024-03-14 14:50:00,22,9,25,48,24,17,96,23,264
2024-03-14 15:00:00,14,11,11,64,21,14,122,47,304
2024-03-14 15:10:00,22,11,13,59,16,12,111,54,298
2024-03-14 15:20:00,16,9,18,64,15,9,122,29,282
2024-03-14 15:30:00,21,8,9,56,26,7,106,21,254
2024-03-14 15:40:00,18,9,11,64,25,9,120,25,281
2024-03-14 15:50:00,23,9,11,64,24,9,124,24,288
2024-03-14 16:00:00,31,15,11,71,15,10,122,32,307
2024-03-14 16:10:00,24,15,12,69,17,5,106,23,271
2024-03-14 16:20:00,21,10,16,71,21,11,105,31,286
2024-03-14 16:30:00,21,8,10,64,20,13,125,28,289
2024-03-14 16:40:00,21,14,10,51,12,10,108,12,238
2024-03-14 16:50:00,115,13,15,47,13,11,127,5,346
2024-03-14 17:00:00,28,9,8,48,17,7,110,13,240
2024-03-14 17:10:00,11,6,24,75,19,11,145,5,296
2024-03-14 17:20:00,13,6,15,70,21,15,115,11,266
2024-03-14 17:30:00,20,11,12,67,18,15,105,16,264
2024-03-14 17:40:00,15,5,16,64,19,9,114,26,268
2024-03-14 17:50:00,16,7,14,59,19,11,121,22,269
2024-03-14 18:00:00,13,5,15,79,16,12,83,21,244
2024-03-14 18:10:00,99,7,13,72,15,9,90,28,333
2024-03-14 18:20:00,13,7,11,55,25,18,118,27,274
2024-03-14 18:30:00,13,9,6,51,17,14,97,31,238
2024-03-14 18:40:00,8,6,8,63,16,14,67,20,202
2024-03-14 18:50:00,10,6,12,67,14,6,68,20,203
2024-03-14 19:00:00,9,6,6,50,9,7,61,25,173
2024-03-14 19:10:00,13,7,3,46,15,8,56,39,187
2024-03-14 19:20:00,7,4,4,46,22,12,56,29,180
2024-03-14 19:30:00,7,2,0,41,15,16,48,24,153
2024-03-14 19:40:00,9,6,6,51,18,6,30,20,146
2024-03-14 19:50:00,7,3,1,43,10,10,57,24,155
2024-03-14 20:00:00,6,4,6,38,10,7,42,33,146
2024-03-14 20:10:00,0,0,1,23,10,9,37,29,109
2024-03-14 20:20:00,8,7,10,29,8,18,35,17,132
2024-03-14 20:30:00,3,3,14,32,9,7,37,26,131
2024-03-14 20:40:00,5,4,5,20,11,10,32,20,107
2024-03-14 20:50:00,6,5,10,30,7,3,36,19,116
2024-03-14 21:00:00,6,2,2,23,6,6,38,32,115
2024-03-14 21:10:00,3,1,8,17,5,3,34,31,102
2024-03-14 21:20:00,1,1,7,17,6,6,42,27,107
2024-03-14 21:30:00,2,2,7,21,5,3,33,29,102
2024-03-14 21:40:00,8,5,4,20,3,2,27,29,98
2024-03-14 21:50:00,2,2,6,27,9,2,27,23,98
2024-03-14 22:00:00,6,3,8,33,10,6,29,23,118
2024-03-14 22:10:00,2,1,2,21,9,3,22,10,70
2024-03-14 22:20:00,5,3,6,26,7,7,26,13,93
2024-03-14 22:30:00,5,3,2,17,3,3,20,17,70
2024-03-14 22:40:00,1,1,1,7,3,2,24,22,61
2024-03-14 22:50:00,5,3,3,6,0,0,18,12,47
2024-03-14 23:00:00,4,2,5,10,1,2,12,13,49
2024-03-14 23:10:00,1,0,2,12,4,2,26,22,69
2024-03-14 23:20:00,0,0,0,18,5,2,17,11,53
2024-03-14 23:30:00,0,0,4,13,3,2,16,17,55
2024-03-14 23:40:00,0,0,1,3,5,3,9,11,32
2024-03-14 23:50:00,1,1,0,8,0,0,10,12,32
2024-03-15 00:00:00,0,0,1,7,0,0,9,10,27
2024-03-15 00:10:00,0,0,0,4,3,1,12,13,33
2024-03-15 00:20:00,0,0,1,10,2,2,8,7,30
2024-03-15 00:30:00,2,2,1,3,2,2,7,7,26
2024-03-15 00:40:00,0,0,0,5,1,1,6,6,19
2024-03-15 00:50:00,1,0,0,4,1,1,9,12,28
2024-03-15 01:00:00,0,0,0,2,0,0,8,10,20
2024-03-15 01:10:00,2,0,0,5,3,4,2,3,19
2024-03-15 01:20:00,0,0,0,6,0,0,2,3,11
2024-03-15 01:30:00,1,1,1,6,1,1,4,5,20
2024-03-15 01:40:00,0,0,0,3,0,0,1,1,5
2024-03-15 01:50:00,2,0,1,5,0,0,3,3,14
2024-03-15 02:00:00,0,0,4,5,1,1,4,3,18
2024-03-15 02:10:00,1,1,1,5,0,0,1,1,10
2024-03-15 02:20:00,1,0,1,3,1,2,5,5,18
2024-03-15 02:30:00,0,0,0,1,5,2,1,1,10
2024-03-15 02:40:00,0,0,0,5,0,0,2,2,9
2024-03-15 02:50:00,0,0,0,5,0,0,3,3,11
2024-03-15 03:00:00,0,0,0,3,1,2,3,5,14
2024-03-15 03:10:00,0,0,0,3,1,1,2,2,9
2024-03-15 03:20:00,0,0,0,0,1,1,6,8,16
2024-03-15 03:30:00,0,0,0,4,1,2,1,7,15
2024-03-15 03:40:00,0,0,0,8,1,1,0,0,10
2024-03-15 03:50:00,0,0,0,6,0,0,3,5,14
2024-03-15 04:00:00,0,0,2,6,1,1,1,1,12
2024-03-15 04:10:00,0,0,0,4,0,0,0,0,4
2024-03-15 04:20:00,0,0,2,14,1,1,2,2,22
2024-03-15 04:30:00,0,0,0,7,1,1,3,4,16
2024-03-15 04:40:00,0,0,4,13,1,0,4,3,25
2024-03-15 04:50:00,0,0,2,17,1,1,2,1,24
2024-03-15 05:00:00,0,0,4,16,0,0,4,7,31
2024-03-15 05:10:00,0,0,6,22,3,2,7,11,51
2024-03-15 05:20:00,3,3,21,43,1,1,6,7,85
2024-03-15 05:30:00,0,0,21,42,5,9,5,5,87
2024-03-15 05:40:00,1,1,24,62,4,3,7,7,109
2024-03-15 05:50:00,3,0,25,52,6,6,9,8,109
2024-03-15 06:00:00,3,0,10,44,2,0,10,12,81
2024-03-15 06:10:00,3,1,15,52,4,4,24,25,128
2024-03-15 06:20:00,2,1,24,71,8,6,29,21,162
2024-03-15 06:30:00,4,1,19,59,8,5,28,20,144
2024-03-15 06:40:00,5,2,19,80,13,8,21,16,164
2024-03-15 06:50:00,4,2,13,82,9,6,33,27,176
2024-03-15 07:00:00,4,3,13,90,14,9,31,17,181
2024-03-15 07:10:00,8,3,29,83,10,9,29,16,187
2024-03-15 07:20:00,12,3,20,89,23,15,31,22,215
2024-03-15 07:30:00,6,3,16,89,12,11,28,27,192
2024-03-15 07:40:00,15,7,34,94,24,15,38,27,254
2024-03-15 07:50:00,11,7,34,95,21,13,49,37,267
2024-03-15 08:00:00,10,6,26,68,23,8,30,23,194
2024-03-15 08:10:00,9,6,16,69,19,8,33,25,185
2024-03-15 08:20:00,14,7,23,73,16,11,44,25,213
2024-03-15 08:30:00,13,6,22,85,20,8,36,30,220
2024-03-15 08:40:00,20,8,68,96,18,11,44,28,293
2024-03-15 08:50:00,11,8,19,82,16,4,51,33,224
2024-03-15 09:00:00,14,7,9,54,21,14,37,25,181
2024-03-15 09:10:00,18,10,11,57,21,17,40,24,198
2024-03-15 09:20:00,11,7,18,73,17,5,46,30,207
2024-03-15 09:30:00,16,9,22,69,21,7,44,33,221
2024-03-15 09:40:00,15,9,26,53,21,12,50,30,216
2024-03-15 09:50:00,17,9,17,75,14,7,41,31,211
2024-03-15 10:00:00,17,8,27,63,23,15,44,30,227
2024-03-15 10:10:00,13,8,29,62,15,8,47,24,206
2024-03-15 10:20:00,15,7,23,49,21,10,59,35,219
2024-03-15 10:30:00,14,6,26,74,8,7,41,25,201
2024-03-15 10:40:00,8,6,24,55,12,12,51,32,200
2024-03-15 10:50:00,14,6,35,49,20,27,51,34,236
2024-03-15 11:00:00,6,4,21,56,17,9,52,30,195
2024-03-15 11:10:00,17,11,31,39,18,13,53,28,210
2024-03-15 11:20:00,15,11,24,58,22,10,56,22,218
2024-03-15 11:30:00,18,6,31,55,16,13,58,32,229
2024-03-15 11:40:00,9,6,30,52,10,9,67,36,219
2024-03-15 11:50:00,11,4,30,55,14,11,82,20,227
2024-03-15 12:00:00,10,1,21,49,18,12,76,26,213
2024-03-15 12:10:00,14,6,24,51,15,9,71,28,218
2024-03-15 12:20:00,16,7,20,53,20,11,85,26,238
2024-03-15 12:30:00,17,10,13,44,14,7,81,28,214
2024-03-15 12:40:00,15,10,20,47,18,8,73,21,212
2024-03-15 12:50:00,12,6,9,62,15,16,120,14,254
2024-03-15 13:00:00,20,6,12,36,14,8,93,32,221
2024-03-15 13:10:00,11,8,12,50,13,9,86,30,219
2024-03-15 13:20:00,16,8,28,81,10,7,112,22,284
2024-03-15 13:30:00,9,8,9,54,8,10,91,29,218
2024-03-15 13:40:00,18,11,16,57,14,10,93,25,244
2024-03-15 13:50:00,17,7,12,51,11,15,85,25,223
2024-03-15 14:00:00,12,8,12,52,11,10,95,26,226
2024-03-15 14:10:00,108,8,12,56,19,11,84,21,319
2024-03-15 14:20:00,10,5,14,62,19,11,105,23,249
2024-03-15 14:30:00,23,9,15,71,11,5,97,33,264
2024-03-15 14:40:00,21,12,21,69,16,18,101,24,282
2024-03-15 14:50:00,17,5,12,69,15,10,84,26,238
2024-03-15 15:00:00,20,10,4,53,14,7,113,28,249
2024-03-15 15:10:00,19,14,15,48,18,9,107,30,260
2024-03-15 15:20:00,16,8,9,62,19,12,98,17,241
2024-03-15 15:30:00,16,9,18,46,21,14,100,32,256
2024-03-15 15:40:00,11,8,15,67,15,10,105,32,263
2024-03-15 15:50:00,10,12,15,86,14,12,83,21,253
2024-03-15 16:00:00,17,7,5,68,14,8,76,27,222
2024-03-15 16:10:00,9,6,11,75,20,12,95,30,258
2024-03-15 16:20:00,13,6,5,50,14,7,93,22,210
2024-03-15 16:30:00,14,5,25,76,13,10,86,27,256
2024-03-15 16:40:00,11,5,26,75,46,12,87,28,290
2024-03-15 16:50:00,13,5,11,59,14,9,93,25,229
2024-03-15 17:00:00,14,7,11,62,20,12,98,39,263
2024-03-15 17:10:00,15,9,24,94,21,7,102,20,292
2024-03-15 17:20:00,14,4,17,61,16,9,105,23,249
2024-03-15 17:30:00,18,7,15,56,24,15,62,23,220
2024-03-15 17:40:00,15,9,19,61,19,14,110,26,273
2024-03-15 17:50:00,24,7,5,61,14,10,80,21,222
2024-03-15 18:00:00,11,8,10,70,18,14,91,31,253
2024-03-15 18:10:00,10,8,6,67,27,17,68,26,229
2024-03-15 18:20:00,11,10,11,61,18,14,73,26,224
2024-03-15 18:30:00,16,8,11,45,19,10,81,27,217
2024-03-15 18:40:00,10,7,8,55,9,8,66,25,188
2024-03-15 18:50:00,7,4,20,52,18,10,72,26,209
2024-03-15 19:00:00,5,2,6,52,11,7,77,33,193
2024-03-15 19:10:00,13,6,10,69,16,10,57,24,205
2024-03-15 19:20:00,5,2,9,62,15,10,55,26,184
2024-03-15 19:30:00,10,5,3,27,17,10,41,21,134
2024-03-15 19:40:00,8,5,8,56,13,9,46,14,159
2024-03-15 19:50:00,6,5,9,49,13,10,63,25,180
2024-03-15 20:00:00,4,6,9,40,12,14,53,17,155
2024-03-15 20:10:00,10,7,5,38,10,6,41,30,147
2024-03-15 20:20:00,6,3,3,39,11,8,38,20,128
2024-03-15 20:30:00,5,2,8,36,12,10,43,22,138
2024-03-15 20:40:00,6,3,13,39,12,12,40,22,147
2024-03-15 20:50:00,2,2,7,35,6,3,46,17,118
2024-03-15 21:00:00,5,5,6,30,8,3,29,19,105
2024-03-15 21:10:00,1,1,8,35,6,11,30,22,114
2024-03-15 21:20:00,0,0,10,28,3,2,44,29,116
2024-03-15 21:30:00,3,3,9,28,8,7,32,22,112
2024-03-15 21:40:00,3,3,10,23,5,2,30,21,97
2024-03-15 21:50:00,5,2,16,37,8,8,43,29,148
2024-03-15 22:00:00,3,2,14,35,7,7,30,22,120
2024-03-15 22:10:00,5,4,3,26,6,5,32,17,98
2024-03-15 22:20:00,4,3,5,28,8,6,28,21,103
2024-03-15 22:30:00,2,2,10,34,5,5,34,36,128
2024-03-15 22:40:00,3,2,5,31,5,6,28,20,100
2024-03-15 22:50:00,3,3,9,31,6,4,36,30,122
2024-03-15 23:00:00,15,4,6,20,2,1,43,22,113
2024-03-15 23:10:00,3,1,7,32,3,3,31,21,101
2024-03-15 23:20:00,5,3,3,22,7,5,25,19,89
2024-03-15 23:30:00,2,1,3,26,3,3,27,24,89
2024-03-15 23:40:00,1,1,5,21,5,4,26,15,78
2024-03-15 23:50:00,3,3,2,14,5,6,27,31,91
2024-03-16 00:00:00,0,0,4,15,1,1,24,31,76
2024-03-16 00:10:00,2,1,1,11,2,1,28,21,67
2024-03-16 00:20:00,3,2,2,19,2,2,25,20,75
2024-03-16 00:30:00,0,0,1,8,4,1,11,15,40
2024-03-16 00:40:00,1,1,3,19,1,1,14,14,54
2024-03-16 00:50:00,1,0,3,10,2,4,14,18,52
2024-03-16 01:00:00,0,0,1,12,7,5,7,7,39
2024-03-16 01:10:00,3,2,1,7,0,0,15,12,40
2024-03-16 01:20:00,3,1,1,7,2,2,14,16,46
2024-03-16 01:30:00,3,2,0,8,2,2,13,17,47
2024-03-16 01:40:00,2,1,0,5,0,0,6,7,21
2024-03-16 01:50:00,1,1,3,11,1,1,6,8,32
2024-03-16 02:00:00,0,0,0,6,1,1,9,9,26
2024-03-16 02:10:00,0,0,0,2,0,0,4,5,11
2024-03-16 02:20:00,1,0,0,5,0,0,6,6,18
2024-03-16 02:30:00,2,0,0,5,2,1,6,9,25
2024-03-16 02:40:00,1,1,0,3,2,2,6,6,21
2024-03-16 02:50:00,2,1,0,2,1,0,8,11,25
2024-03-16 03:00:00,0,0,0,1,2,3,5,6,17
2024-03-16 03:10:00,1,0,3,7,1,1,9,9,31
2024-03-16 03:20:00,1,1,0,0,2,3,1,1,9
2024-03-16 03:30:00,0,0,0,5,2,2,5,5,19
2024-03-16 03:40:00,0,0,2,5,0,0,5,5,17
2024-03-16 03:50:00,0,0,0,12,1,1,3,4,21
2024-03-16 04:00:00,0,0,1,5,3,3,3,3,18
2024-03-16 04:10:00,0,0,0,3,0,0,3,3,9
2024-03-16 04:20:00,4,1,1,8,2,2,5,4,27
2024-03-16 04:30:00,0,0,0,5,2,1,4,5,17
2024-03-16 04:40:00,2,0,1,4,1,1,6,7,22
2024-03-16 04:50:00,0,0,2,4,1,3,4,6,20
2024-03-16 05:00:00,0,0,4,10,1,1,6,6,28
2024-03-16 05:10:00,0,0,3,18,0,0,4,4,29
2024-03-16 05:20:00,2,2,7,18,0,0,8,9,46
2024-03-16 05:30:00,1,0,8,24,3,3,9,9,57
2024-03-16 05:40:00,1,1,2,19,1,1,10,13,48
2024-03-16 05:50:00,1,1,3,13,4,2,8,7,39
2024-03-16 06:00:00,3,2,5,9,2,3,7,6,37
2024-03-16 06:10:00,0,0,4,20,3,2,11,9,49
2024-03-16 06:20:00,1,1,4,20,2,1,9,9,47
2024-03-16 06:30:00,3,2,4,7,5,5,7,7,40
2024-03-16 06:40:00,0,0,2,20,0,0,14,11,47
2024-03-16 06:50:00,3,1,3,14,3,3,9,9,45
2024-03-16 07:00:00,1,0,5,7,4,3,9,8,37
2024-03-16 07:10:00,3,2,9,19,3,3,7,6,52
2024-03-16 07:20:00,0,0,13,29,3,3,10,10,68
2024-03-16 07:30:00,2,0,13,35,5,4,10,9,78
2024-03-16 07:40:00,4,1,9,22,8,6,10,8,68
2024-03-16 07:50:00,5,1,10,31,6,4,16,13,86
2024-03-16 08:00:00,1,0,6,21,4,2,14,12,60
2024-03-16 08:10:00,3,3,10,19,12,10,10,7,74
2024-03-16 08:20:00,4,3,20,39,10,9,15,12,112
2024-03-16 08:30:00,1,0,14,27,8,14,13,11,88
2024-03-16 08:40:00,3,0,21,30,8,9,25,19,115
2024-03-16 08:50:00,6,4,31,42,13,10,19,13,138
2024-03-16 09:00:00,3,2,20,41,13,22,21,17,139
2024-03-16 09:10:00,9,6,12,28,10,7,23,17,112
2024-03-16 09:20:00,1,1,16,41,13,7,27,20,126
2024-03-16 09:30:00,3,2,26,58,8,7,28,24,156
2024-03-16 09:40:00,5,4,29,54,9,7,27,22,157
2024-03-16 09:50:00,5,2,32,59,23,15,37,28,201
2024-03-16 10:00:00,13,5,26,44,14,10,22,20,154
2024-03-16 10:10:00,9,3,16,58,18,12,31,22,169
2024-03-16 10:20:00,2,1,22,52,12,10,45,34,178
2024-03-16 10:30:00,3,2,15,37,21,13,32,29,152
2024-03-16 10:40:00,6,2,35,48,23,13,46,39,212
2024-03-16 10:50:00,6,5,29,57,15,6,45,31,194
2024-03-16 11:00:00,8,3,22,48,11,9,34,22,157
2024-03-16 11:10:00,7,6,35,68,16,9,49,34,224
2024-03-16 11:20:00,8,3,30,63,19,10,45,26,204
2024-03-16 11:30:00,6,4,24,49,9,5,49,37,183
2024-03-16 11:40:00,7,5,31,61,22,11,30,17,184
2024-03-16 11:50:00,4,2,32,50,11,10,48,36,193
2024-03-16 12:00:00,5,3,20,76,9,7,59,34,213
2024-03-16 12:10:00,8,4,38,65,14,7,62,36,234
2024-03-16 12:20:00,3,5,34,40,15,12,71,35,215
2024-03-16 12:30:00,4,4,29,50,16,28,46,28,205
2024-03-16 12:40:00,7,5,34,49,21,16,49,32,213
2024-03-16 12:50:00,10,8,26,60,12,8,45,25,194
2024-03-16 13:00:00,12,4,41,47,14,9,73,42,242
2024-03-16 13:10:00,13,4,40,59,11,7,61,30,225
2024-03-16 13:20:00,13,6,38,70,39,11,80,43,300
2024-03-16 13:30:00,5,5,29,76,20,12,91,39,277
2024-03-16 13:40:00,7,6,41,67,17,9,52,24,223
2024-03-16 13:50:00,18,10,46,74,6,8,72,25,259
2024-03-16 14:00:00,17,12,43,74,14,15,87,32,294
2024-03-16 14:10:00,18,9,32,63,14,11,88,36,271
2024-03-16 14:20:00,18,8,43,66,18,22,92,24,291
2024-03-16 14:30:00,16,9,30,72,18,12,80,29,266
2024-03-16 14:40:00,6,3,31,65,14,9,80,35,243
2024-03-16 14:50:00,4,1,34,59,19,14,85,32,248
2024-03-16 15:00:00,7,5,26,56,16,6,70,41,227
2024-03-16 15:10:00,3,1,23,72,17,7,64,31,218
2024-03-16 15:20:00,18,7,31,51,18,9,62,36,232
2024-03-16 15:30:00,10,5,24,49,14,8,65,40,215
2024-03-16 15:40:00,4,4,27,57,20,13,64,24,213
2024-03-16 15:50:00,8,5,30,60,21,12,46,35,217
2024-03-16 16:00:00,19,8,27,53,23,9,62,31,232
2024-03-16 16:10:00,12,6,21,46,14,10,70,34,213
2024-03-16 16:20:00,10,6,21,45,10,11,79,37,219
2024-03-16 16:30:00,10,4,22,46,6,5,77,45,215
2024-03-16 16:40:00,14,10,35,44,10,7,51,34,205
2024-03-16 16:50:00,8,3,20,44,10,7,70,30,192
2024-03-16 17:00:00,11,3,27,48,10,8,53,34,194
2024-03-16 17:10:00,7,5,25,48,11,8,88,33,225
2024-03-16 17:20:00,8,3,16,57,15,8,65,48,220
2024-03-16 17:30:00,6,4,30,44,19,10,71,35,219
2024-03-16 17:40:00,9,6,18,61,16,12,73,34,229
2024-03-16 17:50:00,13,9,31,60,37,15,99,25,289
2024-03-16 18:00:00,11,8,25,54,41,10,113,20,282
2024-03-16 18:10:00,8,5,25,60,33,12,112,20,275
2024-03-16 18:20:00,11,7,30,55,24,15,89,35,266
2024-03-16 18:30:00,6,3,23,45,28,10,85,31,231
2024-03-16 18:40:00,7,7,20,52,14,12,64,31,207
2024-03-16 18:50:00,5,5,27,53,17,12,65,31,215
2024-03-16 19:00:00,10,7,16,50,15,10,50,22,180
2024-03-16 19:10:00,4,3,23,57,12,9,49,23,180
2024-03-16 19:20:00,4,3,18,56,15,12,47,31,186
2024-03-16 19:30:00,2,2,10,50,11,9,56,24,164
2024-03-16 19:40:00,7,4,18,47,8,6,59,33,182
2024-03-16 19:50:00,4,2,25,39,11,6,45,26,158
2024-03-16 20:00:00,2,1,17,43,9,9,53,31,165
2024-03-16 20:10:00,7,6,17,51,5,4,48,21,159
2024-03-16 20:20:00,7,3,3,27,8,6,38,36,128
2024-03-16 20:30:00,3,2,14,41,9,6,33,26,134
2024-03-16 20:40:00,5,0,9,38,8,8,32,24,124
2024-03-16 20:50:00,3,1,5,26,5,5,41,24,110
2024-03-16 21:00:00,4,3,9,34,6,5,40,33,134
2024-03-16 21:10:00,6,3,12,38,12,7,28,25,131
2024-03-16 21:20:00,7,3,8,43,4,2,32,22,121
2024-03-16 21:30:00,6,3,8,39,6,5,35,26,128
2024-03-16 21:40:00,2,2,10,27,8,4,51,34,138
2024-03-16 21:50:00,1,1,12,32,13,10,47,21,137
2024-03-16 22:00:00,4,1,10,32,6,8,44,32,137
2024-03-16 22:10:00,3,2,9,26,6,6,40,22,114
2024-03-16 22:20:00,3,2,5,27,0,0,45,29,111
2024-03-16 22:30:00,3,3,12,33,3,1,37,21,113
2024-03-16 22:40:00,2,1,7,25,5,5,38,30,113
2024-03-16 22:50:00,5,3,2,29,9,10,49,28,135
2024-03-16 23:00:00,3,3,7,21,4,5,41,30,114
2024-03-16 23:10:00,3,2,4,29,5,2,34,32,111
2024-03-16 23:20:00,3,1,7,26,2,1,40,30,110
2024-03-16 23:30:00,0,0,9,19,6,5,24,20,83
2024-03-16 23:40:00,0,0,5,26,3,2,37,28,101
2024-03-16 23:50:00,0,0,2,26,1,1,25,22,77
2024-03-17 00:00:00,3,2,1,18,8,5,19,19,75
2024-03-17 00:10:00,2,1,3,29,1,2,33,28,99
2024-03-17 00:20:00,5,4,3,19,0,0,23,22,76
2024-03-17 00:30:00,1,1,3,16,0,0,12,16,49
2024-03-17 00:40:00,0,0,0,13,1,1,22,20,57
2024-03-17 00:50:00,0,0,2,18,0,0,21,22,63
2024-03-17 01:00:00,0,0,2,7,5,5,15,14,48
2024-03-17 01:10:00,1,0,0,11,2,2,17,16,49
2024-03-17 01:20:00,0,0,1,8,1,1,17,15,43
2024-03-17 01:30:00,1,0,0,8,1,1,10,11,32
2024-03-17 01:40:00,0,0,2,8,1,1,11,18,41
2024-03-17 01:50:00,0,0,2,15,2,2,19,17,57
2024-03-17 02:00:00,0,0,1,8,2,1,7,9,28
2024-03-17 02:10:00,1,0,1,7,0,0,12,10,31
2024-03-17 02:20:00,0,0,1,16,1,2,8,8,36
2024-03-17 02:30:00,0,0,0,8,1,1,2,3,15
2024-03-17 02:40:00,1,0,0,5,1,1,10,11,29
2024-03-17 02:50:00,1,0,0,10,1,1,14,15,42
2024-03-17 03:00:00,0,0,2,10,2,3,7,8,32
2024-03-17 03:10:00,0,0,1,7,2,2,6,6,24
2024-03-17 03:20:00,2,1,2,12,1,1,12,13,44
2024-03-17 03:30:00,2,1,1,8,1,1,8,8,30
2024-03-17 03:40:00,0,0,3,7,1,2,9,7,29
2024-03-17 03:50:00,0,0,1,6,2,1,7,9,26
2024-03-17 04:00:00,1,0,0,5,0,0,9,8,23
2024-03-17 04:10:00,0,0,0,4,2,2,4,6,18
2024-03-17 04:20:00,1,1,1,10,2,3,7,7,32
2024-03-17 04:30:00,1,0,0,2,0,0,2,2,7
2024-03-17 04:40:00,0,0,0,8,1,1,3,4,17
2024-03-17 04:50:00,0,0,0,2,0,0,5,5,12
2024-03-17 05:00:00,1,0,2,10,2,2,12,14,43
2024-03-17 05:10:00,0,0,1,4,0,0,7,6,18
2024-03-17 05:20:00,0,0,4,22,6,2,5,5,44
2024-03-17 05:30:00,1,1,4,23,5,4,5,7,50
2024-03-17 05:40:00,1,0,3,17,2,2,11,13,49
2024-03-17 05:50:00,2,0,1,6,1,1,7,7,25
2024-03-17 06:00:00,1,1,3,13,1,0,6,7,32
2024-03-17 06:10:00,0,0,1,11,1,0,11,14,38
2024-03-17 06:20:00,2,2,1,11,0,0,6,7,29
2024-03-17 06:30:00,0,0,1,9,3,3,2,2,20
2024-03-17 06:40:00,0,0,2,8,1,1,6,6,24
2024-03-17 06:50:00,2,1,2,8,5,3,8,7,36
2024-03-17 07:00:00,2,1,5,13,0,0,4,4,29
2024-03-17 07:10:00,0,0,2,4,3,3,3,3,18
2024-03-17 07:20:00,1,1,1,5,2,2,4,4,20
2024-03-17 07:30:00,2,1,1,6,4,4,2,2,22
2024-03-17 07:40:00,2,0,3,10,4,3,8,7,37
2024-03-17 07:50:00,3,2,4,14,7,4,5,6,45
2024-03-17 08:00:00,1,0,3,9,1,10,10,9,43
2024-03-17 08:10:00,0,0,9,15,5,5,6,6,46
2024-03-17 08:20:00,0,0,10,21,3,4,12,12,62
2024-03-17 08:30:00,0,0,4,15,3,3,6,6,37
2024-03-17 08:40:00,4,4,4,16,4,5,9,9,55
2024-03-17 08:50:00,5,2,10,25,5,12,20,18,97
2024-03-17 09:00:00,2,3,6,14,7,4,9,8,53
2024-03-17 09:10:00,5,0,11,25,12,9,12,10,84
2024-03-17 09:20:00,9,4,14,24,13,11,13,13,101
2024-03-17 09:30:00,8,5,15,32,8,8,23,22,121
2024-03-17 09:40:00,3,2,10,25,8,8,18,16,90
2024-03-17 09:50:00,7,4,21,39,13,8,32,27,151
2024-03-17 10:00:00,3,4,16,24,8,11,26,24,116
2024-03-17 10:10:00,2,0,23,37,11,9,28,23,133
2024-03-17 10:20:00,10,7,16,32,12,13,24,22,136
2024-03-17 10:30:00,6,5,19,34,12,10,20,16,122
2024-03-17 10:40:00,5,5,27,36,10,8,36,28,155
2024-03-17 10:50:00,10,5,28,46,15,11,31,26,172
2024-03-17 11:00:00,9,5,21,24,16,12,22,17,126
2024-03-17 11:10:00,8,4,23,35,18,9,29,26,152
2024-03-17 11:20:00,9,4,21,38,19,10,43,32,176
2024-03-17 11:30:00,9,4,21,34,12,9,35,25,149
2024-03-17 11:40:00,5,6,23,44,24,14,38,30,184
2024-03-17 11:50:00,9,4,27,43,12,9,38,22,164
2024-03-17 12:00:00,11,4,27,42,17,14,31,22,168
2024-03-17 12:10:00,13,8,22,50,12,9,37,28,179
2024-03-17 12:20:00,15,5,22,45,17,11,37,27,179
2024-03-17 12:30:00,13,5,33,49,23,13,31,24,191
2024-03-17 12:40:00,9,2,15,51,21,13,43,31,185
2024-03-17 12:50:00,10,7,32,47,13,15,46,33,203
2024-03-17 13:00:00,14,9,23,40,21,14,54,32,207
2024-03-17 13:10:00,5,4,22,43,13,11,54,37,189
2024-03-17 13:20:00,14,8,32,43,22,14,45,29,207
2024-03-17 13:30:00,13,6,19,43,13,10,55,32,191
2024-03-17 13:40:00,5,0,36,39,18,11,54,35,198
2024-03-17 13:50:00,12,2,27,48,16,4,56,38,203
2024-03-17 14:00:00,10,6,34,43,9,9,60,23,194
2024-03-17 14:10:00,11,4,18,39,25,11,57,31,196
2024-03-17 14:20:00,16,7,31,47,19,9,55,31,215
2024-03-17 14:30:00,9,5,30,48,13,18,66,28,217
2024-03-17 14:40:00,11,5,15,59,13,16,59,28,206
2024-03-17 14:50:00,10,4,37,53,36,16,52,28,236
2024-03-17 15:00:00,11,4,19,37,19,10,53,28,181
2024-03-17 15:10:00,18,8,36,36,21,20,41,28,208
2024-03-17 15:20:00,12,6,26,66,19,11,57,23,220
2024-03-17 15:30:00,14,8,22,51,19,13,50,29,206
2024-03-17 15:40:00,9,5,27,34,23,39,49,27,213
2024-03-17 15:50:00,17,5,26,47,20,11,50,34,210
2024-03-17 16:00:00,18,7,29,48,22,15,49,25,213
2024-03-17 16:10:00,10,6,25,36,17,16,44,17,171
2024-03-17 16:20:00,18,7,18,47,21,12,40,26,189
2024-03-17 16:30:00,8,10,25,46,22,9,52,26,198
2024-03-17 16:40:00,10,4,26,63,18,14,52,30,217
2024-03-17 16:50:00,13,4,21,45,18,8,54,27,190
2024-03-17 17:00:00,13,9,32,49,20,16,53,29,221
2024-03-17 17:10:00,13,5,27,57,16,13,50,27,208
2024-03-17 17:20:00,15,4,24,57,23,13,39,22,197
2024-03-17 17:30:00,14,5,22,46,21,15,40,28,191
2024-03-17 17:40:00,8,5,33,53,31,19,44,31,224
2024-03-17 17:50:00,25,10,27,51,21,16,56,24,230
2024-03-17 18:00:00,13,7,28,40,18,14,40,27,187
2024-03-17 18:10:00,9,9,14,56,20,14,50,26,198
2024-03-17 18:20:00,6,4,28,47,9,12,38,27,171
2024-03-17 18:30:00,17,12,21,32,14,13,42,24,175
2024-03-17 18:40:00,6,2,12,43,7,7,42,25,144
2024-03-17 18:50:00,10,5,15,36,4,3,22,15,110
2024-03-17 19:00:00,9,4,16,54,9,8,43,21,164
2024-03-17 19:10:00,10,5,19,36,11,8,30,22,141
2024-03-17 19:20:00,6,3,15,46,10,2,35,19,136
2024-03-17 19:30:00,1,2,17,52,15,10,37,18,152
2024-03-17 19:40:00,5,1,19,32,12,9,42,32,152
2024-03-17 19:50:00,5,5,15,40,11,12,24,30,142
2024-03-17 20:00:00,11,7,9,46,8,7,38,22,148
2024-03-17 20:10:00,6,4,13,35,9,10,37,23,137
2024-03-17 20:20:00,8,3,8,44,9,12,41,23,148
2024-03-17 20:30:00,5,3,8,29,4,3,37,23,112
2024-03-17 20:40:00,2,1,14,33,6,6,32,24,118
2024-03-17 20:50:00,2,0,7,31,3,2,28,22,95
2024-03-17 21:00:00,5,1,9,29,6,6,27,20,103
2024-03-17 21:10:00,10,5,10,36,7,6,25,26,125
2024-03-17 21:20:00,4,2,5,26,12,10,20,15,94
2024-03-17 21:30:00,3,2,5,37,6,5,28,28,114
2024-03-17 21:40:00,1,1,9,34,3,0,28,31,107
2024-03-17 21:50:00,3,1,2,20,1,0,28,20,75
2024-03-17 22:00:00,5,1,7,18,3,1,19,16,70
2024-03-17 22:10:00,1,1,2,22,2,1,19,19,67
2024-03-17 22:20:00,3,4,3,8,8,8,18,18,70
2024-03-17 22:30:00,2,2,2,14,3,0,21,20,64
2024-03-17 22:40:00,2,1,0,15,2,1,17,17,55
2024-03-17 22:50:00,0,0,4,11,2,3,20,16,56
2024-03-17 23:00:00,4,2,3,8,3,2,13,15,50
2024-03-17 23:10:00,0,0,0,8,5,5,18,19,55
2024-03-17 23:20:00,1,1,2,6,6,1,12,9,38
2024-03-17 23:30:00,1,1,1,4,1,0,12,12,32
2024-03-17 23:40:00,0,0,0,13,2,2,6,6,29
2024-03-17 23:50:00,0,0,3,6,1,1,8,6,25
2024-03-18 00:00:00,0,0,1,7,0,0,6,7,21
2024-03-18 00:10:00,1,0,1,13,3,4,9,9,40
2024-03-18 00:20:00,1,1,0,5,1,0,6,5,19
2024-03-18 00:30:00,0,0,0,10,1,1,5,4,21
2024-03-18 00:40:00,0,0,0,4,2,2,1,1,10
2024-03-18 00:50:00,1,1,0,1,0,0,6,7,16
2024-03-18 01:00:00,0,0,0,1,1,1,2,2,7
2024-03-18 01:10:00,0,0,0,6,0,0,1,1,8
2024-03-18 01:20:00,0,0,1,5,0,0,3,3,12
2024-03-18 01:30:00,0,0,0,2,2,2,4,4,14
2024-03-18 01:40:00,0,0,0,8,0,0,5,5,18
2024-03-18 01:50:00,0,0,1,4,0,0,2,2,9
2024-03-18 02:00:00,0,0,1,1,1,1,5,5,14
2024-03-18 02:10:00,0,0,2,5,2,3,0,0,12
2024-03-18 02:20:00,0,0,0,3,0,0,1,1,5
2024-03-18 02:30:00,2,2,0,4,2,0,3,3,16
2024-03-18 02:40:00,0,0,1,3,1,1,1,1,8
2024-03-18 02:50:00,0,0,2,3,2,1,6,6,20
2024-03-18 03:00:00,0,0,2,4,0,0,3,3,12
2024-03-18 03:10:00,0,0,1,6,1,1,2,2,13
2024-03-18 03:20:00,0,0,0,5,1,1,1,1,9
2024-03-18 03:30:00,0,0,1,3,0,0,1,1,6
2024-03-18 03:40:00,0,0,0,5,1,1,2,2,11
2024-03-18 03:50:00,0,0,1,7,1,1,2,2,14
2024-03-18 04:00:00,0,0,2,4,0,0,2,2,10
2024-03-18 04:10:00,0,0,0,10,2,2,1,2,17
2024-03-18 04:20:00,0,0,2,12,1,1,1,2,19
2024-03-18 04:30:00,0,0,1,9,0,0,4,6,20
2024-03-18 04:40:00,0,0,5,16,2,3,4,6,36
2024-03-18 04:50:00,0,0,1,18,1,1,3,3,27
2024-03-18 05:00:00,1,1,7,28,2,3,4,4,50
2024-03-18 05:10:00,1,0,9,28,4,7,10,13,72
2024-03-18 05:20:00,1,1,13,44,10,5,14,16,104
2024-03-18 05:30:00,1,0,18,47,4,5,4,4,83
2024-03-18 05:40:00,3,3,22,57,3,3,1,1,93
2024-03-18 05:50:00,5,1,28,84,4,1,8,8,139
2024-03-18 06:00:00,2,0,16,53,8,4,7,7,97
2024-03-18 06:10:00,0,0,18,64,10,11,20,15,138
2024-03-18 06:20:00,2,2,27,68,9,5,24,19,156
2024-03-18 06:30:00,2,1,14,55,6,6,29,19,132
2024-03-18 06:40:00,6,2,20,86,8,8,27,18,175
2024-03-18 06:50:00,2,2,15,88,10,7,30,18,172
2024-03-18 07:00:00,5,5,19,98,20,5,35,25,212
2024-03-18 07:10:00,5,2,19,92,11,10,31,19,189
2024-03-18 07:20:00,8,3,26,93,21,13,55,26,245
2024-03-18 07:30:00,5,4,37,90,19,9,41,27,232
2024-03-18 07:40:00,8,3,31,73,26,7,32,20,200
2024-03-18 07:50:00,16,10,37,89,32,12,50,23,269
2024-03-18 08:00:00,11,5,31,82,25,12,43,32,241
2024-03-18 08:10:00,11,5,22,86,25,12,33,24,218
2024-03-18 08:20:00,14,8,18,70,29,7,37,26,209
2024-03-18 08:30:00,14,9,31,79,36,5,37,23,234
2024-03-18 08:40:00,19,9,23,92,29,8,54,25,259
2024-03-18 08:50:00,11,7,25,84,27,7,58,27,246
2024-03-18 09:00:00,21,9,13,61,24,9,50,25,212
2024-03-18 09:10:00,11,6,27,80,24,12,45,26,231
2024-03-18 09:20:00,11,7,20,73,14,10,55,36,226
2024-03-18 09:30:00,13,8,22,82,21,25,42,28,241
2024-03-18 09:40:00,7,5,36,56,17,21,46,27,215
2024-03-18 09:50:00,18,7,26,56,11,12,62,40,232
2024-03-18 10:00:00,11,7,19,56,16,12,59,30,210
2024-03-18 10:10:00,9,4,33,46,15,12,51,32,202
2024-03-18 10:20:00,17,8,22,56,17,9,55,26,210
2024-03-18 10:30:00,10,5,30,42,17,8,51,28,191
2024-03-18 10:40:00,17,8,21,48,12,10,61,29,206
2024-03-18 10:50:00,22,11,42,67,22,23,65,21,273
2024-03-18 11:00:00,8,4,26,57,29,9,57,32,222
2024-03-18 11:10:00,13,6,28,41,16,11,47,27,189
2024-03-18 11:20:00,13,8,16,53,19,6,58,29,202
2024-03-18 11:30:00,18,10,20,62,15,13,60,34,232
2024-03-18 11:40:00,14,4,27,40,19,7,59,36,206
2024-03-18 11:50:00,10,3,22,51,11,9,52,29,187
2024-03-18 12:00:00,14,5,35,50,20,14,74,36,248
2024-03-18 12:10:00,9,6,23,43,14,11,53,26,185
2024-03-18 12:20:00,10,5,26,57,13,10,71,38,230
2024-03-18 12:30:00,15,9,31,55,14,13,65,22,224
2024-03-18 12:40:00,5,6,34,52,6,5,62,36,206
2024-03-18 12:50:00,22,9,25,50,13,8,67,39,233
2024-03-18 13:00:00,37,8,25,50,14,14,82,33,263
2024-03-18 13:10:00,8,8,24,36,20,7,80,25,208
2024-03-18 13:20:00,21,7,31,50,13,11,86,26,245
2024-03-18 13:30:00,14,10,35,46,21,8,74,22,230
2024-03-18 13:40:00,20,10,28,44,13,19,63,23,220
2024-03-18 13:50:00,13,5,32,48,22,13,60,37,230
2024-03-18 14:00:00,19,8,30,53,13,7,69,38,237
2024-03-18 14:10:00,13,7,23,45,5,5,79,36,213
2024-03-18 14:20:00,15,9,27,57,20,10,108,26,272
2024-03-18 14:30:00,18,5,28,59,11,7,99,39,266
2024-03-18 14:40:00,20,9,24,51,21,10,88,27,250
2024-03-18 14:50:00,14,9,32,43,21,12,117,26,274
2024-03-18 15:00:00,18,10,13,57,19,10,88,38,253
2024-03-18 15:10:00,19,5,21,54,20,14,136,30,299
2024-03-18 15:20:00,16,8,11,49,20,25,105,36,270
2024-03-18 15:30:00,17,9,4,47,6,2,131,23,239
2024-03-18 15:40:00,20,8,20,46,17,9,98,26,244
2024-03-18 15:50:00,16,6,7,55,20,8,127,17,256
2024-03-18 16:00:00,24,13,11,55,12,10,109,20,254
2024-03-18 16:10:00,19,6,18,42,22,12,128,26,273
2024-03-18 16:20:00,14,5,7,64,13,18,122,29,272
2024-03-18 16:30:00,15,7,11,50,11,5,107,33,239
2024-03-18 16:40:00,16,10,17,58,15,11,106,16,249
2024-03-18 16:50:00,26,11,13,65,11,5,129,6,266
2024-03-18 17:00:00,23,13,10,68,22,9,109,5,259
2024-03-18 17:10:00,19,11,16,64,19,15,110,5,259
2024-03-18 17:20:00,16,8,13,71,18,19,117,21,283
2024-03-18 17:30:00,11,6,14,65,22,10,97,26,251
2024-03-18 17:40:00,13,10,10,56,16,7,98,30,240
2024-03-18 17:50:00,14,8,9,45,12,13,113,23,237
2024-03-18 18:00:00,20,9,11,45,22,9,103,27,246
2024-03-18 18:10:00,20,8,12,58,18,5,82,28,231
2024-03-18 18:20:00,13,7,17,67,10,7,84,34,239
2024-03-18 18:30:00,16,11,6,48,15,7,85,29,217
2024-03-18 18:40:00,11,11,10,62,15,14,59,26,208
2024-03-18 18:50:00,11,4,8,38,21,11,57,27,177
2024-03-18 19:00:00,9,8,11,57,13,10,64,30,202
2024-03-18 19:10:00,7,4,5,38,14,10,47,37,162
2024-03-18 19:20:00,7,6,8,37,17,9,58,37,179
2024-03-18 19:30:00,6,7,5,42,8,9,43,30,150
2024-03-18 19:40:00,8,5,6,48,8,10,50,30,165
2024-03-18 19:50:00,7,5,2,46,9,9,51,35,164
2024-03-18 20:00:00,5,4,8,32,10,10,40,28,137
2024-03-18 20:10:00,5,3,2,31,6,4,49,33,133
2024-03-18 20:20:00,4,4,6,26,9,5,47,32,133
2024-03-18 20:30:00,5,4,13,24,6,9,29,30,120
2024-03-18 20:40:00,4,3,4,25,8,6,32,27,109
2024-03-18 20:50:00,5,3,9,29,0,0,29,23,98
2024-03-18 21:00:00,6,5,9,25,6,4,26,20,101
2024-03-18 21:10:00,8,3,1,19,5,5,23,13,77
2024-03-18 21:20:00,8,6,7,25,9,9,24,21,109
2024-03-18 21:30:00,4,3,4,23,5,5,21,15,80
2024-03-18 21:40:00,4,3,2,17,5,3,28,16,78
2024-03-18 21:50:00,4,2,0,8,5,3,28,16,66
2024-03-18 22:00:00,4,3,9,27,2,2,29,17,93
2024-03-18 22:10:00,2,1,1,11,1,2,21,16,55
2024-03-18 22:20:00,4,3,3,16,5,5,35,22,93
2024-03-18 22:30:00,2,3,5,11,5,1,21,12,60
2024-03-18 22:40:00,1,1,3,15,1,1,29,19,70
2024-03-18 22:50:00,1,1,3,12,5,5,21,21,69
2024-03-18 23:00:00,0,0,2,10,2,1,14,9,38
2024-03-18 23:10:00,3,2,1,11,3,4,16,20,60
2024-03-18 23:20:00,0,1,0,9,2,3,16,11,42
2024-03-18 23:30:00,1,1,2,13,4,2,8,9,40
2024-03-18 23:40:00,2,1,0,10,1,1,14,14,43
2024-03-18 23:50:00,0,0,4,7,0,1,5,8,25
2024-03-19 00:00:00,0,0,1,8,2,3,7,8,29
2024-03-19 00:10:00,0,0,0,9,1,2,2,2,16
2024-03-19 00:20:00,0,0,1,10,1,2,5,7,26
2024-03-19 00:30:00,0,0,1,5,0,1,5,5,17
2024-03-19 00:40:00,0,0,0,4,1,1,6,7,19
2024-03-19 00:50:00,0,0,0,4,0,0,4,6,14
2024-03-19 01:00:00,0,0,2,10,1,1,1,1,16
2024-03-19 01:10:00,0,0,0,1,1,4,1,1,8
2024-03-19 01:20:00,0,0,0,3,0,0,4,4,11
2024-03-19 01:30:00,0,0,0,7,1,1,1,1,11
2024-03-19 01:40:00,0,0,0,5,0,0,4,2,11
2024-03-19 01:50:00,0,0,0,5,0,0,3,3,11
2024-03-19 02:00:00,0,0,1,2,0,0,0,0,3
2024-03-19 02:10:00,0,0,0,1,0,0,0,0,1
2024-03-19 02:20:00,0,0,0,5,1,1,2,2,11
2024-03-19 02:30:00,0,0,0,1,0,0,2,3,6
2024-03-19 02:40:00,0,0,0,3,0,0,1,1,5
2024-03-19 02:50:00,0,0,0,2,0,0,1,2,5
2024-03-19 03:00:00,0,0,0,3,1,1,6,6,17
2024-03-19 03:10:00,0,0,0,3,0,0,2,2,7
2024-03-19 03:20:00,0,0,0,2,0,0,3,3,8
2024-03-19 03:30:00,0,0,0,0,0,0,1,1,2
2024-03-19 03:40:00,0,0,0,1,1,1,3,3,9
2024-03-19 03:50:00,0,0,0,6,0,0,3,4,13
2024-03-19 04:00:00,0,0,0,3,0,0,1,1,5
2024-03-19 04:10:00,0,0,0,5,2,2,0,1,10
2024-03-19 04:20:00,0,0,3,14,0,0,1,1,19
2024-03-19 04:30:00,0,0,0,10,1,0,5,6,22
2024-03-19 04:40:00,0,0,1,10,0,0,8,7,26
2024-03-19 04:50:00,0,0,5,19,2,1,3,5,35
2024-03-19 05:00:00,0,0,4,26,2,3,3,4,42
2024-03-19 05:10:00,0,0,7,34,1,2,7,9,60
2024-03-19 05:20:00,0,0,21,47,4,5,11,14,102
2024-03-19 05:30:00,3,0,19,59,5,5,10,10,111
2024-03-19 05:40:00,2,2,36,53,7,8,9,10,127
2024-03-19 05:50:00,3,2,25,67,4,5,12,10,128
2024-03-19 06:00:00,0,0,16,56,8,9,7,5,101
2024-03-19 06:10:00,4,1,18,76,11,8,23,22,163
2024-03-19 06:20:00,2,3,18,69,7,5,27,19,150
2024-03-19 06:30:00,1,0,14,80,13,10,26,21,165
2024-03-19 06:40:00,2,1,11,95,13,7,28,20,177
2024-03-19 06:50:00,3,2,19,94,8,4,28,23,181
2024-03-19 07:00:00,5,3,14,109,18,12,34,23,218
2024-03-19 07:10:00,7,4,26,94,20,9,35,25,220
2024-03-19 07:20:00,12,4,30,91,17,16,37,24,231
2024-03-19 07:30:00,14,7,34,95,20,18,40,17,245
2024-03-19 07:40:00,17,10,34,87,38,5,38,21,250
2024-03-19 07:50:00,6,4,23,98,36,0,53,26,246
2024-03-19 08:00:00,16,13,36,81,48,0,61,23,278
2024-03-19 08:10:00,19,9,33,69,41,1,34,22,228
2024-03-19 08:20:00,12,5,30,83,38,3,30,21,222
2024-03-19 08:30:00,13,5,27,95,30,1,46,31,248
2024-03-19 08:40:00,20,8,31,63,29,13,52,34,250
2024-03-19 08:50:00,12,7,30,87,25,10,60,28,259
2024-03-19 09:00:00,9,5,25,83,25,7,70,24,248
2024-03-19 09:10:00,16,5,20,91,32,19,36,23,242
2024-03-19 09:20:00,8,4,15,84,17,12,57,23,220
2024-03-19 09:30:00,12,7,26,77,14,8,48,39,231
2024-03-19 09:40:00,9,6,37,65,17,12,37,27,210
2024-03-19 09:50:00,21,7,21,53,16,11,43,38,210
2024-03-19 10:00:00,16,8,36,67,13,7,39,29,215
2024-03-19 10:10:00,18,13,29,37,18,11,54,26,206
2024-03-19 10:20:00,17,11,36,65,17,7,62,34,249
2024-03-19 10:30:00,17,7,31,44,15,16,56,35,221
2024-03-19 10:40:00,19,12,30,39,19,10,79,28,236
2024-03-19 10:50:00,19,10,30,47,20,14,81,35,256
2024-03-19 11:00:00,11,5,25,61,12,13,67,29,223
2024-03-19 11:10:00,14,8,25,37,15,10,59,40,208
2024-03-19 11:20:00,23,9,30,69,17,7,68,34,257
2024-03-19 11:30:00,21,9,23,54,14,11,56,33,221
2024-03-19 11:40:00,24,10,15,30,20,13,50,32,194
2024-03-19 11:50:00,10,5,24,44,14,8,61,36,202
2024-03-19 12:00:00,16,9,23,46,7,6,66,37,210
2024-03-19 12:10:00,16,7,27,54,16,7,72,26,225
2024-03-19 12:20:00,14,9,28,42,18,7,70,36,224
2024-03-19 12:30:00,14,8,32,57,6,13,68,29,227
2024-03-19 12:40:00,102,7,24,42,21,13,74,28,311
2024-03-19 12:50:00,8,7,26,47,14,8,83,34,227
2024-03-19 13:00:00,8,0,28,58,22,12,78,31,237
2024-03-19 13:10:00,17,6,25,46,21,11,79,30,235
2024-03-19 13:20:00,13,9,32,39,17,30,87,35,262
2024-03-19 13:30:00,19,8,29,51,14,14,68,32,235
2024-03-19 13:40:00,23,9,31,60,16,14,81,41,275
2024-03-19 13:50:00,16,12,26,50,20,8,77,40,249
2024-03-19 14:00:00,17,8,30,51,19,13,84,41,263
2024-03-19 14:10:00,22,10,25,55,18,30,90,32,282
2024-03-19 14:20:00,22,11,33,49,21,12,95,20,263
2024-03-19 14:30:00,22,9,26,51,23,18,109,44,302
2024-03-19 14:40:00,25,14,39,61,30,11,97,34,311
2024-03-19 14:50:00,37,12,26,42,18,12,107,31,285
2024-03-19 15:00:00,19,5,11,50,16,12,99,39,251
2024-03-19 15:10:00,17,9,14,52,16,9,131,36,284
2024-03-19 15:20:00,19,9,8,65,19,10,125,43,298
2024-03-19 15:30:00,25,13,8,51,19,12,118,28,274
2024-03-19 15:40:00,13,8,14,55,29,23,133,23,298
2024-03-19 15:50:00,17,5,9,48,15,15,105,27,241
2024-03-19 16:00:00,23,10,11,57,20,9,122,31,283
2024-03-19 16:10:00,13,9,15,68,23,8,117,10,263
2024-03-19 16:20:00,20,12,12,68,18,7,124,4,265
2024-03-19 16:30:00,21,9,16,60,14,8,124,10,262
2024-03-19 16:40:00,27,9,23,58,26,8,140,3,294
2024-03-19 16:50:00,20,7,15,76,20,11,116,32,297
2024-03-19 17:00:00,16,9,1,49,22,11,122,20,250
2024-03-19 17:10:00,15,8,27,66,20,12,118,26,292
2024-03-19 17:20:00,15,10,5,60,12,17,118,21,258
2024-03-19 17:30:00,11,6,19,62,16,9,132,32,287
2024-03-19 17:40:00,14,10,17,71,17,14,105,30,278
2024-03-19 17:50:00,19,11,23,57,22,14,115,45,306
2024-03-19 18:00:00,13,11,9,69,22,5,122,36,287
2024-03-19 18:10:00,12,7,14,58,16,9,98,26,240
2024-03-19 18:20:00,19,6,9,55,13,5,98,19,224
2024-03-19 18:30:00,22,7,14,54,14,11,98,22,242
2024-03-19 18:40:00,13,6,10,48,16,12,89,38,232
2024-03-19 18:50:00,28,13,4,51,20,11,62,19,208
2024-03-19 19:00:00,17,8,3,63,16,11,76,27,221
2024-03-19 19:10:00,10,5,5,65,11,12,49,22,179
2024-03-19 19:20:00,14,9,9,59,16,10,77,20,214
2024-03-19 19:30:00,5,2,3,33,12,6,38,25,124
2024-03-19 19:40:00,10,5,3,43,15,15,43,18,152
2024-03-19 19:50:00,4,3,6,35,26,9,53,38,174
2024-03-19 20:00:00,5,1,5,38,5,4,46,27,131
2024-03-19 20:10:00,7,3,9,42,12,11,51,26,161
2024-03-19 20:20:00,3,2,8,39,10,12,38,29,141
2024-03-19 20:30:00,4,2,13,36,15,17,45,36,168
2024-03-19 20:40:00,10,6,9,34,12,7,50,22,150
2024-03-19 20:50:00,6,2,4,31,6,5,35,24,113
2024-03-19 21:00:00,4,2,14,26,7,6,36,27,122
2024-03-19 21:10:00,3,2,9,26,13,12,29,20,114
2024-03-19 21:20:00,3,1,5,28,4,4,32,23,100
2024-03-19 21:30:00,4,2,2,22,11,8,20,23,92
2024-03-19 21:40:00,1,0,6,29,6,5,20,20,87
2024-03-19 21:50:00,10,6,4,25,5,4,26,18,98
2024-03-19 22:00:00,5,3,3,25,7,5,18,17,83
2024-03-19 22:10:00,0,0,3,9,6,5,22,25,70
2024-03-19 22:20:00,0,0,2,12,3,3,29,23,72
2024-03-19 22:30:00,3,2,4,22,7,6,20,17,81
2024-03-19 22:40:00,3,2,0,18,2,2,26,22,75
2024-03-19 22:50:00,2,2,3,11,4,4,27,22,75
2024-03-19 23:00:00,1,1,5,24,6,4,28,20,89
2024-03-19 23:10:00,4,3,1,8,2,1,14,15,48
2024-03-19 23:20:00,1,0,2,14,3,3,15,14,52
2024-03-19 23:30:00,3,1,0,5,1,2,5,5,22
2024-03-19 23:40:00,0,0,1,10,1,0,8,9,29
2024-03-19 23:50:00,2,0,4,12,2,2,13,14,49
2024-03-20 00:00:00,0,1,0,9,0,0,10,9,29
2024-03-20 00:10:00,0,0,0,10,1,1,7,10,29
2024-03-20 00:20:00,3,1,0,3,2,1,9,7,26
2024-03-20 00:30:00,0,0,0,3,1,1,3,4,12
2024-03-20 00:40:00,0,0,1,3,1,1,3,4,13
2024-03-20 00:50:00,1,1,0,7,1,1,6,6,23
2024-03-20 01:00:00,0,0,0,8,1,1,4,5,19
2024-03-20 01:10:00,1,1,1,6,0,0,1,2,12
2024-03-20 01:20:00,0,0,0,6,1,2,3,2,14
2024-03-20 01:30:00,0,0,0,6,0,0,2,2,10
2024-03-20 01:40:00,0,0,0,3,0,0,3,5,11
2024-03-20 01:50:00,0,0,0,4,1,1,3,4,13
2024-03-20 02:00:00,0,0,1,5,1,1,7,7,22
2024-03-20 02:10:00,0,0,0,5,0,0,3,4,12
2024-03-20 02:20:00,0,0,0,5,0,0,1,1,7
2024-03-20 02:30:00,0,0,0,5,0,0,1,1,7
2024-03-20 02:40:00,0,0,0,3,2,2,2,2,11
2024-03-20 02:50:00,0,0,0,5,0,0,2,2,9
2024-03-20 03:00:00,0,0,0,0,0,0,3,4,7
2024-03-20 03:10:00,0,0,0,4,0,0,3,3,10
2024-03-20 03:20:00,1,1,2,5,2,2,3,4,20
2024-03-20 03:30:00,0,0,0,2,3,2,2,2,11
2024-03-20 03:40:00,0,0,0,4,0,0,2,3,9
2024-03-20 03:50:00,0,0,0,2,0,0,3,4,9
2024-03-20 04:00:00,0,0,0,6,0,0,2,2,10
2024-03-20 04:10:00,0,0,4,10,2,3,3,3,25
2024-03-20 04:20:00,0,0,2,10,0,0,3,6,21
2024-03-20 04:30:00,0,0,0,6,0,0,4,2,12
2024-03-20 04:40:00,0,0,1,12,0,0,1,1,15
2024-03-20 04:50:00,0,0,3,22,1,1,9,8,44
2024-03-20 05:00:00,0,0,8,30,0,0,3,3,44
2024-03-20 05:10:00,0,0,7,28,2,3,7,9,56
2024-03-20 05:20:00,0,0,17,57,7,9,10,8,108
2024-03-20 05:30:00,3,0,19,51,5,2,11,11,102
2024-03-20 05:40:00,1,1,26,56,4,3,3,3,97
2024-03-20 05:50:00,2,1,29,67,5,3,13,14,134
2024-03-20 06:00:00,4,2,13,57,6,4,14,13,113
2024-03-20 06:10:00,1,1,12,94,3,4,16,16,147
2024-03-20 06:20:00,3,4,35,65,5,3,30,20,165
2024-03-20 06:30:00,3,2,25,60,6,7,21,16,140
2024-03-20 06:40:00,5,1,20,89,15,10,24,19,183
2024-03-20 06:50:00,5,3,21,82,15,4,35,19,184
2024-03-20 07:00:00,11,6,16,107,14,9,35,18,216
2024-03-20 07:10:00,6,4,32,88,15,10,29,25,209
2024-03-20 07:20:00,11,3,38,102,20,18,41,27,260
2024-03-20 07:30:00,13,3,32,95,29,14,33,26,245
2024-03-20 07:40:00,11,6,27,100,30,11,42,18,245
2024-03-20 07:50:00,18,13,31,110,28,4,46,22,272
2024-03-20 08:00:00,13,5,20,87,41,0,47,28,241
2024-03-20 08:10:00,25,8,40,91,34,1,45,19,263
2024-03-20 08:20:00,14,5,75,71,35,9,50,34,293
2024-03-20 08:30:00,11,3,42,92,30,17,48,27,270
2024-03-20 08:40:00,19,16,22,86,29,12,35,30,249
2024-03-20 08:50:00,18,6,21,82,24,17,57,27,252
2024-03-20 09:00:00,12,6,25,88,16,9,51,30,237
2024-03-20 09:10:00,17,8,25,67,25,13,43,29,227
2024-03-20 09:20:00,15,10,20,95,19,8,50,26,243
2024-03-20 09:30:00,11,7,22,59,17,13,51,40,220
2024-03-20 09:40:00,12,5,45,64,17,10,44,32,229
2024-03-20 09:50:00,10,6,42,74,19,16,60,38,265
2024-03-20 10:00:00,20,11,26,46,23,11,45,30,212
2024-03-20 10:10:00,17,10,32,55,18,13,52,42,239
2024-03-20 10:20:00,14,13,27,55,10,13,46,28,206
2024-03-20 10:30:00,14,8,27,66,13,7,59,37,231
2024-03-20 10:40:00,16,9,26,38,19,12,75,39,234
2024-03-20 10:50:00,14,8,23,54,26,13,56,49,243
2024-03-20 11:00:00,5,4,19,55,20,8,56,43,210
2024-03-20 11:10:00,17,7,31,66,13,7,56,36,233
2024-03-20 11:20:00,14,4,21,54,14,13,65,37,222
2024-03-20 11:30:00,16,8,20,36,17,10,68,41,216
2024-03-20 11:40:00,6,3,33,44,54,12,58,41,251
2024-03-20 11:50:00,10,4,26,56,14,9,62,38,219
2024-03-20 12:00:00,13,5,21,54,22,11,60,40,226
2024-03-20 12:10:00,13,6,20,50,18,9,59,32,207
2024-03-20 12:20:00,10,4,28,42,19,10,84,38,235
2024-03-20 12:30:00,11,3,32,63,10,12,62,32,225
2024-03-20 12:40:00,10,3,36,47,11,9,75,53,244
2024-03-20 12:50:00,14,5,23,59,18,11,94,29,253
2024-03-20 13:00:00,9,4,28,58,17,11,56,21,204
2024-03-20 13:10:00,24,8,24,50,23,10,89,20,248
2024-03-20 13:20:00,14,3,25,60,16,14,89,51,272
2024-03-20 13:30:00,11,6,24,54,15,13,71,40,234
2024-03-20 13:40:00,9,5,33,47,14,10,82,47,247
2024-03-20 13:50:00,20,9,25,45,14,11,79,46,249
2024-03-20 14:00:00,22,9,30,46,17,10,81,52,267
2024-03-20 14:10:00,17,7,31,45,19,9,96,40,264
2024-03-20 14:20:00,21,7,37,50,21,13,101,32,282
2024-03-20 14:30:00,11,2,29,52,13,7,96,45,255
2024-03-20 14:40:00,16,12,34,49,29,13,101,33,287
2024-03-20 14:50:00,17,6,29,63,11,11,122,44,303
2024-03-20 15:00:00,24,12,17,73,18,13,120,29,306
2024-03-20 15:10:00,21,6,16,44,17,4,114,51,273
2024-03-20 15:20:00,13,5,18,72,13,4,131,41,297
2024-03-20 15:30:00,21,9,11,64,16,14,113,19,267
2024-03-20 15:40:00,17,7,17,65,21,24,134,26,311
2024-03-20 15:50:00,14,7,15,65,11,8,119,16,255
2024-03-20 16:00:00,19,10,13,40,20,9,105,4,220
2024-03-20 16:10:00,29,12,12,51,14,10,121,9,258
2024-03-20 16:20:00,17,13,5,60,9,12,132,4,252
2024-03-20 16:30:00,19,10,17,67,27,15,126,15,296
2024-03-20 16:40:00,19,10,15,56,10,9,104,8,231
2024-03-20 16:50:00,19,10,11,74,15,11,111,28,279
2024-03-20 17:00:00,16,10,16,82,16,17,128,26,311
2024-03-20 17:10:00,23,10,28,67,16,10,124,32,310
2024-03-20 17:20:00,13,4,15,67,20,9,129,27,284
2024-03-20 17:30:00,14,6,11,52,17,9,109,31,249
2024-03-20 17:40:00,14,9,19,65,20,8,95,27,257
2024-03-20 17:50:00,31,14,10,82,17,16,118,22,310
2024-03-20 18:00:00,14,6,15,79,16,4,97,24,255
2024-03-20 18:10:00,17,8,13,55,19,9,94,29,244
2024-03-20 18:20:00,11,4,9,51,17,8,111,23,234
2024-03-20 18:30:00,19,8,8,40,12,14,80,28,209
2024-03-20 18:40:00,17,5,8,57,24,9,80,26,226
2024-03-20 18:50:00,12,7,5,39,20,9,59,21,172
2024-03-20 19:00:00,14,6,7,61,38,9,59,23,217
2024-03-20 19:10:00,15,6,14,66,12,9,83,34,239
2024-03-20 19:20:00,4,3,14,67,12,15,49,27,191
2024-03-20 19:30:00,12,5,10,44,8,6,54,32,171
2024-03-20 19:40:00,14,7,3,28,8,4,47,24,135
2024-03-20 19:50:00,13,8,5,50,10,7,67,28,188
2024-03-20 20:00:00,6,3,6,41,11,11,45,30,153
2024-03-20 20:10:00,4,2,10,36,11,12,38,23,136
2024-03-20 20:20:00,2,3,3,27,11,5,49,30,130
2024-03-20 20:30:00,10,7,10,44,16,22,36,25,170
2024-03-20 20:40:00,2,1,9,45,11,9,42,28,147
2024-03-20 20:50:00,3,2,6,32,7,4,49,22,125
2024-03-20 21:00:00,3,1,12,39,11,11,42,31,150
2024-03-20 21:10:00,6,0,14,26,4,4,45,28,127
2024-03-20 21:20:00,12,8,8,23,3,5,32,25,116
2024-03-20 21:30:00,3,3,8,34,1,1,52,30,132
2024-03-20 21:40:00,5,3,4,22,8,9,45,20,116
2024-03-20 21:50:00,2,2,9,18,9,5,31,21,97
2024-03-20 22:00:00,2,1,7,26,8,7,35,31,117
2024-03-20 22:10:00,3,2,2,19,9,7,36,35,113
2024-03-20 22:20:00,5,2,3,17,11,8,34,27,107
2024-03-20 22:30:00,4,3,7,25,6,6,37,26,114
2024-03-20 22:40:00,3,1,1,11,3,5,25,29,78
2024-03-20 22:50:00,2,1,2,18,2,1,28,23,77
2024-03-20 23:00:00,4,4,5,20,1,2,13,11,60
2024-03-20 23:10:00,2,2,0,12,3,5,16,18,58
2024-03-20 23:20:00,2,2,2,16,6,1,24,17,70
2024-03-20 23:30:00,0,0,3,12,4,0,12,12,43
2024-03-20 23:40:00,1,1,0,8,2,2,9,8,31
2024-03-20 23:50:00,0,0,0,8,3,5,14,17,47
2024-03-21 00:00:00,1,1,0,4,0,0,7,9,22
2024-03-21 00:10:00,0,0,0,7,2,1,5,7,22
2024-03-21 00:20:00,0,0,1,4,1,1,4,6,17
2024-03-21 00:30:00,1,1,2,10,2,3,4,6,29
2024-03-21 00:40:00,0,0,2,6,3,4,5,7,27
2024-03-21 00:50:00,0,0,0,5,0,0,6,8,19
2024-03-21 01:00:00,0,0,1,3,2,8,6,8,28
2024-03-21 01:10:00,1,0,1,5,1,2,6,9,25
2024-03-21 01:20:00,1,0,0,6,1,1,8,9,26
2024-03-21 01:30:00,0,0,0,4,0,0,4,4,12
2024-03-21 01:40:00,0,0,0,1,0,0,5,7,13
2024-03-21 01:50:00,0,0,1,5,0,0,1,1,8
2024-03-21 02:00:00,1,1,4,9,0,0,3,3,21
2024-03-21 02:10:00,1,1,1,8,0,0,4,5,20
2024-03-21 02:20:00,0,0,0,3,0,0,1,1,5
2024-03-21 02:30:00,0,0,0,3,1,1,4,6,15
2024-03-21 02:40:00,0,0,0,2,1,2,3,3,11
2024-03-21 02:50:00,1,1,0,8,1,1,2,3,17
2024-03-21 03:00:00,0,0,0,1,0,0,4,3,8
2024-03-21 03:10:00,0,0,1,2,1,1,1,1,7
2024-03-21 03:20:00,0,0,0,3,0,0,0,0,3
2024-03-21 03:30:00,0,0,1,7,0,0,2,2,12
2024-03-21 03:40:00,0,0,0,1,2,2,5,5,15
2024-03-21 03:50:00,0,0,0,5,1,1,3,5,15
2024-03-21 04:00:00,0,0,2,6,3,3,2,2,18
2024-03-21 04:10:00,1,0,1,11,2,2,4,3,24
2024-03-21 04:20:00,0,0,0,8,0,0,2,3,13
2024-03-21 04:30:00,0,0,1,11,0,0,0,1,13
2024-03-21 04:40:00,0,0,3,15,1,1,2,1,23
2024-03-21 04:50:00,0,0,5,19,1,1,8,7,41
2024-03-21 05:00:00,0,0,5,24,1,1,5,5,41
2024-03-21 05:10:00,1,0,5,25,3,3,6,6,49
2024-03-21 05:20:00,0,0,15,46,3,2,15,11,92
2024-03-21 05:30:00,2,0,24,50,6,6,9,11,108
2024-03-21 05:40:00,1,1,30,76,8,7,7,6,136
2024-03-21 05:50:00,4,3,42,66,5,1,9,10,140
2024-03-21 06:00:00,1,0,15,55,6,7,15,15,114
2024-03-21 06:10:00,2,2,21,76,9,8,20,14,152
2024-03-21 06:20:00,1,1,18,85,11,8,21,16,161
2024-03-21 06:30:00,1,1,25,70,9,8,24,21,159
2024-03-21 06:40:00,1,0,15,103,14,9,28,26,196
2024-03-21 06:50:00,5,3,23,85,19,7,37,23,202
2024-03-21 07:00:00,7,4,19,81,21,12,36,25,205
2024-03-21 07:10:00,2,1,27,87,17,8,34,26,202
2024-03-21 07:20:00,10,7,35,97,21,13,45,28,256
2024-03-21 07:30:00,12,6,34,90,30,14,28,25,239
2024-03-21 07:40:00,10,6,21,77,40,11,31,18,214
2024-03-21 07:50:00,15,9,34,82,28,4,51,34,257
2024-03-21 08:00:00,22,9,40,89,32,7,51,26,276
2024-03-21 08:10:00,16,8,17,93,28,7,50,26,245
2024-03-21 08:20:00,17,6,12,80,24,11,47,31,228
2024-03-21 08:30:00,11,7,32,76,15,5,55,27,228
2024-03-21 08:40:00,19,15,22,101,21,12,41,22,253
2024-03-21 08:50:00,13,6,17,79,23,8,52,33,231
2024-03-21 09:00:00,16,8,20,77,27,13,47,26,234
2024-03-21 09:10:00,15,12,24,68,17,10,40,18,204
2024-03-21 09:20:00,8,6,13,75,14,13,44,31,204
2024-03-21 09:30:00,4,1,22,76,18,15,37,27,200
2024-03-21 09:40:00,14,11,35,48,24,12,40,24,208
2024-03-21 09:50:00,21,13,29,47,24,12,48,23,217
2024-03-21 10:00:00,15,8,33,60,21,13,50,31,231
2024-03-21 10:10:00,18,11,34,56,13,15,40,32,219
2024-03-21 10:20:00,12,7,36,51,17,10,50,25,208
2024-03-21 10:30:00,14,6,27,46,15,11,55,35,209
2024-03-21 10:40:00,14,7,24,47,11,11,54,51,219
2024-03-21 10:50:00,12,12,24,42,24,16,57,35,222
2024-03-21 11:00:00,14,9,19,103,14,9,57,37,262
2024-03-21 11:10:00,13,7,31,102,13,11,50,31,258
2024-03-21 11:20:00,12,9,26,67,23,44,66,42,289
2024-03-21 11:30:00,13,6,36,86,21,11,70,34,277
2024-03-21 11:40:00,17,9,27,49,12,10,50,29,203
2024-03-21 11:50:00,22,10,23,52,22,13,77,30,249
2024-03-21 12:00:00,18,10,23,131,23,13,62,43,323
2024-03-21 12:10:00,11,6,28,112,15,16,75,31,294
2024-03-21 12:20:00,10,4,35,61,15,13,84,46,268
2024-03-21 12:30:00,20,9,37,64,17,12,72,23,254
2024-03-21 12:40:00,15,6,35,56,21,13,68,37,251
2024-03-21 12:50:00,20,8,28,49,21,22,83,42,273
2024-03-21 13:00:00,14,9,28,63,17,13,77,33,254
2024-03-21 13:10:00,12,9,25,54,24,8,106,20,258
2024-03-21 13:20:00,10,5,31,54,15,12,80,31,238
2024-03-21 13:30:00,15,5,33,25,22,14,69,31,214
2024-03-21 13:40:00,13,6,32,45,19,12,68,34,229
2024-03-21 13:50:00,11,5,34,96,21,12,80,41,300
2024-03-21 14:00:00,25,7,33,63,17,9,86,48,288
2024-03-21 14:10:00,18,8,31,88,26,15,119,28,333
2024-03-21 14:20:00,18,7,28,108,15,12,110,42,340
2024-03-21 14:30:00,16,6,27,55,11,11,78,37,241
2024-03-21 14:40:00,23,11,20,67,15,12,104,31,283
2024-03-21 14:50:00,18,5,33,53,23,5,119,30,286
2024-03-21 15:00:00,16,7,10,96,18,14,123,34,318
2024-03-21 15:10:00,24,11,16,81,15,9,126,19,301
2024-03-21 15:20:00,16,7,13,63,23,9,137,29,297
2024-03-21 15:30:00,24,11,21,69,18,7,139,29,318
2024-03-21 15:40:00,29,10,16,69,22,13,123,30,312
2024-03-21 15:50:00,24,11,18,59,12,12,124,32,292
2024-03-21 16:00:00,32,9,16,53,20,15,103,25,273
2024-03-21 16:10:00,23,8,13,60,19,7,132,13,275
2024-03-21 16:20:00,19,9,10,80,14,9,131,19,291
2024-03-21 16:30:00,22,13,29,69,14,13,122,20,302
2024-03-21 16:40:00,21,15,14,74,24,11,133,5,297
2024-03-21 16:50:00,19,8,16,64,26,6,101,25,265
2024-03-21 17:00:00,15,10,8,49,24,14,117,30,267
2024-03-21 17:10:00,24,8,17,92,9,7,109,37,303
2024-03-21 17:20:00,21,10,7,67,29,13,132,33,312
2024-03-21 17:30:00,16,9,14,63,17,15,113,25,272
2024-03-21 17:40:00,48,8,17,69,21,13,111,32,319
2024-03-21 17:50:00,18,7,20,52,18,10,123,19,267
2024-03-21 18:00:00,21,7,3,63,23,15,99,32,263
2024-03-21 18:10:00,15,11,19,62,8,7,107,37,266
2024-03-21 18:20:00,13,4,13,70,21,9,105,18,253
2024-03-21 18:30:00,10,7,6,58,16,13,94,30,234
2024-03-21 18:40:00,19,7,6,70,38,7,83,23,253
2024-03-21 18:50:00,7,3,12,44,21,10,70,31,198
2024-03-21 19:00:00,11,5,4,42,12,4,71,20,169
2024-03-21 19:10:00,16,7,10,43,17,10,67,33,203
2024-03-21 19:20:00,8,5,7,43,15,5,60,26,169
2024-03-21 19:30:00,11,7,2,47,16,10,50,27,170
2024-03-21 19:40:00,6,3,16,33,15,11,35,18,137
2024-03-21 19:50:00,10,1,5,31,12,9,54,28,150
2024-03-21 20:00:00,11,8,8,34,12,7,43,28,151
2024-03-21 20:10:00,7,3,3,34,9,12,52,26,146
2024-03-21 20:20:00,6,3,12,28,13,56,47,29,194
2024-03-21 20:30:00,9,4,6,35,14,10,48,31,157
2024-03-21 20:40:00,8,6,11,29,17,14,39,32,156
2024-03-21 20:50:00,5,3,8,32,7,3,39,27,124
2024-03-21 21:00:00,9,4,15,32,6,2,40,24,132
2024-03-21 21:10:00,4,2,8,41,13,15,32,26,141
2024-03-21 21:20:00,10,6,12,31,7,5,24,18,113
2024-03-21 21:30:00,1,0,3,18,9,4,38,27,100
2024-03-21 21:40:00,5,3,8,31,4,5,34,23,113
2024-03-21 21:50:00,4,6,4,26,10,7,33,26,116
2024-03-21 22:00:00,1,0,6,25,5,6,44,32,119
2024-03-21 22:10:00,5,4,8,26,6,8,32,15,104
2024-03-21 22:20:00,4,4,2,17,6,6,31,31,101
2024-03-21 22:30:00,1,0,5,16,5,8,18,16,69
2024-03-21 22:40:00,4,1,5,18,4,3,28,25,88
2024-03-21 22:50:00,7,5,2,20,2,1,27,24,88
2024-03-21 23:00:00,2,1,5,20,2,3,30,18,81
2024-03-21 23:10:00,3,2,1,10,3,3,19,20,61
2024-03-21 23:20:00,6,2,0,9,2,3,13,17,52
2024-03-21 23:30:00,0,0,1,16,2,2,14,13,48
2024-03-21 23:40:00,1,1,0,5,5,1,8,9,30
2024-03-21 23:50:00,1,1,0,8,1,1,14,13,39
2024-03-22 00:00:00,2,1,4,9,2,1,12,12,43
2024-03-22 00:10:00,2,1,2,16,2,2,3,3,31
2024-03-22 00:20:00,0,0,0,4,2,3,9,10,28
2024-03-22 00:30:00,2,0,0,5,6,5,5,5,28
2024-03-22 00:40:00,0,0,0,6,1,1,7,7,22
2024-03-22 00:50:00,0,0,2,6,1,1,6,12,28
2024-03-22 01:00:00,1,1,1,3,1,1,4,5,17
2024-03-22 01:10:00,0,0,0,3,2,3,8,10,26
2024-03-22 01:20:00,0,0,1,3,3,3,3,2,15
2024-03-22 01:30:00,0,0,1,5,0,0,0,0,6
2024-03-22 01:40:00,0,0,0,4,0,0,2,3,9
2024-03-22 01:50:00,0,0,2,4,0,0,2,2,10
2024-03-22 02:00:00,0,0,0,4,2,2,3,4,15
2024-03-22 02:10:00,0,0,1,3,0,0,2,3,9
2024-03-22 02:20:00,0,0,1,4,0,0,1,1,7
2024-03-22 02:30:00,1,1,0,4,1,1,4,4,16
2024-03-22 02:40:00,0,0,0,6,0,0,3,4,13
2024-03-22 02:50:00,0,0,0,5,1,1,2,2,11
2024-03-22 03:00:00,1,0,0,2,2,0,0,0,5
2024-03-22 03:10:00,0,0,0,2,0,0,1,1,4
2024-03-22 03:20:00,0,0,0,4,0,0,1,1,6
2024-03-22 03:30:00,1,1,0,4,1,2,0,0,9
2024-03-22 03:40:00,0,0,1,5,3,4,5,7,25
2024-03-22 03:50:00,0,0,2,10,0,0,3,5,20
2024-03-22 04:00:00,0,0,2,8,1,1,2,3,17
2024-03-22 04:10:00,0,0,1,6,0,0,4,5,16
2024-03-22 04:20:00,0,0,0,16,0,0,3,2,21
2024-03-22 04:30:00,0,0,0,8,0,0,1,1,10
2024-03-22 04:40:00,0,0,2,12,3,1,5,4,27
2024-03-22 04:50:00,0,0,4,32,2,1,4,4,47
2024-03-22 05:00:00,0,0,5,22,1,1,6,9,44
2024-03-22 05:10:00,1,0,11,29,3,4,7,8,63
2024-03-22 05:20:00,1,1,20,38,5,5,8,9,87
2024-03-22 05:30:00,0,0,10,53,4,5,7,8,87
2024-03-22 05:40:00,1,1,23,56,7,5,7,7,107
2024-03-22 05:50:00,3,3,26,58,6,5,7,8,116
2024-03-22 06:00:00,2,2,17,41,8,9,13,12,104
2024-03-22 06:10:00,3,2,21,74,6,5,15,12,138
2024-03-22 06:20:00,2,2,31,69,4,6,22,19,155
2024-03-22 06:30:00,3,1,25,58,8,7,22,15,139
2024-03-22 06:40:00,5,4,23,70,11,7,20,18,158
2024-03-22 06:50:00,4,2,24,96,14,9,30,20,199
2024-03-22 07:00:00,6,4,19,74,5,3,42,22,175
2024-03-22 07:10:00,4,2,28,101,12,6,21,17,191
2024-03-22 07:20:00,10,5,25,90,20,13,38,24,225
2024-03-22 07:30:00,8,4,25,96,22,14,35,21,225
2024-03-22 07:40:00,17,9,35,59,17,10,40,27,214
2024-03-22 07:50:00,11,3,35,87,26,9,39,28,238
2024-03-22 08:00:00,14,6,9,72,24,8,54,31,218
2024-03-22 08:10:00,11,6,19,97,22,12,32,18,217
2024-03-22 08:20:00,9,5,24,80,22,9,48,25,222
2024-03-22 08:30:00,4,2,18,69,20,11,43,25,192
2024-03-22 08:40:00,19,11,12,76,18,15,37,16,204
2024-03-22 08:50:00,10,7,15,68,19,9,53,30,211
2024-03-22 09:00:00,8,6,10,66,18,15,45,23,191
2024-03-22 09:10:00,17,9,14,69,20,12,41,23,205
2024-03-22 09:20:00,10,5,14,88,12,9,40,27,205
2024-03-22 09:30:00,15,9,22,75,25,13,46,32,237
2024-03-22 09:40:00,11,11,36,52,23,16,50,29,228
2024-03-22 09:50:00,12,5,33,56,16,6,42,29,199
2024-03-22 10:00:00,11,6,31,50,15,10,63,45,231
2024-03-22 10:10:00,8,8,31,57,13,10,50,23,200
2024-03-22 10:20:00,10,5,33,56,15,9,43,24,195
2024-03-22 10:30:00,23,11,35,53,19,7,48,31,227
2024-03-22 10:40:00,14,7,30,47,27,11,48,35,219
2024-03-22 10:50:00,21,8,24,69,17,10,50,26,225
2024-03-22 11:00:00,17,9,29,47,16,9,58,29,214
2024-03-22 11:10:00,20,9,31,58,26,14,64,34,256
2024-03-22 11:20:00,7,3,25,64,15,8,59,40,221
2024-03-22 11:30:00,9,5,23,53,11,11,80,37,229
2024-03-22 11:40:00,13,6,30,49,15,8,58,37,216
2024-03-22 11:50:00,12,5,32,46,21,13,75,35,239
2024-03-22 12:00:00,12,7,27,54,20,10,75,29,234
2024-03-22 12:10:00,13,6,21,48,17,11,100,27,243
2024-03-22 12:20:00,10,6,22,46,13,11,85,31,224
2024-03-22 12:30:00,19,7,4,69,17,8,94,33,251
2024-03-22 12:40:00,21,8,18,72,14,9,80,35,257
2024-03-22 12:50:00,15,7,11,71,11,7,98,33,253
2024-03-22 13:00:00,12,6,6,75,17,15,87,25,243
2024-03-22 13:10:00,18,7,21,63,22,13,111,34,289
2024-03-22 13:20:00,18,6,9,62,15,11,111,22,254
2024-03-22 13:30:00,14,5,17,69,17,9,86,31,248
2024-03-22 13:40:00,16,10,11,119,21,13,85,29,304
2024-03-22 13:50:00,18,7,17,116,14,9,106,42,329
2024-03-22 14:00:00,23,6,12,76,19,12,100,37,285
2024-03-22 14:10:00,18,8,14,70,20,13,105,37,285
2024-03-22 14:20:00,21,11,17,70,21,12,122,34,308
2024-03-22 14:30:00,23,10,17,72,11,12,112,27,284
2024-03-22 14:40:00,28,9,17,61,19,8,106,29,277
2024-03-22 14:50:00,20,9,18,71,20,5,126,21,290
2024-03-22 15:00:00,22,15,2,57,16,8,126,24,270
2024-03-22 15:10:00,21,11,20,80,17,9,118,6,282
2024-03-22 15:20:00,15,10,12,63,16,10,116,15,257
2024-03-22 15:30:00,12,7,16,68,17,9,119,17,265
2024-03-22 15:40:00,17,7,19,69,23,11,114,10,270
2024-03-22 15:50:00,16,7,16,72,16,7,141,24,299
2024-03-22 16:00:00,14,12,14,59,23,12,113,1,248
2024-03-22 16:10:00,13,8,16,54,13,9,170,17,300
2024-03-22 16:20:00,14,7,8,55,15,10,118,12,239
2024-03-22 16:30:00,12,6,16,72,18,9,109,29,271
2024-03-22 16:40:00,12,8,17,67,15,11,79,28,237
2024-03-22 16:50:00,10,5,9,55,15,14,100,30,238
2024-03-22 17:00:00,10,4,4,60,16,10,85,16,205
2024-03-22 17:10:00,17,7,19,57,17,18,95,36,266
2024-03-22 17:20:00,20,11,15,73,17,11,88,35,270
2024-03-22 17:30:00,15,7,14,62,15,13,87,32,245
2024-03-22 17:40:00,17,8,6,65,24,7,64,33,224
2024-03-22 17:50:00,17,10,10,70,18,8,82,33,248
2024-03-22 18:00:00,16,8,14,50,22,11,77,29,227
2024-03-22 18:10:00,6,3,6,50,17,10,66,25,183
2024-03-22 18:20:00,17,6,15,66,11,4,72,31,222
2024-03-22 18:30:00,5,2,3,26,12,5,24,17,94
2024-03-22 18:40:00,8,2,8,19,5,2,27,12,83
2024-03-22 18:50:00,2,1,7,43,7,6,44,15,125
2024-03-22 19:00:00,7,4,4,55,7,9,54,23,163
2024-03-22 19:10:00,8,6,12,41,19,10,55,28,179
2024-03-22 19:20:00,7,4,9,56,11,8,61,31,187
2024-03-22 19:30:00,13,7,0,59,14,12,50,35,190
2024-03-22 19:40:00,10,6,8,50,12,10,42,21,159
2024-03-22 19:50:00,9,4,7,49,10,9,43,26,157
2024-03-22 20:00:00,3,0,5,39,11,10,55,35,158
2024-03-22 20:10:00,3,3,13,34,13,12,35,20,133
2024-03-22 20:20:00,3,2,9,44,19,13,45,32,167
2024-03-22 20:30:00,9,5,12,39,10,8,43,28,154
2024-03-22 20:40:00,4,3,12,38,7,7,40,24,135
2024-03-22 20:50:00,2,2,10,35,7,6,27,19,108
2024-03-22 21:00:00,3,1,10,38,11,16,23,21,123
2024-03-22 21:10:00,1,1,15,42,6,3,34,24,126
2024-03-22 21:20:00,6,5,13,40,3,3,32,26,128
2024-03-22 21:30:00,5,5,7,26,1,1,32,25,102
2024-03-22 21:40:00,6,3,12,29,5,3,32,26,116
2024-03-22 21:50:00,3,4,5,26,5,5,33,32,113
2024-03-22 22:00:00,9,9,8,31,9,6,37,25,134
2024-03-22 22:10:00,5,3,4,21,10,8,41,26,118
2024-03-22 22:20:00,4,2,4,32,7,5,41,31,126
2024-03-22 22:30:00,5,3,5,32,4,6,33,23,111
2024-03-22 22:40:00,7,3,5,24,6,5,22,21,93
2024-03-22 22:50:00,8,7,2,28,4,6,44,35,134
2024-03-22 23:00:00,9,3,2,22,6,7,27,26,102
2024-03-22 23:10:00,1,0,4,24,0,0,21,20,70
2024-03-22 23:20:00,7,5,3,15,2,2,24,24,82
2024-03-22 23:30:00,2,2,5,32,8,7,23,23,102
2024-03-22 23:40:00,2,1,1,17,8,6,27,20,82
2024-03-22 23:50:00,4,1,2,18,4,3,22,16,70
2024-03-23 00:00:00,0,0,4,17,4,8,31,23,87
2024-03-23 00:10:00,0,0,0,6,3,2,19,18,48
2024-03-23 00:20:00,0,0,1,15,0,0,18,29,63
2024-03-23 00:30:00,4,2,1,12,0,0,8,10,37
2024-03-23 00:40:00,0,0,0,13,4,4,19,19,59
2024-03-23 00:50:00,2,1,4,13,1,1,14,19,55
2024-03-23 01:00:00,2,1,1,8,1,1,12,11,37
2024-03-23 01:10:00,1,0,0,5,1,1,6,5,19
2024-03-23 01:20:00,2,2,0,10,0,0,20,17,51
2024-03-23 01:30:00,1,1,3,8,2,5,8,12,40
2024-03-23 01:40:00,0,0,0,6,1,1,14,14,36
2024-03-23 01:50:00,0,0,0,2,0,0,12,10,24
2024-03-23 02:00:00,0,0,2,7,0,0,11,13,33
2024-03-23 02:10:00,0,0,0,2,0,0,3,5,10
2024-03-23 02:20:00,5,0,1,8,1,1,13,16,45
2024-03-23 02:30:00,1,1,1,9,0,1,10,10,33
2024-03-23 02:40:00,1,1,0,2,2,0,10,10,26
2024-03-23 02:50:00,0,0,0,4,2,3,9,12,30
2024-03-23 03:00:00,0,0,1,7,1,0,11,12,32
2024-03-23 03:10:00,0,0,0,5,1,2,10,9,27
2024-03-23 03:20:00,0,0,0,5,0,0,9,8,22
2024-03-23 03:30:00,0,0,0,1,2,4,2,2,11
2024-03-23 03:40:00,1,1,0,4,4,4,7,6,27
2024-03-23 03:50:00,0,0,0,8,0,0,6,6,20
2024-03-23 04:00:00,0,0,0,7,1,1,4,5,18
2024-03-23 04:10:00,0,0,0,8,2,2,2,2,16
2024-03-23 04:20:00,0,0,1,8,2,1,6,7,25
2024-03-23 04:30:00,0,0,1,7,4,1,2,2,17
2024-03-23 04:40:00,0,0,1,6,2,1,4,7,21
2024-03-23 04:50:00,0,0,3,8,3,4,2,3,23
2024-03-23 05:00:00,0,0,4,14,2,2,6,9,37
2024-03-23 05:10:00,0,0,2,13,2,2,7,9,35
2024-03-23 05:20:00,0,0,1,23,1,1,8,9,43
2024-03-23 05:30:00,2,1,4,22,1,1,6,6,43
2024-03-23 05:40:00,3,3,13,25,1,1,7,15,68
2024-03-23 05:50:00,1,1,3,14,2,2,4,3,30
2024-03-23 06:00:00,3,2,9,15,2,3,5,3,42
2024-03-23 06:10:00,0,0,6,19,3,3,8,9,48
2024-03-23 06:20:00,3,3,5,25,3,3,7,7,56
2024-03-23 06:30:00,1,1,2,15,3,5,14,15,56
2024-03-23 06:40:00,4,4,10,24,1,1,21,13,78
2024-03-23 06:50:00,0,0,12,14,2,1,17,14,60
2024-03-23 07:00:00,2,2,7,13,5,4,10,11,54
2024-03-23 07:10:00,0,0,5,16,1,1,7,9,39
2024-03-23 07:20:00,3,3,8,22,6,4,10,9,65
2024-03-23 07:30:00,0,0,13,26,6,5,8,10,68
2024-03-23 07:40:00,4,0,21,48,2,2,10,8,95
2024-03-23 07:50:00,3,2,5,23,5,22,9,7,76
2024-03-23 08:00:00,1,1,12,28,13,8,16,12,91
2024-03-23 08:10:00,0,0,8,45,3,3,8,5,72
2024-03-23 08:20:00,3,2,10,28,4,7,12,12,78
2024-03-23 08:30:00,2,2,21,35,7,5,15,11,98
2024-03-23 08:40:00,3,4,26,41,9,6,26,22,137
2024-03-23 08:50:00,4,0,18,26,11,9,22,16,106
2024-03-23 09:00:00,2,2,15,40,10,10,15,14,108
2024-03-23 09:10:00,3,2,10,61,12,9,22,14,133
2024-03-23 09:20:00,3,2,13,43,8,7,27,22,125
2024-03-23 09:30:00,1,1,27,51,13,24,27,22,166
2024-03-23 09:40:00,2,3,27,54,17,9,24,21,157
2024-03-23 09:50:00,6,4,30,87,18,11,22,23,201
2024-03-23 10:00:00,6,5,25,64,12,27,38,27,204
2024-03-23 10:10:00,3,4,28,110,10,9,33,33,230
2024-03-23 10:20:00,4,2,37,53,12,8,33,34,183
2024-03-23 10:30:00,4,4,14,50,14,14,26,21,147
2024-03-23 10:40:00,2,2,22,45,11,8,37,28,155
2024-03-23 10:50:00,10,5,38,59,11,6,29,22,180
2024-03-23 11:00:00,13,4,19,47,13,9,38,28,171
2024-03-23 11:10:00,2,1,35,72,15,12,40,24,201
2024-03-23 11:20:00,4,4,26,52,17,12,51,38,204
2024-03-23 11:30:00,6,3,24,48,24,21,42,35,203
2024-03-23 11:40:00,4,1,27,55,27,11,63,35,223
2024-03-23 11:50:00,9,3,32,69,15,10,66,35,239
2024-03-23 12:00:00,8,5,25,53,11,10,50,29,191
2024-03-23 12:10:00,12,3,34,59,12,14,56,23,213
2024-03-23 12:20:00,9,6,34,66,19,10,57,27,228
2024-03-23 12:30:00,7,3,34,78,13,8,49,37,229
2024-03-23 12:40:00,12,6,29,58,12,8,80,28,233
2024-03-23 12:50:00,11,6,24,52,15,21,69,31,229
2024-03-23 13:00:00,10,6,15,45,13,12,62,31,194
2024-03-23 13:10:00,11,5,31,19,16,5,67,33,187
2024-03-23 13:20:00,10,6,30,38,16,9,57,28,194
2024-03-23 13:30:00,10,2,33,47,13,18,50,24,197
2024-03-23 13:40:00,7,1,29,60,8,5,58,39,207
2024-03-23 13:50:00,51,10,30,43,17,16,90,42,299
2024-03-23 14:00:00,10,8,27,45,11,10,75,37,223
2024-03-23 14:10:00,5,6,31,66,19,13,60,34,234
2024-03-23 14:20:00,8,7,43,72,15,12,62,30,249
2024-03-23 14:30:00,8,2,19,52,13,10,63,34,201
2024-03-23 14:40:00,2,1,31,51,13,12,69,43,222
2024-03-23 14:50:00,6,3,26,37,6,4,60,37,179
2024-03-23 15:00:00,4,4,24,37,10,7,64,36,186
2024-03-23 15:10:00,4,5,27,36,14,10,69,43,208
2024-03-23 15:20:00,11,7,11,16,16,13,44,23,141
2024-03-23 15:30:00,6,6,30,50,12,11,58,35,208
2024-03-23 15:40:00,7,5,21,58,11,7,66,36,211
2024-03-23 15:50:00,10,3,28,40,5,4,70,20,180
2024-03-23 16:00:00,11,4,21,20,9,7,75,39,186
2024-03-23 16:10:00,6,4,28,60,12,7,78,37,232
2024-03-23 16:20:00,8,5,12,51,15,16,71,19,197
2024-03-23 16:30:00,5,2,23,56,17,11,66,21,201
2024-03-23 16:40:00,7,4,17,50,13,8,62,18,179
2024-03-23 16:50:00,5,2,19,42,9,8,76,33,194
2024-03-23 17:00:00,5,5,18,23,13,10,75,12,161
2024-03-23 17:10:00,7,3,29,47,14,13,62,37,212
2024-03-23 17:20:00,10,4,21,56,10,8,57,23,189
2024-03-23 17:30:00,9,3,31,38,18,10,54,32,195
2024-03-23 17:40:00,5,4,28,63,15,9,64,28,216
2024-03-23 17:50:00,10,4,30,42,18,11,59,22,196
2024-03-23 18:00:00,8,2,21,61,12,8,59,44,215
2024-03-23 18:10:00,7,5,25,45,16,9,66,31,204
2024-03-23 18:20:00,8,7,13,51,11,14,64,34,202
2024-03-23 18:30:00,5,3,20,46,13,6,62,41,196
2024-03-23 18:40:00,7,3,18,43,11,5,52,28,167
2024-03-23 18:50:00,9,8,17,45,10,13,53,29,184
2024-03-23 19:00:00,4,4,19,45,14,11,33,21,151
2024-03-23 19:10:00,9,5,10,56,14,8,43,35,180
2024-03-23 19:20:00,3,1,18,39,9,10,49,36,165
2024-03-23 19:30:00,6,2,11,38,10,6,50,33,156
2024-03-23 19:40:00,9,5,11,53,16,13,38,21,166
2024-03-23 19:50:00,13,5,10,48,8,8,66,27,185
2024-03-23 20:00:00,3,2,19,38,10,9,47,32,160
2024-03-23 20:10:00,4,2,12,42,11,8,42,30,151
2024-03-23 20:20:00,1,1,15,52,8,9,31,19,136
2024-03-23 20:30:00,7,2,17,38,9,9,37,20,139
2024-03-23 20:40:00,4,3,12,35,9,11,28,18,120
2024-03-23 20:50:00,4,2,6,36,8,7,29,16,108
2024-03-23 21:00:00,1,1,12,33,3,2,27,13,92
2024-03-23 21:10:00,5,4,5,39,7,10,34,21,125
2024-03-23 21:20:00,8,5,6,26,3,3,40,21,112
2024-03-23 21:30:00,3,4,3,24,4,3,28,17,86
2024-03-23 21:40:00,3,1,1,30,3,2,35,17,92
2024-03-23 21:50:00,14,3,3,14,7,8,33,21,103
2024-03-23 22:00:00,3,1,3,24,4,1,35,17,88
2024-03-23 22:10:00,2,2,4,26,4,4,27,20,89
2024-03-23 22:20:00,1,1,9,33,6,5,27,14,96
2024-03-23 22:30:00,5,2,0,23,1,2,31,17,81
2024-03-23 22:40:00,5,3,5,36,1,1,46,24,121
2024-03-23 22:50:00,1,0,5,30,14,12,48,22,132
2024-03-23 23:00:00,6,3,11,39,4,2,33,27,125
2024-03-23 23:10:00,3,0,7,35,3,3,48,30,129
2024-03-23 23:20:00,9,4,3,17,5,6,44,31,119
2024-03-23 23:30:00,2,2,10,32,6,3,36,25,116
2024-03-23 23:40:00,1,1,10,26,4,4,30,33,109
2024-03-23 23:50:00,0,0,3,23,1,1,42,39,109
2024-03-24 00:00:00,3,2,6,26,2,1,32,21,93
2024-03-24 00:10:00,0,0,3,23,2,2,16,16,62
2024-03-24 00:20:00,0,0,0,24,6,4,20,16,70
2024-03-24 00:30:00,2,2,1,19,2,0,16,14,56
2024-03-24 00:40:00,1,1,1,13,3,5,25,17,66
2024-03-24 00:50:00,1,1,4,21,2,1,26,16,72
2024-03-24 01:00:00,0,0,3,19,7,6,24,17,76
2024-03-24 01:10:00,0,0,0,13,3,3,12,11,42
2024-03-24 01:20:00,0,0,1,13,6,7,16,13,56
2024-03-24 01:30:00,0,0,1,10,0,0,12,10,33
2024-03-24 01:40:00,0,0,1,10,2,1,11,7,32
2024-03-24 01:50:00,0,0,3,10,0,0,14,11,38
2024-03-24 02:00:00,0,0,1,11,0,0,18,15,45
2024-03-24 02:10:00,0,0,0,7,2,2,14,12,37
2024-03-24 02:20:00,5,2,2,11,3,2,8,7,40
2024-03-24 02:30:00,2,1,0,4,1,1,7,8,24
2024-03-24 02:40:00,0,0,0,5,1,1,6,6,19
2024-03-24 02:50:00,1,0,2,7,0,0,6,6,22
2024-03-24 03:00:00,1,0,2,7,0,0,8,9,27
2024-03-24 03:10:00,0,0,0,4,1,1,5,5,16
2024-03-24 03:20:00,1,1,0,3,1,0,7,9,22
2024-03-24 03:30:00,0,0,1,5,0,0,6,8,20
2024-03-24 03:40:00,0,0,0,4,3,3,3,5,18
2024-03-24 03:50:00,0,0,0,2,1,2,7,7,19
2024-03-24 04:00:00,0,0,0,5,1,1,3,4,14
2024-03-24 04:10:00,1,0,0,2,0,0,6,7,16
2024-03-24 04:20:00,1,0,0,4,3,2,3,3,16
2024-03-24 04:30:00,0,0,1,8,0,0,4,5,18
2024-03-24 04:40:00,0,0,1,7,0,0,4,5,17
2024-03-24 04:50:00,0,0,0,8,2,3,2,2,17
2024-03-24 05:00:00,0,0,1,11,0,0,1,1,14
2024-03-24 05:10:00,0,0,0,6,1,1,4,6,18
2024-03-24 05:20:00,0,0,2,19,2,1,5,8,37
2024-03-24 05:30:00,2,0,4,15,4,3,6,7,41
2024-03-24 05:40:00,1,1,4,13,1,0,3,3,26
2024-03-24 05:50:00,0,0,0,7,1,3,3,3,17
2024-03-24 06:00:00,0,0,2,9,1,1,7,8,28
2024-03-24 06:10:00,1,1,2,11,1,1,6,6,29
2024-03-24 06:20:00,0,0,3,5,1,1,5,5,20
2024-03-24 06:30:00,2,2,5,14,2,4,3,3,35
2024-03-24 06:40:00,5,2,3,7,1,1,7,7,33
2024-03-24 06:50:00,0,0,0,4,1,0,6,6,17
2024-03-24 07:00:00,0,0,3,5,1,1,10,9,29
2024-03-24 07:10:00,1,1,0,5,3,2,8,9,29
2024-03-24 07:20:00,0,0,0,6,2,2,5,5,20
2024-03-24 07:30:00,0,0,6,11,3,2,4,4,30
2024-03-24 07:40:00,1,1,3,14,3,3,6,5,36
2024-03-24 07:50:00,4,2,3,7,4,2,10,10,42
2024-03-24 08:00:00,0,0,4,20,2,3,4,4,37
2024-03-24 08:10:00,4,1,4,10,0,0,5,5,29
2024-03-24 08:20:00,0,0,7,10,3,4,14,13,51
2024-03-24 08:30:00,1,1,4,16,2,2,8,8,42
2024-03-24 08:40:00,1,1,3,16,1,2,5,5,34
2024-03-24 08:50:00,8,5,12,23,8,4,21,18,99
2024-03-24 09:00:00,4,4,15,22,2,6,10,9,72
2024-03-24 09:10:00,9,5,12,20,9,7,10,8,80
2024-03-24 09:20:00,3,3,6,33,6,7,13,13,84
2024-03-24 09:30:00,5,3,15,29,8,6,12,12,90
2024-03-24 09:40:00,8,7,11,31,11,8,25,21,122
2024-03-24 09:50:00,5,3,29,39,5,4,20,18,123
2024-03-24 10:00:00,5,3,16,32,13,8,19,15,111
2024-03-24 10:10:00,7,3,16,36,8,8,19,15,112
2024-03-24 10:20:00,5,3,17,35,6,5,22,15,108
2024-03-24 10:30:00,2,1,9,29,11,3,24,24,103
2024-03-24 10:40:00,4,2,23,28,3,4,35,25,124
2024-03-24 10:50:00,8,8,21,51,6,10,19,16,139
2024-03-24 11:00:00,6,5,11,35,15,10,23,16,121
2024-03-24 11:10:00,0,0,14,29,8,8,18,16,93
2024-03-24 11:20:00,3,2,17,42,9,5,31,23,132
2024-03-24 11:30:00,8,4,19,35,7,7,39,18,137
2024-03-24 11:40:00,8,6,20,40,12,10,36,26,158
2024-03-24 11:50:00,4,4,28,32,8,2,45,26,149
2024-03-24 12:00:00,4,2,15,24,6,6,38,24,119
2024-03-24 12:10:00,7,3,27,62,11,8,42,25,185
2024-03-24 12:20:00,4,4,25,79,12,10,29,21,184
2024-03-24 12:30:00,13,7,24,70,11,10,30,27,192
2024-03-24 12:40:00,10,5,17,77,16,11,40,31,207
2024-03-24 12:50:00,2,2,26,43,11,7,32,18,141
2024-03-24 13:00:00,9,5,22,22,17,18,43,25,161
2024-03-24 13:10:00,8,6,27,90,9,8,37,26,211
2024-03-24 13:20:00,12,10,20,101,7,7,54,29,240
2024-03-24 13:30:00,10,5,25,116,9,7,43,26,241
2024-03-24 13:40:00,4,4,22,54,7,8,40,26,165
2024-03-24 13:50:00,16,9,35,83,11,10,37,25,226
2024-03-24 14:00:00,3,3,22,187,19,15,43,35,327
2024-03-24 14:10:00,10,4,33,88,12,7,46,27,227
2024-03-24 14:20:00,7,4,24,39,16,14,58,42,204
2024-03-24 14:30:00,9,5,38,42,12,11,52,31,200
2024-03-24 14:40:00,10,7,25,179,14,8,64,36,343
2024-03-24 14:50:00,8,4,28,66,9,7,53,25,200
2024-03-24 15:00:00,9,9,19,84,11,7,53,45,237
2024-03-24 15:10:00,6,3,18,186,19,15,59,23,329
2024-03-24 15:20:00,10,8,19,106,21,15,35,18,232
2024-03-24 15:30:00,7,5,28,42,11,7,51,39,190
2024-03-24 15:40:00,10,6,18,65,15,10,39,21,184
2024-03-24 15:50:00,5,2,15,52,13,12,35,21,155
2024-03-24 16:00:00,10,6,21,50,8,8,48,33,184
2024-03-24 16:10:00,8,4,19,36,19,20,48,27,181
2024-03-24 16:20:00,6,5,18,50,16,14,48,21,178
2024-03-24 16:30:00,3,2,30,64,13,12,56,29,209
2024-03-24 16:40:00,5,5,20,48,10,20,58,14,180
2024-03-24 16:50:00,8,5,25,28,14,20,51,20,171
2024-03-24 17:00:00,6,7,22,43,13,9,54,34,188
2024-03-24 17:10:00,11,8,28,48,18,14,53,19,199
2024-03-24 17:20:00,11,7,25,44,11,11,58,32,199
2024-03-24 17:30:00,9,6,31,42,15,9,62,26,200
2024-03-24 17:40:00,12,7,22,39,9,8,62,31,190
2024-03-24 17:50:00,7,5,30,49,13,8,53,20,185
2024-03-24 18:00:00,8,8,30,38,8,6,33,31,162
2024-03-24 18:10:00,3,2,19,91,6,6,51,30,208
2024-03-24 18:20:00,5,3,21,39,6,4,37,25,140
2024-03-24 18:30:00,5,5,19,28,14,11,40,16,138
2024-03-24 18:40:00,4,1,25,42,10,7,36,21,146
2024-03-24 18:50:00,8,3,21,46,9,7,37,21,152
2024-03-24 19:00:00,3,3,8,32,5,5,29,24,109
2024-03-24 19:10:00,5,1,13,37,7,7,31,26,127
2024-03-24 19:20:00,10,7,16,35,9,8,35,30,150
2024-03-24 19:30:00,6,5,20,35,12,15,31,36,160
2024-03-24 19:40:00,3,2,18,35,10,11,41,35,155
2024-03-24 19:50:00,7,5,11,29,6,11,39,21,129
2024-03-24 20:00:00,2,0,14,41,9,6,46,30,148
2024-03-24 20:10:00,7,3,12,30,3,7,57,25,144
2024-03-24 20:20:00,2,0,12,50,10,6,30,24,134
2024-03-24 20:30:00,2,1,13,39,7,5,41,28,136
2024-03-24 20:40:00,2,1,6,29,8,6,21,18,91
2024-03-24 20:50:00,6,4,3,20,5,2,49,30,119
2024-03-24 21:00:00,3,1,5,21,10,8,30,35,113
2024-03-24 21:10:00,4,1,6,15,7,8,25,18,84
2024-03-24 21:20:00,5,2,5,22,5,6,26,21,92
2024-03-24 21:30:00,0,0,4,30,5,3,27,17,86
2024-03-24 21:40:00,4,4,5,22,3,3,19,22,82
2024-03-24 21:50:00,4,2,10,21,5,8,11,11,72
2024-03-24 22:00:00,8,3,4,21,4,3,24,18,85
2024-03-24 22:10:00,2,1,3,26,3,3,23,23,84
2024-03-24 22:20:00,3,1,4,11,3,4,21,20,67
2024-03-24 22:30:00,4,4,1,10,3,6,18,20,66
2024-03-24 22:40:00,2,1,3,15,3,1,26,23,74
2024-03-24 22:50:00,0,0,1,13,2,1,15,17,49
2024-03-24 23:00:00,1,1,1,13,0,0,16,16,48
2024-03-24 23:10:00,1,1,0,5,2,2,9,11,31
2024-03-24 23:20:00,1,1,4,15,4,2,12,13,52
2024-03-24 23:30:00,0,0,0,13,6,10,12,12,53
2024-03-24 23:40:00,4,2,0,7,0,0,12,12,37
2024-03-24 23:50:00,0,0,0,15,3,4,12,14,48
2024-03-25 00:00:00,1,0,2,5,0,0,4,4,16
2024-03-25 00:10:00,0,0,1,7,2,2,3,4,19
2024-03-25 00:20:00,3,1,0,7,2,1,8,9,31
2024-03-25 00:30:00,0,0,0,8,1,2,5,6,22
2024-03-25 00:40:00,0,0,1,7,0,0,5,6,19
2024-03-25 00:50:00,0,0,0,8,0,0,8,10,26
2024-03-25 01:00:00,0,0,1,3,0,0,8,10,22
2024-03-25 01:10:00,0,0,2,6,0,0,4,4,16
2024-03-25 01:20:00,1,0,0,3,1,2,4,4,15
2024-03-25 01:30:00,0,0,0,3,1,0,7,8,19
2024-03-25 01:40:00,0,0,0,2,0,0,0,0,2
2024-03-25 01:50:00,0,0,0,1,0,0,6,5,12
2024-03-25 02:00:00,1,1,0,6,2,2,2,2,16
2024-03-25 02:10:00,1,0,0,6,0,0,2,2,11
2024-03-25 02:20:00,0,0,0,3,0,0,2,2,7
2024-03-25 02:30:00,0,0,0,6,0,0,4,4,14
2024-03-25 02:40:00,0,0,0,4,1,1,0,0,6
2024-03-25 02:50:00,0,0,0,1,1,1,1,1,5
2024-03-25 03:00:00,0,0,0,0,0,0,6,9,15
2024-03-25 03:10:00,0,0,1,6,0,0,3,4,14
2024-03-25 03:20:00,0,0,0,4,2,2,2,2,12
2024-03-25 03:30:00,1,1,0,6,0,0,2,1,11
2024-03-25 03:40:00,0,0,1,1,0,0,4,4,10
2024-03-25 03:50:00,1,1,1,13,0,0,2,2,20
2024-03-25 04:00:00,0,0,1,6,0,0,5,6,18
2024-03-25 04:10:00,0,0,1,8,2,2,6,7,26
2024-03-25 04:20:00,0,0,4,12,4,5,1,1,27
2024-03-25 04:30:00,0,0,0,10,1,0,5,5,21
2024-03-25 04:40:00,0,0,3,7,1,1,4,8,24
2024-03-25 04:50:00,0,0,5,26,1,1,2,3,38
2024-03-25 05:00:00,0,0,2,15,1,1,8,12,39
2024-03-25 05:10:00,2,1,9,19,1,1,7,7,47
2024-03-25 05:20:00,0,0,18,54,3,4,6,7,92
2024-03-25 05:30:00,0,0,21,41,4,4,4,4,78
2024-03-25 05:40:00,5,5,22,53,7,8,4,3,107
2024-03-25 05:50:00,0,0,22,56,10,10,11,13,122
2024-03-25 06:00:00,5,1,16,45,6,6,9,10,98
2024-03-25 06:10:00,7,3,18,77,5,4,18,16,148
2024-03-25 06:20:00,3,3,32,67,5,5,16,14,145
2024-03-25 06:30:00,3,1,17,72,8,6,28,22,157
2024-03-25 06:40:00,5,5,18,89,8,5,26,21,177
2024-03-25 06:50:00,7,4,25,96,15,9,29,27,212
2024-03-25 07:00:00,2,1,27,72,10,5,25,18,160
2024-03-25 07:10:00,0,1,17,78,13,7,26,22,164
2024-03-25 07:20:00,3,2,20,95,11,11,42,32,216
2024-03-25 07:30:00,10,4,25,105,23,12,28,19,226
2024-03-25 07:40:00,10,4,22,103,17,10,35,25,226
2024-03-25 07:50:00,8,5,29,79,17,15,43,34,230
2024-03-25 08:00:00,15,6,32,93,14,13,35,30,238
2024-03-25 08:10:00,11,5,21,73,21,11,35,22,199
2024-03-25 08:20:00,12,4,19,97,23,10,36,32,233
2024-03-25 08:30:00,10,6,27,58,27,23,33,24,208
2024-03-25 08:40:00,11,3,16,91,14,26,43,30,234
2024-03-25 08:50:00,7,5,25,69,18,17,37,28,206
2024-03-25 09:00:00,8,3,25,79,17,18,33,25,208
2024-03-25 09:10:00,17,4,20,92,12,11,36,27,219
2024-03-25 09:20:00,11,1,14,70,26,20,42,28,212
2024-03-25 09:30:00,11,3,31,70,9,7,50,38,219
2024-03-25 09:40:00,17,8,39,41,12,12,43,33,205
2024-03-25 09:50:00,13,9,39,79,20,15,45,38,258
2024-03-25 10:00:00,12,11,39,60,21,13,35,32,223
2024-03-25 10:10:00,8,6,37,62,13,15,55,40,236
2024-03-25 10:20:00,11,6,32,61,18,12,50,47,237
2024-03-25 10:30:00,12,8,42,64,17,17,48,32,240
2024-03-25 10:40:00,11,4,39,74,18,7,64,47,264
2024-03-25 10:50:00,11,7,29,61,16,14,42,38,218
2024-03-25 11:00:00,10,8,10,57,11,13,59,43,211
2024-03-25 11:10:00,10,9,28,42,14,7,59,33,202
2024-03-25 11:20:00,8,6,35,63,14,8,64,49,247
2024-03-25 11:30:00,9,5,40,59,19,11,50,51,244
2024-03-25 11:40:00,12,7,34,57,14,10,63,40,237
2024-03-25 11:50:00,21,11,21,52,14,11,70,37,237
2024-03-25 12:00:00,12,6,25,53,13,8,72,38,227
2024-03-25 12:10:00,14,7,31,43,18,13,63,39,228
2024-03-25 12:20:00,11,3,23,50,11,5,57,29,189
2024-03-25 12:30:00,13,4,33,57,15,8,71,37,238
2024-03-25 12:40:00,14,6,36,45,16,8,59,36,220
2024-03-25 12:50:00,15,8,30,45,13,8,55,27,201
2024-03-25 13:00:00,10,4,31,52,13,8,57,24,199
2024-03-25 13:10:00,10,5,24,49,18,11,63,19,199
2024-03-25 13:20:00,7,3,18,50,15,14,65,32,204
2024-03-25 13:30:00,13,5,22,58,12,10,88,37,245
2024-03-25 13:40:00,10,5,41,61,10,14,65,44,250
2024-03-25 13:50:00,13,6,26,38,13,8,80,49,233
2024-03-25 14:00:00,14,3,25,57,17,14,74,42,246
2024-03-25 14:10:00,20,7,29,56,15,7,79,55,268
2024-03-25 14:20:00,18,7,26,57,12,16,72,62,270
2024-03-25 14:30:00,15,7,23,51,26,16,95,53,286
2024-03-25 14:40:00,18,5,27,37,20,16,90,61,274
2024-03-25 14:50:00,29,7,34,54,20,13,102,41,300
2024-03-25 15:00:00,18,5,10,62,13,17,91,51,267
2024-03-25 15:10:00,19,13,7,61,14,22,92,48,276
2024-03-25 15:20:00,16,6,9,63,14,1,128,28,265
2024-03-25 15:30:00,17,9,11,62,18,15,112,19,263
2024-03-25 15:40:00,21,12,28,71,18,11,108,32,301
2024-03-25 15:50:00,11,7,10,59,21,15,139,15,277
2024-03-25 16:00:00,23,5,5,61,14,13,123,0,244
2024-03-25 16:10:00,12,7,16,51,13,9,134,0,242
2024-03-25 16:20:00,20,8,19,68,12,13,113,4,257
2024-03-25 16:30:00,22,12,10,55,11,7,107,9,233
2024-03-25 16:40:00,13,11,28,64,22,9,90,0,237
2024-03-25 16:50:00,14,7,16,64,15,15,100,3,234
2024-03-25 17:00:00,48,11,8,59,16,9,111,8,270
2024-03-25 17:10:00,11,9,6,54,19,7,99,7,212
2024-03-25 17:20:00,14,11,13,63,17,16,103,32,269
2024-03-25 17:30:00,15,7,9,55,14,5,116,42,263
2024-03-25 17:40:00,10,6,8,74,21,16,102,36,273
2024-03-25 17:50:00,14,7,10,73,15,16,90,76,301
2024-03-25 18:00:00,12,4,10,56,22,11,99,86,300
2024-03-25 18:10:00,9,6,16,71,21,11,87,51,272
2024-03-25 18:20:00,11,8,11,58,10,5,87,22,212
2024-03-25 18:30:00,12,4,14,60,19,9,78,23,219
2024-03-25 18:40:00,16,9,9,70,16,10,57,27,214
2024-03-25 18:50:00,7,5,7,63,19,11,55,22,189
2024-03-25 19:00:00,15,10,1,41,12,8,58,24,169
2024-03-25 19:10:00,8,5,7,35,17,15,72,38,197
2024-03-25 19:20:00,8,5,10,41,16,20,46,25,171
2024-03-25 19:30:00,7,5,4,49,8,5,51,38,167
2024-03-25 19:40:00,6,4,4,39,8,3,44,32,140
2024-03-25 19:50:00,5,5,4,42,8,7,44,29,144
2024-03-25 20:00:00,5,2,4,32,11,12,45,26,137
2024-03-25 20:10:00,14,6,2,26,10,7,41,22,128
2024-03-25 20:20:00,2,2,4,30,9,12,34,23,116
2024-03-25 20:30:00,7,4,10,23,6,3,22,20,95
2024-03-25 20:40:00,2,2,13,34,5,2,36,23,117
2024-03-25 20:50:00,3,2,8,24,5,3,30,21,96
2024-03-25 21:00:00,4,3,6,23,5,7,34,26,108
2024-03-25 21:10:00,3,1,11,25,8,6,24,25,103
2024-03-25 21:20:00,10,5,8,21,7,8,47,31,137
2024-03-25 21:30:00,4,2,6,24,6,10,21,19,92
2024-03-25 21:40:00,2,1,8,31,9,6,24,19,100
2024-03-25 21:50:00,4,1,6,21,7,9,28,24,100
2024-03-25 22:00:00,1,1,3,21,10,3,28,25,92
2024-03-25 22:10:00,3,1,1,25,6,3,21,22,82
2024-03-25 22:20:00,9,3,5,21,6,5,29,17,95
2024-03-25 22:30:00,6,2,3,16,5,4,22,23,81
2024-03-25 22:40:00,8,2,3,15,4,5,29,34,100
2024-03-25 22:50:00,2,2,0,11,4,3,21,29,72
2024-03-25 23:00:00,3,1,4,15,4,5,38,31,101
2024-03-25 23:10:00,1,0,0,11,3,4,38,17,74
2024-03-25 23:20:00,0,0,1,17,0,0,28,28,74
2024-03-25 23:30:00,0,0,4,17,1,2,11,13,48
2024-03-25 23:40:00,0,0,0,8,2,4,10,12,36
2024-03-25 23:50:00,0,0,0,11,3,3,13,12,42
2024-03-26 00:00:00,1,1,1,14,4,2,8,9,40
2024-03-26 00:10:00,0,0,2,14,0,0,14,16,46
2024-03-26 00:20:00,0,0,0,10,0,0,7,8,25
2024-03-26 00:30:00,0,0,2,6,2,3,8,11,32
2024-03-26 00:40:00,0,0,0,5,3,3,8,10,29
2024-03-26 00:50:00,0,0,0,3,1,2,7,7,20
2024-03-26 01:00:00,0,0,0,2,1,1,2,2,8
2024-03-26 01:10:00,0,0,0,3,2,2,7,7,21
2024-03-26 01:20:00,1,1,0,9,1,1,5,6,24
2024-03-26 01:30:00,1,0,0,9,1,4,1,1,17
2024-03-26 01:40:00,0,0,0,3,1,1,2,4,11
2024-03-26 01:50:00,2,1,1,5,0,0,4,4,17
2024-03-26 02:00:00,0,0,1,8,0,0,3,5,17
2024-03-26 02:10:00,5,1,0,3,0,0,1,1,11
2024-03-26 02:20:00,2,1,1,4,0,0,0,0,8
2024-03-26 02:30:00,0,0,1,4,0,0,3,2,10
2024-03-26 02:40:00,0,0,0,3,1,0,3,3,10
2024-03-26 02:50:00,0,0,0,1,0,0,3,3,7
2024-03-26 03:00:00,0,0,0,5,1,0,1,1,8
2024-03-26 03:10:00,0,0,0,3,3,3,3,3,15
2024-03-26 03:20:00,0,0,0,0,2,1,4,5,12
2024-03-26 03:30:00,0,0,0,1,0,0,2,2,5
2024-03-26 03:40:00,0,0,0,5,1,1,1,2,10
2024-03-26 03:50:00,2,0,0,6,0,0,6,5,19
2024-03-26 04:00:00,0,0,0,6,0,0,1,1,8
2024-03-26 04:10:00,0,0,2,10,1,2,1,1,17
2024-03-26 04:20:00,0,0,0,11,0,0,5,8,24
2024-03-26 04:30:00,0,0,3,13,0,0,5,6,27
2024-03-26 04:40:00,1,1,3,15,3,3,5,3,34
2024-03-26 04:50:00,1,0,2,13,0,0,2,3,21
2024-03-26 05:00:00,1,1,4,22,0,0,6,8,42
2024-03-26 05:10:00,2,2,7,30,3,7,7,7,65
2024-03-26 05:20:00,1,1,11,39,2,3,9,10,76
2024-03-26 05:30:00,1,0,21,52,3,3,12,14,106
2024-03-26 05:40:00,2,1,31,64,5,4,10,10,127
2024-03-26 05:50:00,1,1,39,56,9,12,12,14,144
2024-03-26 06:00:00,3,1,16,59,2,1,13,12,107
2024-03-26 06:10:00,6,3,22,70,5,5,23,18,152
2024-03-26 06:20:00,2,2,24,80,3,3,23,22,159
2024-03-26 06:30:00,6,2,14,81,5,5,32,20,165
2024-03-26 06:40:00,4,1,15,78,9,5,29,23,164
2024-03-26 06:50:00,7,2,15,93,13,9,25,20,184
2024-03-26 07:00:00,1,2,22,87,19,10,46,30,217
2024-03-26 07:10:00,8,2,12,86,12,9,21,14,164
2024-03-26 07:20:00,10,5,17,108,14,9,36,25,224
2024-03-26 07:30:00,9,8,23,89,11,8,25,16,189
2024-03-26 07:40:00,11,4,25,78,28,11,31,20,208
2024-03-26 07:50:00,9,3,27,71,16,5,51,28,210
2024-03-26 08:00:00,12,6,27,72,23,10,37,19,206
2024-03-26 08:10:00,4,3,24,92,9,6,32,20,190
2024-03-26 08:20:00,14,3,13,88,22,9,33,22,204
2024-03-26 08:30:00,17,7,24,81,19,13,47,29,237
2024-03-26 08:40:00,16,8,22,79,23,9,41,27,225
2024-03-26 08:50:00,13,9,14,82,24,8,69,34,253
2024-03-26 09:00:00,14,6,15,82,19,13,46,23,218
2024-03-26 09:10:00,20,9,30,86,20,11,33,23,232
2024-03-26 09:20:00,12,4,24,80,12,10,50,24,216
2024-03-26 09:30:00,11,7,23,80,15,41,33,28,238
2024-03-26 09:40:00,15,6,39,73,20,12,47,35,247
2024-03-26 09:50:00,15,6,33,66,13,10,52,32,227
2024-03-26 10:00:00,13,5,28,64,20,12,46,31,219
2024-03-26 10:10:00,9,6,32,58,22,12,65,26,230
2024-03-26 10:20:00,10,6,38,57,19,15,53,33,231
2024-03-26 10:30:00,14,6,26,55,12,11,45,32,201
2024-03-26 10:40:00,11,10,54,64,12,10,49,38,248
2024-03-26 10:50:00,11,8,29,48,14,9,63,41,223
2024-03-26 11:00:00,16,6,34,57,9,7,58,30,217
2024-03-26 11:10:00,13,10,29,48,15,11,48,24,198
2024-03-26 11:20:00,20,8,28,45,13,10,62,38,224
2024-03-26 11:30:00,16,10,28,61,19,11,42,21,208
2024-03-26 11:40:00,16,9,17,48,14,8,78,38,228
2024-03-26 11:50:00,14,9,21,75,19,12,51,31,232
2024-03-26 12:00:00,15,8,25,76,5,4,58,30,221
2024-03-26 12:10:00,14,8,24,36,12,7,82,36,219
2024-03-26 12:20:00,14,8,22,41,12,9,62,34,202
2024-03-26 12:30:00,18,9,27,46,17,11,69,28,225
2024-03-26 12:40:00,7,4,26,48,19,12,72,38,226
2024-03-26 12:50:00,16,8,28,51,16,12,71,44,246
2024-03-26 13:00:00,7,2,21,52,16,8,81,37,224
2024-03-26 13:10:00,11,5,37,43,16,14,71,46,243
2024-03-26 13:20:00,11,4,34,57,10,10,66,42,234
2024-03-26 13:30:00,9,8,30,44,15,10,56,45,217
2024-03-26 13:40:00,18,4,38,54,12,7,71,28,232
2024-03-26 13:50:00,14,5,28,61,20,8,65,36,237
2024-03-26 14:00:00,19,8,23,46,16,12,72,33,229
2024-03-26 14:10:00,13,8,27,57,13,8,75,39,240
2024-03-26 14:20:00,21,12,24,48,14,13,97,47,276
2024-03-26 14:30:00,20,6,37,56,16,13,89,45,282
2024-03-26 14:40:00,22,9,30,62,14,15,86,43,281
2024-03-26 14:50:00,14,6,18,55,14,12,107,39,265
2024-03-26 15:00:00,18,7,12,48,23,13,80,39,240
2024-03-26 15:10:00,27,13,13,55,11,29,111,40,299
2024-03-26 15:20:00,19,5,11,38,19,7,111,22,232
2024-03-26 15:30:00,20,9,9,54,14,12,128,17,263
2024-03-26 15:40:00,12,4,12,60,21,16,116,31,272
2024-03-26 15:50:00,18,6,19,59,99,12,109,34,356
2024-03-26 16:00:00,24,8,12,68,18,10,99,30,269
2024-03-26 16:10:00,19,9,24,62,21,8,115,27,285
2024-03-26 16:20:00,21,11,14,78,15,12,107,23,281
2024-03-26 16:30:00,20,14,14,61,12,11,112,45,289
2024-03-26 16:40:00,21,16,6,44,69,10,117,21,304
2024-03-26 16:50:00,12,8,17,48,16,10,117,27,255
2024-03-26 17:00:00,17,8,8,73,33,4,94,24,261
2024-03-26 17:10:00,16,5,7,59,15,12,111,24,249
2024-03-26 17:20:00,9,4,9,48,15,15,107,33,240
2024-03-26 17:30:00,12,11,8,54,13,7,117,25,247
2024-03-26 17:40:00,12,6,6,71,22,12,93,26,248
2024-03-26 17:50:00,9,5,6,64,21,15,105,48,273
2024-03-26 18:00:00,17,7,8,70,17,10,85,49,263
2024-03-26 18:10:00,14,6,18,55,16,12,82,18,221
2024-03-26 18:20:00,17,8,11,69,16,10,96,23,250
2024-03-26 18:30:00,19,9,8,60,19,7,80,26,228
2024-03-26 18:40:00,14,7,9,55,20,14,77,25,221
2024-03-26 18:50:00,6,6,9,51,15,10,66,25,188
2024-03-26 19:00:00,9,7,7,45,7,5,57,29,166
2024-03-26 19:10:00,16,9,7,48,10,6,57,23,176
2024-03-26 19:20:00,12,7,2,46,12,8,55,28,170
2024-03-26 19:30:00,14,10,3,44,15,8,52,25,171
2024-03-26 19:40:00,6,6,10,35,8,8,37,26,136
2024-03-26 19:50:00,10,8,1,36,15,9,44,19,142
2024-03-26 20:00:00,5,3,7,30,10,8,42,25,130
2024-03-26 20:10:00,4,2,5,35,10,8,45,27,136
2024-03-26 20:20:00,4,4,7,37,8,10,44,23,137
2024-03-26 20:30:00,9,4,6,30,7,4,38,20,118
2024-03-26 20:40:00,10,4,9,40,6,5,37,23,134
2024-03-26 20:50:00,5,2,11,43,4,2,30,23,120
2024-03-26 21:00:00,1,1,10,33,5,4,28,25,107
2024-03-26 21:10:00,3,2,9,21,6,4,38,29,112
2024-03-26 21:20:00,7,1,4,28,5,4,34,24,107
2024-03-26 21:30:00,5,1,4,24,3,5,22,21,85
2024-03-26 21:40:00,6,3,7,33,3,4,21,15,92
2024-03-26 21:50:00,4,3,2,21,4,5,39,30,108
2024-03-26 22:00:00,5,5,4,19,6,10,32,21,102
2024-03-26 22:10:00,2,1,8,17,3,0,30,20,81
2024-03-26 22:20:00,4,2,4,18,5,6,28,23,90
2024-03-26 22:30:00,2,1,2,13,5,6,29,26,84
2024-03-26 22:40:00,6,1,6,18,2,1,17,17,68
2024-03-26 22:50:00,3,1,2,16,5,7,25,21,80
2024-03-26 23:00:00,1,1,2,11,4,5,14,19,57
2024-03-26 23:10:00,1,1,1,11,2,3,28,20,67
2024-03-26 23:20:00,2,0,1,10,2,3,22,19,59
2024-03-26 23:30:00,4,1,0,11,1,1,15,20,53
2024-03-26 23:40:00,3,1,3,8,1,3,11,16,46
2024-03-26 23:50:00,0,0,3,12,3,3,11,12,44
2024-03-27 00:00:00,0,0,1,12,2,2,9,9,35
2024-03-27 00:10:00,1,1,0,8,1,1,9,9,30
2024-03-27 00:20:00,0,0,1,8,1,2,11,11,34
2024-03-27 00:30:00,0,0,2,7,1,1,6,18,35
2024-03-27 00:40:00,0,0,0,1,0,0,7,8,16
2024-03-27 00:50:00,0,0,1,7,4,4,5,6,27
2024-03-27 01:00:00,1,1,1,6,0,0,5,8,22
2024-03-27 01:10:00,0,0,2,2,0,0,1,1,6
2024-03-27 01:20:00,0,0,1,5,2,2,1,1,12
2024-03-27 01:30:00,0,0,1,6,0,3,4,4,18
2024-03-27 01:40:00,0,0,0,2,1,1,7,8,19
2024-03-27 01:50:00,1,0,0,4,0,0,1,2,8
2024-03-27 02:00:00,0,0,0,4,0,0,2,3,9
2024-03-27 02:10:00,0,0,2,7,0,0,1,1,11
2024-03-27 02:20:00,0,0,1,4,0,0,5,8,18
2024-03-27 02:30:00,1,1,0,5,1,1,3,3,15
2024-03-27 02:40:00,0,0,0,8,1,1,3,3,16
2024-03-27 02:50:00,0,0,0,3,0,0,3,3,9
2024-03-27 03:00:00,0,0,2,5,0,0,2,2,11
2024-03-27 03:10:00,0,0,0,0,0,0,0,0,0
2024-03-27 03:20:00,1,2,0,2,2,4,0,0,11
2024-03-27 03:30:00,1,1,0,3,0,0,3,3,11
2024-03-27 03:40:00,0,0,0,3,1,1,3,3,11
2024-03-27 03:50:00,0,0,0,5,1,1,3,5,15
2024-03-27 04:00:00,0,0,0,1,0,0,4,3,8
2024-03-27 04:10:00,0,0,0,6,1,1,1,1,10
2024-03-27 04:20:00,0,0,0,12,1,2,6,6,27
2024-03-27 04:30:00,0,0,1,7,2,1,2,2,15
2024-03-27 04:40:00,0,0,1,11,2,2,5,4,25
2024-03-27 04:50:00,0,0,3,21,1,1,3,3,32
2024-03-27 05:00:00,2,0,3,19,0,0,6,7,37
2024-03-27 05:10:00,1,0,3,28,3,4,6,7,52
2024-03-27 05:20:00,0,0,16,39,5,8,7,8,83
2024-03-27 05:30:00,0,0,22,47,4,4,9,11,97
2024-03-27 05:40:00,3,2,27,63,5,6,7,5,118
2024-03-27 05:50:00,1,1,29,66,4,3,8,6,118
2024-03-27 06:00:00,4,3,13,65,8,5,15,14,127
2024-03-27 06:10:00,2,3,25,68,5,3,26,18,150
2024-03-27 06:20:00,2,1,23,60,4,3,29,27,149
2024-03-27 06:30:00,2,1,19,67,7,4,27,18,145
2024-03-27 06:40:00,1,2,14,95,13,7,28,16,176
2024-03-27 06:50:00,5,3,17,85,9,6,42,32,199
2024-03-27 07:00:00,5,1,20,90,13,6,28,21,184
2024-03-27 07:10:00,4,1,20,106,13,7,37,20,208
2024-03-27 07:20:00,11,2,28,105,14,12,26,22,220
2024-03-27 07:30:00,6,4,15,92,12,10,46,36,221
2024-03-27 07:40:00,12,7,27,87,19,8,41,22,223
2024-03-27 07:50:00,13,4,32,81,19,11,47,28,235
2024-03-27 08:00:00,10,8,22,74,16,7,31,23,191
2024-03-27 08:10:00,13,7,15,87,15,11,32,25,205
2024-03-27 08:20:00,13,6,19,91,21,9,33,28,220
2024-03-27 08:30:00,8,6,17,102,21,11,34,27,226
2024-03-27 08:40:00,14,10,22,78,20,6,33,24,207
2024-03-27 08:50:00,11,4,19,71,24,10,37,24,200
2024-03-27 09:00:00,5,0,18,74,22,13,40,27,199
2024-03-27 09:10:00,12,4,13,69,24,8,33,19,182
2024-03-27 09:20:00,9,5,18,79,16,11,52,27,217
2024-03-27 09:30:00,13,10,23,75,19,8,32,19,199
2024-03-27 09:40:00,12,5,36,69,23,15,46,28,234
2024-03-27 09:50:00,12,7,26,67,16,10,51,29,218
2024-03-27 10:00:00,12,7,33,57,23,14,54,38,238
2024-03-27 10:10:00,11,6,29,45,12,9,44,33,189
2024-03-27 10:20:00,15,9,42,64,17,10,63,33,253
2024-03-27 10:30:00,14,6,43,51,18,12,58,39,241
2024-03-27 10:40:00,13,8,34,52,16,24,66,39,252
2024-03-27 10:50:00,16,11,26,48,20,11,57,34,223
2024-03-27 11:00:00,17,10,28,71,23,12,71,47,279
2024-03-27 11:10:00,14,9,31,46,23,10,65,34,232
2024-03-27 11:20:00,5,4,22,58,14,8,64,36,211
2024-03-27 11:30:00,7,4,29,61,14,8,73,40,236
2024-03-27 11:40:00,14,5,27,57,10,7,72,34,226
2024-03-27 11:50:00,18,10,36,47,10,7,56,27,211
2024-03-27 12:00:00,18,8,26,45,14,10,70,38,229
2024-03-27 12:10:00,7,2,30,53,20,9,67,32,220
2024-03-27 12:20:00,15,5,23,50,13,10,76,36,228
2024-03-27 12:30:00,17,8,30,56,14,8,66,37,236
2024-03-27 12:40:00,15,12,33,50,16,9,67,23,225
2024-03-27 12:50:00,11,6,36,55,15,11,86,23,243
2024-03-27 13:00:00,14,9,23,52,15,11,72,30,226
2024-03-27 13:10:00,14,7,26,78,17,10,74,32,258
2024-03-27 13:20:00,15,7,27,57,10,8,78,38,240
2024-03-27 13:30:00,10,5,31,71,17,9,67,39,249
2024-03-27 13:40:00,11,6,28,69,14,7,75,36,246
2024-03-27 13:50:00,22,10,28,39,21,16,73,34,243
2024-03-27 14:00:00,16,8,18,59,16,10,80,27,234
2024-03-27 14:10:00,20,9,17,46,17,13,92,32,246
2024-03-27 14:20:00,22,12,28,46,7,6,94,36,251
2024-03-27 14:30:00,8,4,22,72,12,11,109,34,272
2024-03-27 14:40:00,16,7,32,48,13,9,88,28,241
2024-03-27 14:50:00,17,10,29,65,14,6,112,18,271
2024-03-27 15:00:00,18,7,17,59,12,9,107,35,264
2024-03-27 15:10:00,13,9,17,58,14,11,106,44,272
2024-03-27 15:20:00,21,8,7,47,21,7,93,13,217
2024-03-27 15:30:00,20,13,13,75,17,13,132,26,309
2024-03-27 15:40:00,24,9,23,52,13,8,102,21,252
2024-03-27 15:50:00,26,11,13,79,17,6,115,34,301
2024-03-27 16:00:00,31,11,10,70,15,6,118,31,292
2024-03-27 16:10:00,20,8,5,60,14,8,134,18,267
2024-03-27 16:20:00,13,5,11,54,9,7,107,28,234
2024-03-27 16:30:00,15,10,11,61,12,6,120,27,262
2024-03-27 16:40:00,12,10,22,72,11,6,117,26,276
2024-03-27 16:50:00,23,13,4,58,11,11,111,14,245
2024-03-27 17:00:00,9,7,8,44,17,8,108,17,218
2024-03-27 17:10:00,18,9,22,54,26,8,101,15,253
2024-03-27 17:20:00,13,10,25,48,11,10,110,17,244
2024-03-27 17:30:00,11,6,9,63,20,15,109,18,251
2024-03-27 17:40:00,19,10,22,56,20,13,82,19,241
2024-03-27 17:50:00,10,5,10,62,14,10,103,13,227
2024-03-27 18:00:00,19,8,8,52,20,10,105,17,239
2024-03-27 18:10:00,11,6,13,76,16,11,87,20,240
2024-03-27 18:20:00,8,8,13,42,13,12,142,12,250
2024-03-27 18:30:00,16,9,10,57,13,9,88,19,221
2024-03-27 18:40:00,15,6,17,43,18,9,80,19,207
2024-03-27 18:50:00,8,4,8,64,26,16,65,20,211
2024-03-27 19:00:00,12,6,6,43,18,8,50,19,162
2024-03-27 19:10:00,11,9,13,53,7,4,56,22,175
2024-03-27 19:20:00,8,5,5,48,16,12,45,15,154
2024-03-27 19:30:00,6,3,4,51,8,6,46,19,143
2024-03-27 19:40:00,10,8,5,43,15,10,45,18,154
2024-03-27 19:50:00,9,6,7,52,7,7,63,16,167
2024-03-27 20:00:00,8,5,11,35,12,10,40,16,137
2024-03-27 20:10:00,8,6,11,40,2,3,44,21,135
2024-03-27 20:20:00,7,4,10,44,7,4,54,18,148
2024-03-27 20:30:00,5,4,11,38,7,6,35,18,124
2024-03-27 20:40:00,2,1,9,30,6,3,35,14,100
2024-03-27 20:50:00,3,3,6,34,3,6,40,19,114
2024-03-27 21:00:00,5,4,5,17,8,6,32,15,92
2024-03-27 21:10:00,7,4,4,20,4,8,26,16,89
2024-03-27 21:20:00,8,4,5,16,6,1,40,19,99
2024-03-27 21:30:00,7,4,12,27,7,5,32,20,114
2024-03-27 21:40:00,7,5,7,23,7,5,35,20,109
2024-03-27 21:50:00,6,5,3,22,5,10,31,18,100
2024-03-27 22:00:00,6,6,11,20,8,5,39,20,115
2024-03-27 22:10:00,0,0,11,21,12,9,39,28,120
2024-03-27 22:20:00,7,3,6,20,2,3,23,17,81
2024-03-27 22:30:00,3,0,3,10,7,6,28,16,73
2024-03-27 22:40:00,1,1,0,9,4,1,24,14,54
2024-03-27 22:50:00,4,2,4,22,2,2,18,20,74
2024-03-27 23:00:00,0,0,3,9,2,3,16,16,49
2024-03-27 23:10:00,1,0,3,19,3,3,21,18,68
2024-03-27 23:20:00,4,2,0,19,4,5,25,16,75
2024-03-27 23:30:00,0,0,2,8,2,4,14,14,44
2024-03-27 23:40:00,0,0,2,9,2,1,8,10,32
2024-03-27 23:50:00,0,0,2,10,3,2,15,15,47
2024-03-28 00:00:00,0,0,2,16,0,0,6,8,32
2024-03-28 00:10:00,1,1,0,6,0,0,6,6,20
2024-03-28 00:20:00,0,0,0,8,2,0,9,4,23
2024-03-28 00:30:00,0,0,0,9,0,0,9,11,29
2024-03-28 00:40:00,0,0,1,5,1,2,4,5,18
2024-03-28 00:50:00,1,1,1,7,1,3,9,10,33
2024-03-28 01:00:00,0,0,0,3,1,1,12,18,35
2024-03-28 01:10:00,0,0,0,4,0,0,4,6,14
2024-03-28 01:20:00,3,1,0,3,1,1,5,6,20
2024-03-28 01:30:00,0,0,0,7,1,2,3,4,17
2024-03-28 01:40:00,1,1,1,4,2,1,6,6,22
2024-03-28 01:50:00,0,0,0,4,2,3,2,3,14
2024-03-28 02:00:00,2,1,1,4,0,0,3,3,14
2024-03-28 02:10:00,0,0,1,3,0,0,2,3,9
2024-03-28 02:20:00,0,0,1,2,0,0,4,4,11
2024-03-28 02:30:00,0,0,0,1,0,0,3,3,7
2024-03-28 02:40:00,0,0,0,6,0,0,4,4,14
2024-03-28 02:50:00,0,0,0,6,2,2,2,3,15
2024-03-28 03:00:00,0,0,0,3,3,2,1,1,10
2024-03-28 03:10:00,0,0,0,5,1,1,2,3,12
2024-03-28 03:20:00,0,0,0,2,0,0,4,4,10
2024-03-28 03:30:00,0,0,1,4,1,1,3,4,14
2024-03-28 03:40:00,0,0,0,1,2,2,3,4,12
2024-03-28 03:50:00,0,0,1,4,1,2,4,5,17
2024-03-28 04:00:00,1,1,0,6,0,0,1,2,11
2024-03-28 04:10:00,0,0,1,4,2,3,1,2,13
2024-03-28 04:20:00,0,0,2,8,0,0,3,3,16
2024-03-28 04:30:00,0,0,1,9,0,0,8,7,25
2024-03-28 04:40:00,0,0,0,12,2,2,3,4,23
2024-03-28 04:50:00,0,0,3,25,2,3,6,8,47
2024-03-28 05:00:00,1,1,5,19,1,2,5,7,41
2024-03-28 05:10:00,0,0,9,29,1,1,8,9,57
2024-03-28 05:20:00,0,0,15,41,4,6,8,8,82
2024-03-28 05:30:00,0,0,9,55,5,8,13,12,102
2024-03-28 05:40:00,0,0,31,46,3,4,7,7,98
2024-03-28 05:50:00,3,1,14,49,2,2,11,12,94
2024-03-28 06:00:00,0,0,12,51,7,6,10,10,96
2024-03-28 06:10:00,2,2,18,60,3,3,19,18,125
2024-03-28 06:20:00,3,1,22,72,8,6,24,19,155
2024-03-28 06:30:00,1,1,13,82,10,6,25,20,158
2024-03-28 06:40:00,6,3,12,80,6,6,25,16,154
2024-03-28 06:50:00,3,1,17,97,9,6,26,24,183
2024-03-28 07:00:00,4,2,18,70,11,8,31,20,164
2024-03-28 07:10:00,2,1,19,92,9,3,32,22,180
2024-03-28 07:20:00,10,5,31,111,20,11,20,17,225
2024-03-28 07:30:00,7,2,20,78,16,16,36,21,196
2024-03-28 07:40:00,9,5,24,85,23,6,28,18,198
2024-03-28 07:50:00,10,7,17,82,15,10,45,18,204
2024-03-28 08:00:00,14,8,23,61,16,5,43,31,201
2024-03-28 08:10:00,11,8,8,78,21,6,43,17,192
2024-03-28 08:20:00,12,11,23,93,15,8,36,24,222
2024-03-28 08:30:00,6,5,21,85,14,14,30,19,194
2024-03-28 08:40:00,9,4,27,82,22,11,46,26,227
2024-03-28 08:50:00,9,5,25,81,26,12,43,20,221
2024-03-28 09:00:00,13,8,23,79,17,13,41,24,218
2024-03-28 09:10:00,8,8,22,85,16,15,39,19,212
2024-03-28 09:20:00,17,8,25,79,14,13,55,26,237
2024-03-28 09:30:00,11,7,22,58,8,5,41,18,170
2024-03-28 09:40:00,6,6,31,70,14,10,30,23,190
2024-03-28 09:50:00,15,6,42,78,12,6,53,31,243
2024-03-28 10:00:00,12,10,31,74,11,11,51,26,226
2024-03-28 10:10:00,19,9,38,71,14,11,61,25,248
2024-03-28 10:20:00,16,9,35,45,15,10,41,29,200
2024-03-28 10:30:00,13,8,38,65,15,13,48,38,238
2024-03-28 10:40:00,7,3,29,44,17,14,59,33,206
2024-03-28 10:50:00,10,5,28,61,22,12,69,30,237
2024-03-28 11:00:00,12,8,33,72,13,12,59,36,245
2024-03-28 11:10:00,15,6,23,57,20,14,54,26,215
2024-03-28 11:20:00,15,6,39,76,15,10,69,31,261
2024-03-28 11:30:00,11,8,32,68,8,8,56,24,215
2024-03-28 11:40:00,17,8,20,52,22,13,68,30,230
2024-03-28 11:50:00,26,9,39,86,17,16,84,34,311
2024-03-28 12:00:00,15,7,24,39,12,14,70,34,215
2024-03-28 12:10:00,10,4,33,141,16,9,74,29,316
2024-03-28 12:20:00,8,6,38,52,14,8,73,27,226
2024-03-28 12:30:00,17,8,25,46,15,13,74,26,224
2024-03-28 12:40:00,14,6,39,47,17,10,80,25,238
2024-03-28 12:50:00,14,9,21,48,17,10,56,24,199
2024-03-28 13:00:00,9,4,17,83,9,15,82,31,250
2024-03-28 13:10:00,13,8,23,106,25,17,90,30,312
2024-03-28 13:20:00,12,5,17,84,11,10,83,23,245
2024-03-28 13:30:00,14,9,17,87,15,7,90,35,274
2024-03-28 13:40:00,14,6,42,82,16,9,72,38,279
2024-03-28 13:50:00,19,13,28,62,19,9,88,34,272
2024-03-28 14:00:00,15,7,26,59,12,12,72,48,251
2024-03-28 14:10:00,15,10,28,35,17,9,96,32,242
2024-03-28 14:20:00,16,6,28,51,17,26,108,26,278
2024-03-28 14:30:00,14,5,32,81,15,13,95,43,298
2024-03-28 14:40:00,17,7,30,72,20,15,89,39,289
2024-03-28 14:50:00,22,8,15,112,10,6,97,26,296
2024-03-28 15:00:00,18,11,18,84,19,7,91,35,283
2024-03-28 15:10:00,15,5,18,35,18,10,106,44,251
2024-03-28 15:20:00,23,9,18,35,21,10,117,18,251
2024-03-28 15:30:00,21,13,12,99,16,12,113,10,296
2024-03-28 15:40:00,20,9,16,27,17,17,102,14,222
2024-03-28 15:50:00,19,13,11,148,12,11,118,24,356
2024-03-28 16:00:00,14,9,17,60,16,14,126,30,286
2024-03-28 16:10:00,22,12,14,74,13,11,116,8,270
2024-03-28 16:20:00,16,7,11,123,20,11,125,20,333
2024-03-28 16:30:00,22,10,10,78,17,8,100,27,272
2024-03-28 16:40:00,17,10,22,73,17,11,102,31,283
2024-03-28 16:50:00,15,9,16,70,14,8,103,33,268
2024-03-28 17:00:00,22,12,9,68,19,11,117,27,285
2024-03-28 17:10:00,21,12,17,65,17,7,128,21,288
2024-03-28 17:20:00,15,9,15,72,12,8,103,24,258
2024-03-28 17:30:00,14,11,10,45,23,9,93,22,227
2024-03-28 17:40:00,15,7,11,70,19,10,92,31,255
2024-03-28 17:50:00,17,4,5,64,19,15,99,16,239
2024-03-28 18:00:00,17,7,8,79,14,9,92,39,265
2024-03-28 18:10:00,20,12,9,64,17,7,84,24,237
2024-03-28 18:20:00,10,6,10,62,13,13,91,28,233
2024-03-28 18:30:00,9,6,9,65,19,10,75,27,220
2024-03-28 18:40:00,14,5,12,61,32,15,81,29,249
2024-03-28 18:50:00,3,1,3,62,13,7,83,30,202
2024-03-28 19:00:00,9,6,1,63,12,9,76,18,194
2024-03-28 19:10:00,13,6,9,53,9,6,62,28,186
2024-03-28 19:20:00,12,10,6,73,10,7,77,31,226
2024-03-28 19:30:00,8,4,3,47,9,8,44,22,145
2024-03-28 19:40:00,12,5,6,59,12,9,47,31,181
2024-03-28 19:50:00,7,3,3,48,9,10,52,34,166
2024-03-28 20:00:00,9,4,8,47,8,6,56,23,161
2024-03-28 20:10:00,17,10,5,32,13,5,57,21,160
2024-03-28 20:20:00,2,2,5,57,3,4,57,36,166
2024-03-28 20:30:00,4,3,14,45,12,7,36,31,152
2024-03-28 20:40:00,3,2,1,26,5,3,45,21,106
2024-03-28 20:50:00,1,0,8,44,4,5,34,24,120
2024-03-28 21:00:00,12,4,13,47,8,5,42,30,161
2024-03-28 21:10:00,6,2,9,27,5,5,45,29,128
2024-03-28 21:20:00,4,3,5,25,8,7,41,33,126
2024-03-28 21:30:00,6,4,6,29,4,2,41,34,126
2024-03-28 21:40:00,9,6,7,31,5,4,34,30,126
2024-03-28 21:50:00,2,1,5,32,4,4,29,29,106
2024-03-28 22:00:00,1,0,3,26,4,4,32,20,90
2024-03-28 22:10:00,5,3,8,26,8,3,47,27,127
2024-03-28 22:20:00,4,3,3,30,7,10,41,27,125
2024-03-28 22:30:00,1,0,1,27,2,3,34,29,97
2024-03-28 22:40:00,1,1,4,20,3,1,24,20,74
2024-03-28 22:50:00,3,1,2,24,6,7,33,25,101
2024-03-28 23:00:00,4,3,5,25,5,1,25,16,84
2024-03-28 23:10:00,5,3,2,12,3,4,31,25,85
2024-03-28 23:20:00,0,0,7,23,3,6,29,23,91
2024-03-28 23:30:00,1,1,5,18,1,1,19,21,67
2024-03-28 23:40:00,1,1,1,12,4,5,16,21,61
2024-03-28 23:50:00,1,0,1,14,4,3,16,22,61
2024-03-29 00:00:00,0,1,1,10,3,2,21,24,62
2024-03-29 00:10:00,1,1,1,12,4,2,14,15,50
2024-03-29 00:20:00,0,0,1,15,1,1,19,17,54
2024-03-29 00:30:00,0,0,1,8,1,4,11,11,36
2024-03-29 00:40:00,1,1,3,11,2,1,7,9,35
2024-03-29 00:50:00,0,0,2,12,7,7,7,10,45
2024-03-29 01:00:00,2,1,2,10,2,3,16,15,51
2024-03-29 01:10:00,1,1,0,3,4,3,9,10,31
2024-03-29 01:20:00,0,0,1,2,3,4,12,12,34
2024-03-29 01:30:00,0,0,0,14,4,3,7,8,36
2024-03-29 01:40:00,0,0,1,8,0,0,7,9,25
2024-03-29 01:50:00,0,0,4,12,3,3,9,12,43
2024-03-29 02:00:00,0,0,1,4,0,0,9,11,25
2024-03-29 02:10:00,1,1,1,3,2,1,5,7,21
2024-03-29 02:20:00,0,0,1,7,0,6,7,7,28
2024-03-29 02:30:00,1,1,0,6,0,0,4,7,19
2024-03-29 02:40:00,1,1,0,3,0,0,3,4,12
2024-03-29 02:50:00,0,0,1,5,1,1,7,7,22
2024-03-29 03:00:00,0,0,0,7,2,2,3,4,18
2024-03-29 03:10:00,0,0,0,1,1,1,7,9,19
2024-03-29 03:20:00,2,2,0,6,1,1,11,13,36
2024-03-29 03:30:00,0,0,0,4,0,0,5,8,17
2024-03-29 03:40:00,0,0,0,5,0,0,5,6,16
2024-03-29 03:50:00,0,0,0,3,1,1,7,8,20
2024-03-29 04:00:00,0,0,0,5,0,0,7,7,19
2024-03-29 04:10:00,0,0,0,3,0,0,4,5,12
2024-03-29 04:20:00,3,0,1,7,3,2,2,3,21
2024-03-29 04:30:00,0,0,3,7,0,0,5,5,20
2024-03-29 04:40:00,0,0,3,3,0,0,4,3,13
2024-03-29 04:50:00,0,0,0,13,0,0,7,11,31
2024-03-29 05:00:00,1,0,1,11,0,0,2,2,17
2024-03-29 05:10:00,0,0,1,9,0,0,4,3,17
2024-03-29 05:20:00,1,1,3,15,1,0,6,3,30
2024-03-29 05:30:00,2,2,7,22,2,2,4,4,45
2024-03-29 05:40:00,1,1,6,21,1,1,5,5,41
2024-03-29 05:50:00,1,1,2,9,1,1,6,6,27
2024-03-29 06:00:00,1,1,4,8,1,1,8,5,29
2024-03-29 06:10:00,3,3,3,14,1,1,7,7,39
2024-03-29 06:20:00,0,0,3,12,2,3,5,6,31
2024-03-29 06:30:00,3,3,3,14,2,1,7,7,40
2024-03-29 06:40:00,1,1,4,8,0,0,5,6,25
2024-03-29 06:50:00,2,1,2,8,1,1,5,5,25
2024-03-29 07:00:00,1,1,0,7,4,2,6,6,27
2024-03-29 07:10:00,3,5,1,7,3,3,7,7,36
2024-03-29 07:20:00,0,0,3,13,3,2,7,6,34
2024-03-29 07:30:00,0,0,0,15,3,4,4,3,29
2024-03-29 07:40:00,0,0,2,10,5,6,7,6,36
2024-03-29 07:50:00,3,0,5,19,2,2,2,3,36
2024-03-29 08:00:00,1,0,6,10,0,0,8,6,31
2024-03-29 08:10:00,2,2,3,15,1,1,3,3,30
2024-03-29 08:20:00,0,0,1,13,4,5,8,8,39
2024-03-29 08:30:00,1,1,4,16,2,2,4,5,35
2024-03-29 08:40:00,0,0,5,15,7,4,12,11,54
2024-03-29 08:50:00,6,5,8,17,9,7,16,12,80
2024-03-29 09:00:00,4,0,10,19,7,5,14,15,74
2024-03-29 09:10:00,4,4,7,16,8,5,19,11,74
2024-03-29 09:20:00,1,1,6,21,5,3,12,11,60
2024-03-29 09:30:00,0,1,7,17,6,5,7,7,50
2024-03-29 09:40:00,8,6,10,28,8,6,16,14,96
2024-03-29 09:50:00,3,2,19,26,7,8,25,18,108
2024-03-29 10:00:00,5,5,16,30,6,5,19,14,100
2024-03-29 10:10:00,6,4,7,32,10,9,14,13,95
2024-03-29 10:20:00,1,1,18,37,8,5,20,17,107
2024-03-29 10:30:00,9,6,14,29,7,7,23,16,111
2024-03-29 10:40:00,2,2,19,41,7,11,31,21,134
2024-03-29 10:50:00,2,1,13,27,6,5,16,13,83
2024-03-29 11:00:00,4,3,15,17,5,2,18,18,82
2024-03-29 11:10:00,2,1,23,37,12,10,29,19,133
2024-03-29 11:20:00,5,2,15,35,7,7,33,21,125
2024-03-29 11:30:00,6,6,19,39,6,6,35,30,147
2024-03-29 11:40:00,15,11,11,32,12,12,35,19,147
2024-03-29 11:50:00,6,4,13,30,5,6,30,21,115
2024-03-29 12:00:00,3,2,19,48,10,12,28,19,141
2024-03-29 12:10:00,8,6,18,35,7,9,28,22,133
2024-03-29 12:20:00,4,3,24,36,11,10,39,21,148
2024-03-29 12:30:00,7,5,28,30,11,8,22,17,128
2024-03-29 12:40:00,5,2,19,43,16,7,38,25,155
2024-03-29 12:50:00,3,2,23,39,17,12,27,20,143
2024-03-29 13:00:00,7,7,29,40,16,8,25,16,148
2024-03-29 13:10:00,5,4,16,31,10,8,26,16,116
2024-03-29 13:20:00,3,3,17,33,6,4,35,27,128
2024-03-29 13:30:00,9,7,26,35,9,6,35,27,154
2024-03-29 13:40:00,6,3,19,33,11,11,30,19,132
2024-03-29 13:50:00,8,8,23,45,11,11,44,27,177
2024-03-29 14:00:00,2,2,19,44,9,7,36,18,137
2024-03-29 14:10:00,9,6,20,50,8,7,51,24,175
2024-03-29 14:20:00,6,6,16,28,11,11,53,26,157
2024-03-29 14:30:00,15,8,18,28,20,12,53,33,187
2024-03-29 14:40:00,4,3,28,33,7,7,40,26,148
2024-03-29 14:50:00,4,4,12,36,9,8,32,23,128
2024-03-29 15:00:00,6,3,20,33,12,10,48,22,154
2024-03-29 15:10:00,5,4,23,40,5,5,37,23,142
2024-03-29 15:20:00,7,6,25,39,12,10,48,23,170
2024-03-29 15:30:00,5,4,24,34,19,13,39,22,160
2024-03-29 15:40:00,9,8,17,34,17,10,40,23,158
2024-03-29 15:50:00,10,8,14,42,13,8,27,19,141
2024-03-29 16:00:00,9,5,23,33,6,10,41,29,156
2024-03-29 16:10:00,3,2,22,51,8,6,35,18,145
2024-03-29 16:20:00,3,3,12,49,13,11,37,20,148
2024-03-29 16:30:00,6,5,31,48,8,8,40,28,174
2024-03-29 16:40:00,13,9,26,35,10,8,41,22,164
2024-03-29 16:50:00,10,7,13,45,7,7,37,21,147
2024-03-29 17:00:00,5,5,18,44,6,6,37,26,147
2024-03-29 17:10:00,11,7,24,19,10,8,48,19,146
2024-03-29 17:20:00,2,3,30,36,9,9,42,26,157
2024-03-29 17:30:00,7,2,20,41,16,11,38,24,159
2024-03-29 17:40:00,10,7,14,30,19,14,33,21,148
2024-03-29 17:50:00,6,3,26,41,13,12,24,21,146
2024-03-29 18:00:00,13,6,20,41,12,8,36,25,161
2024-03-29 18:10:00,4,4,25,37,14,11,38,24,157
2024-03-29 18:20:00,10,6,18,43,7,7,23,20,134
2024-03-29 18:30:00,9,7,25,42,10,12,34,24,163
2024-03-29 18:40:00,7,6,28,43,16,9,39,23,171
2024-03-29 18:50:00,7,6,15,49,15,12,26,18,148
2024-03-29 19:00:00,8,6,10,28,15,11,39,25,142
2024-03-29 19:10:00,4,5,17,49,14,13,59,20,181
2024-03-29 19:20:00,2,2,22,45,6,6,42,18,143
2024-03-29 19:30:00,10,6,3,36,12,6,32,15,120
2024-03-29 19:40:00,5,4,13,37,7,9,25,18,118
2024-03-29 19:50:00,3,4,13,58,10,12,29,19,148
2024-03-29 20:00:00,5,5,15,34,9,7,29,20,124
2024-03-29 20:10:00,1,1,8,31,12,11,43,22,129
2024-03-29 20:20:00,5,4,17,42,6,6,35,17,132
2024-03-29 20:30:00,6,7,9,41,9,10,37,19,138
2024-03-29 20:40:00,8,7,9,35,9,7,24,16,115
2024-03-29 20:50:00,2,2,16,29,9,6,21,14,99
2024-03-29 21:00:00,9,8,11,39,6,5,29,12,119
2024-03-29 21:10:00,6,5,5,27,8,4,34,22,111
2024-03-29 21:20:00,7,4,9,29,9,6,17,11,92
2024-03-29 21:30:00,3,2,10,34,0,0,31,16,96
2024-03-29 21:40:00,1,1,1,23,6,5,36,23,96
2024-03-29 21:50:00,0,0,11,27,2,2,23,18,83
2024-03-29 22:00:00,2,2,14,30,2,2,34,13,99
2024-03-29 22:10:00,3,3,2,26,4,2,43,21,104
2024-03-29 22:20:00,0,0,2,31,5,10,31,17,96
2024-03-29 22:30:00,4,4,2,27,2,4,34,22,99
2024-03-29 22:40:00,0,0,0,20,5,6,32,17,80
2024-03-29 22:50:00,2,2,9,22,4,4,16,15,74
2024-03-29 23:00:00,2,2,4,20,6,3,28,14,79
2024-03-29 23:10:00,2,2,1,20,2,2,23,15,67
2024-03-29 23:20:00,0,0,3,14,1,0,22,15,55
2024-03-29 23:30:00,0,0,3,21,4,3,17,13,61
2024-03-29 23:40:00,0,0,2,18,2,2,16,12,52
2024-03-29 23:50:00,0,0,0,16,1,1,20,13,51
2024-03-30 00:00:00,2,2,5,12,2,1,15,12,51
2024-03-30 00:10:00,1,1,1,4,2,1,14,9,33
2024-03-30 00:20:00,1,1,0,9,4,3,11,10,39
2024-03-30 00:30:00,2,2,0,8,2,2,11,11,38
2024-03-30 00:40:00,1,1,2,18,2,1,8,6,39
2024-03-30 00:50:00,0,0,1,10,3,3,9,8,34
2024-03-30 01:00:00,0,0,0,3,1,1,12,11,28
2024-03-30 01:10:00,0,0,1,9,0,0,12,9,31
2024-03-30 01:20:00,2,2,3,11,1,1,7,6,33
2024-03-30 01:30:00,1,1,0,5,0,0,9,8,24
2024-03-30 01:40:00,1,1,0,10,4,3,8,7,34
2024-03-30 01:50:00,0,0,4,10,1,0,5,4,24
2024-03-30 02:00:00,0,0,1,12,1,1,3,3,21
2024-03-30 02:10:00,0,0,0,11,0,0,5,3,19
2024-03-30 02:20:00,0,0,0,8,2,1,8,7,26
2024-03-30 02:30:00,0,0,0,7,1,1,9,7,25
2024-03-30 02:40:00,0,0,0,2,1,1,3,3,10
2024-03-30 02:50:00,0,0,0,1,0,0,10,11,22
2024-03-30 03:00:00,0,0,0,2,1,1,5,5,14
2024-03-30 03:10:00,0,0,0,7,1,1,0,0,9
2024-03-30 03:20:00,0,0,0,4,1,1,3,3,12
2024-03-30 03:30:00,1,1,0,3,0,0,3,3,11
2024-03-30 03:40:00,0,0,1,3,3,4,6,6,23
2024-03-30 03:50:00,0,0,0,4,0,0,6,5,15
2024-03-30 04:00:00,0,0,1,3,1,1,2,2,10
2024-03-30 04:10:00,1,1,0,4,0,0,9,9,24
2024-03-30 04:20:00,0,0,0,8,1,0,4,4,17
2024-03-30 04:30:00,1,1,0,3,0,0,4,3,12
2024-03-30 04:40:00,0,0,0,3,0,0,2,2,7
2024-03-30 04:50:00,0,0,1,15,1,1,4,4,26
2024-03-30 05:00:00,0,0,5,18,1,2,2,2,30
2024-03-30 05:10:00,0,0,0,14,0,0,3,3,20
2024-03-30 05:20:00,0,0,2,16,2,2,4,3,29
2024-03-30 05:30:00,0,0,3,23,2,1,5,6,40
2024-03-30 05:40:00,1,1,5,17,1,1,7,7,40
2024-03-30 05:50:00,0,0,3,17,2,2,5,5,34
2024-03-30 06:00:00,0,0,5,12,2,3,11,8,41
2024-03-30 06:10:00,0,0,6,8,3,2,6,6,31
2024-03-30 06:20:00,3,2,8,17,1,0,12,15,58
2024-03-30 06:30:00,4,3,1,15,1,1,12,12,49
2024-03-30 06:40:00,2,1,7,17,0,0,13,8,48
2024-03-30 06:50:00,2,1,6,15,0,0,7,7,38
2024-03-30 07:00:00,2,1,5,12,4,4,16,13,57
2024-03-30 07:10:00,1,1,4,16,5,4,8,8,47
2024-03-30 07:20:00,0,0,6,12,7,5,7,7,44
2024-03-30 07:30:00,3,1,3,15,3,3,8,9,45
2024-03-30 07:40:00,1,1,12,21,5,6,11,10,67
2024-03-30 07:50:00,0,0,6,20,2,2,9,9,48
2024-03-30 08:00:00,3,1,14,24,1,1,9,9,62
2024-03-30 08:10:00,2,1,5,17,8,6,7,7,53
2024-03-30 08:20:00,4,1,9,22,4,5,10,9,64
2024-03-30 08:30:00,1,2,16,24,4,5,15,12,79
2024-03-30 08:40:00,4,2,19,37,10,15,18,17,122
2024-03-30 08:50:00,5,4,20,31,11,7,20,17,115
2024-03-30 09:00:00,8,3,10,42,10,6,25,18,122
2024-03-30 09:10:00,6,4,18,29,16,13,23,22,131
2024-03-30 09:20:00,3,3,15,56,15,11,20,17,140
2024-03-30 09:30:00,4,4,17,52,9,7,19,19,131
2024-03-30 09:40:00,3,2,17,59,9,8,29,19,146
2024-03-30 09:50:00,6,4,36,60,14,25,31,25,201
2024-03-30 10:00:00,7,2,23,45,17,6,28,27,155
2024-03-30 10:10:00,2,2,32,54,17,11,30,27,175
2024-03-30 10:20:00,6,4,28,55,10,6,46,32,187
2024-03-30 10:30:00,3,1,27,44,10,11,35,28,159
2024-03-30 10:40:00,6,2,34,62,10,7,46,31,198
2024-03-30 10:50:00,8,5,27,48,14,10,46,28,186
2024-03-30 11:00:00,13,6,38,60,15,10,39,29,210
2024-03-30 11:10:00,9,3,32,37,21,11,56,43,212
2024-03-30 11:20:00,10,7,34,69,17,9,57,28,231
2024-03-30 11:30:00,4,3,33,58,17,12,65,30,222
2024-03-30 11:40:00,4,3,30,63,8,9,46,29,192
2024-03-30 11:50:00,8,4,28,58,12,5,56,35,206
2024-03-30 12:00:00,8,6,24,62,10,11,48,29,198
2024-03-30 12:10:00,8,5,26,52,11,8,50,35,195
2024-03-30 12:20:00,8,4,20,46,17,13,48,29,185
2024-03-30 12:30:00,12,10,31,71,8,10,59,31,232
2024-03-30 12:40:00,6,4,50,52,16,12,62,30,232
2024-03-30 12:50:00,2,3,33,66,15,11,46,28,204
2024-03-30 13:00:00,13,6,28,65,15,12,57,31,227
2024-03-30 13:10:00,10,6,44,57,22,11,67,37,254
2024-03-30 13:20:00,5,3,23,65,10,14,61,34,215
2024-03-30 13:30:00,9,5,13,65,13,7,65,31,208
2024-03-30 13:40:00,9,6,33,47,11,8,68,32,214
2024-03-30 13:50:00,6,4,32,59,20,14,59,32,226
2024-03-30 14:00:00,12,7,23,50,21,12,70,36,231
2024-03-30 14:10:00,14,7,36,52,14,7,65,37,232
2024-03-30 14:20:00,8,3,24,57,8,6,79,40,225
2024-03-30 14:30:00,19,11,32,39,20,11,61,39,232
2024-03-30 14:40:00,7,2,27,65,17,13,69,36,236
2024-03-30 14:50:00,15,6,20,59,20,14,86,34,254
2024-03-30 15:00:00,13,3,35,51,16,7,66,41,232
2024-03-30 15:10:00,10,4,34,47,6,7,76,33,217
2024-03-30 15:20:00,7,3,21,39,8,5,62,37,182
2024-03-30 15:30:00,10,8,21,65,18,9,53,39,223
2024-03-30 15:40:00,11,6,37,52,13,5,61,34,219
2024-03-30 15:50:00,11,6,15,51,18,10,78,34,223
2024-03-30 16:00:00,6,4,12,49,11,6,71,39,198
2024-03-30 16:10:00,15,7,21,44,15,13,79,40,234
2024-03-30 16:20:00,7,4,15,51,13,11,67,28,196
2024-03-30 16:30:00,5,5,28,41,16,12,62,31,200
2024-03-30 16:40:00,2,2,17,55,9,8,71,25,189
2024-03-30 16:50:00,6,3,21,54,18,12,76,34,224
2024-03-30 17:00:00,12,6,21,48,13,9,62,31,202
2024-03-30 17:10:00,6,4,20,56,8,6,63,41,204
2024-03-30 17:20:00,7,6,14,55,7,4,61,34,188
2024-03-30 17:30:00,12,5,19,38,17,13,56,41,201
2024-03-30 17:40:00,6,2,14,55,14,11,56,32,190
2024-03-30 17:50:00,8,3,19,47,14,11,53,37,192
2024-03-30 18:00:00,4,3,7,38,13,11,58,27,161
2024-03-30 18:10:00,5,4,13,43,10,7,58,33,173
2024-03-30 18:20:00,2,2,15,38,16,10,50,38,171
2024-03-30 18:30:00,2,2,20,40,11,9,56,33,173
2024-03-30 18:40:00,8,5,20,26,38,9,60,33,199
2024-03-30 18:50:00,5,3,10,40,11,10,47,30,156
2024-03-30 19:00:00,8,7,6,41,14,10,31,20,137
2024-03-30 19:10:00,8,4,7,38,14,13,52,29,165
2024-03-30 19:20:00,6,2,9,45,8,7,48,26,151
2024-03-30 19:30:00,4,1,5,32,2,1,42,30,117
2024-03-30 19:40:00,8,6,14,46,10,9,39,30,162
2024-03-30 19:50:00,5,2,4,33,9,4,35,27,119
2024-03-30 20:00:00,1,2,13,34,11,7,45,28,141
2024-03-30 20:10:00,5,3,5,34,11,12,58,33,161
2024-03-30 20:20:00,4,2,12,44,11,9,42,23,147
2024-03-30 20:30:00,10,5,15,29,9,10,31,26,135
2024-03-30 20:40:00,2,1,13,44,5,3,30,22,120
2024-03-30 20:50:00,5,4,6,29,4,7,38,24,117
2024-03-30 21:00:00,4,4,6,47,7,6,30,22,126
2024-03-30 21:10:00,5,0,7,31,5,6,40,23,117
2024-03-30 21:20:00,1,1,12,29,5,2,28,19,97
2024-03-30 21:30:00,1,0,3,33,2,2,27,25,93
2024-03-30 21:40:00,2,1,8,41,7,4,32,27,122
2024-03-30 21:50:00,2,2,6,22,4,6,36,23,101
2024-03-30 22:00:00,2,2,11,38,3,0,28,21,105
2024-03-30 22:10:00,2,1,5,22,2,4,33,21,90
2024-03-30 22:20:00,3,1,8,31,7,8,21,17,96
2024-03-30 22:30:00,2,1,6,27,5,4,23,26,94
2024-03-30 22:40:00,2,1,3,25,6,5,41,26,109
2024-03-30 22:50:00,1,1,3,18,1,1,35,19,79
2024-03-30 23:00:00,3,2,8,25,1,2,19,15,75
2024-03-30 23:10:00,0,0,5,25,1,1,27,19,78
2024-03-30 23:20:00,0,0,6,25,6,2,20,21,80
2024-03-30 23:30:00,10,6,7,20,4,4,21,21,93
2024-03-30 23:40:00,4,0,2,16,1,1,16,11,51
2024-03-30 23:50:00,0,0,1,21,3,3,20,15,63
2024-03-31 00:00:00,4,1,5,21,5,3,18,15,72
2024-03-31 00:10:00,3,2,2,16,4,2,22,20,71
2024-03-31 00:20:00,1,0,4,18,3,6,20,21,73
2024-03-31 00:30:00,2,1,0,12,1,2,11,10,39
2024-03-31 00:40:00,1,0,2,18,3,1,11,12,48
2024-03-31 00:50:00,1,1,0,14,3,4,24,15,62
2024-03-31 01:00:00,3,2,2,6,4,2,26,24,69
2024-03-31 01:10:00,1,2,0,10,7,7,12,11,50
2024-03-31 01:20:00,0,0,2,15,0,0,9,9,35
2024-03-31 01:30:00,1,1,0,8,1,1,7,6,25
2024-03-31 01:40:00,0,0,0,12,3,1,16,13,45
2024-03-31 01:50:00,0,0,0,4,0,0,6,6,16
2024-03-31 02:00:00,0,0,0,0,0,0,0,0,0
2024-03-31 02:10:00,0,0,0,0,0,0,0,0,0
2024-03-31 02:20:00,0,0,0,0,0,0,0,0,0
2024-03-31 02:30:00,0,0,0,0,0,0,0,0,0
2024-03-31 02:40:00,0,0,0,0,0,0,0,0,0
2024-03-31 02:50:00,0,0,0,0,0,0,0,0,0
2024-03-31 03:00:00,0,0,0,0,0,0,0,0,0
2024-03-31 03:10:00,0,0,0,0,0,0,0,0,0
2024-03-31 03:20:00,0,0,0,0,0,0,0,0,0
2024-03-31 03:30:00,0,0,0,0,0,0,0,0,0
2024-03-31 03:40:00,0,0,0,0,0,0,0,0,0
2024-03-31 03:50:00,0,0,0,0,0,0,0,0,0
2024-03-31 04:00:00,0,0,0,5,4,4,9,8,30
2024-03-31 04:10:00,0,0,5,12,1,0,6,6,30
2024-03-31 04:20:00,0,0,2,11,0,0,10,10,33
2024-03-31 04:30:00,0,0,2,4,1,1,5,4,17
2024-03-31 04:40:00,0,0,0,4,0,0,7,9,20
2024-03-31 04:50:00,0,0,2,11,0,0,5,3,21
2024-03-31 05:00:00,0,0,2,9,1,1,9,8,30
2024-03-31 05:10:00,1,1,5,7,0,0,7,7,28
2024-03-31 05:20:00,0,0,6,15,2,2,4,4,33
2024-03-31 05:30:00,1,1,1,15,3,2,4,4,31
2024-03-31 05:40:00,2,2,3,14,4,10,8,6,49
2024-03-31 05:50:00,1,0,7,13,6,6,9,10,52
2024-03-31 06:00:00,1,2,2,14,0,0,7,7,33
2024-03-31 06:10:00,1,1,7,16,1,0,10,7,43
2024-03-31 06:20:00,1,1,2,7,4,3,11,8,37
2024-03-31 06:30:00,4,3,0,11,2,1,5,4,30
2024-03-31 06:40:00,4,2,3,7,2,1,12,9,40
2024-03-31 06:50:00,1,1,0,9,0,0,12,9,32
2024-03-31 07:00:00,1,1,1,7,1,1,4,4,20
2024-03-31 07:10:00,3,1,2,6,1,1,4,2,20
2024-03-31 07:20:00,0,0,1,2,4,6,6,5,24
2024-03-31 07:30:00,0,0,3,9,9,7,3,3,34
2024-03-31 07:40:00,1,2,1,9,6,10,5,5,39
2024-03-31 07:50:00,0,0,6,10,2,2,4,5,29
2024-03-31 08:00:00,0,0,3,12,3,3,7,7,35
2024-03-31 08:10:00,1,0,4,11,3,2,12,11,44
2024-03-31 08:20:00,0,0,4,14,4,3,13,12,50
2024-03-31 08:30:00,2,1,3,14,6,3,13,11,53
2024-03-31 08:40:00,5,1,13,24,5,6,15,14,83
2024-03-31 08:50:00,1,0,5,17,8,6,11,10,58
2024-03-31 09:00:00,1,0,9,20,2,2,11,8,53
2024-03-31 09:10:00,3,0,5,15,5,7,11,11,57
2024-03-31 09:20:00,1,0,8,27,7,2,13,12,70
2024-03-31 09:30:00,3,0,9,18,7,6,9,9,61
2024-03-31 09:40:00,7,2,9,23,13,12,19,15,100
2024-03-31 09:50:00,4,1,17,33,10,10,21,20,116
2024-03-31 10:00:00,6,1,11,72,7,6,19,19,141
2024-03-31 10:10:00,7,5,19,35,9,10,23,24,132
2024-03-31 10:20:00,3,0,22,30,12,37,14,15,133
2024-03-31 10:30:00,4,3,22,32,11,9,27,19,127
2024-03-31 10:40:00,7,0,27,39,8,11,22,23,137
2024-03-31 10:50:00,8,5,17,45,21,27,29,23,175
2024-03-31 11:00:00,12,7,22,43,13,15,36,32,180
2024-03-31 11:10:00,2,1,19,36,11,8,26,25,128
2024-03-31 11:20:00,12,5,18,44,20,17,43,24,183
2024-03-31 11:30:00,6,3,27,41,17,12,48,38,192
2024-03-31 11:40:00,10,6,27,42,24,11,48,42,210
2024-03-31 11:50:00,10,7,13,57,13,14,54,39,207
2024-03-31 12:00:00,10,8,18,41,14,12,52,31,186
2024-03-31 12:10:00,11,4,23,46,18,11,45,27,185
2024-03-31 12:20:00,11,3,25,39,16,14,36,26,170
2024-03-31 12:30:00,6,3,28,44,11,10,52,32,186
2024-03-31 12:40:00,11,2,26,42,18,13,24,22,158
2024-03-31 12:50:00,13,4,16,45,14,9,48,29,178
2024-03-31 13:00:00,9,3,29,45,11,11,38,31,177
2024-03-31 13:10:00,12,4,16,33,12,13,40,27,157
2024-03-31 13:20:00,11,4,20,113,9,10,50,34,251
2024-03-31 13:30:00,5,2,19,40,12,9,42,30,159
2024-03-31 13:40:00,5,6,27,32,12,11,44,29,166
2024-03-31 13:50:00,15,4,18,49,10,28,54,32,210
2024-03-31 14:00:00,6,4,10,42,11,12,61,35,181
2024-03-31 14:10:00,6,3,19,75,12,13,44,30,202
2024-03-31 14:20:00,7,1,21,39,15,14,53,28,178
2024-03-31 14:30:00,18,6,23,46,13,11,44,24,185
2024-03-31 14:40:00,8,6,24,44,16,10,59,27,194
2024-03-31 14:50:00,8,4,14,44,9,9,59,26,173
2024-03-31 15:00:00,7,2,25,39,16,11,41,23,164
2024-03-31 15:10:00,8,5,28,44,19,11,38,24,177
2024-03-31 15:20:00,10,5,17,51,12,5,50,29,179
2024-03-31 15:30:00,13,6,18,78,12,12,38,28,205
2024-03-31 15:40:00,8,3,13,39,14,7,31,20,135
2024-03-31 15:50:00,6,4,27,36,21,13,36,23,166
2024-03-31 16:00:00,12,11,20,52,9,5,37,20,166
2024-03-31 16:10:00,13,4,27,42,11,7,36,21,161
2024-03-31 16:20:00,18,7,26,40,11,9,35,20,166
2024-03-31 16:30:00,10,7,34,57,9,5,43,28,193
2024-03-31 16:40:00,8,9,18,53,9,9,54,27,187
2024-03-31 16:50:00,7,4,21,47,15,13,42,24,173
2024-03-31 17:00:00,7,7,21,48,14,8,49,29,183
2024-03-31 17:10:00,18,9,35,34,17,14,49,28,204
2024-03-31 17:20:00,8,4,27,53,15,15,42,26,190
2024-03-31 17:30:00,8,6,23,48,11,8,45,26,175
2024-03-31 17:40:00,11,3,19,57,14,8,39,34,185
2024-03-31 17:50:00,14,4,33,60,10,12,44,22,199
2024-03-31 18:00:00,9,6,17,30,14,10,33,16,135
2024-03-31 18:10:00,6,4,27,40,15,11,38,25,166
2024-03-31 18:20:00,8,4,25,34,13,7,43,25,159
2024-03-31 18:30:00,9,1,16,42,11,8,31,25,143
2024-03-31 18:40:00,5,4,13,47,11,10,56,27,173
2024-03-31 18:50:00,6,5,28,45,12,9,33,28,166
2024-03-31 19:00:00,3,3,21,45,9,8,30,24,143
2024-03-31 19:10:00,4,2,25,43,16,15,43,23,171
2024-03-31 19:20:00,7,5,21,46,9,5,37,23,153
2024-03-31 19:30:00,14,5,14,47,13,9,40,22,164
2024-03-31 19:40:00,13,3,22,40,10,10,40,27,165
2024-03-31 19:50:00,4,2,13,40,10,5,25,19,118
2024-03-31 20:00:00,4,3,13,38,6,4,31,21,120
2024-03-31 20:10:00,3,2,12,40,5,3,27,20,112
2024-03-31 20:20:00,5,4,26,47,4,3,24,18,131
2024-03-31 20:30:00,4,2,17,47,2,3,38,31,144
2024-03-31 20:40:00,4,4,11,40,8,7,22,28,124
2024-03-31 20:50:00,12,7,13,22,8,9,28,15,114
2024-03-31 21:00:00,7,1,19,42,6,6,26,32,139
2024-03-31 21:10:00,3,2,16,57,7,8,31,32,156
2024-03-31 21:20:00,3,2,6,36,9,6,28,18,108
2024-03-31 21:30:00,4,3,13,35,10,9,47,22,143
2024-03-31 21:40:00,7,2,12,32,10,4,39,21,127
2024-03-31 21:50:00,5,3,5,33,9,9,30,25,119
2024-03-31 22:00:00,1,1,12,23,5,6,19,19,86
2024-03-31 22:10:00,5,1,3,28,1,0,22,25,85
2024-03-31 22:20:00,3,2,5,24,0,0,19,14,67
2024-03-31 22:30:00,0,0,12,31,2,2,24,16,87
2024-03-31 22:40:00,4,1,1,21,3,3,23,20,76
2024-03-31 22:50:00,6,4,13,33,4,2,39,24,125
2024-03-31 23:00:00,5,2,0,16,1,0,28,21,73
2024-03-31 23:10:00,0,0,5,27,0,0,25,15,72
2024-03-31 23:20:00,1,1,6,17,0,0,20,14,59
2024-03-31 23:30:00,3,1,4,14,3,3,22,14,64
2024-03-31 23:40:00,0,0,3,19,4,3,20,14,63
2024-03-31 23:50:00,3,1,5,19,0,0,10,6,44
2024-04-01 00:00:00,1,1,5,17,1,5,13,17,60
2024-04-01 00:10:00,0,0,2,21,2,2,19,11,57
2024-04-01 00:20:00,1,1,3,10,1,1,11,14,42
2024-04-01 00:30:00,1,1,1,9,2,2,8,10,34
2024-04-01 00:40:00,5,1,0,11,7,1,15,12,52
2024-04-01 00:50:00,2,3,6,17,4,3,15,10,60
2024-04-01 01:00:00,0,0,0,10,0,0,10,8,28
2024-04-01 01:10:00,1,1,2,10,1,1,5,4,25
2024-04-01 01:20:00,0,0,0,6,2,1,16,14,39
2024-04-01 01:30:00,0,0,2,12,0,0,9,5,28
2024-04-01 01:40:00,0,0,0,9,2,1,16,7,35
2024-04-01 01:50:00,0,0,2,6,1,2,10,8,29
2024-04-01 02:00:00,0,0,1,8,1,1,7,7,25
2024-04-01 02:10:00,1,0,4,5,2,3,9,9,33
2024-04-01 02:20:00,4,3,0,11,1,2,9,9,39
2024-04-01 02:30:00,0,0,1,2,0,0,9,5,17
2024-04-01 02:40:00,0,0,1,5,1,1,8,8,24
2024-04-01 02:50:00,0,0,2,8,0,0,12,10,32
2024-04-01 03:00:00,0,0,1,7,1,1,6,6,22
2024-04-01 03:10:00,0,0,1,7,3,2,2,3,18
2024-04-01 03:20:00,1,1,2,8,0,0,3,3,18
2024-04-01 03:30:00,0,0,0,5,0,0,6,7,18
2024-04-01 03:40:00,0,0,0,1,0,0,5,5,11
2024-04-01 03:50:00,0,0,0,0,1,0,7,11,19
2024-04-01 04:00:00,0,0,0,9,0,0,4,5,18
2024-04-01 04:10:00,1,1,2,7,0,0,2,3,16
2024-04-01 04:20:00,0,0,1,4,1,1,3,3,13
2024-04-01 04:30:00,0,0,1,3,2,2,5,5,18
2024-04-01 04:40:00,0,0,1,7,1,1,4,5,19
2024-04-01 04:50:00,0,0,1,4,1,0,6,9,21
2024-04-01 05:00:00,0,0,0,5,2,2,2,3,14
2024-04-01 05:10:00,0,0,1,8,0,0,4,4,17
2024-04-01 05:20:00,0,0,1,11,3,2,3,3,23
2024-04-01 05:30:00,0,0,8,17,1,1,2,2,31
2024-04-01 05:40:00,1,0,5,18,1,1,3,3,32
2024-04-01 05:50:00,1,0,3,16,4,5,8,7,44
2024-04-01 06:00:00,2,2,1,12,0,0,7,7,31
2024-04-01 06:10:00,3,2,2,14,1,0,4,4,30
2024-04-01 06:20:00,1,1,1,7,0,0,6,6,22
2024-04-01 06:30:00,2,2,2,9,4,4,8,8,39
2024-04-01 06:40:00,1,1,3,9,2,2,12,7,37
2024-04-01 06:50:00,0,0,0,5,1,1,13,11,31
2024-04-01 07:00:00,1,1,0,6,5,4,2,2,21
2024-04-01 07:10:00,1,1,1,9,0,0,5,7,24
2024-04-01 07:20:00,0,0,2,10,0,0,1,1,14
2024-04-01 07:30:00,0,0,2,5,2,2,1,1,13
2024-04-01 07:40:00,1,1,3,8,6,6,3,3,31
2024-04-01 07:50:00,0,0,3,10,1,1,5,7,27
2024-04-01 08:00:00,1,1,2,11,1,1,1,1,19
2024-04-01 08:10:00,2,1,4,10,5,2,6,8,38
2024-04-01 08:20:00,2,0,1,16,3,5,6,6,39
2024-04-01 08:30:00,3,2,6,20,0,0,7,8,46
2024-04-01 08:40:00,0,0,4,14,0,0,8,8,34
2024-04-01 08:50:00,1,1,4,17,5,6,6,6,46
2024-04-01 09:00:00,3,0,5,16,2,4,6,6,42
2024-04-01 09:10:00,0,0,5,26,2,3,15,10,61
2024-04-01 09:20:00,1,1,14,26,6,10,11,8,77
2024-04-01 09:30:00,1,0,7,19,4,4,12,12,59
2024-04-01 09:40:00,1,1,11,34,8,8,5,5,73
2024-04-01 09:50:00,2,0,12,26,7,6,18,17,88
2024-04-01 10:00:00,3,3,16,27,8,6,12,10,85
2024-04-01 10:10:00,2,2,9,32,6,3,20,20,94
2024-04-01 10:20:00,4,4,7,30,8,6,24,18,101
2024-04-01 10:30:00,5,5,12,24,12,6,11,8,83
2024-04-01 10:40:00,3,2,20,26,12,9,15,11,98
2024-04-01 10:50:00,6,3,18,36,8,9,27,23,130
2024-04-01 11:00:00,2,2,13,31,7,7,29,17,108
2024-04-01 11:10:00,2,1,17,29,11,8,30,13,111
2024-04-01 11:20:00,6,5,8,45,9,9,33,21,136
2024-04-01 11:30:00,4,4,18,37,13,10,29,19,134
2024-04-01 11:40:00,6,4,24,41,7,7,29,23,141
2024-04-01 11:50:00,7,4,29,28,8,6,39,25,146
2024-04-01 12:00:00,10,9,30,41,12,9,31,20,162
2024-04-01 12:10:00,4,3,28,47,11,10,33,22,158
2024-04-01 12:20:00,6,6,20,36,8,9,25,18,128
2024-04-01 12:30:00,8,4,27,48,13,14,36,26,176
2024-04-01 12:40:00,5,2,32,39,12,11,49,30,180
2024-04-01 12:50:00,3,2,21,48,11,10,32,24,151
2024-04-01 13:00:00,5,4,21,52,12,10,39,29,172
2024-04-01 13:10:00,3,3,26,36,13,12,25,18,136
2024-04-01 13:20:00,8,4,30,47,10,9,44,27,179
2024-04-01 13:30:00,9,6,24,39,6,6,39,27,156
2024-04-01 13:40:00,4,4,27,46,11,8,41,27,168
2024-04-01 13:50:00,9,6,32,60,8,7,42,28,192
2024-04-01 14:00:00,8,5,39,42,7,9,42,24,176
2024-04-01 14:10:00,6,3,26,43,13,5,46,30,172
2024-04-01 14:20:00,10,9,31,55,10,6,45,26,192
2024-04-01 14:30:00,11,4,29,40,9,6,45,18,162
2024-04-01 14:40:00,6,5,31,51,13,12,48,22,188
2024-04-01 14:50:00,7,4,28,139,12,9,51,27,277
2024-04-01 15:00:00,5,3,26,50,11,10,40,29,174
2024-04-01 15:10:00,12,7,34,38,17,10,45,34,197
2024-04-01 15:20:00,7,5,31,46,10,11,34,39,183
2024-04-01 15:30:00,12,7,27,44,12,10,38,28,178
2024-04-01 15:40:00,8,5,29,48,15,9,32,29,175
2024-04-01 15:50:00,7,6,18,42,14,8,33,23,151
2024-04-01 16:00:00,8,5,24,47,13,11,42,34,184
2024-04-01 16:10:00,8,5,16,60,8,8,49,29,183
2024-04-01 16:20:00,6,2,35,47,8,4,35,26,163
2024-04-01 16:30:00,4,4,29,41,9,6,46,32,171
2024-04-01 16:40:00,8,7,30,48,13,11,36,25,178
2024-04-01 16:50:00,10,9,32,44,19,10,47,18,189
2024-04-01 17:00:00,9,4,28,52,10,14,36,24,177
2024-04-01 17:10:00,13,6,23,38,14,11,44,28,177
2024-04-01 17:20:00,8,6,33,49,5,8,41,22,172
2024-04-01 17:30:00,11,4,24,56,8,9,49,32,193
2024-04-01 17:40:00,3,3,27,33,7,7,34,19,133
2024-04-01 17:50:00,7,5,42,55,14,12,49,24,208
2024-04-01 18:00:00,4,2,13,85,10,9,44,28,195
2024-04-01 18:10:00,9,7,26,48,19,11,41,29,190
2024-04-01 18:20:00,12,5,24,44,8,7,31,23,154
2024-04-01 18:30:00,9,6,23,45,7,8,30,23,151
2024-04-01 18:40:00,3,3,22,36,23,11,47,28,173
2024-04-01 18:50:00,6,4,28,81,17,11,38,24,209
2024-04-01 19:00:00,6,3,16,74,12,7,46,31,195
2024-04-01 19:10:00,6,4,36,52,7,5,42,17,169
2024-04-01 19:20:00,5,3,21,49,10,8,44,23,163
2024-04-01 19:30:00,5,3,21,36,19,13,38,25,160
2024-04-01 19:40:00,6,4,23,46,14,19,34,21,167
2024-04-01 19:50:00,5,4,17,44,9,10,37,22,148
2024-04-01 20:00:00,7,7,11,38,7,7,33,20,130
2024-04-01 20:10:00,5,5,12,50,13,13,34,19,151
2024-04-01 20:20:00,7,6,2,24,9,7,25,19,99
2024-04-01 20:30:00,1,1,11,49,4,4,37,17,124
2024-04-01 20:40:00,9,8,16,44,7,7,17,20,128
2024-04-01 20:50:00,12,6,11,37,8,9,33,22,138
2024-04-01 21:00:00,1,1,11,30,8,3,25,18,97
2024-04-01 21:10:00,4,3,5,33,10,6,22,17,100
2024-04-01 21:20:00,3,3,11,40,9,9,24,15,114
2024-04-01 21:30:00,1,1,10,35,3,3,36,21,110
2024-04-01 21:40:00,3,4,12,29,6,4,39,26,123
2024-04-01 21:50:00,3,2,5,21,4,5,27,17,84
2024-04-01 22:00:00,2,1,6,21,5,3,27,29,94
2024-04-01 22:10:00,2,2,3,22,6,6,27,22,90
2024-04-01 22:20:00,4,1,0,16,8,3,25,22,79
2024-04-01 22:30:00,3,2,7,23,6,8,24,20,93
2024-04-01 22:40:00,0,0,5,21,3,1,15,17,62
2024-04-01 22:50:00,2,0,5,21,6,5,20,20,79
2024-04-01 23:00:00,0,0,5,9,3,4,13,12,46
2024-04-01 23:10:00,0,0,6,22,0,0,14,16,58
2024-04-01 23:20:00,2,2,2,7,2,4,23,22,64
2024-04-01 23:30:00,0,0,2,14,2,3,16,17,54
2024-04-01 23:40:00,4,1,2,13,5,9,15,17,66
2024-04-01 23:50:00,1,1,2,10,1,1,9,9,34
2024-04-02 00:00:00,0,0,0,7,1,0,11,10,29
2024-04-02 00:10:00,2,1,2,12,4,2,8,8,39
2024-04-02 00:20:00,0,0,2,11,0,0,10,8,31
2024-04-02 00:30:00,0,0,1,4,4,2,6,7,24
2024-04-02 00:40:00,1,1,1,8,2,1,7,5,26
2024-04-02 00:50:00,0,0,1,6,0,0,3,3,13
2024-04-02 01:00:00,0,0,0,2,0,0,7,10,19
2024-04-02 01:10:00,0,0,1,4,1,0,2,3,11
2024-04-02 01:20:00,0,0,1,7,0,0,6,8,22
2024-04-02 01:30:00,0,0,1,7,1,3,2,3,17
2024-04-02 01:40:00,0,0,2,7,0,0,2,4,15
2024-04-02 01:50:00,0,0,0,4,0,0,7,10,21
2024-04-02 02:00:00,0,0,0,6,0,0,2,2,10
2024-04-02 02:10:00,0,0,0,6,0,0,2,3,11
2024-04-02 02:20:00,0,0,0,9,1,1,4,5,20
2024-04-02 02:30:00,0,0,1,3,0,0,4,5,13
2024-04-02 02:40:00,0,0,1,6,1,1,3,4,16
2024-04-02 02:50:00,0,0,0,9,2,1,1,1,14
2024-04-02 03:00:00,0,0,0,4,3,3,2,2,14
2024-04-02 03:10:00,0,0,1,7,1,1,5,8,23
2024-04-02 03:20:00,0,0,0,5,0,0,0,0,5
2024-04-02 03:30:00,1,0,1,7,1,1,2,2,15
2024-04-02 03:40:00,1,0,0,2,1,2,2,3,11
2024-04-02 03:50:00,0,0,0,3,2,2,3,4,14
2024-04-02 04:00:00,1,0,0,6,2,2,3,3,17
2024-04-02 04:10:00,0,0,1,8,2,2,1,1,15
2024-04-02 04:20:00,0,0,2,6,1,2,5,5,21
2024-04-02 04:30:00,0,0,1,11,1,1,6,5,25
2024-04-02 04:40:00,0,0,1,12,1,1,4,6,25
2024-04-02 04:50:00,0,0,9,17,0,0,1,0,27
2024-04-02 05:00:00,0,0,4,18,3,4,8,11,48
2024-04-02 05:10:00,0,0,1,23,3,2,8,9,46
2024-04-02 05:20:00,1,0,17,45,5,5,9,17,99
2024-04-02 05:30:00,0,0,17,40,5,3,6,7,78
2024-04-02 05:40:00,2,0,22,57,1,1,9,9,101
2024-04-02 05:50:00,1,1,24,52,3,4,9,13,107
2024-04-02 06:00:00,0,0,19,56,1,2,14,14,106
2024-04-02 06:10:00,5,2,23,62,7,14,15,15,143
2024-04-02 06:20:00,3,2,35,59,4,9,23,23,158
2024-04-02 06:30:00,3,1,16,64,5,5,16,19,129
2024-04-02 06:40:00,4,1,15,90,10,11,19,18,168
2024-04-02 06:50:00,4,1,19,90,11,9,22,28,184
2024-04-02 07:00:00,3,1,10,78,11,11,26,21,161
2024-04-02 07:10:00,3,2,11,86,14,10,26,21,173
2024-04-02 07:20:00,5,2,24,99,13,13,25,23,204
2024-04-02 07:30:00,9,8,31,79,16,6,34,25,208
2024-04-02 07:40:00,11,5,34,74,18,9,34,22,207
2024-04-02 07:50:00,6,3,23,81,16,10,43,25,207
2024-04-02 08:00:00,9,4,32,84,20,9,32,25,215
2024-04-02 08:10:00,19,11,16,90,14,7,32,17,206
2024-04-02 08:20:00,10,6,19,92,12,9,47,27,222
2024-04-02 08:30:00,9,5,11,82,22,10,34,23,196
2024-04-02 08:40:00,17,10,27,78,26,10,43,17,228
2024-04-02 08:50:00,18,10,21,83,25,7,34,21,219
2024-04-02 09:00:00,11,9,28,66,17,9,35,25,200
2024-04-02 09:10:00,12,6,25,82,14,10,42,25,216
2024-04-02 09:20:00,16,7,18,85,17,12,47,30,232
2024-04-02 09:30:00,9,7,38,58,18,8,30,21,189
2024-04-02 09:40:00,13,9,35,61,16,2,43,28,207
2024-04-02 09:50:00,12,7,21,39,11,6,44,28,168
2024-04-02 10:00:00,14,10,27,53,21,12,40,27,204
2024-04-02 10:10:00,7,4,25,87,16,11,49,32,231
2024-04-02 10:20:00,13,7,27,71,13,17,47,19,214
2024-04-02 10:30:00,10,6,33,70,14,11,40,32,216
2024-04-02 10:40:00,22,7,30,93,13,12,46,23,246
2024-04-02 10:50:00,10,9,42,65,20,12,57,36,251
2024-04-02 11:00:00,14,7,16,67,21,19,41,33,218
2024-04-02 11:10:00,13,10,32,46,22,10,42,22,197
2024-04-02 11:20:00,15,7,37,60,17,8,51,32,227
2024-04-02 11:30:00,12,6,29,50,17,15,64,36,229
2024-04-02 11:40:00,12,5,21,46,20,17,51,22,194
2024-04-02 11:50:00,10,6,32,43,15,18,59,39,222
2024-04-02 12:00:00,10,6,33,59,13,13,65,30,229
2024-04-02 12:10:00,19,8,29,61,19,11,76,37,260
2024-04-02 12:20:00,17,9,31,55,15,8,52,29,216
2024-04-02 12:30:00,9,5,21,55,13,6,64,36,209
2024-04-02 12:40:00,13,7,36,55,13,8,107,32,271
2024-04-02 12:50:00,11,8,29,88,14,58,56,24,288
2024-04-02 13:00:00,14,8,36,67,10,19,82,28,264
2024-04-02 13:10:00,18,10,39,114,15,10,67,33,306
2024-04-02 13:20:00,11,6,33,95,14,11,62,32,264
2024-04-02 13:30:00,11,6,25,66,18,11,60,33,230
2024-04-02 13:40:00,20,6,30,44,13,9,71,31,224
2024-04-02 13:50:00,15,10,35,53,13,9,65,35,235
2024-04-02 14:00:00,12,6,30,63,17,13,66,32,239
2024-04-02 14:10:00,13,5,26,111,14,12,58,29,268
2024-04-02 14:20:00,14,7,22,62,11,6,84,36,242
2024-04-02 14:30:00,17,8,37,40,11,11,90,29,243
2024-04-02 14:40:00,15,9,24,78,16,12,83,48,285
2024-04-02 14:50:00,16,5,27,55,18,8,87,35,251
2024-04-02 15:00:00,19,8,17,60,10,9,97,48,268
2024-04-02 15:10:00,16,7,15,72,18,9,103,36,276
2024-04-02 15:20:00,17,8,11,82,16,10,128,37,309
2024-04-02 15:30:00,17,9,18,137,12,6,101,26,326
2024-04-02 15:40:00,18,3,13,117,15,8,121,37,332
2024-04-02 15:50:00,10,4,14,65,18,13,122,30,276
2024-04-02 16:00:00,20,10,6,64,12,10,100,23,245
2024-04-02 16:10:00,14,10,25,70,16,13,122,21,291
2024-04-02 16:20:00,13,5,12,59,21,12,118,26,266
2024-04-02 16:30:00,21,10,5,58,20,14,108,30,266
2024-04-02 16:40:00,20,9,24,91,23,11,118,31,327
2024-04-02 16:50:00,18,7,13,65,14,9,126,23,275
2024-04-02 17:00:00,17,8,7,62,20,10,106,27,257
2024-04-02 17:10:00,11,5,9,69,18,13,97,30,252
2024-04-02 17:20:00,10,9,11,80,20,13,104,12,259
2024-04-02 17:30:00,15,8,4,88,19,11,80,13,238
2024-04-02 17:40:00,8,4,16,56,21,12,98,21,236
2024-04-02 17:50:00,9,6,3,55,15,11,82,21,202
2024-04-02 18:00:00,11,7,11,68,14,8,86,23,228
2024-04-02 18:10:00,8,7,12,58,18,10,63,21,197
2024-04-02 18:20:00,13,10,9,49,14,6,104,41,246
2024-04-02 18:30:00,13,6,6,43,23,15,77,27,210
2024-04-02 18:40:00,9,4,8,61,17,9,64,31,203
2024-04-02 18:50:00,8,3,9,46,19,8,60,29,182
2024-04-02 19:00:00,7,5,4,51,12,6,65,27,177
2024-04-02 19:10:00,7,3,7,30,4,3,58,28,140
2024-04-02 19:20:00,10,4,7,35,16,10,62,23,167
2024-04-02 19:30:00,4,4,8,38,17,6,52,28,157
2024-04-02 19:40:00,10,5,8,41,8,5,41,22,140
2024-04-02 19:50:00,8,4,4,33,10,8,44,21,132
2024-04-02 20:00:00,18,10,11,27,7,6,41,30,150
2024-04-02 20:10:00,3,0,2,25,6,6,45,32,119
2024-04-02 20:20:00,8,4,12,41,6,7,30,20,128
2024-04-02 20:30:00,4,3,6,31,2,2,31,23,102
2024-04-02 20:40:00,5,4,9,26,5,6,35,20,110
2024-04-02 20:50:00,7,3,6,21,5,5,31,24,102
2024-04-02 21:00:00,4,3,7,21,6,5,33,29,108
2024-04-02 21:10:00,5,2,14,37,8,8,19,16,109
2024-04-02 21:20:00,3,1,8,19,8,8,41,26,114
2024-04-02 21:30:00,6,2,7,26,6,6,28,22,103
2024-04-02 21:40:00,6,3,8,17,4,5,22,30,95
2024-04-02 21:50:00,2,1,2,17,8,4,39,33,106
2024-04-02 22:00:00,5,4,7,21,5,7,18,18,85
2024-04-02 22:10:00,2,2,2,14,7,6,25,21,79
2024-04-02 22:20:00,5,2,3,13,2,7,20,18,70
2024-04-02 22:30:00,4,2,9,21,4,1,24,16,81
2024-04-02 22:40:00,5,1,2,16,3,3,17,12,59
2024-04-02 22:50:00,4,2,1,15,6,6,19,20,73
2024-04-02 23:00:00,0,0,7,13,0,0,19,25,64
2024-04-02 23:10:00,1,0,5,10,3,3,26,20,68
2024-04-02 23:20:00,1,1,2,7,2,6,13,13,45
2024-04-02 23:30:00,1,0,3,17,2,2,11,14,50
2024-04-02 23:40:00,0,0,0,7,1,1,15,16,40
2024-04-02 23:50:00,4,2,2,13,3,3,15,17,59
2024-04-03 00:00:00,1,1,5,14,0,0,11,11,43
2024-04-03 00:10:00,0,0,2,9,0,0,10,12,33
2024-04-03 00:20:00,0,0,0,8,0,0,9,10,27
2024-04-03 00:30:00,1,1,1,7,0,0,8,11,29
2024-04-03 00:40:00,0,0,0,9,0,0,2,2,13
2024-04-03 00:50:00,0,0,2,9,0,0,5,7,23
2024-04-03 01:00:00,0,0,0,1,1,2,2,2,8
2024-04-03 01:10:00,0,0,0,2,0,0,7,8,17
2024-04-03 01:20:00,0,0,1,3,1,1,2,2,10
2024-04-03 01:30:00,0,0,0,4,0,0,0,0,4
2024-04-03 01:40:00,0,0,0,2,3,3,5,4,17
2024-04-03 01:50:00,0,0,0,3,1,1,2,2,9
2024-04-03 02:00:00,0,0,2,11,2,4,5,5,29
2024-04-03 02:10:00,1,1,0,4,0,0,5,5,16
2024-04-03 02:20:00,0,0,1,6,1,2,2,2,14
2024-04-03 02:30:00,0,0,2,7,0,1,4,5,19
2024-04-03 02:40:00,0,0,0,7,2,1,2,2,14
2024-04-03 02:50:00,0,0,1,4,1,1,4,6,17
2024-04-03 03:00:00,0,0,0,3,0,0,2,3,8
2024-04-03 03:10:00,0,0,0,2,2,2,3,5,14
2024-04-03 03:20:00,1,0,1,4,0,0,2,3,11
2024-04-03 03:30:00,0,0,0,2,1,2,2,2,9
2024-04-03 03:40:00,0,0,2,9,0,0,0,0,11
2024-04-03 03:50:00,0,0,1,6,0,0,1,2,10
2024-04-03 04:00:00,0,0,1,5,0,0,2,3,11
2024-04-03 04:10:00,0,0,1,11,1,1,2,2,18
2024-04-03 04:20:00,0,0,0,5,2,3,6,7,23
2024-04-03 04:30:00,0,0,1,10,0,0,3,4,18
2024-04-03 04:40:00,0,0,2,10,2,2,3,2,21
2024-04-03 04:50:00,0,0,2,15,2,3,3,2,27
2024-04-03 05:00:00,0,0,5,25,2,2,6,4,44
2024-04-03 05:10:00,1,1,9,22,2,6,7,20,68
2024-04-03 05:20:00,0,0,13,41,7,7,9,9,86
2024-04-03 05:30:00,0,0,18,44,2,2,11,10,87
2024-04-03 05:40:00,2,1,28,63,3,2,12,8,119
2024-04-03 05:50:00,1,1,20,70,1,1,8,8,110
2024-04-03 06:00:00,2,2,10,52,1,1,9,8,85
2024-04-03 06:10:00,2,2,18,58,9,8,14,12,123
2024-04-03 06:20:00,1,2,26,69,9,10,26,19,162
2024-04-03 06:30:00,4,1,12,67,6,5,23,24,142
2024-04-03 06:40:00,3,1,13,71,9,9,28,24,158
2024-04-03 06:50:00,5,5,28,89,16,9,30,24,206
2024-04-03 07:00:00,3,3,16,76,8,7,30,18,161
2024-04-03 07:10:00,1,0,19,83,9,8,22,23,165
2024-04-03 07:20:00,6,3,31,86,13,8,37,28,212
2024-04-03 07:30:00,4,2,33,71,15,8,26,24,183
2024-04-03 07:40:00,10,3,26,94,16,9,32,15,205
2024-04-03 07:50:00,16,6,27,85,29,8,40,26,237
2024-04-03 08:00:00,10,6,25,65,17,9,43,26,201
2024-04-03 08:10:00,7,5,16,63,23,10,32,19,175
2024-04-03 08:20:00,9,4,10,82,15,10,42,31,203
2024-04-03 08:30:00,10,8,12,67,20,10,33,24,184
2024-04-03 08:40:00,14,9,29,79,23,10,32,22,218
2024-04-03 08:50:00,11,5,14,91,13,6,36,25,201
2024-04-03 09:00:00,16,9,13,75,14,11,33,30,201
2024-04-03 09:10:00,15,7,9,72,18,9,29,22,181
2024-04-03 09:20:00,8,4,21,83,14,9,35,17,191
2024-04-03 09:30:00,7,6,32,46,13,14,46,23,187
2024-04-03 09:40:00,14,10,41,46,15,7,39,25,197
2024-04-03 09:50:00,8,6,33,52,19,8,40,30,196
2024-04-03 10:00:00,11,7,39,59,12,8,46,31,213
2024-04-03 10:10:00,18,11,34,55,17,12,48,29,224
2024-04-03 10:20:00,10,6,43,57,17,10,55,33,231
2024-04-03 10:30:00,16,9,30,47,17,14,53,29,215
2024-04-03 10:40:00,13,9,38,47,18,8,38,28,199
2024-04-03 10:50:00,14,7,36,58,10,8,44,27,204
2024-04-03 11:00:00,9,5,25,55,14,10,58,39,215
2024-04-03 11:10:00,16,8,27,65,9,6,42,35,208
2024-04-03 11:20:00,8,4,20,60,13,11,46,25,187
2024-04-03 11:30:00,11,6,32,52,16,10,57,37,221
2024-04-03 11:40:00,8,5,22,49,13,11,61,33,202
2024-04-03 11:50:00,24,7,30,62,19,13,59,36,250
2024-04-03 12:00:00,11,6,41,63,23,6,60,33,243
2024-04-03 12:10:00,16,7,28,65,12,7,46,28,209
2024-04-03 12:20:00,7,5,32,47,16,8,64,37,216
2024-04-03 12:30:00,9,7,20,53,11,13,68,37,218
2024-04-03 12:40:00,13,8,35,50,20,10,53,34,223
2024-04-03 12:50:00,16,8,17,50,14,14,67,33,219
2024-04-03 13:00:00,12,7,22,49,14,11,43,18,176
2024-04-03 13:10:00,19,8,29,42,16,13,57,28,212
2024-04-03 13:20:00,13,5,27,46,7,7,67,36,208
2024-04-03 13:30:00,10,7,32,54,19,11,61,33,227
2024-04-03 13:40:00,14,8,28,49,15,12,62,37,225
2024-04-03 13:50:00,11,6,25,48,12,12,69,34,217
2024-04-03 14:00:00,12,8,24,48,17,12,60,27,208
2024-04-03 14:10:00,16,8,26,39,17,13,75,28,222
2024-04-03 14:20:00,16,10,34,57,20,10,79,24,250
2024-04-03 14:30:00,16,10,29,52,15,8,77,19,226
2024-04-03 14:40:00,18,7,33,51,11,7,84,36,247
2024-04-03 14:50:00,12,8,19,46,14,11,77,37,224
2024-04-03 15:00:00,9,9,15,53,15,11,95,44,251
2024-04-03 15:10:00,19,8,23,46,13,9,94,31,243
2024-04-03 15:20:00,13,8,18,60,12,9,118,20,258
2024-04-03 15:30:00,16,8,2,59,12,7,109,29,242
2024-04-03 15:40:00,14,9,16,70,11,6,120,29,275
2024-04-03 15:50:00,11,6,29,85,12,7,98,35,283
2024-04-03 16:00:00,16,9,7,64,15,9,104,22,246
2024-04-03 16:10:00,19,10,12,55,9,5,116,29,255
2024-04-03 16:20:00,19,6,15,65,14,10,123,24,276
2024-04-03 16:30:00,10,11,4,76,8,6,120,25,260
2024-04-03 16:40:00,14,7,20,57,10,7,106,24,245
2024-04-03 16:50:00,15,5,14,62,12,9,127,16,260
2024-04-03 17:00:00,15,9,15,51,14,11,108,20,243
2024-04-03 17:10:00,13,7,10,63,22,8,130,14,267
2024-04-03 17:20:00,11,9,11,69,26,13,126,22,287
2024-04-03 17:30:00,19,7,9,76,18,10,121,30,290
2024-04-03 17:40:00,14,7,12,56,28,12,108,26,263
2024-04-03 17:50:00,22,6,16,105,11,12,152,26,350
2024-04-03 18:00:00,14,6,6,61,17,13,75,18,210
2024-04-03 18:10:00,12,7,8,58,17,12,100,39,253
2024-04-03 18:20:00,16,8,10,56,12,8,91,32,233
2024-04-03 18:30:00,7,5,18,59,15,11,82,22,219
2024-04-03 18:40:00,8,5,8,54,12,56,64,25,232
2024-04-03 18:50:00,15,5,5,61,7,4,65,28,190
2024-04-03 19:00:00,8,4,4,34,11,12,56,30,159
2024-04-03 19:10:00,7,1,10,52,10,9,55,34,178
2024-04-03 19:20:00,10,6,10,39,80,11,62,44,262
2024-04-03 19:30:00,9,6,4,49,15,7,50,25,165
2024-04-03 19:40:00,15,7,8,35,15,29,46,19,174
2024-04-03 19:50:00,8,4,6,43,7,7,43,23,141
2024-04-03 20:00:00,4,1,11,23,12,9,47,25,132
2024-04-03 20:10:00,4,0,6,26,12,8,33,27,116
2024-04-03 20:20:00,1,1,5,29,6,9,38,24,113
2024-04-03 20:30:00,8,5,4,30,10,5,32,30,124
2024-04-03 20:40:00,3,3,15,27,8,9,45,38,148
2024-04-03 20:50:00,11,4,14,23,7,8,38,35,140
2024-04-03 21:00:00,3,4,9,23,7,9,29,21,105
2024-04-03 21:10:00,3,3,5,23,7,4,32,26,103
2024-04-03 21:20:00,5,4,12,34,4,5,38,24,126
2024-04-03 21:30:00,8,5,11,26,9,5,24,18,106
2024-04-03 21:40:00,7,5,11,27,7,7,31,17,112
2024-04-03 21:50:00,0,0,5,21,6,9,32,15,88
2024-04-03 22:00:00,7,6,12,23,5,3,27,16,99
2024-04-03 22:10:00,4,1,4,22,7,8,35,22,103
2024-04-03 22:20:00,4,3,5,21,10,8,21,14,86
2024-04-03 22:30:00,3,3,4,17,6,3,28,28,92
2024-04-03 22:40:00,4,3,4,20,7,5,24,14,81
2024-04-03 22:50:00,3,2,4,18,4,2,32,23,88
2024-04-03 23:00:00,1,1,1,19,2,2,27,16,69
2024-04-03 23:10:00,3,3,1,6,3,2,31,18,67
2024-04-03 23:20:00,1,1,4,18,2,1,19,15,61
2024-04-03 23:30:00,3,1,3,12,4,5,19,13,60
2024-04-03 23:40:00,1,1,0,8,2,2,15,13,42
2024-04-03 23:50:00,0,0,2,12,3,8,16,16,57
2024-04-04 00:00:00,0,0,1,4,2,2,7,6,22
2024-04-04 00:10:00,2,1,0,3,1,1,10,8,26
2024-04-04 00:20:00,1,1,1,7,3,0,13,11,37
2024-04-04 00:30:00,0,0,1,12,0,2,3,3,21
2024-04-04 00:40:00,1,1,1,6,3,1,9,8,30
2024-04-04 00:50:00,0,0,0,8,0,0,6,11,25
2024-04-04 01:00:00,0,0,1,5,0,0,5,2,13
2024-04-04 01:10:00,0,0,1,1,0,0,4,2,8
2024-04-04 01:20:00,2,0,0,1,2,2,5,5,17
2024-04-04 01:30:00,0,0,0,7,1,1,3,3,15
2024-04-04 01:40:00,0,0,0,2,0,0,5,4,11
2024-04-04 01:50:00,0,0,0,4,0,0,1,1,6
2024-04-04 02:00:00,0,0,2,7,0,0,3,3,15
2024-04-04 02:10:00,0,0,0,5,0,0,4,5,14
2024-04-04 02:20:00,0,0,1,5,0,0,3,3,12
2024-04-04 02:30:00,0,0,0,2,1,1,2,2,8
2024-04-04 02:40:00,0,0,0,5,3,1,6,6,21
2024-04-04 02:50:00,0,0,0,2,2,2,2,2,10
2024-04-04 03:00:00,0,0,1,2,0,0,2,2,7
2024-04-04 03:10:00,0,0,0,3,0,0,0,0,3
2024-04-04 03:20:00,1,1,1,3,3,3,2,2,16
2024-04-04 03:30:00,0,0,1,4,0,0,0,0,5
2024-04-04 03:40:00,1,1,0,4,0,0,1,1,8
2024-04-04 03:50:00,0,0,2,7,1,1,4,4,19
2024-04-04 04:00:00,0,0,1,6,0,0,3,3,13
2024-04-04 04:10:00,0,0,2,7,1,1,2,2,15
2024-04-04 04:20:00,0,0,3,11,1,2,3,3,23
2024-04-04 04:30:00,0,0,3,13,0,1,4,3,24
2024-04-04 04:40:00,0,0,2,14,3,3,6,5,33
2024-04-04 04:50:00,0,0,8,18,1,3,6,5,41
2024-04-04 05:00:00,0,0,4,21,0,0,5,7,37
2024-04-04 05:10:00,0,1,4,24,3,4,9,12,57
2024-04-04 05:20:00,0,0,15,23,3,3,7,6,57
2024-04-04 05:30:00,1,1,19,47,5,6,10,12,101
2024-04-04 05:40:00,1,1,17,52,3,5,9,6,94
2024-04-04 05:50:00,1,0,23,47,2,2,10,7,92
2024-04-04 06:00:00,1,1,19,53,7,3,13,10,107
2024-04-04 06:10:00,3,2,27,76,6,9,21,14,158
2024-04-04 06:20:00,2,1,23,69,4,4,18,13,134
2024-04-04 06:30:00,4,2,9,62,2,4,19,14,116
2024-04-04 06:40:00,3,1,18,67,12,6,19,12,138
2024-04-04 06:50:00,1,0,18,65,14,20,28,20,166
2024-04-04 07:00:00,2,0,15,71,8,8,31,16,151
2024-04-04 07:10:00,2,1,14,88,10,12,21,19,167
2024-04-04 07:20:00,6,2,20,81,15,11,26,23,184
2024-04-04 07:30:00,4,4,21,78,15,10,38,28,198
2024-04-04 07:40:00,6,2,14,86,16,11,32,20,187
2024-04-04 07:50:00,10,4,22,71,19,10,45,22,203
2024-04-04 08:00:00,11,6,22,85,16,7,30,19,196
2024-04-04 08:10:00,12,7,18,103,14,8,42,15,219
2024-04-04 08:20:00,11,3,9,79,14,14,38,28,196
2024-04-04 08:30:00,6,2,17,96,24,8,26,21,200
2024-04-04 08:40:00,15,10,18,96,19,11,39,22,230
2024-04-04 08:50:00,13,3,17,88,16,9,35,23,204
2024-04-04 09:00:00,6,3,5,72,21,10,42,23,182
2024-04-04 09:10:00,8,5,12,72,15,9,39,25,185
2024-04-04 09:20:00,12,5,12,63,15,6,44,27,184
2024-04-04 09:30:00,15,7,22,64,20,12,42,31,213
2024-04-04 09:40:00,15,6,42,80,11,8,47,30,239
2024-04-04 09:50:00,14,9,37,62,13,10,48,28,221
2024-04-04 10:00:00,10,5,31,51,10,9,35,29,180
2024-04-04 10:10:00,5,3,37,64,14,10,48,38,219
2024-04-04 10:20:00,13,4,33,51,10,8,39,26,184
2024-04-04 10:30:00,28,7,38,56,16,12,41,28,226
2024-04-04 10:40:00,13,7,39,47,15,10,41,30,202
2024-04-04 10:50:00,4,4,17,53,15,12,52,28,185
2024-04-04 11:00:00,10,4,16,79,14,12,46,24,205
2024-04-04 11:10:00,8,4,25,76,11,4,56,32,216
2024-04-04 11:20:00,19,10,11,48,20,10,56,31,205
2024-04-04 11:30:00,12,6,25,64,21,11,53,31,223
2024-04-04 11:40:00,13,5,15,62,15,11,50,32,203
2024-04-04 11:50:00,18,11,20,81,19,5,49,30,233
2024-04-04 12:00:00,20,13,24,83,11,11,64,29,255
2024-04-04 12:10:00,12,7,30,56,9,8,79,34,235
2024-04-04 12:20:00,13,9,30,48,10,9,69,37,225
2024-04-04 12:30:00,12,8,17,61,15,11,54,31,209
2024-04-04 12:40:00,14,10,36,57,15,10,62,41,245
2024-04-04 12:50:00,12,6,18,95,10,6,65,29,241
2024-04-04 13:00:00,16,8,25,61,14,11,55,33,223
2024-04-04 13:10:00,8,6,28,55,10,5,63,19,194
2024-04-04 13:20:00,8,4,30,48,11,9,61,26,197
2024-04-04 13:30:00,7,8,23,40,13,8,47,30,176
2024-04-04 13:40:00,10,8,32,55,9,8,54,28,204
2024-04-04 13:50:00,12,6,20,44,19,9,66,22,198
2024-04-04 14:00:00,14,8,27,60,10,5,69,19,212
2024-04-04 14:10:00,15,8,33,45,8,9,86,24,228
2024-04-04 14:20:00,11,8,23,49,17,11,71,26,216
2024-04-04 14:30:00,8,5,27,32,14,9,95,29,219
2024-04-04 14:40:00,10,5,36,55,17,12,85,32,252
2024-04-04 14:50:00,25,11,20,48,18,10,89,20,241
2024-04-04 15:00:00,15,5,13,56,19,8,95,31,242
2024-04-04 15:10:00,17,12,17,73,13,6,114,29,281
2024-04-04 15:20:00,13,9,13,50,16,8,117,7,233
2024-04-04 15:30:00,24,9,16,66,21,6,108,19,269
2024-04-04 15:40:00,17,10,25,44,24,10,107,19,256
2024-04-04 15:50:00,22,9,16,69,11,7,110,15,259
2024-04-04 16:00:00,20,10,12,61,8,7,103,11,232
2024-04-04 16:10:00,21,12,11,55,14,11,117,18,259
2024-04-04 16:20:00,19,7,12,68,17,12,80,14,229
2024-04-04 16:30:00,15,9,26,57,14,11,126,11,269
2024-04-04 16:40:00,17,11,26,67,17,26,101,24,289
2024-04-04 16:50:00,12,7,14,39,14,4,98,19,207
2024-04-04 17:00:00,13,6,16,0,17,9,120,30,211
2024-04-04 17:10:00,13,9,14,78,22,23,102,19,280
2024-04-04 17:20:00,7,2,10,70,21,7,128,16,261
2024-04-04 17:30:00,12,8,17,87,16,14,92,6,252
2024-04-04 17:40:00,15,9,9,58,18,14,85,1,209
2024-04-04 17:50:00,11,6,3,58,16,12,104,0,210
2024-04-04 18:00:00,12,5,7,89,15,9,80,25,242
2024-04-04 18:10:00,15,7,10,29,11,7,86,29,194
2024-04-04 18:20:00,15,11,12,61,14,14,106,23,256
2024-04-04 18:30:00,14,5,5,40,14,7,91,35,211
2024-04-04 18:40:00,8,6,12,56,15,10,61,26,194
2024-04-04 18:50:00,15,6,9,61,17,14,78,25,225
2024-04-04 19:00:00,7,5,4,47,12,9,72,20,176
2024-04-04 19:10:00,6,3,8,46,9,7,56,24,159
2024-04-04 19:20:00,14,8,11,45,9,8,72,23,190
2024-04-04 19:30:00,16,9,9,44,9,10,61,30,188
2024-04-04 19:40:00,9,6,5,42,21,14,43,24,164
2024-04-04 19:50:00,6,5,6,54,7,7,43,19,147
2024-04-04 20:00:00,8,5,7,32,16,11,39,20,138
2024-04-04 20:10:00,8,5,4,28,13,12,40,18,128
2024-04-04 20:20:00,2,1,3,23,4,2,28,16,79
2024-04-04 20:30:00,5,4,15,25,3,6,41,32,131
2024-04-04 20:40:00,6,6,10,27,6,4,36,19,114
2024-04-04 20:50:00,4,4,4,23,9,8,41,26,119
2024-04-04 21:00:00,5,4,11,29,5,4,34,18,110
2024-04-04 21:10:00,7,6,6,21,12,10,25,16,103
2024-04-04 21:20:00,6,2,4,27,9,8,44,21,121
2024-04-04 21:30:00,9,6,4,22,10,5,41,24,121
2024-04-04 21:40:00,4,4,7,32,5,6,26,12,96
2024-04-04 21:50:00,3,3,8,17,4,3,38,17,93
2024-04-04 22:00:00,2,2,2,26,4,9,30,19,94
2024-04-04 22:10:00,10,7,7,20,10,5,32,17,108
2024-04-04 22:20:00,7,5,1,18,4,4,31,15,85
2024-04-04 22:30:00,3,3,5,22,7,5,22,14,81
2024-04-04 22:40:00,6,3,5,20,2,1,25,16,78
2024-04-04 22:50:00,7,5,1,16,0,2,33,17,81
2024-04-04 23:00:00,5,3,1,13,1,1,20,13,57
2024-04-04 23:10:00,1,1,3,12,1,2,26,14,60
2024-04-04 23:20:00,2,1,2,13,1,1,13,12,45
2024-04-04 23:30:00,0,0,1,8,3,2,8,6,28
2024-04-04 23:40:00,1,1,1,4,3,1,22,17,50
2024-04-04 23:50:00,1,0,3,12,1,1,14,10,42
2024-04-05 00:00:00,1,1,1,12,2,3,11,11,42
2024-04-05 00:10:00,0,0,4,13,3,2,17,11,50
2024-04-05 00:20:00,0,0,2,6,2,6,15,15,46
2024-04-05 00:30:00,0,0,1,9,1,2,6,6,25
2024-04-05 00:40:00,2,2,2,4,2,3,4,3,22
2024-04-05 00:50:00,0,0,1,3,1,1,5,3,14
2024-04-05 01:00:00,1,2,0,5,3,4,10,10,35
2024-04-05 01:10:00,2,2,1,5,1,0,3,4,18
2024-04-05 01:20:00,1,0,2,4,2,2,6,5,22
2024-04-05 01:30:00,0,0,1,5,2,2,3,3,16
2024-04-05 01:40:00,0,0,0,1,2,3,1,1,8
2024-04-05 01:50:00,0,0,0,1,0,0,3,3,7
2024-04-05 02:00:00,0,0,0,1,0,0,0,0,1
