datetime,V51Z,V52Z,V111Z,V112Z,V351Z,Total
2024-03-01 01:00:00,7,2,5,2,0,16
2024-03-01 01:10:00,5,2,5,5,0,17
2024-03-01 01:20:00,5,2,3,1,0,11
2024-03-01 01:30:00,1,0,1,1,0,3
2024-03-01 01:40:00,4,3,2,1,0,10
2024-03-01 01:50:00,0,3,2,0,0,5
2024-03-01 02:00:00,1,1,2,0,0,4
2024-03-01 02:10:00,3,0,4,1,0,8
2024-03-01 02:20:00,2,0,4,2,0,8
2024-03-01 02:30:00,6,0,2,0,0,8
2024-03-01 02:40:00,2,2,3,3,0,10
2024-03-01 02:50:00,2,0,2,0,0,4
2024-03-01 03:00:00,0,0,2,2,0,4
2024-03-01 03:10:00,2,0,1,0,0,3
2024-03-01 03:20:00,0,2,2,3,0,7
2024-03-01 03:30:00,1,2,3,0,0,6
2024-03-01 03:40:00,3,0,0,0,0,3
2024-03-01 03:50:00,2,0,8,0,0,10
2024-03-01 04:00:00,4,3,1,2,0,10
2024-03-01 04:10:00,3,0,6,2,0,11
2024-03-01 04:20:00,6,3,3,3,0,15
2024-03-01 04:30:00,10,3,6,2,0,21
2024-03-01 04:40:00,1,0,3,7,0,11
2024-03-01 04:50:00,5,3,5,0,0,13
2024-03-01 05:00:00,11,16,9,3,1,40
2024-03-01 05:10:00,12,11,20,3,0,46
2024-03-01 05:20:00,20,12,11,4,0,47
2024-03-01 05:30:00,35,20,16,6,1,78
2024-03-01 05:40:00,35,16,32,16,1,100
2024-03-01 05:50:00,34,26,31,9,1,101
2024-03-01 06:00:00,25,14,30,14,2,85
2024-03-01 06:10:00,38,22,36,20,0,116
2024-03-01 06:20:00,43,30,28,18,0,119
2024-03-01 06:30:00,39,34,37,14,1,125
2024-03-01 06:40:00,48,34,47,24,1,154
2024-03-01 06:50:00,48,18,48,20,2,136
2024-03-01 07:00:00,39,16,29,15,3,102
2024-03-01 07:10:00,35,27,31,26,5,124
2024-03-01 07:20:00,39,27,38,38,7,149
2024-03-01 07:30:00,42,36,39,28,11,156
2024-03-01 07:40:00,48,33,42,37,13,173
2024-03-01 07:50:00,58,30,35,36,8,167
2024-03-01 08:00:00,47,24,42,23,4,140
2024-03-01 08:10:00,56,22,36,25,4,143
2024-03-01 08:20:00,49,33,30,18,5,135
2024-03-01 08:30:00,59,25,42,21,4,151
2024-03-01 08:40:00,58,24,34,30,3,149
2024-03-01 08:50:00,51,25,35,20,5,136
2024-03-01 09:00:00,50,27,30,16,4,127
2024-03-01 09:10:00,47,23,27,27,5,129
2024-03-01 09:20:00,40,20,32,29,6,127
2024-03-01 09:30:00,35,12,34,18,4,103
2024-03-01 09:40:00,31,20,42,19,5,117
2024-03-01 09:50:00,33,13,34,24,2,106
2024-03-01 10:00:00,39,17,29,16,1,102
2024-03-01 10:10:00,33,17,46,22,4,122
2024-03-01 10:20:00,39,14,43,12,5,113
2024-03-01 10:30:00,39,16,36,24,2,117
2024-03-01 10:40:00,44,18,40,22,2,126
2024-03-01 10:50:00,37,11,37,23,1,109
2024-03-01 11:00:00,40,21,26,16,3,106
2024-03-01 11:10:00,42,13,28,12,4,99
2024-03-01 11:20:00,37,31,30,19,5,122
2024-03-01 11:30:00,32,20,30,18,7,107
2024-03-01 11:40:00,48,14,32,27,1,122
2024-03-01 11:50:00,43,21,34,20,7,125
2024-03-01 12:00:00,47,19,42,27,2,137
2024-03-01 12:10:00,44,20,41,23,4,132
2024-03-01 12:20:00,50,18,42,37,3,150
2024-03-01 12:30:00,43,27,37,25,7,139
2024-03-01 12:40:00,44,21,45,27,7,144
2024-03-01 12:50:00,46,24,31,26,6,133
2024-03-01 13:00:00,45,36,32,17,4,134
2024-03-01 13:10:00,39,14,39,31,7,130
2024-03-01 13:20:00,32,13,39,26,9,119
2024-03-01 13:30:00,50,24,34,25,8,141
2024-03-01 13:40:00,40,20,37,30,3,130
2024-03-01 13:50:00,50,21,45,27,4,147
2024-03-01 14:00:00,35,19,34,29,7,124
2024-03-01 14:10:00,41,23,46,33,4,147
2024-03-01 14:20:00,53,24,45,27,4,153
2024-03-01 14:30:00,52,22,41,31,5,151
2024-03-01 14:40:00,50,22,46,32,5,155
2024-03-01 14:50:00,38,25,46,43,5,157
2024-03-01 15:00:00,38,26,47,22,5,138
2024-03-01 15:10:00,49,22,38,29,6,144
2024-03-01 15:20:00,42,26,37,30,7,142
2024-03-01 15:30:00,58,22,46,40,3,169
2024-03-01 15:40:00,64,29,46,31,5,175
2024-03-01 15:50:00,46,22,39,27,11,145
2024-03-01 16:00:00,48,26,41,36,7,158
2024-03-01 16:10:00,50,31,45,28,3,157
2024-03-01 16:20:00,39,25,43,34,4,145
2024-03-01 16:30:00,55,18,38,29,4,144
2024-03-01 16:40:00,44,31,40,36,10,161
2024-03-01 16:50:00,53,21,40,30,4,148
2024-03-01 17:00:00,49,21,37,27,5,139
2024-03-01 17:10:00,44,29,44,29,4,150
2024-03-01 17:20:00,50,25,41,31,6,153
2024-03-01 17:30:00,54,19,42,26,3,144
2024-03-01 17:40:00,48,29,56,26,3,162
2024-03-01 17:50:00,39,30,53,45,5,172
2024-03-01 18:00:00,33,18,37,29,3,120
2024-03-01 18:10:00,51,21,37,26,4,139
2024-03-01 18:20:00,45,28,42,35,2,152
2024-03-01 18:30:00,43,32,54,44,5,178
2024-03-01 18:40:00,48,20,75,49,5,197
2024-03-01 18:50:00,59,29,46,41,8,183
2024-03-01 19:00:00,46,16,58,43,2,165
2024-03-01 19:10:00,48,22,45,38,2,155
2024-03-01 19:20:00,38,28,41,45,1,153
2024-03-01 19:30:00,41,10,35,50,2,138
2024-03-01 19:40:00,33,21,42,42,8,146
2024-03-01 19:50:00,37,15,42,25,2,121
2024-03-01 20:00:00,34,18,26,29,1,108
2024-03-01 20:10:00,41,15,29,28,3,116
2024-03-01 20:20:00,29,16,24,24,1,94
2024-03-01 20:30:00,33,13,21,30,1,98
2024-03-01 20:40:00,29,14,30,24,3,100
2024-03-01 20:50:00,29,8,30,12,4,83
2024-03-01 21:00:00,34,11,34,28,3,110
2024-03-01 21:10:00,30,4,11,27,0,72
2024-03-01 21:20:00,28,18,26,25,2,99
2024-03-01 21:30:00,28,13,22,32,0,95
2024-03-01 21:40:00,31,14,26,35,2,108
2024-03-01 21:50:00,25,7,28,25,3,88
2024-03-01 22:00:00,21,6,18,37,2,84
2024-03-01 22:10:00,28,4,28,27,1,88
2024-03-01 22:20:00,24,7,32,37,0,100
2024-03-01 22:30:00,14,13,25,32,1,85
2024-03-01 22:40:00,9,6,19,23,3,60
2024-03-01 22:50:00,32,8,8,15,0,63
2024-03-01 23:00:00,18,4,10,20,0,52
2024-03-01 23:10:00,21,7,7,25,0,60
2024-03-01 23:20:00,22,15,16,17,1,71
2024-03-01 23:30:00,12,3,13,14,0,42
2024-03-01 23:40:00,13,7,10,13,1,44
2024-03-01 23:50:00,11,4,7,11,2,35
2024-03-02 00:00:00,15,4,8,9,0,36
2024-03-02 00:10:00,12,5,12,18,0,47
2024-03-02 00:20:00,12,1,7,8,0,28
2024-03-02 00:30:00,7,4,9,11,0,31
2024-03-02 00:40:00,12,3,6,9,0,30
2024-03-02 00:50:00,16,1,15,12,0,44
2024-03-02 01:00:00,9,4,5,7,0,25
2024-03-02 01:10:00,2,0,7,8,0,17
2024-03-02 01:20:00,11,3,5,4,0,23
2024-03-02 01:30:00,6,1,5,1,0,13
2024-03-02 01:40:00,3,0,1,13,0,17
2024-03-02 01:50:00,3,4,2,11,0,20
2024-03-02 02:00:00,10,0,4,6,0,20
2024-03-02 02:10:00,9,0,4,3,0,16
2024-03-02 02:20:00,11,0,3,8,0,22
2024-03-02 02:30:00,4,0,1,2,1,8
2024-03-02 02:40:00,3,2,6,3,0,14
2024-03-02 02:50:00,11,0,0,2,0,13
2024-03-02 03:00:00,6,0,3,5,0,14
2024-03-02 03:10:00,6,1,6,6,0,19
2024-03-02 03:20:00,4,0,5,7,0,16
2024-03-02 03:30:00,3,1,2,6,0,12
2024-03-02 03:40:00,8,1,2,6,0,17
2024-03-02 03:50:00,6,2,5,4,0,17
2024-03-02 04:00:00,2,2,6,5,0,15
2024-03-02 04:10:00,4,3,8,0,0,15
2024-03-02 04:20:00,7,0,2,5,0,14
2024-03-02 04:30:00,8,3,4,1,0,16
2024-03-02 04:40:00,3,4,5,4,0,16
2024-03-02 04:50:00,12,2,2,5,0,21
2024-03-02 05:00:00,9,2,1,7,0,19
2024-03-02 05:10:00,10,8,3,7,1,29
2024-03-02 05:20:00,21,2,8,6,0,37
2024-03-02 05:30:00,13,7,7,2,0,29
2024-03-02 05:40:00,13,7,10,4,0,34
2024-03-02 05:50:00,14,4,10,6,0,34
2024-03-02 06:00:00,10,8,7,6,1,32
2024-03-02 06:10:00,8,6,12,6,0,32
2024-03-02 06:20:00,12,5,15,18,0,50
2024-03-02 06:30:00,12,6,12,9,2,41
2024-03-02 06:40:00,13,2,8,20,2,45
2024-03-02 06:50:00,18,6,5,12,0,41
2024-03-02 07:00:00,9,3,8,2,1,23
2024-03-02 07:10:00,10,4,7,7,1,29
2024-03-02 07:20:00,15,6,13,13,0,47
2024-03-02 07:30:00,9,3,14,10,0,36
2024-03-02 07:40:00,18,8,15,18,1,60
2024-03-02 07:50:00,17,6,10,13,1,47
2024-03-02 08:00:00,20,3,21,13,0,57
2024-03-02 08:10:00,20,5,19,13,0,57
2024-03-02 08:20:00,19,6,18,14,2,59
2024-03-02 08:30:00,35,7,16,12,0,70
2024-03-02 08:40:00,28,10,17,16,2,73
2024-03-02 08:50:00,23,9,26,27,0,85
2024-03-02 09:00:00,32,11,26,16,2,87
2024-03-02 09:10:00,39,15,22,17,3,96
2024-03-02 09:20:00,36,11,20,21,3,91
2024-03-02 09:30:00,42,25,28,22,2,119
2024-03-02 09:40:00,46,15,29,27,4,121
2024-03-02 09:50:00,33,15,24,31,1,104
2024-03-02 10:00:00,47,12,21,24,0,104
2024-03-02 10:10:00,37,22,24,27,9,119
2024-03-02 10:20:00,42,12,23,21,3,101
2024-03-02 10:30:00,41,24,31,23,4,123
2024-03-02 10:40:00,49,16,32,28,1,126
2024-03-02 10:50:00,36,16,28,17,5,102
2024-03-02 11:00:00,43,21,37,15,3,119
2024-03-02 11:10:00,43,20,30,34,3,130
2024-03-02 11:20:00,36,20,29,22,9,116
2024-03-02 11:30:00,41,15,38,26,3,123
2024-03-02 11:40:00,44,21,39,27,3,134
2024-03-02 11:50:00,44,16,42,21,3,126
2024-03-02 12:00:00,57,15,49,26,5,152
2024-03-02 12:10:00,53,25,37,21,1,137
2024-03-02 12:20:00,45,16,37,37,3,138
2024-03-02 12:30:00,43,26,43,35,4,151
2024-03-02 12:40:00,44,21,36,22,10,133
2024-03-02 12:50:00,59,26,39,46,4,174
2024-03-02 13:00:00,43,14,23,38,3,121
2024-03-02 13:10:00,41,24,28,39,4,136
2024-03-02 13:20:00,33,17,37,34,4,125
2024-03-02 13:30:00,39,19,30,37,4,129
2024-03-02 13:40:00,30,16,41,40,6,133
2024-03-02 13:50:00,42,23,32,42,1,140
2024-03-02 14:00:00,39,19,31,40,8,137
2024-03-02 14:10:00,45,20,41,37,11,154
2024-03-02 14:20:00,36,20,35,53,2,146
2024-03-02 14:30:00,32,24,29,35,7,127
2024-03-02 14:40:00,36,19,27,48,6,136
2024-03-02 14:50:00,36,13,30,36,3,118
2024-03-02 15:00:00,46,11,24,34,4,119
2024-03-02 15:10:00,33,20,22,23,5,103
2024-03-02 15:20:00,55,23,22,31,2,133
2024-03-02 15:30:00,46,18,24,32,7,127
2024-03-02 15:40:00,36,18,25,32,4,115
2024-03-02 15:50:00,39,9,26,23,5,102
2024-03-02 16:00:00,32,13,24,27,1,97
2024-03-02 16:10:00,38,25,21,24,5,113
2024-03-02 16:20:00,50,7,32,24,4,117
2024-03-02 16:30:00,33,19,17,20,8,97
2024-03-02 16:40:00,34,18,23,21,4,100
2024-03-02 16:50:00,41,22,33,25,2,123
2024-03-02 17:00:00,29,20,22,23,5,99
2024-03-02 17:10:00,46,19,28,20,3,116
2024-03-02 17:20:00,44,26,27,27,3,127
2024-03-02 17:30:00,39,18,25,27,6,115
2024-03-02 17:40:00,44,16,19,34,5,118
2024-03-02 17:50:00,50,30,26,25,3,134
2024-03-02 18:00:00,52,34,26,28,5,145
2024-03-02 18:10:00,44,18,22,22,3,109
2024-03-02 18:20:00,44,19,21,41,2,127
2024-03-02 18:30:00,29,29,39,29,2,128
2024-03-02 18:40:00,43,33,35,37,3,151
2024-03-02 18:50:00,47,26,32,45,2,152
2024-03-02 19:00:00,48,19,43,33,0,143
2024-03-02 19:10:00,58,22,32,43,1,156
2024-03-02 19:20:00,42,20,37,29,1,129
2024-03-02 19:30:00,40,18,49,36,1,144
2024-03-02 19:40:00,37,22,29,27,0,115
2024-03-02 19:50:00,40,27,32,25,0,124
2024-03-02 20:00:00,32,19,25,26,3,105
2024-03-02 20:10:00,32,18,32,34,5,121
2024-03-02 20:20:00,28,22,24,42,1,117
2024-03-02 20:30:00,24,15,25,27,2,93
2024-03-02 20:40:00,30,20,18,29,3,100
2024-03-02 20:50:00,25,9,26,29,2,91
2024-03-02 21:00:00,28,21,27,34,2,112
2024-03-02 21:10:00,29,16,19,36,2,102
2024-03-02 21:20:00,20,10,5,40,1,76
2024-03-02 21:30:00,13,6,15,19,1,54
2024-03-02 21:40:00,26,6,15,26,1,74
2024-03-02 21:50:00,20,4,15,24,0,63
2024-03-02 22:00:00,15,10,12,18,1,56
2024-03-02 22:10:00,26,10,21,18,1,76
2024-03-02 22:20:00,25,8,24,22,1,80
2024-03-02 22:30:00,22,6,11,20,1,60
2024-03-02 22:40:00,23,3,14,18,2,60
2024-03-02 22:50:00,19,15,15,26,0,75
2024-03-02 23:00:00,11,8,11,13,0,43
2024-03-02 23:10:00,24,19,14,18,0,75
2024-03-02 23:20:00,26,8,13,11,0,58
2024-03-02 23:30:00,24,7,16,15,1,63
2024-03-02 23:40:00,15,1,10,13,1,40
2024-03-02 23:50:00,18,4,11,22,0,55
2024-03-03 00:00:00,12,3,10,14,0,39
2024-03-03 00:10:00,22,5,4,19,0,50
2024-03-03 00:20:00,17,1,11,12,0,41
2024-03-03 00:30:00,12,7,7,14,0,40
2024-03-03 00:40:00,20,2,7,32,1,62
2024-03-03 00:50:00,18,5,8,8,0,39
2024-03-03 01:00:00,12,1,2,10,0,25
2024-03-03 01:10:00,9,3,3,14,0,29
2024-03-03 01:20:00,12,2,3,7,0,24
2024-03-03 01:30:00,11,0,2,5,2,20
2024-03-03 01:40:00,11,3,1,7,0,22
2024-03-03 01:50:00,3,6,8,9,0,26
2024-03-03 02:00:00,15,7,2,16,0,40
2024-03-03 02:10:00,16,0,2,4,1,23
2024-03-03 02:20:00,4,2,4,13,0,23
2024-03-03 02:30:00,9,0,2,5,0,16
2024-03-03 02:40:00,6,2,3,7,0,18
2024-03-03 02:50:00,3,0,2,10,0,15
2024-03-03 03:00:00,11,0,5,10,0,26
2024-03-03 03:10:00,2,0,6,4,0,12
2024-03-03 03:20:00,8,1,1,3,0,13
2024-03-03 03:30:00,5,0,3,4,0,12
2024-03-03 03:40:00,5,2,6,7,0,20
2024-03-03 03:50:00,9,0,4,7,0,20
2024-03-03 04:00:00,7,2,2,4,0,15
2024-03-03 04:10:00,8,1,3,3,0,15
2024-03-03 04:20:00,13,2,0,0,0,15
2024-03-03 04:30:00,6,0,2,6,0,14
2024-03-03 04:40:00,1,1,0,3,0,5
2024-03-03 04:50:00,3,2,3,5,0,13
2024-03-03 05:00:00,4,2,2,3,0,11
2024-03-03 05:10:00,6,2,0,6,0,14
2024-03-03 05:20:00,10,3,1,6,0,20
2024-03-03 05:30:00,12,1,2,4,0,19
2024-03-03 05:40:00,3,3,6,4,1,17
2024-03-03 05:50:00,6,1,8,2,0,17
2024-03-03 06:00:00,10,4,6,3,0,23
2024-03-03 06:10:00,6,0,4,3,1,14
2024-03-03 06:20:00,11,2,6,1,1,21
2024-03-03 06:30:00,8,0,2,6,0,16
2024-03-03 06:40:00,7,3,3,4,0,17
2024-03-03 06:50:00,7,3,2,5,0,17
2024-03-03 07:00:00,9,3,3,4,0,19
2024-03-03 07:10:00,4,4,0,3,0,11
2024-03-03 07:20:00,7,5,7,3,1,23
2024-03-03 07:30:00,12,2,8,6,0,28
2024-03-03 07:40:00,7,5,6,4,0,22
2024-03-03 07:50:00,2,1,7,6,0,16
2024-03-03 08:00:00,10,3,3,5,1,22
2024-03-03 08:10:00,4,3,6,7,2,22
2024-03-03 08:20:00,10,5,7,11,3,36
2024-03-03 08:30:00,14,6,8,11,3,42
2024-03-03 08:40:00,19,8,12,11,1,51
2024-03-03 08:50:00,18,10,12,12,0,52
2024-03-03 09:00:00,14,9,10,10,0,43
2024-03-03 09:10:00,20,8,15,15,1,59
2024-03-03 09:20:00,17,9,16,21,2,65
2024-03-03 09:30:00,32,13,9,20,4,78
2024-03-03 09:40:00,28,12,22,17,3,82
2024-03-03 09:50:00,23,6,17,16,2,64
2024-03-03 10:00:00,40,15,19,14,3,91
2024-03-03 10:10:00,34,9,20,20,1,84
2024-03-03 10:20:00,21,16,13,19,3,72
2024-03-03 10:30:00,21,8,18,19,2,68
2024-03-03 10:40:00,27,14,26,23,7,97
2024-03-03 10:50:00,30,11,15,31,4,91
2024-03-03 11:00:00,38,18,18,18,5,97
2024-03-03 11:10:00,36,16,22,25,2,101
2024-03-03 11:20:00,26,15,23,25,2,91
2024-03-03 11:30:00,26,16,17,16,3,78
2024-03-03 11:40:00,32,19,16,31,6,104
2024-03-03 11:50:00,48,14,26,24,5,117
2024-03-03 12:00:00,37,12,17,35,1,102
2024-03-03 12:10:00,32,18,23,43,5,121
2024-03-03 12:20:00,34,13,20,31,6,104
2024-03-03 12:30:00,34,21,21,43,5,124
2024-03-03 12:40:00,43,21,30,25,2,121
2024-03-03 12:50:00,21,19,25,24,4,93
2024-03-03 13:00:00,33,9,23,40,4,109
2024-03-03 13:10:00,34,16,40,35,2,127
2024-03-03 13:20:00,52,11,28,24,5,120
2024-03-03 13:30:00,34,12,29,24,4,103
2024-03-03 13:40:00,36,28,34,41,3,142
2024-03-03 13:50:00,32,22,15,25,5,99
2024-03-03 14:00:00,31,21,23,29,8,112
2024-03-03 14:10:00,34,15,19,29,3,100
2024-03-03 14:20:00,41,17,29,29,4,120
2024-03-03 14:30:00,28,13,19,38,3,101
2024-03-03 14:40:00,37,31,27,36,4,135
2024-03-03 14:50:00,33,24,11,27,7,102
2024-03-03 15:00:00,31,24,27,34,9,125
2024-03-03 15:10:00,35,24,23,25,13,120
2024-03-03 15:20:00,27,18,19,25,8,97
2024-03-03 15:30:00,30,16,23,24,7,100
2024-03-03 15:40:00,49,17,17,35,3,121
2024-03-03 15:50:00,43,15,19,28,2,107
2024-03-03 16:00:00,39,16,14,17,7,93
2024-03-03 16:10:00,30,17,19,28,10,104
2024-03-03 16:20:00,37,20,15,24,5,101
2024-03-03 16:30:00,42,22,18,21,3,106
2024-03-03 16:40:00,32,14,19,21,5,91
2024-03-03 16:50:00,44,22,14,30,2,112
2024-03-03 17:00:00,48,15,11,36,5,115
2024-03-03 17:10:00,31,17,20,41,5,114
2024-03-03 17:20:00,35,24,22,29,3,113
2024-03-03 17:30:00,48,16,17,22,9,112
2024-03-03 17:40:00,38,21,16,26,6,107
2024-03-03 17:50:00,46,23,23,20,6,118
2024-03-03 18:00:00,27,15,23,26,6,97
2024-03-03 18:10:00,36,25,25,20,7,113
2024-03-03 18:20:00,31,18,22,24,4,99
2024-03-03 18:30:00,30,16,13,14,4,77
2024-03-03 18:40:00,25,34,29,31,6,125
2024-03-03 18:50:00,40,24,31,39,2,136
2024-03-03 19:00:00,48,13,23,33,3,120
2024-03-03 19:10:00,43,14,35,13,1,106
2024-03-03 19:20:00,34,13,48,27,3,125
2024-03-03 19:30:00,34,13,34,22,2,105
2024-03-03 19:40:00,36,17,27,21,1,102
2024-03-03 19:50:00,30,15,27,28,2,102
2024-03-03 20:00:00,23,15,18,30,0,86
2024-03-03 20:10:00,27,20,31,16,0,94
2024-03-03 20:20:00,31,6,38,17,1,93
2024-03-03 20:30:00,33,19,34,14,1,101
2024-03-03 20:40:00,17,12,33,17,2,81
2024-03-03 20:50:00,27,9,38,9,1,84
2024-03-03 21:00:00,15,16,18,12,1,62
2024-03-03 21:10:00,26,5,26,15,2,74
2024-03-03 21:20:00,22,21,18,19,0,80
2024-03-03 21:30:00,20,12,25,16,0,73
2024-03-03 21:40:00,14,20,18,13,0,65
2024-03-03 21:50:00,17,5,20,19,0,61
2024-03-03 22:00:00,18,3,8,12,0,41
2024-03-03 22:10:00,15,7,20,8,0,50
2024-03-03 22:20:00,11,8,19,6,0,44
2024-03-03 22:30:00,12,4,9,9,0,34
2024-03-03 22:40:00,10,7,11,11,0,39
2024-03-03 22:50:00,10,6,10,9,0,35
2024-03-03 23:00:00,19,4,7,6,0,36
2024-03-03 23:10:00,9,8,10,13,0,40
2024-03-03 23:20:00,6,3,7,9,0,25
2024-03-03 23:30:00,4,1,7,7,0,19
2024-03-03 23:40:00,15,3,9,3,1,31
2024-03-03 23:50:00,3,1,7,3,0,14
2024-03-04 00:00:00,5,4,5,4,0,18
2024-03-04 00:10:00,5,0,2,5,0,12
2024-03-04 00:20:00,4,5,1,2,0,12
2024-03-04 00:30:00,3,3,0,4,0,10
2024-03-04 00:40:00,3,1,4,6,0,14
2024-03-04 00:50:00,4,1,6,1,1,13
2024-03-04 01:00:00,1,1,0,4,0,6
2024-03-04 01:10:00,5,2,2,1,0,10
2024-03-04 01:20:00,8,2,3,2,0,15
2024-03-04 01:30:00,5,0,0,4,0,9
2024-03-04 01:40:00,2,0,1,0,0,3
2024-03-04 01:50:00,3,0,1,0,0,4
2024-03-04 02:00:00,1,0,1,0,0,2
2024-03-04 02:10:00,1,0,3,4,0,8
2024-03-04 02:20:00,6,2,2,1,0,11
2024-03-04 02:30:00,1,0,5,2,0,8
2024-03-04 02:40:00,3,2,0,1,0,6
2024-03-04 02:50:00,1,0,2,0,0,3
2024-03-04 03:00:00,1,0,0,1,0,2
2024-03-04 03:10:00,2,0,1,2,0,5
2024-03-04 03:20:00,1,3,1,2,0,7
2024-03-04 03:30:00,3,4,3,0,0,10
2024-03-04 03:40:00,3,2,6,1,0,12
2024-03-04 03:50:00,2,4,7,0,0,13
2024-03-04 04:00:00,2,0,2,3,0,7
2024-03-04 04:10:00,6,3,2,2,0,13
2024-03-04 04:20:00,9,3,4,0,0,16
2024-03-04 04:30:00,7,1,5,2,0,15
2024-03-04 04:40:00,7,1,13,2,0,23
2024-03-04 04:50:00,3,1,12,3,0,19
2024-03-04 05:00:00,8,5,12,2,0,27
2024-03-04 05:10:00,17,8,14,4,1,44
2024-03-04 05:20:00,26,15,12,10,0,63
2024-03-04 05:30:00,29,10,29,4,0,72
2024-03-04 05:40:00,31,28,33,16,1,109
2024-03-04 05:50:00,41,21,33,14,3,112
2024-03-04 06:00:00,28,28,27,14,0,97
2024-03-04 06:10:00,31,12,23,24,0,90
2024-03-04 06:20:00,32,21,40,22,0,115
2024-03-04 06:30:00,67,27,46,21,2,163
2024-03-04 06:40:00,74,37,52,30,2,195
2024-03-04 06:50:00,34,16,37,25,4,116
2024-03-04 07:00:00,51,28,29,27,4,139
2024-03-04 07:10:00,49,32,29,25,4,139
2024-03-04 07:20:00,68,32,39,30,8,177
2024-03-04 07:30:00,56,40,33,32,7,168
2024-03-04 07:40:00,54,37,38,26,11,166
2024-03-04 07:50:00,42,31,42,23,4,142
2024-03-04 08:00:00,70,36,51,33,6,196
2024-03-04 08:10:00,62,32,47,28,3,172
2024-03-04 08:20:00,43,31,31,27,7,139
2024-03-04 08:30:00,45,33,30,18,6,132
2024-03-04 08:40:00,51,30,26,30,6,143
2024-03-04 08:50:00,55,27,31,18,6,137
2024-03-04 09:00:00,49,22,31,24,4,130
2024-03-04 09:10:00,42,21,24,26,5,118
2024-03-04 09:20:00,43,14,27,16,4,104
2024-03-04 09:30:00,44,10,40,24,1,119
2024-03-04 09:40:00,45,22,35,20,1,123
2024-03-04 09:50:00,45,23,27,16,6,117
2024-03-04 10:00:00,38,17,21,14,6,96
2024-03-04 10:10:00,48,10,35,20,4,117
2024-03-04 10:20:00,48,11,35,18,4,116
2024-03-04 10:30:00,42,14,30,17,2,105
2024-03-04 10:40:00,26,13,23,17,2,81
2024-03-04 10:50:00,48,16,33,28,4,129
2024-03-04 11:00:00,40,15,22,26,2,105
2024-03-04 11:10:00,37,18,38,23,3,119
2024-03-04 11:20:00,37,20,34,19,5,115
2024-03-04 11:30:00,39,19,34,20,2,114
2024-03-04 11:40:00,41,14,39,26,1,121
2024-03-04 11:50:00,41,18,29,21,3,112
2024-03-04 12:00:00,38,12,36,18,1,105
2024-03-04 12:10:00,53,18,31,19,1,122
2024-03-04 12:20:00,44,27,33,20,4,128
2024-03-04 12:30:00,34,26,35,24,8,127
2024-03-04 12:40:00,33,20,41,20,6,120
2024-03-04 12:50:00,39,21,38,27,7,132
2024-03-04 13:00:00,35,13,37,23,5,113
2024-03-04 13:10:00,40,28,32,20,6,126
2024-03-04 13:20:00,35,32,28,25,7,127
2024-03-04 13:30:00,40,25,36,26,10,137
2024-03-04 13:40:00,51,25,43,24,5,148
2024-03-04 13:50:00,47,22,25,25,4,123
2024-03-04 14:00:00,35,15,39,30,4,123
2024-03-04 14:10:00,42,21,50,25,4,142
2024-03-04 14:20:00,49,15,43,28,6,141
2024-03-04 14:30:00,42,16,34,25,4,121
2024-03-04 14:40:00,48,15,29,36,7,135
2024-03-04 14:50:00,56,22,49,26,5,158
2024-03-04 15:00:00,42,18,45,33,5,143
2024-03-04 15:10:00,37,22,38,24,8,129
2024-03-04 15:20:00,40,26,28,22,9,125
2024-03-04 15:30:00,67,30,41,26,3,167
2024-03-04 15:40:00,32,23,40,26,6,127
2024-03-04 15:50:00,39,21,44,26,6,136
2024-03-04 16:00:00,42,33,34,23,5,137
2024-03-04 16:10:00,45,25,36,20,6,132
2024-03-04 16:20:00,33,25,41,38,5,142
2024-03-04 16:30:00,53,31,45,32,3,164
2024-03-04 16:40:00,41,25,38,42,8,154
2024-03-04 16:50:00,50,35,44,32,3,164
2024-03-04 17:00:00,50,29,33,42,8,162
2024-03-04 17:10:00,48,26,45,35,5,159
2024-03-04 17:20:00,61,29,38,33,6,167
2024-03-04 17:30:00,41,31,38,34,5,149
2024-03-04 17:40:00,32,24,40,27,7,130
2024-03-04 17:50:00,49,24,39,25,6,143
2024-03-04 18:00:00,35,24,35,34,4,132
2024-03-04 18:10:00,39,22,45,35,2,143
2024-03-04 18:20:00,55,26,79,44,6,210
2024-03-04 18:30:00,37,22,67,31,5,162
2024-03-04 18:40:00,42,38,73,43,6,202
2024-03-04 18:50:00,42,32,59,30,5,168
2024-03-04 19:00:00,29,17,43,27,4,120
2024-03-04 19:10:00,29,27,47,34,4,141
2024-03-04 19:20:00,23,17,39,29,5,113
2024-03-04 19:30:00,43,22,35,32,0,132
2024-03-04 19:40:00,23,7,36,32,5,103
2024-03-04 19:50:00,37,13,41,19,0,110
2024-03-04 20:00:00,25,15,34,38,2,114
2024-03-04 20:10:00,33,13,20,23,3,92
2024-03-04 20:20:00,28,18,24,21,3,94
2024-03-04 20:30:00,31,14,34,22,0,101
2024-03-04 20:40:00,23,6,23,24,3,79
2024-03-04 20:50:00,23,16,25,25,2,91
2024-03-04 21:00:00,28,15,20,17,2,82
2024-03-04 21:10:00,29,14,27,24,0,94
2024-03-04 21:20:00,27,15,26,10,2,80
2024-03-04 21:30:00,20,10,28,16,0,74
2024-03-04 21:40:00,26,6,36,9,0,77
2024-03-04 21:50:00,10,6,19,16,0,51
2024-03-04 22:00:00,14,10,23,16,3,66
2024-03-04 22:10:00,17,4,34,13,0,68
2024-03-04 22:20:00,11,10,30,24,0,75
2024-03-04 22:30:00,7,7,29,12,0,55
2024-03-04 22:40:00,6,6,11,10,1,34
2024-03-04 22:50:00,10,6,19,13,1,49
2024-03-04 23:00:00,4,3,17,3,0,27
2024-03-04 23:10:00,5,0,9,7,0,21
2024-03-04 23:20:00,6,7,18,10,0,41
2024-03-04 23:30:00,14,4,9,3,0,30
2024-03-04 23:40:00,6,3,9,3,0,21
2024-03-04 23:50:00,7,3,3,5,0,18
2024-03-05 00:00:00,12,3,9,7,0,31
2024-03-05 00:10:00,7,0,7,3,1,18
2024-03-05 00:20:00,9,1,5,0,0,15
2024-03-05 00:30:00,9,2,1,2,0,14
2024-03-05 00:40:00,4,1,4,6,0,15
2024-03-05 00:50:00,4,1,5,8,0,18
2024-03-05 01:00:00,1,0,1,6,0,8
2024-03-05 01:10:00,5,3,0,2,0,10
2024-03-05 01:20:00,4,5,2,0,0,11
2024-03-05 01:30:00,2,2,1,0,0,5
2024-03-05 01:40:00,0,2,2,2,0,6
2024-03-05 01:50:00,1,0,2,1,0,4
2024-03-05 02:00:00,5,1,1,4,0,11
2024-03-05 02:10:00,3,0,0,0,0,3
2024-03-05 02:20:00,2,0,3,4,0,9
2024-03-05 02:30:00,1,0,5,0,0,6
2024-03-05 02:40:00,1,1,0,1,0,3
2024-03-05 02:50:00,1,0,2,1,0,4
2024-03-05 03:00:00,5,0,1,1,0,7
2024-03-05 03:10:00,0,0,1,0,0,1
2024-03-05 03:20:00,1,1,3,3,0,8
2024-03-05 03:30:00,4,3,1,2,1,11
2024-03-05 03:40:00,6,2,3,0,0,11
2024-03-05 03:50:00,2,1,8,8,0,19
2024-03-05 04:00:00,1,2,2,3,0,8
2024-03-05 04:10:00,9,0,6,0,0,15
2024-03-05 04:20:00,7,2,4,1,0,14
2024-03-05 04:30:00,9,1,4,2,0,16
2024-03-05 04:40:00,5,0,11,4,0,20
2024-03-05 04:50:00,3,2,7,2,0,14
2024-03-05 05:00:00,16,6,9,1,0,32
2024-03-05 05:10:00,23,17,9,11,0,60
2024-03-05 05:20:00,19,17,15,3,0,54
2024-03-05 05:30:00,33,29,26,6,0,94
2024-03-05 05:40:00,29,25,23,11,1,89
2024-03-05 05:50:00,32,19,31,23,2,107
2024-03-05 06:00:00,28,23,45,22,0,118
2024-03-05 06:10:00,37,18,30,13,0,98
2024-03-05 06:20:00,39,32,35,20,2,128
2024-03-05 06:30:00,44,31,36,20,3,134
2024-03-05 06:40:00,48,40,52,24,3,167
2024-03-05 06:50:00,54,27,33,26,2,142
2024-03-05 07:00:00,37,25,25,21,4,112
2024-03-05 07:10:00,61,27,26,26,5,145
2024-03-05 07:20:00,41,27,32,32,10,142
2024-03-05 07:30:00,62,40,47,36,9,194
2024-03-05 07:40:00,55,25,44,32,10,166
2024-03-05 07:50:00,62,27,28,31,9,157
2024-03-05 08:00:00,63,37,31,27,4,162
2024-03-05 08:10:00,45,51,38,25,6,165
2024-03-05 08:20:00,60,25,38,25,6,154
2024-03-05 08:30:00,67,35,34,16,5,157
2024-03-05 08:40:00,55,36,43,27,5,166
2024-03-05 08:50:00,64,21,36,17,1,139
2024-03-05 09:00:00,56,16,44,21,4,141
2024-03-05 09:10:00,45,27,31,23,3,129
2024-03-05 09:20:00,58,14,31,15,2,120
2024-03-05 09:30:00,47,18,39,26,3,133
2024-03-05 09:40:00,46,17,44,18,2,127
2024-03-05 09:50:00,48,14,34,29,0,125
2024-03-05 10:00:00,46,22,32,17,3,120
2024-03-05 10:10:00,46,12,28,18,2,106
2024-03-05 10:20:00,43,22,27,13,2,107
2024-03-05 10:30:00,52,19,26,19,2,118
2024-03-05 10:40:00,43,17,31,18,0,109
2024-03-05 10:50:00,39,13,36,23,3,114
2024-03-05 11:00:00,40,10,27,14,1,92
2024-03-05 11:10:00,51,14,37,19,2,123
2024-03-05 11:20:00,28,24,41,25,5,123
2024-03-05 11:30:00,37,27,33,11,4,112
2024-03-05 11:40:00,45,18,30,21,3,117
2024-03-05 11:50:00,43,20,38,31,2,134
2024-03-05 12:00:00,36,14,40,21,3,114
2024-03-05 12:10:00,35,15,38,17,2,107
2024-03-05 12:20:00,36,21,36,18,4,115
2024-03-05 12:30:00,26,14,39,25,7,111
2024-03-05 12:40:00,31,28,32,24,5,120
2024-03-05 12:50:00,28,8,26,11,3,76
2024-03-05 13:00:00,15,6,16,10,1,48
2024-03-05 13:10:00,0,0,0,0,0,0
2024-03-05 13:20:00,0,0,0,0,0,0
2024-03-05 13:30:00,25,9,28,16,4,82
2024-03-05 13:40:00,82,70,35,16,5,208
2024-03-05 13:50:00,44,31,36,20,3,134
2024-03-05 14:00:00,36,30,37,28,6,137
2024-03-05 14:10:00,44,27,25,38,3,137
2024-03-05 14:20:00,41,18,43,38,8,148
2024-03-05 14:30:00,36,18,39,29,5,127
2024-03-05 14:40:00,44,18,37,28,7,134
2024-03-05 14:50:00,44,22,57,26,3,152
2024-03-05 15:00:00,47,17,40,25,3,132
2024-03-05 15:10:00,50,28,46,34,3,161
2024-03-05 15:20:00,38,32,48,30,6,154
2024-03-05 15:30:00,34,18,33,29,7,121
2024-03-05 15:40:00,40,32,42,28,3,145
2024-03-05 15:50:00,46,19,38,32,4,139
2024-03-05 16:00:00,43,21,45,30,4,143
2024-03-05 16:10:00,59,24,55,37,2,177
2024-03-05 16:20:00,55,27,40,38,5,165
2024-03-05 16:30:00,44,32,42,27,3,148
2024-03-05 16:40:00,50,34,47,34,11,176
2024-03-05 16:50:00,43,28,50,38,5,164
2024-03-05 17:00:00,49,24,32,34,8,147
2024-03-05 17:10:00,41,25,41,25,5,137
2024-03-05 17:20:00,55,37,42,29,4,167
2024-03-05 17:30:00,45,22,36,24,7,134
2024-03-05 17:40:00,47,29,47,34,5,162
2024-03-05 17:50:00,38,17,39,33,4,131
2024-03-05 18:00:00,47,19,38,31,5,140
2024-03-05 18:10:00,35,24,42,40,5,146
2024-03-05 18:20:00,45,21,63,34,1,164
2024-03-05 18:30:00,38,16,59,41,8,162
2024-03-05 18:40:00,40,35,53,51,9,188
2024-03-05 18:50:00,30,26,44,45,10,155
2024-03-05 19:00:00,44,31,69,38,6,188
2024-03-05 19:10:00,44,26,63,30,0,163
2024-03-05 19:20:00,37,19,55,36,2,149
2024-03-05 19:30:00,34,29,60,43,4,170
2024-03-05 19:40:00,29,13,36,40,3,121
2024-03-05 19:50:00,28,17,42,35,1,123
2024-03-05 20:00:00,22,10,31,34,7,104
2024-03-05 20:10:00,32,9,28,21,3,93
2024-03-05 20:20:00,36,22,18,23,3,102
2024-03-05 20:30:00,26,15,24,32,6,103
2024-03-05 20:40:00,21,17,25,14,0,77
2024-03-05 20:50:00,14,18,36,22,3,93
2024-03-05 21:00:00,24,18,17,36,0,95
2024-03-05 21:10:00,25,4,35,22,0,86
2024-03-05 21:20:00,41,11,28,22,1,103
2024-03-05 21:30:00,28,12,39,18,0,97
2024-03-05 21:40:00,30,9,7,17,1,64
2024-03-05 21:50:00,20,9,28,18,0,75
2024-03-05 22:00:00,25,10,30,11,0,76
2024-03-05 22:10:00,18,7,38,26,0,89
2024-03-05 22:20:00,20,5,31,24,0,80
2024-03-05 22:30:00,17,8,21,14,2,62
2024-03-05 22:40:00,14,8,21,17,1,61
2024-03-05 22:50:00,11,10,10,8,1,40
2024-03-05 23:00:00,8,1,9,13,0,31
2024-03-05 23:10:00,12,5,13,3,0,33
2024-03-05 23:20:00,7,1,6,5,0,19
2024-03-05 23:30:00,8,4,14,15,1,42
2024-03-05 23:40:00,6,4,8,4,0,22
2024-03-05 23:50:00,11,2,3,7,0,23
2024-03-06 00:00:00,3,2,10,2,0,17
2024-03-06 00:10:00,5,0,6,2,0,13
2024-03-06 00:20:00,7,1,8,9,0,25
2024-03-06 00:30:00,3,2,3,3,0,11
2024-03-06 00:40:00,1,0,0,0,0,1
2024-03-06 00:50:00,4,2,5,7,0,18
2024-03-06 01:00:00,1,0,3,5,0,9
2024-03-06 01:10:00,1,0,6,0,0,7
2024-03-06 01:20:00,3,0,6,2,0,11
2024-03-06 01:30:00,7,2,1,3,0,13
2024-03-06 01:40:00,5,0,2,0,0,7
2024-03-06 01:50:00,4,0,0,2,0,6
2024-03-06 02:00:00,4,2,2,0,0,8
2024-03-06 02:10:00,4,0,2,3,0,9
2024-03-06 02:20:00,1,0,1,0,0,2
2024-03-06 02:30:00,2,0,4,4,0,10
2024-03-06 02:40:00,8,0,0,2,0,10
2024-03-06 02:50:00,3,2,3,0,0,8
2024-03-06 03:00:00,3,1,5,0,0,9
2024-03-06 03:10:00,0,0,1,0,0,1
2024-03-06 03:20:00,1,0,5,0,0,6
2024-03-06 03:30:00,4,0,2,1,0,7
2024-03-06 03:40:00,3,2,4,3,0,12
2024-03-06 03:50:00,4,0,3,4,0,11
2024-03-06 04:00:00,2,1,2,1,0,6
2024-03-06 04:10:00,5,1,5,1,0,12
2024-03-06 04:20:00,11,4,4,0,0,19
2024-03-06 04:30:00,10,3,2,4,0,19
2024-03-06 04:40:00,5,2,8,7,0,22
2024-03-06 04:50:00,6,6,10,2,0,24
2024-03-06 05:00:00,17,3,9,2,0,31
2024-03-06 05:10:00,16,8,19,2,0,45
2024-03-06 05:20:00,29,11,19,6,0,65
2024-03-06 05:30:00,34,23,20,8,0,85
2024-03-06 05:40:00,30,24,31,11,5,101
2024-03-06 05:50:00,36,26,26,22,1,111
2024-03-06 06:00:00,32,24,30,16,0,102
2024-03-06 06:10:00,35,26,29,16,0,106
2024-03-06 06:20:00,41,29,38,33,5,146
2024-03-06 06:30:00,44,29,51,13,0,137
2024-03-06 06:40:00,55,33,50,42,2,182
2024-03-06 06:50:00,46,23,22,15,3,109
2024-03-06 07:00:00,61,27,32,19,6,145
2024-03-06 07:10:00,56,27,37,25,5,150
2024-03-06 07:20:00,64,66,31,25,8,194
2024-03-06 07:30:00,41,57,35,31,12,176
2024-03-06 07:40:00,49,26,49,33,9,166
2024-03-06 07:50:00,80,30,44,22,2,178
2024-03-06 08:00:00,57,38,45,24,3,167
2024-03-06 08:10:00,59,26,64,30,3,182
2024-03-06 08:20:00,49,24,35,30,7,145
2024-03-06 08:30:00,55,24,42,20,6,147
2024-03-06 08:40:00,44,28,47,25,5,149
2024-03-06 08:50:00,51,19,34,20,4,128
2024-03-06 09:00:00,48,29,25,15,6,123
2024-03-06 09:10:00,44,18,18,21,3,104
2024-03-06 09:20:00,50,18,28,23,5,124
2024-03-06 09:30:00,29,12,38,19,8,106
2024-03-06 09:40:00,47,16,37,22,5,127
2024-03-06 09:50:00,48,25,35,21,3,132
2024-03-06 10:00:00,31,12,42,16,3,104
2024-03-06 10:10:00,45,15,36,16,3,115
2024-03-06 10:20:00,38,13,32,22,5,110
2024-03-06 10:30:00,39,20,42,19,1,121
2024-03-06 10:40:00,37,18,33,21,3,112
2024-03-06 10:50:00,37,21,29,19,2,108
2024-03-06 11:00:00,38,8,46,19,2,113
2024-03-06 11:10:00,40,16,25,24,3,108
2024-03-06 11:20:00,41,18,37,16,5,117
2024-03-06 11:30:00,40,18,44,14,4,120
2024-03-06 11:40:00,40,15,41,23,3,122
2024-03-06 11:50:00,43,26,40,19,1,129
2024-03-06 12:00:00,50,18,25,25,1,119
2024-03-06 12:10:00,40,14,42,21,3,120
2024-03-06 12:20:00,36,17,25,22,3,103
2024-03-06 12:30:00,33,18,33,22,6,112
2024-03-06 12:40:00,45,22,27,23,3,120
2024-03-06 12:50:00,38,20,49,24,5,136
2024-03-06 13:00:00,37,16,39,32,4,128
2024-03-06 13:10:00,32,24,32,17,9,114
2024-03-06 13:20:00,36,32,40,32,10,150
2024-03-06 13:30:00,31,15,38,34,7,125
2024-03-06 13:40:00,37,31,34,20,8,130
2024-03-06 13:50:00,44,18,36,24,4,126
2024-03-06 14:00:00,44,16,39,22,4,125
2024-03-06 14:10:00,34,21,44,26,6,131
2024-03-06 14:20:00,44,16,24,26,7,117
2024-03-06 14:30:00,36,18,33,26,9,122
2024-03-06 14:40:00,56,18,48,24,3,149
2024-03-06 14:50:00,37,19,36,28,6,126
2024-03-06 15:00:00,40,24,43,23,2,132
2024-03-06 15:10:00,33,28,38,22,7,128
2024-03-06 15:20:00,47,23,44,19,3,136
2024-03-06 15:30:00,51,21,37,26,8,143
2024-03-06 15:40:00,40,22,30,24,5,121
2024-03-06 15:50:00,55,22,43,31,8,159
2024-03-06 16:00:00,53,23,47,33,5,161
2024-03-06 16:10:00,49,33,31,27,8,148
2024-03-06 16:20:00,52,25,42,36,7,162
2024-03-06 16:30:00,48,40,41,32,3,164
2024-03-06 16:40:00,45,22,41,38,4,150
2024-03-06 16:50:00,54,35,43,37,3,172
2024-03-06 17:00:00,60,28,45,44,6,183
2024-03-06 17:10:00,45,27,38,31,6,147
2024-03-06 17:20:00,49,31,41,35,7,163
2024-03-06 17:30:00,46,32,52,37,4,171
2024-03-06 17:40:00,39,21,45,43,4,152
2024-03-06 17:50:00,27,27,37,38,4,133
2024-03-06 18:00:00,37,22,39,39,4,141
2024-03-06 18:10:00,43,23,49,28,3,146
2024-03-06 18:20:00,44,18,41,42,5,150
2024-03-06 18:30:00,38,23,46,40,10,157
2024-03-06 18:40:00,55,21,57,43,5,181
2024-03-06 18:50:00,63,31,65,42,8,209
2024-03-06 19:00:00,41,21,66,35,3,166
2024-03-06 19:10:00,36,19,53,32,2,142
2024-03-06 19:20:00,38,20,53,37,4,152
2024-03-06 19:30:00,50,26,52,21,2,151
2024-03-06 19:40:00,37,17,40,19,3,116
2024-03-06 19:50:00,46,26,63,31,1,167
2024-03-06 20:00:00,25,17,56,24,2,124
2024-03-06 20:10:00,26,21,28,28,0,103
2024-03-06 20:20:00,28,17,46,22,4,117
2024-03-06 20:30:00,30,16,45,27,2,120
2024-03-06 20:40:00,35,13,23,16,2,89
2024-03-06 20:50:00,21,22,35,16,0,94
2024-03-06 21:00:00,45,16,38,27,2,128
2024-03-06 21:10:00,18,15,34,23,2,92
2024-03-06 21:20:00,33,24,32,19,1,109
2024-03-06 21:30:00,38,16,50,24,2,130
2024-03-06 21:40:00,16,7,35,20,2,80
2024-03-06 21:50:00,25,15,29,21,1,91
2024-03-06 22:00:00,23,16,35,28,1,103
2024-03-06 22:10:00,19,5,34,19,2,79
2024-03-06 22:20:00,17,2,26,21,0,66
2024-03-06 22:30:00,12,10,25,24,0,71
2024-03-06 22:40:00,17,2,16,16,0,51
2024-03-06 22:50:00,27,4,12,11,0,54
2024-03-06 23:00:00,25,5,19,7,1,57
2024-03-06 23:10:00,13,7,20,6,0,46
2024-03-06 23:20:00,12,2,13,12,0,39
2024-03-06 23:30:00,19,1,2,8,0,30
2024-03-06 23:40:00,11,6,8,7,0,32
2024-03-06 23:50:00,12,3,10,10,0,35
2024-03-07 00:00:00,7,4,13,5,0,29
2024-03-07 00:10:00,7,0,6,7,1,21
2024-03-07 00:20:00,3,1,3,2,0,9
2024-03-07 00:30:00,11,2,7,5,0,25
2024-03-07 00:40:00,11,4,2,7,0,24
2024-03-07 00:50:00,3,0,0,2,0,5
2024-03-07 01:00:00,14,0,4,4,0,22
2024-03-07 01:10:00,8,2,7,2,0,19
2024-03-07 01:20:00,2,0,1,4,0,7
2024-03-07 01:30:00,3,1,0,0,0,4
2024-03-07 01:40:00,3,0,1,0,0,4
2024-03-07 01:50:00,0,2,1,0,0,3
2024-03-07 02:00:00,3,0,0,0,0,3
2024-03-07 02:10:00,3,0,5,1,0,9
2024-03-07 02:20:00,2,1,2,2,0,7
2024-03-07 02:30:00,4,1,5,2,0,12
2024-03-07 02:40:00,4,2,1,1,0,8
2024-03-07 02:50:00,1,2,0,0,0,3
2024-03-07 03:00:00,4,0,3,2,0,9
2024-03-07 03:10:00,1,0,5,3,0,9
2024-03-07 03:20:00,2,0,2,4,0,8
2024-03-07 03:30:00,0,1,7,1,0,9
2024-03-07 03:40:00,3,2,4,2,0,11
2024-03-07 03:50:00,0,2,6,2,0,10
2024-03-07 04:00:00,4,1,4,3,0,12
2024-03-07 04:10:00,5,2,5,1,0,13
2024-03-07 04:20:00,8,4,5,2,0,19
2024-03-07 04:30:00,5,6,0,3,0,14
2024-03-07 04:40:00,7,1,9,0,1,18
2024-03-07 04:50:00,3,4,4,4,0,15
2024-03-07 05:00:00,12,5,10,4,0,31
2024-03-07 05:10:00,18,9,12,2,0,41
2024-03-07 05:20:00,30,25,14,4,0,73
2024-03-07 05:30:00,21,17,31,4,0,73
2024-03-07 05:40:00,31,30,39,8,4,112
2024-03-07 05:50:00,35,24,29,17,1,106
2024-03-07 06:00:00,28,12,27,18,0,85
2024-03-07 06:10:00,30,21,24,21,0,96
2024-03-07 06:20:00,52,29,52,23,0,156
2024-03-07 06:30:00,41,26,42,19,2,130
2024-03-07 06:40:00,35,23,31,16,2,107
2024-03-07 06:50:00,46,22,33,23,2,126
2024-03-07 07:00:00,50,29,37,24,4,144
2024-03-07 07:10:00,55,24,45,28,4,156
2024-03-07 07:20:00,56,31,31,26,11,155
2024-03-07 07:30:00,48,39,42,37,8,174
2024-03-07 07:40:00,53,29,58,48,9,197
2024-03-07 07:50:00,47,35,46,33,10,171
2024-03-07 08:00:00,56,34,39,24,6,159
2024-03-07 08:10:00,67,31,39,34,3,174
2024-03-07 08:20:00,52,25,39,23,6,145
2024-03-07 08:30:00,46,31,35,28,5,145
2024-03-07 08:40:00,59,24,34,26,3,146
2024-03-07 08:50:00,56,29,43,22,5,155
2024-03-07 09:00:00,38,23,32,18,5,116
2024-03-07 09:10:00,47,22,35,28,3,135
2024-03-07 09:20:00,43,17,38,14,2,114
2024-03-07 09:30:00,37,11,37,33,3,121
2024-03-07 09:40:00,40,15,40,18,4,117
2024-03-07 09:50:00,34,14,31,23,1,103
2024-03-07 10:00:00,39,12,32,16,3,102
2024-03-07 10:10:00,46,17,33,18,2,116
2024-03-07 10:20:00,43,15,36,22,0,116
2024-03-07 10:30:00,40,19,43,16,1,119
2024-03-07 10:40:00,43,15,46,27,3,134
2024-03-07 10:50:00,39,19,41,23,2,124
2024-03-07 11:00:00,36,10,38,12,1,97
2024-03-07 11:10:00,32,19,32,29,5,117
2024-03-07 11:20:00,42,30,44,17,3,136
2024-03-07 11:30:00,33,19,40,15,9,116
2024-03-07 11:40:00,48,19,54,17,3,141
2024-03-07 11:50:00,42,25,45,26,2,140
2024-03-07 12:00:00,36,25,29,17,3,110
2024-03-07 12:10:00,42,11,38,40,5,136
2024-03-07 12:20:00,44,13,32,30,4,123
2024-03-07 12:30:00,51,22,37,26,4,140
2024-03-07 12:40:00,35,17,46,28,3,129
2024-03-07 12:50:00,43,25,52,27,6,153
2024-03-07 13:00:00,63,17,46,23,3,152
2024-03-07 13:10:00,48,19,40,22,7,136
2024-03-07 13:20:00,34,20,47,27,9,137
2024-03-07 13:30:00,39,19,39,21,5,123
2024-03-07 13:40:00,42,15,26,22,5,110
2024-03-07 13:50:00,33,23,39,21,5,121
2024-03-07 14:00:00,40,17,42,29,6,134
2024-03-07 14:10:00,45,21,41,24,6,137
2024-03-07 14:20:00,42,24,39,35,7,147
2024-03-07 14:30:00,36,19,40,32,7,134
2024-03-07 14:40:00,43,17,40,45,5,150
2024-03-07 14:50:00,60,17,41,43,3,164
2024-03-07 15:00:00,48,38,47,29,2,164
2024-03-07 15:10:00,54,26,33,26,7,146
2024-03-07 15:20:00,34,20,42,30,5,131
2024-03-07 15:30:00,43,22,43,34,6,148
2024-03-07 15:40:00,52,17,39,37,5,150
2024-03-07 15:50:00,51,29,61,33,3,177
2024-03-07 16:00:00,51,24,48,33,5,161
2024-03-07 16:10:00,46,27,27,26,8,134
2024-03-07 16:20:00,39,29,32,36,8,144
2024-03-07 16:30:00,53,32,43,29,6,163
2024-03-07 16:40:00,41,33,39,25,10,148
2024-03-07 16:50:00,51,30,45,31,6,163
2024-03-07 17:00:00,61,22,40,33,7,163
2024-03-07 17:10:00,53,23,44,41,7,168
2024-03-07 17:20:00,43,36,46,33,8,166
2024-03-07 17:30:00,51,34,44,38,5,172
2024-03-07 17:40:00,57,28,45,47,4,181
2024-03-07 17:50:00,40,23,54,45,6,168
2024-03-07 18:00:00,51,27,37,25,5,145
2024-03-07 18:10:00,45,24,47,41,4,161
2024-03-07 18:20:00,50,18,41,31,3,143
2024-03-07 18:30:00,60,30,41,40,2,173
2024-03-07 18:40:00,56,27,94,35,4,216
2024-03-07 18:50:00,61,17,67,39,3,187
2024-03-07 19:00:00,47,22,50,28,2,149
2024-03-07 19:10:00,42,22,71,41,6,182
2024-03-07 19:20:00,30,30,53,26,5,144
2024-03-07 19:30:00,40,20,39,25,1,125
2024-03-07 19:40:00,47,16,45,25,4,137
2024-03-07 19:50:00,36,13,44,33,4,130
2024-03-07 20:00:00,27,18,39,25,1,110
2024-03-07 20:10:00,45,21,42,26,1,135
2024-03-07 20:20:00,29,14,42,32,0,117
2024-03-07 20:30:00,30,25,40,10,3,108
2024-03-07 20:40:00,16,23,29,20,4,92
2024-03-07 20:50:00,31,29,37,15,3,115
2024-03-07 21:00:00,34,18,48,13,3,116
2024-03-07 21:10:00,29,15,27,23,0,94
2024-03-07 21:20:00,33,11,40,25,1,110
2024-03-07 21:30:00,25,16,37,18,1,97
2024-03-07 21:40:00,39,4,33,20,0,96
2024-03-07 21:50:00,31,7,39,13,1,91
2024-03-07 22:00:00,23,5,36,26,0,90
2024-03-07 22:10:00,20,10,22,13,1,66
2024-03-07 22:20:00,22,4,34,17,0,77
2024-03-07 22:30:00,31,5,34,9,0,79
2024-03-07 22:40:00,18,5,22,9,1,55
2024-03-07 22:50:00,30,4,29,9,0,72
2024-03-07 23:00:00,15,10,20,6,0,51
2024-03-07 23:10:00,9,5,21,9,1,45
2024-03-07 23:20:00,5,7,8,4,0,24
2024-03-07 23:30:00,16,3,11,9,1,40
2024-03-07 23:40:00,13,4,12,10,0,39
2024-03-07 23:50:00,5,2,2,7,0,16
2024-03-08 00:00:00,9,0,11,7,0,27
2024-03-08 00:10:00,2,0,2,1,0,5
2024-03-08 00:20:00,3,2,13,1,0,19
2024-03-08 00:30:00,4,0,5,4,0,13
2024-03-08 00:40:00,8,2,4,4,0,18
2024-03-08 00:50:00,3,1,6,2,0,12
2024-03-08 01:00:00,4,2,2,1,0,9
2024-03-08 01:10:00,7,3,19,6,0,35
2024-03-08 01:20:00,3,0,1,4,0,8
2024-03-08 01:30:00,1,3,0,1,0,5
2024-03-08 01:40:00,0,0,5,4,0,9
2024-03-08 01:50:00,6,0,2,1,0,9
2024-03-08 02:00:00,7,0,3,2,0,12
2024-03-08 02:10:00,4,3,0,0,0,7
2024-03-08 02:20:00,1,0,2,1,0,4
2024-03-08 02:30:00,3,1,4,3,0,11
2024-03-08 02:40:00,2,0,1,1,0,4
2024-03-08 02:50:00,2,2,2,2,0,8
2024-03-08 03:00:00,1,0,2,1,0,4
2024-03-08 03:10:00,0,0,0,2,0,2
2024-03-08 03:20:00,1,1,4,0,0,6
2024-03-08 03:30:00,3,0,3,2,0,8
2024-03-08 03:40:00,3,1,7,2,0,13
2024-03-08 03:50:00,9,4,4,0,0,17
2024-03-08 04:00:00,4,2,2,4,0,12
2024-03-08 04:10:00,6,0,5,1,0,12
2024-03-08 04:20:00,12,2,4,4,0,22
2024-03-08 04:30:00,3,6,8,4,0,21
2024-03-08 04:40:00,3,1,4,3,0,11
2024-03-08 04:50:00,7,3,3,3,0,16
2024-03-08 05:00:00,9,6,18,2,0,35
2024-03-08 05:10:00,14,12,16,5,0,47
2024-03-08 05:20:00,35,12,18,7,0,72
2024-03-08 05:30:00,25,23,14,1,0,63
2024-03-08 05:40:00,32,16,34,14,2,98
2024-03-08 05:50:00,29,23,27,19,0,98
2024-03-08 06:00:00,27,20,23,22,2,94
2024-03-08 06:10:00,32,27,31,22,0,112
2024-03-08 06:20:00,47,22,44,23,1,137
2024-03-08 06:30:00,44,27,32,16,1,120
2024-03-08 06:40:00,39,19,38,24,1,121
2024-03-08 06:50:00,46,16,34,16,3,115
2024-03-08 07:00:00,42,34,34,25,2,137
2024-03-08 07:10:00,46,27,33,23,4,133
2024-03-08 07:20:00,45,25,42,20,10,142
2024-03-08 07:30:00,36,28,45,35,9,153
2024-03-08 07:40:00,72,39,47,36,7,201
2024-03-08 07:50:00,56,24,43,43,4,170
2024-03-08 08:00:00,42,31,34,26,4,137
2024-03-08 08:10:00,45,31,35,26,4,141
2024-03-08 08:20:00,46,27,7,42,6,128
2024-03-08 08:30:00,50,25,42,22,4,143
2024-03-08 08:40:00,41,21,46,24,4,136
2024-03-08 08:50:00,44,19,39,19,6,127
2024-03-08 09:00:00,42,22,37,24,4,129
2024-03-08 09:10:00,35,21,35,16,3,110
2024-03-08 09:20:00,39,18,42,22,5,126
2024-03-08 09:30:00,33,19,48,22,6,128
2024-03-08 09:40:00,35,14,45,20,6,120
2024-03-08 09:50:00,41,14,39,19,2,115
2024-03-08 10:00:00,42,33,38,21,2,136
2024-03-08 10:10:00,31,15,39,18,3,106
2024-03-08 10:20:00,33,17,44,18,4,116
2024-03-08 10:30:00,32,15,33,24,3,107
2024-03-08 10:40:00,41,16,25,11,2,95
2024-03-08 10:50:00,47,19,43,14,3,126
2024-03-08 11:00:00,42,15,44,24,4,129
2024-03-08 11:10:00,43,23,32,28,3,129
2024-03-08 11:20:00,38,22,42,19,8,129
2024-03-08 11:30:00,51,27,35,27,6,146
2024-03-08 11:40:00,48,16,42,31,3,140
2024-03-08 11:50:00,38,19,44,17,5,123
2024-03-08 12:00:00,61,20,47,40,3,171
2024-03-08 12:10:00,52,18,60,34,3,167
2024-03-08 12:20:00,33,17,51,34,4,139
2024-03-08 12:30:00,35,23,54,30,5,147
2024-03-08 12:40:00,56,28,31,34,5,154
2024-03-08 12:50:00,48,21,40,38,6,153
2024-03-08 13:00:00,50,23,43,27,3,146
2024-03-08 13:10:00,41,28,51,27,4,151
2024-03-08 13:20:00,64,18,43,25,5,155
2024-03-08 13:30:00,37,23,48,29,7,144
2024-03-08 13:40:00,52,32,42,30,4,160
2024-03-08 13:50:00,51,27,44,31,8,161
2024-03-08 14:00:00,46,25,45,25,6,147
2024-03-08 14:10:00,37,23,43,36,4,143
2024-03-08 14:20:00,50,27,39,39,6,161
2024-03-08 14:30:00,36,36,38,30,10,150
2024-03-08 14:40:00,51,21,36,30,8,146
2024-03-08 14:50:00,57,23,40,21,8,149
2024-03-08 15:00:00,39,20,42,32,4,137
2024-03-08 15:10:00,56,21,43,40,6,166
2024-03-08 15:20:00,50,16,37,25,5,133
2024-03-08 15:30:00,41,25,39,26,5,136
2024-03-08 15:40:00,54,27,43,26,7,157
2024-03-08 15:50:00,42,28,46,32,8,156
2024-03-08 16:00:00,41,26,47,27,5,146
2024-03-08 16:10:00,64,30,33,25,5,157
2024-03-08 16:20:00,40,27,39,31,7,144
2024-03-08 16:30:00,47,26,44,25,7,149
2024-03-08 16:40:00,36,27,36,22,9,130
2024-03-08 16:50:00,39,25,50,33,5,152
2024-03-08 17:00:00,58,38,51,24,5,176
2024-03-08 17:10:00,55,24,43,29,4,155
2024-03-08 17:20:00,42,24,43,32,5,146
2024-03-08 17:30:00,58,35,42,30,2,167
2024-03-08 17:40:00,47,33,41,28,6,155
2024-03-08 17:50:00,49,21,36,37,2,145
2024-03-08 18:00:00,54,19,37,37,3,150
2024-03-08 18:10:00,48,21,38,21,1,129
2024-03-08 18:20:00,46,23,33,31,3,136
2024-03-08 18:30:00,33,18,37,22,7,117
2024-03-08 18:40:00,45,39,40,32,7,163
2024-03-08 18:50:00,54,37,70,34,6,201
2024-03-08 19:00:00,42,25,66,23,8,164
2024-03-08 19:10:00,55,18,60,26,3,162
2024-03-08 19:20:00,35,34,52,34,4,159
2024-03-08 19:30:00,30,29,49,34,5,147
2024-03-08 19:40:00,40,19,42,32,3,136
2024-03-08 19:50:00,35,28,34,30,3,130
2024-03-08 20:00:00,34,14,39,20,2,109
2024-03-08 20:10:00,46,12,41,34,2,135
2024-03-08 20:20:00,29,27,56,18,4,134
2024-03-08 20:30:00,30,18,26,29,2,105
2024-03-08 20:40:00,18,40,31,17,2,108
2024-03-08 20:50:00,16,39,24,17,0,96
2024-03-08 21:00:00,13,23,36,16,0,88
2024-03-08 21:10:00,15,36,30,24,2,107
2024-03-08 21:20:00,22,24,27,31,1,105
2024-03-08 21:30:00,15,16,24,29,2,86
2024-03-08 21:40:00,16,15,27,37,3,98
2024-03-08 21:50:00,20,23,23,30,0,96
2024-03-08 22:00:00,10,14,22,10,0,56
2024-03-08 22:10:00,21,15,19,26,4,85
2024-03-08 22:20:00,18,22,24,16,2,82
2024-03-08 22:30:00,23,17,27,20,0,87
2024-03-08 22:40:00,17,17,28,17,1,80
2024-03-08 22:50:00,9,17,21,15,0,62
2024-03-08 23:00:00,20,17,20,18,1,76
2024-03-08 23:10:00,12,16,14,11,0,53
2024-03-08 23:20:00,18,10,18,18,0,64
2024-03-08 23:30:00,13,12,13,12,0,50
2024-03-08 23:40:00,4,7,18,8,0,37
2024-03-08 23:50:00,16,15,11,15,1,58
2024-03-09 00:00:00,13,5,15,17,0,50
2024-03-09 00:10:00,9,14,14,14,0,51
2024-03-09 00:20:00,4,12,11,3,2,32
2024-03-09 00:30:00,11,11,16,14,3,55
2024-03-09 00:40:00,4,4,8,6,0,22
2024-03-09 00:50:00,6,8,10,13,0,37
2024-03-09 01:00:00,5,2,13,12,1,33
2024-03-09 01:10:00,10,12,7,11,0,40
2024-03-09 01:20:00,6,10,5,2,0,23
2024-03-09 01:30:00,4,4,0,11,1,20
2024-03-09 01:40:00,5,4,3,11,0,23
2024-03-09 01:50:00,2,2,6,6,0,16
2024-03-09 02:00:00,2,2,0,5,0,9
2024-03-09 02:10:00,7,9,2,6,0,24
2024-03-09 02:20:00,2,9,2,1,0,14
2024-03-09 02:30:00,5,7,1,8,0,21
2024-03-09 02:40:00,5,4,4,8,0,21
2024-03-09 02:50:00,3,2,2,10,0,17
2024-03-09 03:00:00,4,3,2,1,0,10
2024-03-09 03:10:00,1,3,0,4,0,8
2024-03-09 03:20:00,5,5,3,5,0,18
2024-03-09 03:30:00,2,2,0,4,0,8
2024-03-09 03:40:00,6,5,5,3,0,19
2024-03-09 03:50:00,3,1,3,6,0,13
2024-03-09 04:00:00,3,3,6,3,0,15
2024-03-09 04:10:00,2,9,1,0,0,12
2024-03-09 04:20:00,2,3,2,1,0,8
2024-03-09 04:30:00,3,10,7,7,0,27
2024-03-09 04:40:00,4,10,1,9,0,24
2024-03-09 04:50:00,7,11,4,5,1,28
2024-03-09 05:00:00,5,6,2,2,0,15
2024-03-09 05:10:00,6,10,9,7,1,33
2024-03-09 05:20:00,6,17,3,5,0,31
2024-03-09 05:30:00,6,6,7,0,0,19
2024-03-09 05:40:00,17,7,7,11,0,42
2024-03-09 05:50:00,13,3,7,9,0,32
2024-03-09 06:00:00,12,7,8,7,0,34
2024-03-09 06:10:00,12,5,18,6,1,42
2024-03-09 06:20:00,10,5,17,14,0,46
2024-03-09 06:30:00,17,7,12,7,2,45
2024-03-09 06:40:00,17,6,13,7,0,43
2024-03-09 06:50:00,16,6,12,12,0,46
2024-03-09 07:00:00,11,1,9,8,1,30
2024-03-09 07:10:00,16,6,8,2,1,33
2024-03-09 07:20:00,10,4,3,7,1,25
2024-03-09 07:30:00,13,5,7,10,0,35
2024-03-09 07:40:00,20,9,18,12,3,62
2024-03-09 07:50:00,17,5,16,16,1,55
2024-03-09 08:00:00,14,9,7,13,2,45
2024-03-09 08:10:00,13,7,27,7,2,56
2024-03-09 08:20:00,20,7,15,15,1,58
2024-03-09 08:30:00,32,18,12,14,1,77
2024-03-09 08:40:00,29,13,15,17,2,76
2024-03-09 08:50:00,25,11,25,25,2,88
2024-03-09 09:00:00,35,15,22,14,1,87
2024-03-09 09:10:00,29,16,17,22,2,86
2024-03-09 09:20:00,26,15,20,19,3,83
2024-03-09 09:30:00,37,11,20,24,4,96
2024-03-09 09:40:00,50,23,27,26,4,130
2024-03-09 09:50:00,31,20,20,33,2,106
2024-03-09 10:00:00,38,17,26,21,4,106
2024-03-09 10:10:00,41,11,21,33,4,110
2024-03-09 10:20:00,28,15,27,28,4,102
2024-03-09 10:30:00,39,19,28,26,2,114
2024-03-09 10:40:00,37,16,19,33,3,108
2024-03-09 10:50:00,35,6,24,24,4,93
2024-03-09 11:00:00,40,16,29,40,3,128
2024-03-09 11:10:00,48,20,40,18,1,127
2024-03-09 11:20:00,46,15,42,38,7,148
2024-03-09 11:30:00,48,17,36,28,6,135
2024-03-09 11:40:00,35,23,40,26,4,128
2024-03-09 11:50:00,37,19,28,34,2,120
2024-03-09 12:00:00,46,27,28,31,1,133
2024-03-09 12:10:00,57,22,39,38,3,159
2024-03-09 12:20:00,40,20,33,29,4,126
2024-03-09 12:30:00,49,18,39,37,3,146
2024-03-09 12:40:00,51,15,23,35,3,127
2024-03-09 12:50:00,45,15,34,40,6,140
2024-03-09 13:00:00,51,17,33,22,6,129
2024-03-09 13:10:00,49,35,24,37,5,150
2024-03-09 13:20:00,41,25,33,37,7,143
2024-03-09 13:30:00,43,28,29,39,5,144
2024-03-09 13:40:00,45,44,28,27,3,147
2024-03-09 13:50:00,45,27,26,43,4,145
2024-03-09 14:00:00,34,12,33,36,5,120
2024-03-09 14:10:00,34,16,29,34,8,121
2024-03-09 14:20:00,35,12,24,30,6,107
2024-03-09 14:30:00,49,18,22,26,2,117
2024-03-09 14:40:00,47,21,25,34,6,133
2024-03-09 14:50:00,47,14,17,30,2,110
2024-03-09 15:00:00,49,19,29,29,3,129
2024-03-09 15:10:00,37,15,30,29,4,115
2024-03-09 15:20:00,40,20,22,39,5,126
2024-03-09 15:30:00,32,17,18,30,5,102
2024-03-09 15:40:00,39,15,24,30,3,111
2024-03-09 15:50:00,37,23,29,23,2,114
2024-03-09 16:00:00,46,23,22,33,5,129
2024-03-09 16:10:00,32,25,24,31,4,116
2024-03-09 16:20:00,40,14,22,34,6,116
2024-03-09 16:30:00,40,18,14,30,2,104
2024-03-09 16:40:00,40,18,20,44,2,124
2024-03-09 16:50:00,44,19,24,34,1,122
2024-03-09 17:00:00,39,21,24,31,5,120
2024-03-09 17:10:00,40,18,19,37,3,117
2024-03-09 17:20:00,41,14,25,28,4,112
2024-03-09 17:30:00,35,27,21,31,2,116
2024-03-09 17:40:00,41,22,25,40,4,132
2024-03-09 17:50:00,40,24,18,39,5,126
2024-03-09 18:00:00,46,22,27,25,5,125
2024-03-09 18:10:00,39,19,24,19,7,108
2024-03-09 18:20:00,28,18,25,26,2,99
2024-03-09 18:30:00,38,16,33,26,1,114
2024-03-09 18:40:00,49,35,34,37,2,157
2024-03-09 18:50:00,41,21,45,43,3,153
2024-03-09 19:00:00,37,20,23,45,2,127
2024-03-09 19:10:00,30,31,27,35,4,127
2024-03-09 19:20:00,25,24,26,37,3,115
2024-03-09 19:30:00,34,30,40,37,5,146
2024-03-09 19:40:00,24,28,31,30,3,116
2024-03-09 19:50:00,21,33,33,31,2,120
2024-03-09 20:00:00,19,16,24,19,3,81
2024-03-09 20:10:00,20,24,18,24,2,88
2024-03-09 20:20:00,18,36,22,35,1,112
2024-03-09 20:30:00,19,21,25,28,0,93
2024-03-09 20:40:00,18,25,26,31,5,105
2024-03-09 20:50:00,19,22,17,17,2,77
2024-03-09 21:00:00,23,23,18,39,0,103
2024-03-09 21:10:00,28,30,20,23,0,101
2024-03-09 21:20:00,17,27,20,31,0,95
2024-03-09 21:30:00,22,23,14,23,0,82
2024-03-09 21:40:00,21,17,17,28,0,83
2024-03-09 21:50:00,21,23,19,21,1,85
2024-03-09 22:00:00,21,19,16,25,1,82
2024-03-09 22:10:00,10,14,25,19,0,68
2024-03-09 22:20:00,19,23,25,26,1,94
2024-03-09 22:30:00,13,23,12,24,1,73
2024-03-09 22:40:00,8,18,32,18,0,76
2024-03-09 22:50:00,20,21,17,16,0,74
2024-03-09 23:00:00,19,21,15,16,3,74
2024-03-09 23:10:00,16,13,8,23,0,60
2024-03-09 23:20:00,13,10,20,20,0,63
2024-03-09 23:30:00,11,13,14,17,1,56
2024-03-09 23:40:00,11,14,13,20,1,59
2024-03-09 23:50:00,21,21,11,17,0,70
2024-03-10 00:00:00,8,6,2,10,0,26
2024-03-10 00:10:00,6,9,14,15,3,47
2024-03-10 00:20:00,12,17,8,19,0,56
2024-03-10 00:30:00,8,12,4,9,0,33
2024-03-10 00:40:00,7,7,5,10,1,30
2024-03-10 00:50:00,12,9,8,4,0,33
2024-03-10 01:00:00,7,8,2,10,0,27
2024-03-10 01:10:00,11,5,10,5,0,31
2024-03-10 01:20:00,6,8,5,18,0,37
2024-03-10 01:30:00,9,12,6,4,0,31
2024-03-10 01:40:00,6,11,5,6,0,28
2024-03-10 01:50:00,7,12,1,10,0,30
2024-03-10 02:00:00,3,2,5,3,1,14
2024-03-10 02:10:00,4,3,4,0,0,11
2024-03-10 02:20:00,6,4,4,7,0,21
2024-03-10 02:30:00,9,8,4,6,1,28
2024-03-10 02:40:00,6,8,7,6,0,27
2024-03-10 02:50:00,4,1,2,4,0,11
2024-03-10 03:00:00,3,3,6,6,0,18
2024-03-10 03:10:00,2,2,3,3,0,10
2024-03-10 03:20:00,2,5,4,1,0,12
2024-03-10 03:30:00,7,6,1,8,0,22
2024-03-10 03:40:00,8,4,0,3,0,15
2024-03-10 03:50:00,2,0,7,2,0,11
2024-03-10 04:00:00,1,4,2,0,0,7
2024-03-10 04:10:00,6,3,4,6,0,19
2024-03-10 04:20:00,1,2,0,4,0,7
2024-03-10 04:30:00,2,10,0,0,0,12
2024-03-10 04:40:00,1,5,0,0,0,6
2024-03-10 04:50:00,3,3,4,2,1,13
2024-03-10 05:00:00,1,4,0,1,0,6
2024-03-10 05:10:00,1,2,1,6,0,10
2024-03-10 05:20:00,6,6,3,3,0,18
2024-03-10 05:30:00,9,6,2,3,0,20
2024-03-10 05:40:00,9,2,0,5,0,16
2024-03-10 05:50:00,11,4,2,10,0,27
2024-03-10 06:00:00,7,0,14,4,1,26
2024-03-10 06:10:00,4,2,3,7,0,16
2024-03-10 06:20:00,12,3,2,6,0,23
2024-03-10 06:30:00,4,1,7,5,0,17
2024-03-10 06:40:00,4,3,5,0,1,13
2024-03-10 06:50:00,5,1,1,5,0,12
2024-03-10 07:00:00,7,3,3,3,0,16
2024-03-10 07:10:00,5,2,0,0,0,7
2024-03-10 07:20:00,6,0,1,2,0,9
2024-03-10 07:30:00,9,2,4,5,0,20
2024-03-10 07:40:00,6,2,7,4,1,20
2024-03-10 07:50:00,7,1,1,6,1,16
2024-03-10 08:00:00,9,3,7,8,0,27
2024-03-10 08:10:00,15,8,7,6,0,36
2024-03-10 08:20:00,10,3,8,3,0,24
2024-03-10 08:30:00,17,2,7,9,1,36
2024-03-10 08:40:00,11,9,6,11,2,39
2024-03-10 08:50:00,19,2,14,16,2,53
2024-03-10 09:00:00,13,10,8,10,1,42
2024-03-10 09:10:00,22,8,17,11,0,58
2024-03-10 09:20:00,18,9,17,19,4,67
2024-03-10 09:30:00,23,9,11,13,3,59
2024-03-10 09:40:00,31,13,22,19,1,86
2024-03-10 09:50:00,29,17,21,15,1,83
2024-03-10 10:00:00,27,8,18,18,2,73
2024-03-10 10:10:00,23,14,20,14,3,74
2024-03-10 10:20:00,26,13,25,17,2,83
2024-03-10 10:30:00,23,10,17,18,2,70
2024-03-10 10:40:00,33,10,16,19,4,82
2024-03-10 10:50:00,42,10,14,20,2,88
2024-03-10 11:00:00,40,22,24,23,3,112
2024-03-10 11:10:00,30,10,17,22,4,83
2024-03-10 11:20:00,36,14,22,22,2,96
2024-03-10 11:30:00,32,11,20,19,3,85
2024-03-10 11:40:00,29,12,23,22,4,90
2024-03-10 11:50:00,33,15,19,39,2,108
2024-03-10 12:00:00,28,6,18,17,5,74
2024-03-10 12:10:00,36,22,29,29,2,118
2024-03-10 12:20:00,35,19,22,24,7,107
2024-03-10 12:30:00,37,22,29,22,2,112
2024-03-10 12:40:00,27,21,18,37,4,107
2024-03-10 12:50:00,34,30,24,40,2,130
2024-03-10 13:00:00,26,13,31,20,1,91
2024-03-10 13:10:00,33,18,22,32,2,107
2024-03-10 13:20:00,35,17,25,22,1,100
2024-03-10 13:30:00,34,17,26,41,3,121
2024-03-10 13:40:00,37,17,23,22,3,102
2024-03-10 13:50:00,34,18,18,28,3,101
2024-03-10 14:00:00,38,14,26,38,3,119
2024-03-10 14:10:00,45,18,24,45,2,134
2024-03-10 14:20:00,34,20,23,35,2,114
2024-03-10 14:30:00,40,7,26,23,3,99
2024-03-10 14:40:00,40,25,27,40,4,136
2024-03-10 14:50:00,37,20,13,25,5,100
2024-03-10 15:00:00,26,17,14,33,5,95
2024-03-10 15:10:00,44,30,21,33,2,130
2024-03-10 15:20:00,37,13,24,25,3,102
2024-03-10 15:30:00,34,22,17,39,4,116
2024-03-10 15:40:00,38,19,21,34,2,114
2024-03-10 15:50:00,35,20,15,23,8,101
2024-03-10 16:00:00,35,14,20,26,7,102
2024-03-10 16:10:00,40,22,13,23,2,100
2024-03-10 16:20:00,33,17,21,23,4,98
2024-03-10 16:30:00,30,22,24,36,3,115
2024-03-10 16:40:00,36,9,16,38,2,101
2024-03-10 16:50:00,32,20,16,18,5,91
2024-03-10 17:00:00,36,19,25,35,3,118
2024-03-10 17:10:00,44,19,21,37,5,126
2024-03-10 17:20:00,29,16,18,32,2,97
2024-03-10 17:30:00,46,24,15,30,4,119
2024-03-10 17:40:00,27,12,13,22,5,79
2024-03-10 17:50:00,44,22,16,30,2,114
2024-03-10 18:00:00,32,15,25,32,2,106
2024-03-10 18:10:00,24,13,22,32,5,96
2024-03-10 18:20:00,31,17,14,20,2,84
2024-03-10 18:30:00,35,21,29,39,3,127
2024-03-10 18:40:00,32,25,24,26,2,109
2024-03-10 18:50:00,31,23,34,31,2,121
2024-03-10 19:00:00,21,25,39,29,3,117
2024-03-10 19:10:00,34,19,37,28,0,118
2024-03-10 19:20:00,27,15,22,24,2,90
2024-03-10 19:30:00,29,11,14,23,1,78
2024-03-10 19:40:00,29,8,25,32,0,94
2024-03-10 19:50:00,29,21,32,27,0,109
2024-03-10 20:00:00,33,7,11,19,3,73
2024-03-10 20:10:00,34,16,7,23,0,80
2024-03-10 20:20:00,25,12,19,33,1,90
2024-03-10 20:30:00,44,16,24,24,1,109
2024-03-10 20:40:00,29,17,20,21,3,90
2024-03-10 20:50:00,27,7,30,29,1,94
2024-03-10 21:00:00,17,9,23,21,4,74
2024-03-10 21:10:00,24,8,19,29,1,81
2024-03-10 21:20:00,25,21,12,14,1,73
2024-03-10 21:30:00,20,19,17,25,1,82
2024-03-10 21:40:00,25,17,13,15,0,70
2024-03-10 21:50:00,16,11,15,11,0,53
2024-03-10 22:00:00,15,6,15,15,0,51
2024-03-10 22:10:00,4,17,12,21,0,54
2024-03-10 22:20:00,10,11,10,15,1,47
2024-03-10 22:30:00,10,9,5,9,0,33
2024-03-10 22:40:00,5,7,7,9,0,28
2024-03-10 22:50:00,5,7,5,8,0,25
2024-03-10 23:00:00,4,4,4,5,0,17
2024-03-10 23:10:00,5,4,7,4,0,20
2024-03-10 23:20:00,5,3,7,4,0,19
2024-03-10 23:30:00,8,3,4,6,1,22
2024-03-10 23:40:00,6,3,5,6,1,21
2024-03-10 23:50:00,2,2,2,4,1,11
2024-03-11 00:00:00,5,1,4,3,1,14
2024-03-11 00:10:00,3,0,5,4,1,13
2024-03-11 00:20:00,7,3,3,3,0,16
2024-03-11 00:30:00,2,1,1,4,0,8
2024-03-11 00:40:00,3,3,2,1,0,9
2024-03-11 00:50:00,3,2,1,0,1,7
2024-03-11 01:00:00,2,6,2,2,0,12
2024-03-11 01:10:00,2,1,1,2,0,6
2024-03-11 01:20:00,2,2,0,0,0,4
2024-03-11 01:30:00,1,0,3,0,0,4
2024-03-11 01:40:00,2,2,1,0,0,5
2024-03-11 01:50:00,1,3,0,0,0,4
2024-03-11 02:00:00,3,4,2,1,0,10
2024-03-11 02:10:00,3,3,1,1,0,8
2024-03-11 02:20:00,1,1,2,2,0,6
2024-03-11 02:30:00,4,2,3,1,0,10
2024-03-11 02:40:00,0,1,1,1,0,3
2024-03-11 02:50:00,2,2,2,1,0,7
2024-03-11 03:00:00,0,0,1,6,0,7
2024-03-11 03:10:00,0,1,3,2,1,7
2024-03-11 03:20:00,2,1,1,0,0,4
2024-03-11 03:30:00,2,1,1,1,1,6
2024-03-11 03:40:00,4,4,0,0,0,8
2024-03-11 03:50:00,3,3,3,4,0,13
2024-03-11 04:00:00,2,1,1,4,0,8
2024-03-11 04:10:00,2,4,2,1,0,9
2024-03-11 04:20:00,3,5,4,4,1,17
2024-03-11 04:30:00,8,6,2,6,0,22
2024-03-11 04:40:00,6,5,6,4,0,21
2024-03-11 04:50:00,4,4,9,9,0,26
2024-03-11 05:00:00,13,10,4,5,1,33
2024-03-11 05:10:00,12,15,11,10,0,48
2024-03-11 05:20:00,16,27,8,10,0,61
2024-03-11 05:30:00,20,22,18,10,1,71
2024-03-11 05:40:00,22,24,18,21,2,87
2024-03-11 05:50:00,17,16,23,17,5,78
2024-03-11 06:00:00,28,13,17,12,0,70
2024-03-11 06:10:00,28,12,23,15,1,79
2024-03-11 06:20:00,25,20,19,14,2,80
2024-03-11 06:30:00,30,21,31,13,0,95
2024-03-11 06:40:00,32,24,23,13,1,93
2024-03-11 06:50:00,31,22,31,14,2,100
2024-03-11 07:00:00,38,30,35,16,6,125
2024-03-11 07:10:00,36,23,23,21,6,109
2024-03-11 07:20:00,58,28,35,23,8,152
2024-03-11 07:30:00,37,32,48,36,7,160
2024-03-11 07:40:00,43,34,41,35,6,159
2024-03-11 07:50:00,34,37,45,34,6,156
2024-03-11 08:00:00,42,29,38,23,5,137
2024-03-11 08:10:00,51,37,36,26,6,156
2024-03-11 08:20:00,63,21,36,21,7,148
2024-03-11 08:30:00,57,29,41,33,2,162
2024-03-11 08:40:00,46,24,31,22,3,126
2024-03-11 08:50:00,59,24,41,16,3,143
2024-03-11 09:00:00,41,20,33,22,2,118
2024-03-11 09:10:00,53,22,24,19,4,122
2024-03-11 09:20:00,54,19,35,20,3,131
2024-03-11 09:30:00,36,15,23,12,2,88
2024-03-11 09:40:00,51,12,33,22,0,118
2024-03-11 09:50:00,29,22,34,14,1,100
2024-03-11 10:00:00,26,13,28,15,3,85
2024-03-11 10:10:00,30,10,33,21,1,95
2024-03-11 10:20:00,42,17,25,10,2,96
2024-03-11 10:30:00,37,9,39,13,3,101
2024-03-11 10:40:00,38,17,32,12,1,100
2024-03-11 10:50:00,27,12,33,18,4,94
2024-03-11 11:00:00,40,17,35,16,1,109
2024-03-11 11:10:00,33,12,30,9,2,86
2024-03-11 11:20:00,34,21,35,24,6,120
2024-03-11 11:30:00,39,20,31,14,3,107
2024-03-11 11:40:00,42,18,48,26,1,135
2024-03-11 11:50:00,48,19,36,17,6,126
2024-03-11 12:00:00,38,22,38,23,3,124
2024-03-11 12:10:00,44,19,41,14,2,120
2024-03-11 12:20:00,44,20,34,19,2,119
2024-03-11 12:30:00,33,21,40,21,5,120
2024-03-11 12:40:00,44,22,42,21,5,134
2024-03-11 12:50:00,37,13,41,22,4,117
2024-03-11 13:00:00,33,16,46,21,4,120
2024-03-11 13:10:00,46,23,34,27,3,133
2024-03-11 13:20:00,48,20,28,20,7,123
2024-03-11 13:30:00,40,20,33,24,4,121
2024-03-11 13:40:00,48,29,42,35,5,159
2024-03-11 13:50:00,51,29,17,46,6,149
2024-03-11 14:00:00,40,16,21,40,4,121
2024-03-11 14:10:00,35,20,8,64,3,130
2024-03-11 14:20:00,32,17,8,46,6,109
2024-03-11 14:30:00,34,19,43,27,3,126
2024-03-11 14:40:00,46,15,45,22,5,133
2024-03-11 14:50:00,54,19,52,30,2,157
2024-03-11 15:00:00,41,24,25,29,5,124
2024-03-11 15:10:00,41,21,48,22,4,136
2024-03-11 15:20:00,36,24,36,38,5,139
2024-03-11 15:30:00,48,24,47,26,4,149
2024-03-11 15:40:00,38,22,40,27,10,137
2024-03-11 15:50:00,44,23,36,27,6,136
2024-03-11 16:00:00,40,24,36,29,5,134
2024-03-11 16:10:00,68,23,44,32,7,174
2024-03-11 16:20:00,54,23,37,32,7,153
2024-03-11 16:30:00,45,29,37,32,7,150
2024-03-11 16:40:00,45,25,38,44,6,158
2024-03-11 16:50:00,44,31,42,35,4,156
2024-03-11 17:00:00,53,29,41,40,4,167
2024-03-11 17:10:00,44,38,35,25,10,152
2024-03-11 17:20:00,49,23,44,32,5,153
2024-03-11 17:30:00,41,20,38,32,7,138
2024-03-11 17:40:00,48,15,43,35,5,146
2024-03-11 17:50:00,25,14,29,24,5,97
2024-03-11 18:00:00,48,34,46,35,4,167
2024-03-11 18:10:00,41,24,37,31,9,142
2024-03-11 18:20:00,41,28,39,26,8,142
2024-03-11 18:30:00,28,17,30,22,5,102
2024-03-11 18:40:00,32,18,38,34,5,127
2024-03-11 18:50:00,40,21,30,32,0,123
2024-03-11 19:00:00,43,16,62,37,4,162
2024-03-11 19:10:00,40,24,60,29,4,157
2024-03-11 19:20:00,46,14,60,28,2,150
2024-03-11 19:30:00,41,27,46,18,1,133
2024-03-11 19:40:00,34,19,39,26,6,124
2024-03-11 19:50:00,40,17,47,24,1,129
2024-03-11 20:00:00,24,12,39,21,0,96
2024-03-11 20:10:00,22,8,38,29,4,101
2024-03-11 20:20:00,25,14,41,20,1,101
2024-03-11 20:30:00,21,14,42,12,3,92
2024-03-11 20:40:00,18,10,18,20,1,67
2024-03-11 20:50:00,29,18,23,20,1,91
2024-03-11 21:00:00,20,9,29,21,0,79
2024-03-11 21:10:00,27,19,42,16,2,106
2024-03-11 21:20:00,14,21,22,22,0,79
2024-03-11 21:30:00,34,16,29,9,4,92
2024-03-11 21:40:00,21,15,26,31,1,94
2024-03-11 21:50:00,14,7,30,13,2,66
2024-03-11 22:00:00,19,6,28,10,0,63
2024-03-11 22:10:00,25,24,29,23,1,102
2024-03-11 22:20:00,17,6,38,15,0,76
2024-03-11 22:30:00,10,8,34,10,0,62
2024-03-11 22:40:00,8,6,14,6,0,34
2024-03-11 22:50:00,11,4,9,22,0,46
2024-03-11 23:00:00,9,4,9,6,0,28
2024-03-11 23:10:00,9,5,13,8,0,35
2024-03-11 23:20:00,4,3,8,1,1,17
2024-03-11 23:30:00,14,5,6,5,0,30
2024-03-11 23:40:00,7,0,10,2,0,19
2024-03-11 23:50:00,6,2,3,0,0,11
2024-03-12 00:00:00,3,2,3,4,0,12
2024-03-12 00:10:00,3,2,7,5,0,17
2024-03-12 00:20:00,0,0,3,4,0,7
2024-03-12 00:30:00,5,6,5,1,0,17
2024-03-12 00:40:00,6,0,2,5,0,13
2024-03-12 00:50:00,4,1,4,1,0,10
2024-03-12 01:00:00,6,0,2,10,0,18
2024-03-12 01:10:00,4,0,1,2,0,7
2024-03-12 01:20:00,2,0,0,2,0,4
2024-03-12 01:30:00,1,0,7,2,0,10
2024-03-12 01:40:00,2,0,0,0,0,2
2024-03-12 01:50:00,1,0,0,0,0,1
2024-03-12 02:00:00,3,0,1,0,0,4
2024-03-12 02:10:00,8,0,0,4,0,12
2024-03-12 02:20:00,3,0,2,3,0,8
2024-03-12 02:30:00,0,2,3,0,0,5
2024-03-12 02:40:00,2,3,2,1,0,8
2024-03-12 02:50:00,3,0,2,2,0,7
2024-03-12 03:00:00,3,1,2,1,0,7
2024-03-12 03:10:00,0,2,3,3,0,8
2024-03-12 03:20:00,2,0,1,5,1,9
2024-03-12 03:30:00,3,0,2,2,0,7
2024-03-12 03:40:00,4,2,0,0,0,6
2024-03-12 03:50:00,2,2,4,4,0,12
2024-03-12 04:00:00,3,2,4,2,0,11
2024-03-12 04:10:00,1,1,2,0,0,4
2024-03-12 04:20:00,8,2,6,2,0,18
2024-03-12 04:30:00,10,2,4,0,0,16
2024-03-12 04:40:00,5,2,3,3,0,13
2024-03-12 04:50:00,3,6,10,0,0,19
2024-03-12 05:00:00,7,12,7,2,0,28
2024-03-12 05:10:00,23,11,15,10,0,59
2024-03-12 05:20:00,24,12,20,6,0,62
2024-03-12 05:30:00,28,26,22,10,0,86
2024-03-12 05:40:00,37,25,30,15,1,108
2024-03-12 05:50:00,39,22,38,17,0,116
2024-03-12 06:00:00,35,29,32,15,2,113
2024-03-12 06:10:00,40,22,38,12,0,112
2024-03-12 06:20:00,39,26,48,13,0,126
2024-03-12 06:30:00,61,34,45,13,1,154
2024-03-12 06:40:00,46,25,45,22,5,143
2024-03-12 06:50:00,40,23,33,19,3,118
2024-03-12 07:00:00,56,29,36,22,2,145
2024-03-12 07:10:00,72,30,28,25,5,160
2024-03-12 07:20:00,49,35,30,26,6,146
2024-03-12 07:30:00,51,32,27,38,15,163
2024-03-12 07:40:00,53,34,41,44,10,182
2024-03-12 07:50:00,61,29,46,33,4,173
2024-03-12 08:00:00,56,35,45,31,5,172
2024-03-12 08:10:00,67,30,25,27,5,154
2024-03-12 08:20:00,56,30,38,26,4,154
2024-03-12 08:30:00,66,29,44,26,3,168
2024-03-12 08:40:00,56,31,45,25,4,161
2024-03-12 08:50:00,45,30,48,25,5,153
2024-03-12 09:00:00,60,24,33,21,4,142
2024-03-12 09:10:00,45,19,32,25,5,126
2024-03-12 09:20:00,43,24,31,18,4,120
2024-03-12 09:30:00,48,24,29,22,5,128
2024-03-12 09:40:00,46,10,37,19,4,116
2024-03-12 09:50:00,35,10,36,24,1,106
2024-03-12 10:00:00,39,9,43,16,2,109
2024-03-12 10:10:00,46,13,32,16,0,107
2024-03-12 10:20:00,49,18,32,18,0,117
2024-03-12 10:30:00,46,12,41,18,3,120
2024-03-12 10:40:00,47,22,28,22,3,122
2024-03-12 10:50:00,31,19,29,16,1,96
2024-03-12 11:00:00,47,12,27,12,2,100
2024-03-12 11:10:00,28,18,25,15,2,88
2024-03-12 11:20:00,48,15,36,24,2,125
2024-03-12 11:30:00,30,16,29,12,7,94
2024-03-12 11:40:00,40,25,41,26,2,134
2024-03-12 11:50:00,32,17,30,25,4,108
2024-03-12 12:00:00,48,11,31,18,1,109
2024-03-12 12:10:00,44,16,45,23,2,130
2024-03-12 12:20:00,44,15,30,17,4,110
2024-03-12 12:30:00,40,14,39,35,2,130
2024-03-12 12:40:00,36,19,32,23,6,116
2024-03-12 12:50:00,39,14,37,34,5,129
2024-03-12 13:00:00,54,15,35,24,1,129
2024-03-12 13:10:00,38,15,42,19,8,122
2024-03-12 13:20:00,47,27,26,27,7,134
2024-03-12 13:30:00,30,20,31,13,5,99
2024-03-12 13:40:00,41,15,37,32,5,130
2024-03-12 13:50:00,35,18,28,22,5,108
2024-03-12 14:00:00,42,27,42,37,3,151
2024-03-12 14:10:00,36,26,40,35,8,145
2024-03-12 14:20:00,52,23,33,29,6,143
2024-03-12 14:30:00,36,31,37,20,6,130
2024-03-12 14:40:00,35,18,37,34,5,129
2024-03-12 14:50:00,43,23,47,34,2,149
2024-03-12 15:00:00,42,27,40,25,5,139
2024-03-12 15:10:00,44,22,43,28,5,142
2024-03-12 15:20:00,53,23,51,31,2,160
2024-03-12 15:30:00,44,23,41,28,5,141
2024-03-12 15:40:00,47,18,42,32,6,145
2024-03-12 15:50:00,46,20,44,35,9,154
2024-03-12 16:00:00,51,21,49,35,4,160
2024-03-12 16:10:00,50,32,59,39,4,184
2024-03-12 16:20:00,54,22,45,34,7,162
2024-03-12 16:30:00,49,27,48,34,5,163
2024-03-12 16:40:00,52,32,43,34,6,167
2024-03-12 16:50:00,44,31,31,30,8,144
2024-03-12 17:00:00,39,20,39,35,8,141
2024-03-12 17:10:00,41,29,42,53,6,171
2024-03-12 17:20:00,40,26,32,31,7,136
2024-03-12 17:30:00,43,26,37,34,4,144
2024-03-12 17:40:00,63,31,36,44,6,180
2024-03-12 17:50:00,47,23,50,35,3,158
2024-03-12 18:00:00,49,34,37,22,6,148
2024-03-12 18:10:00,35,21,37,28,7,128
2024-03-12 18:20:00,30,23,46,34,6,139
2024-03-12 18:30:00,43,27,73,41,4,188
2024-03-12 18:40:00,42,27,68,34,6,177
2024-03-12 18:50:00,36,23,63,33,6,161
2024-03-12 19:00:00,36,20,45,37,2,140
2024-03-12 19:10:00,37,36,47,25,10,155
2024-03-12 19:20:00,25,7,55,35,6,128
2024-03-12 19:30:00,41,19,50,21,4,135
2024-03-12 19:40:00,37,13,35,27,3,115
2024-03-12 19:50:00,25,24,24,30,3,106
2024-03-12 20:00:00,28,15,31,31,1,106
2024-03-12 20:10:00,32,15,37,18,1,103
2024-03-12 20:20:00,34,14,44,10,2,104
2024-03-12 20:30:00,24,10,40,12,3,89
2024-03-12 20:40:00,34,21,21,13,2,91
2024-03-12 20:50:00,24,10,27,11,0,72
2024-03-12 21:00:00,15,10,22,21,2,70
2024-03-12 21:10:00,16,10,26,22,0,74
2024-03-12 21:20:00,13,11,23,17,1,65
2024-03-12 21:30:00,25,7,13,14,1,60
2024-03-12 21:40:00,13,8,14,15,1,51
2024-03-12 21:50:00,9,12,21,14,1,57
2024-03-12 22:00:00,16,9,13,15,1,54
2024-03-12 22:10:00,12,3,19,16,1,51
2024-03-12 22:20:00,15,9,20,14,1,59
2024-03-12 22:30:00,8,5,15,17,1,46
2024-03-12 22:40:00,13,8,16,13,1,51
2024-03-12 22:50:00,8,6,9,9,0,32
2024-03-12 23:00:00,11,5,5,9,0,30
2024-03-12 23:10:00,16,3,4,8,0,31
2024-03-12 23:20:00,4,7,7,5,0,23
2024-03-12 23:30:00,5,6,5,16,0,32
2024-03-12 23:40:00,3,6,4,7,0,20
2024-03-12 23:50:00,5,3,1,6,0,15
2024-03-13 00:00:00,7,2,6,6,0,21
2024-03-13 00:10:00,2,0,6,6,0,14
2024-03-13 00:20:00,7,1,3,5,0,16
2024-03-13 00:30:00,5,3,4,4,0,16
2024-03-13 00:40:00,6,4,4,3,0,17
2024-03-13 00:50:00,4,0,4,4,0,12
2024-03-13 01:00:00,6,0,7,5,0,18
2024-03-13 01:10:00,3,2,1,1,0,7
2024-03-13 01:20:00,1,0,2,1,0,4
2024-03-13 01:30:00,0,0,0,1,0,1
2024-03-13 01:40:00,3,1,2,1,0,7
2024-03-13 01:50:00,1,1,1,0,0,3
2024-03-13 02:00:00,0,0,0,0,0,0
2024-03-13 02:10:00,3,2,1,4,0,10
2024-03-13 02:20:00,1,0,0,0,0,1
2024-03-13 02:30:00,2,1,1,2,0,6
2024-03-13 02:40:00,3,3,0,2,0,8
2024-03-13 02:50:00,2,0,2,2,0,6
2024-03-13 03:00:00,3,0,0,2,0,5
2024-03-13 03:10:00,0,1,1,1,1,4
2024-03-13 03:20:00,4,0,3,1,1,9
2024-03-13 03:30:00,6,1,2,0,1,10
2024-03-13 03:40:00,6,3,2,0,0,11
2024-03-13 03:50:00,1,2,3,1,0,7
2024-03-13 04:00:00,1,1,3,0,0,5
2024-03-13 04:10:00,1,0,2,1,0,4
2024-03-13 04:20:00,4,1,3,1,0,9
2024-03-13 04:30:00,7,6,4,0,0,17
2024-03-13 04:40:00,3,1,7,4,0,15
2024-03-13 04:50:00,7,4,5,3,0,19
2024-03-13 05:00:00,7,7,8,2,0,24
2024-03-13 05:10:00,15,10,12,4,0,41
2024-03-13 05:20:00,27,12,9,2,0,50
2024-03-13 05:30:00,22,14,9,6,1,52
2024-03-13 05:40:00,39,16,18,10,2,85
2024-03-13 05:50:00,33,17,15,9,2,76
2024-03-13 06:00:00,20,10,24,13,1,68
2024-03-13 06:10:00,35,17,21,11,2,86
2024-03-13 06:20:00,33,27,29,12,4,105
2024-03-13 06:30:00,37,19,25,16,4,101
2024-03-13 06:40:00,31,22,31,22,4,110
2024-03-13 06:50:00,40,18,31,19,1,109
2024-03-13 07:00:00,31,18,28,16,5,98
2024-03-13 07:10:00,52,24,34,25,6,141
2024-03-13 07:20:00,42,36,29,26,8,141
2024-03-13 07:30:00,46,34,30,27,7,144
2024-03-13 07:40:00,63,30,18,29,5,145
2024-03-13 07:50:00,51,43,34,34,4,166
2024-03-13 08:00:00,51,39,39,19,5,153
2024-03-13 08:10:00,60,33,42,30,3,168
2024-03-13 08:20:00,68,23,43,24,5,163
2024-03-13 08:30:00,60,28,37,32,2,159
2024-03-13 08:40:00,52,28,28,22,6,136
2024-03-13 08:50:00,55,24,44,22,4,149
2024-03-13 09:00:00,42,14,23,23,3,105
2024-03-13 09:10:00,54,24,30,25,3,136
2024-03-13 09:20:00,44,34,31,14,5,128
2024-03-13 09:30:00,47,16,33,26,2,124
2024-03-13 09:40:00,55,9,39,14,3,120
2024-03-13 09:50:00,42,20,36,18,3,119
2024-03-13 10:00:00,42,13,30,14,1,100
2024-03-13 10:10:00,34,14,29,16,4,97
2024-03-13 10:20:00,37,22,29,19,3,110
2024-03-13 10:30:00,33,7,33,22,1,96
2024-03-13 10:40:00,38,19,31,10,2,100
2024-03-13 10:50:00,44,18,26,17,2,107
2024-03-13 11:00:00,50,12,37,26,2,127
2024-03-13 11:10:00,43,10,31,16,3,103
2024-03-13 11:20:00,31,17,29,21,4,102
2024-03-13 11:30:00,37,23,25,20,5,110
2024-03-13 11:40:00,40,16,33,36,4,129
2024-03-13 11:50:00,48,22,38,27,3,138
2024-03-13 12:00:00,46,20,34,17,2,119
2024-03-13 12:10:00,35,16,32,28,6,117
2024-03-13 12:20:00,51,14,31,24,2,122
2024-03-13 12:30:00,29,21,45,25,6,126
2024-03-13 12:40:00,41,20,28,20,4,113
2024-03-13 12:50:00,45,23,46,19,3,136
2024-03-13 13:00:00,59,24,36,23,2,144
2024-03-13 13:10:00,44,17,55,20,4,140
2024-03-13 13:20:00,31,17,31,26,9,114
2024-03-13 13:30:00,38,10,30,28,5,111
2024-03-13 13:40:00,42,32,20,36,4,134
2024-03-13 13:50:00,49,25,44,29,4,151
2024-03-13 14:00:00,40,16,42,39,1,138
2024-03-13 14:10:00,29,26,4,53,7,119
2024-03-13 14:20:00,42,24,4,43,8,121
2024-03-13 14:30:00,40,25,2,46,5,118
2024-03-13 14:40:00,44,29,12,41,8,134
2024-03-13 14:50:00,56,17,4,49,3,129
2024-03-13 15:00:00,37,21,42,24,3,127
2024-03-13 15:10:00,49,20,47,29,5,150
2024-03-13 15:20:00,44,18,31,46,5,144
2024-03-13 15:30:00,46,22,44,34,6,152
2024-03-13 15:40:00,44,22,50,30,5,151
2024-03-13 15:50:00,50,25,42,32,4,153
2024-03-13 16:00:00,45,31,38,23,5,142
2024-03-13 16:10:00,58,21,45,38,4,166
2024-03-13 16:20:00,35,20,52,31,3,141
2024-03-13 16:30:00,44,29,45,32,3,153
2024-03-13 16:40:00,38,27,40,42,10,157
2024-03-13 16:50:00,44,22,39,42,4,151
2024-03-13 17:00:00,41,25,48,31,5,150
2024-03-13 17:10:00,35,25,57,27,3,147
2024-03-13 17:20:00,43,20,46,31,6,146
2024-03-13 17:30:00,46,29,34,37,6,152
2024-03-13 17:40:00,38,25,45,39,4,151
2024-03-13 17:50:00,32,20,39,33,6,130
2024-03-13 18:00:00,44,19,50,31,5,149
2024-03-13 18:10:00,31,28,49,32,4,144
2024-03-13 18:20:00,31,17,46,28,2,124
2024-03-13 18:30:00,29,21,42,40,2,134
2024-03-13 18:40:00,40,23,60,33,5,161
2024-03-13 18:50:00,50,24,57,32,4,167
2024-03-13 19:00:00,35,20,37,19,8,119
2024-03-13 19:10:00,38,17,51,24,7,137
2024-03-13 19:20:00,42,16,53,32,3,146
2024-03-13 19:30:00,47,15,41,29,1,133
2024-03-13 19:40:00,35,21,49,31,1,137
2024-03-13 19:50:00,33,11,56,25,2,127
2024-03-13 20:00:00,34,14,50,23,3,124
2024-03-13 20:10:00,35,14,43,27,1,120
2024-03-13 20:20:00,27,16,36,16,0,95
2024-03-13 20:30:00,23,24,41,24,1,113
2024-03-13 20:40:00,22,12,43,33,1,111
2024-03-13 20:50:00,20,16,37,24,5,102
2024-03-13 21:00:00,34,12,29,21,3,99
2024-03-13 21:10:00,29,9,42,17,2,99
2024-03-13 21:20:00,43,18,31,10,2,104
2024-03-13 21:30:00,23,12,37,21,0,93
2024-03-13 21:40:00,42,17,25,26,0,110
2024-03-13 21:50:00,35,12,15,29,1,92
2024-03-13 22:00:00,23,20,28,28,0,99
2024-03-13 22:10:00,33,6,24,24,1,88
2024-03-13 22:20:00,25,12,29,18,1,85
2024-03-13 22:30:00,20,5,23,25,0,73
2024-03-13 22:40:00,16,5,18,23,2,64
2024-03-13 22:50:00,19,5,9,9,0,42
2024-03-13 23:00:00,33,8,8,16,1,66
2024-03-13 23:10:00,20,8,7,9,0,44
2024-03-13 23:20:00,10,3,6,8,0,27
2024-03-13 23:30:00,14,11,2,12,0,39
2024-03-13 23:40:00,5,3,5,12,0,25
2024-03-13 23:50:00,5,5,5,9,0,24
2024-03-14 00:00:00,7,5,7,1,0,20
2024-03-14 00:10:00,3,2,13,5,0,23
2024-03-14 00:20:00,7,4,9,4,0,24
2024-03-14 00:30:00,4,1,4,6,0,15
2024-03-14 00:40:00,10,0,3,2,0,15
2024-03-14 00:50:00,6,0,1,3,0,10
2024-03-14 01:00:00,1,2,3,8,0,14
2024-03-14 01:10:00,8,0,3,0,1,12
2024-03-14 01:20:00,9,0,1,1,0,11
2024-03-14 01:30:00,1,2,0,1,0,4
2024-03-14 01:40:00,2,0,2,0,0,4
2024-03-14 01:50:00,3,0,2,0,0,5
2024-03-14 02:00:00,2,2,2,5,0,11
2024-03-14 02:10:00,3,2,2,1,0,8
2024-03-14 02:20:00,1,2,4,0,0,7
2024-03-14 02:30:00,3,0,2,0,0,5
2024-03-14 02:40:00,0,0,4,0,0,4
2024-03-14 02:50:00,2,1,2,0,0,5
2024-03-14 03:00:00,3,1,4,0,1,9
2024-03-14 03:10:00,0,0,2,4,0,6
2024-03-14 03:20:00,0,0,3,1,1,5
2024-03-14 03:30:00,7,0,3,0,0,10
2024-03-14 03:40:00,6,1,2,0,0,9
2024-03-14 03:50:00,5,2,4,3,0,14
2024-03-14 04:00:00,1,1,5,1,0,8
2024-03-14 04:10:00,8,2,2,0,0,12
2024-03-14 04:20:00,3,2,6,1,0,12
2024-03-14 04:30:00,5,1,6,4,1,17
2024-03-14 04:40:00,9,1,6,1,0,17
2024-03-14 04:50:00,9,5,11,4,0,29
2024-03-14 05:00:00,9,10,13,4,0,36
2024-03-14 05:10:00,20,18,16,8,0,62
2024-03-14 05:20:00,25,12,25,8,0,70
2024-03-14 05:30:00,20,34,21,6,0,81
2024-03-14 05:40:00,30,19,39,12,0,100
2024-03-14 05:50:00,36,24,30,12,1,103
2024-03-14 06:00:00,30,20,27,5,1,83
2024-03-14 06:10:00,42,24,42,19,2,129
2024-03-14 06:20:00,52,28,46,15,1,142
2024-03-14 06:30:00,40,19,32,25,0,116
2024-03-14 06:40:00,46,20,28,14,3,111
2024-03-14 06:50:00,53,29,29,22,4,137
2024-03-14 07:00:00,41,22,33,21,6,123
2024-03-14 07:10:00,44,27,39,29,5,144
2024-03-14 07:20:00,49,25,32,23,11,140
2024-03-14 07:30:00,37,29,42,34,11,153
2024-03-14 07:40:00,37,33,39,31,10,150
2024-03-14 07:50:00,47,33,34,27,9,150
2024-03-14 08:00:00,70,25,43,17,6,161
2024-03-14 08:10:00,68,22,51,19,3,163
2024-03-14 08:20:00,59,32,49,26,4,170
2024-03-14 08:30:00,44,33,35,21,4,137
2024-03-14 08:40:00,60,23,46,25,2,156
2024-03-14 08:50:00,53,21,51,19,4,148
2024-03-14 09:00:00,52,24,33,22,5,136
2024-03-14 09:10:00,50,21,50,21,7,149
2024-03-14 09:20:00,53,21,49,14,2,139
2024-03-14 09:30:00,35,18,31,13,4,101
2024-03-14 09:40:00,38,22,39,28,4,131
2024-03-14 09:50:00,55,21,38,18,4,136
2024-03-14 10:00:00,33,20,22,18,3,96
2024-03-14 10:10:00,41,10,34,14,5,104
2024-03-14 10:20:00,39,16,41,26,4,126
2024-03-14 10:30:00,45,11,41,24,1,122
2024-03-14 10:40:00,44,16,46,12,1,119
2024-03-14 10:50:00,39,17,32,20,7,115
2024-03-14 11:00:00,32,16,50,24,4,126
2024-03-14 11:10:00,34,22,36,19,4,115
2024-03-14 11:20:00,24,15,33,28,4,104
2024-03-14 11:30:00,33,16,38,24,3,114
2024-03-14 11:40:00,32,13,47,24,5,121
2024-03-14 11:50:00,53,18,29,30,3,133
2024-03-14 12:00:00,49,16,44,20,2,131
2024-03-14 12:10:00,36,19,38,16,4,113
2024-03-14 12:20:00,33,17,27,26,4,107
2024-03-14 12:30:00,52,25,41,33,3,154
2024-03-14 12:40:00,22,17,33,26,6,104
2024-03-14 12:50:00,49,14,47,30,3,143
2024-03-14 13:00:00,44,24,37,24,4,133
2024-03-14 13:10:00,40,25,48,21,7,141
2024-03-14 13:20:00,49,32,39,20,6,146
2024-03-14 13:30:00,40,21,34,26,4,125
2024-03-14 13:40:00,49,20,42,28,5,144
2024-03-14 13:50:00,45,24,50,28,4,151
2024-03-14 14:00:00,38,25,36,30,7,136
2024-03-14 14:10:00,47,22,43,32,4,148
2024-03-14 14:20:00,57,29,35,33,8,162
2024-03-14 14:30:00,51,24,34,40,5,154
2024-03-14 14:40:00,46,12,48,32,5,143
2024-03-14 14:50:00,45,17,38,33,5,138
2024-03-14 15:00:00,40,23,37,28,3,131
2024-03-14 15:10:00,42,16,34,27,10,129
2024-03-14 15:20:00,49,24,32,25,7,137
2024-03-14 15:30:00,54,24,35,34,6,153
2024-03-14 15:40:00,61,25,38,26,3,153
2024-03-14 15:50:00,54,32,37,26,5,154
2024-03-14 16:00:00,63,18,45,25,2,153
2024-03-14 16:10:00,71,30,40,26,6,173
2024-03-14 16:20:00,38,20,34,27,9,128
2024-03-14 16:30:00,55,29,46,33,6,169
2024-03-14 16:40:00,37,23,43,31,7,141
2024-03-14 16:50:00,56,31,60,28,4,179
2024-03-14 17:00:00,48,17,42,38,6,151
2024-03-14 17:10:00,44,24,42,48,7,165
2024-03-14 17:20:00,43,26,55,40,4,168
2024-03-14 17:30:00,36,25,39,37,9,146
2024-03-14 17:40:00,68,17,45,30,1,161
2024-03-14 17:50:00,36,26,41,37,6,146
2024-03-14 18:00:00,48,26,46,28,6,154
2024-03-14 18:10:00,17,12,21,12,2,64
2024-03-14 18:20:00,7,10,12,15,2,46
2024-03-14 18:30:00,43,23,31,27,7,131
2024-03-14 18:40:00,44,22,33,34,4,137
2024-03-14 18:50:00,26,33,60,33,3,155
2024-03-14 19:00:00,46,28,43,42,3,162
2024-03-14 19:10:00,56,26,65,54,2,203
2024-03-14 19:20:00,33,20,43,46,4,146
2024-03-14 19:30:00,33,23,42,35,5,138
2024-03-14 19:40:00,26,28,53,17,3,127
2024-03-14 19:50:00,35,18,33,25,2,113
2024-03-14 20:00:00,42,22,51,26,1,142
2024-03-14 20:10:00,37,19,31,25,3,115
2024-03-14 20:20:00,24,17,44,16,4,105
2024-03-14 20:30:00,25,17,42,22,2,108
2024-03-14 20:40:00,29,19,30,22,2,102
2024-03-14 20:50:00,34,13,28,23,1,99
2024-03-14 21:00:00,28,12,41,18,1,100
2024-03-14 21:10:00,30,19,28,25,0,102
2024-03-14 21:20:00,24,10,29,18,1,82
2024-03-14 21:30:00,31,9,30,25,0,95
2024-03-14 21:40:00,25,10,26,15,1,77
2024-03-14 21:50:00,24,8,41,17,0,90
2024-03-14 22:00:00,18,19,30,24,1,92
2024-03-14 22:10:00,23,11,37,15,1,87
2024-03-14 22:20:00,23,12,26,13,0,74
2024-03-14 22:30:00,21,13,30,10,1,75
2024-03-14 22:40:00,12,5,25,12,1,55
2024-03-14 22:50:00,9,0,18,15,0,42
2024-03-14 23:00:00,26,5,18,7,0,56
2024-03-14 23:10:00,14,6,13,10,1,44
2024-03-14 23:20:00,20,6,11,15,1,53
2024-03-14 23:30:00,4,7,17,2,1,31
2024-03-14 23:40:00,11,7,11,7,0,36
2024-03-14 23:50:00,7,4,1,5,0,17
2024-03-15 00:00:00,8,4,14,6,0,32
2024-03-15 00:10:00,5,5,11,2,0,23
2024-03-15 00:20:00,0,0,5,1,0,6
2024-03-15 00:30:00,6,1,4,8,1,20
2024-03-15 00:40:00,5,5,4,4,0,18
2024-03-15 00:50:00,5,1,9,6,0,21
2024-03-15 01:00:00,6,2,4,4,0,16
2024-03-15 01:10:00,9,2,4,6,0,21
2024-03-15 01:20:00,2,1,0,1,0,4
2024-03-15 01:30:00,5,3,0,0,0,8
2024-03-15 01:40:00,2,0,1,1,0,4
2024-03-15 01:50:00,0,1,4,0,0,5
2024-03-15 02:00:00,4,0,2,0,1,7
2024-03-15 02:10:00,3,1,2,0,0,6
2024-03-15 02:20:00,0,0,1,1,0,2
2024-03-15 02:30:00,4,1,0,0,0,5
2024-03-15 02:40:00,0,2,2,6,0,10
2024-03-15 02:50:00,0,0,5,0,0,5
2024-03-15 03:00:00,3,0,3,0,0,6
2024-03-15 03:10:00,2,0,5,4,1,12
2024-03-15 03:20:00,1,0,1,1,0,3
2024-03-15 03:30:00,5,3,2,0,0,10
2024-03-15 03:40:00,4,0,8,1,0,13
2024-03-15 03:50:00,3,2,8,1,0,14
2024-03-15 04:00:00,7,1,6,2,0,16
2024-03-15 04:10:00,9,2,2,2,0,15
2024-03-15 04:20:00,4,2,5,0,0,11
2024-03-15 04:30:00,6,0,6,0,0,12
2024-03-15 04:40:00,8,7,4,3,0,22
2024-03-15 04:50:00,1,1,8,3,0,13
2024-03-15 05:00:00,10,8,11,4,0,33
2024-03-15 05:10:00,20,8,17,5,0,50
2024-03-15 05:20:00,31,30,17,5,0,83
2024-03-15 05:30:00,19,16,26,5,0,66
2024-03-15 05:40:00,26,28,39,14,1,108
2024-03-15 05:50:00,30,18,31,11,0,90
2024-03-15 06:00:00,38,18,30,12,2,100
2024-03-15 06:10:00,37,17,42,9,0,105
2024-03-15 06:20:00,36,20,25,15,1,97
2024-03-15 06:30:00,41,18,27,11,3,100
2024-03-15 06:40:00,57,27,38,23,5,150
2024-03-15 06:50:00,55,19,34,13,3,124
2024-03-15 07:00:00,53,32,38,28,3,154
2024-03-15 07:10:00,41,19,33,20,5,118
2024-03-15 07:20:00,46,32,37,26,10,151
2024-03-15 07:30:00,56,35,37,40,10,178
2024-03-15 07:40:00,65,35,34,45,6,185
2024-03-15 07:50:00,58,35,35,32,6,166
2024-03-15 08:00:00,29,33,36,20,5,123
2024-03-15 08:10:00,50,23,49,22,5,149
2024-03-15 08:20:00,52,24,33,27,6,142
2024-03-15 08:30:00,50,26,36,21,5,138
2024-03-15 08:40:00,35,22,44,32,4,137
2024-03-15 08:50:00,49,27,33,22,5,136
2024-03-15 09:00:00,43,17,30,22,6,118
2024-03-15 09:10:00,34,17,34,15,5,105
2024-03-15 09:20:00,47,14,36,16,4,117
2024-03-15 09:30:00,34,11,39,19,5,108
2024-03-15 09:40:00,47,24,36,14,3,124
2024-03-15 09:50:00,47,19,18,15,2,101
2024-03-15 10:00:00,29,11,36,15,3,94
2024-03-15 10:10:00,41,8,34,22,2,107
2024-03-15 10:20:00,32,20,27,13,2,94
2024-03-15 10:30:00,36,13,34,33,1,117
2024-03-15 10:40:00,43,21,30,18,2,114
2024-03-15 10:50:00,38,10,29,19,4,100
2024-03-15 11:00:00,35,19,29,25,3,111
2024-03-15 11:10:00,30,19,31,29,6,115
2024-03-15 11:20:00,29,16,29,16,3,93
2024-03-15 11:30:00,27,21,29,22,6,105
2024-03-15 11:40:00,47,17,43,21,2,130
2024-03-15 11:50:00,23,15,37,20,4,99
2024-03-15 12:00:00,43,18,33,21,3,118
2024-03-15 12:10:00,39,13,45,19,7,123
2024-03-15 12:20:00,38,20,28,19,6,111
2024-03-15 12:30:00,36,22,44,25,2,129
2024-03-15 12:40:00,33,26,33,23,6,121
2024-03-15 12:50:00,49,24,39,38,3,153
2024-03-15 13:00:00,45,19,39,26,5,134
2024-03-15 13:10:00,48,29,22,21,7,127
2024-03-15 13:20:00,46,33,33,32,9,153
2024-03-15 13:30:00,39,21,38,23,4,125
2024-03-15 13:40:00,26,35,42,29,5,137
2024-03-15 13:50:00,6,28,34,24,4,96
2024-03-15 14:00:00,42,20,41,28,3,134
2024-03-15 14:10:00,31,25,35,33,8,132
2024-03-15 14:20:00,43,30,50,31,5,159
2024-03-15 14:30:00,34,18,39,33,6,130
2024-03-15 14:40:00,50,25,36,39,4,154
2024-03-15 14:50:00,32,12,45,35,7,131
2024-03-15 15:00:00,54,31,33,37,6,161
2024-03-15 15:10:00,56,15,48,21,4,144
2024-03-15 15:20:00,46,30,29,36,3,144
2024-03-15 15:30:00,43,25,40,26,4,138
2024-03-15 15:40:00,57,18,44,35,8,162
2024-03-15 15:50:00,40,29,47,32,9,157
2024-03-15 16:00:00,52,21,43,25,4,145
2024-03-15 16:10:00,50,28,58,33,4,173
2024-03-15 16:20:00,39,23,32,22,8,124
2024-03-15 16:30:00,48,29,37,25,3,142
2024-03-15 16:40:00,45,40,36,31,6,158
2024-03-15 16:50:00,56,25,43,34,4,162
2024-03-15 17:00:00,52,22,41,24,5,144
2024-03-15 17:10:00,54,34,48,25,2,163
2024-03-15 17:20:00,45,26,35,41,6,153
2024-03-15 17:30:00,29,27,46,21,4,127
2024-03-15 17:40:00,48,27,35,26,6,142
2024-03-15 17:50:00,35,22,37,29,6,129
2024-03-15 18:00:00,47,21,35,35,6,144
2024-03-15 18:10:00,44,29,30,29,6,138
2024-03-15 18:20:00,50,23,42,30,3,148
2024-03-15 18:30:00,34,24,34,28,3,123
2024-03-15 18:40:00,48,23,75,44,5,195
2024-03-15 18:50:00,34,26,58,47,6,171
2024-03-15 19:00:00,39,28,54,27,3,151
2024-03-15 19:10:00,49,21,63,31,4,168
2024-03-15 19:20:00,41,12,39,23,5,120
2024-03-15 19:30:00,26,15,39,17,1,98
2024-03-15 19:40:00,28,12,45,16,4,105
2024-03-15 19:50:00,33,11,30,22,1,97
2024-03-15 20:00:00,36,7,26,9,5,83
2024-03-15 20:10:00,31,14,36,21,0,102
2024-03-15 20:20:00,29,9,32,14,0,84
2024-03-15 20:30:00,29,6,13,21,2,71
2024-03-15 20:40:00,23,8,21,22,2,76
2024-03-15 20:50:00,28,12,25,17,0,82
2024-03-15 21:00:00,26,17,16,18,4,81
2024-03-15 21:10:00,18,7,30,18,4,77
2024-03-15 21:20:00,20,7,23,13,1,64
2024-03-15 21:30:00,26,13,16,18,2,75
2024-03-15 21:40:00,16,8,28,12,3,67
2024-03-15 21:50:00,16,14,11,26,0,67
2024-03-15 22:00:00,21,14,22,21,0,78
2024-03-15 22:10:00,19,5,17,16,0,57
2024-03-15 22:20:00,29,9,31,32,0,101
2024-03-15 22:30:00,27,8,21,25,1,82
2024-03-15 22:40:00,24,10,17,22,2,75
2024-03-15 22:50:00,21,14,24,17,0,76
2024-03-15 23:00:00,19,5,17,15,0,56
2024-03-15 23:10:00,21,12,8,21,0,62
2024-03-15 23:20:00,20,14,12,26,1,73
2024-03-15 23:30:00,13,10,13,27,0,63
2024-03-15 23:40:00,19,10,9,14,1,53
2024-03-15 23:50:00,14,10,5,18,0,47
2024-03-16 00:00:00,10,5,9,12,0,36
2024-03-16 00:10:00,10,3,10,18,0,41
2024-03-16 00:20:00,6,4,4,10,0,24
2024-03-16 00:30:00,12,2,2,7,1,24
2024-03-16 00:40:00,9,2,2,23,0,36
2024-03-16 00:50:00,10,3,3,5,0,21
2024-03-16 01:00:00,5,5,2,18,0,30
2024-03-16 01:10:00,13,5,4,11,0,33
2024-03-16 01:20:00,9,2,13,6,0,30
2024-03-16 01:30:00,8,1,3,6,1,19
2024-03-16 01:40:00,7,7,4,11,2,31
2024-03-16 01:50:00,8,4,4,3,0,19
2024-03-16 02:00:00,8,3,2,4,0,17
2024-03-16 02:10:00,7,0,0,11,0,18
2024-03-16 02:20:00,3,1,0,3,0,7
2024-03-16 02:30:00,11,0,9,8,1,29
2024-03-16 02:40:00,4,5,1,5,0,15
2024-03-16 02:50:00,3,4,3,2,0,12
2024-03-16 03:00:00,4,0,2,3,0,9
2024-03-16 03:10:00,3,1,2,1,0,7
2024-03-16 03:20:00,3,2,1,1,0,7
2024-03-16 03:30:00,4,1,0,1,1,7
2024-03-16 03:40:00,5,0,1,2,0,8
2024-03-16 03:50:00,3,0,3,5,0,11
2024-03-16 04:00:00,1,3,2,3,0,9
2024-03-16 04:10:00,7,1,3,6,1,18
2024-03-16 04:20:00,3,2,3,7,0,15
2024-03-16 04:30:00,4,2,3,2,1,12
2024-03-16 04:40:00,5,1,6,5,0,17
2024-03-16 04:50:00,13,3,3,4,0,23
2024-03-16 05:00:00,4,3,0,4,0,11
2024-03-16 05:10:00,13,7,2,2,0,24
2024-03-16 05:20:00,16,6,4,5,0,31
2024-03-16 05:30:00,5,6,3,1,0,15
2024-03-16 05:40:00,8,6,8,10,0,32
2024-03-16 05:50:00,10,3,5,8,0,26
2024-03-16 06:00:00,7,2,6,6,1,22
2024-03-16 06:10:00,9,5,6,9,0,29
2024-03-16 06:20:00,10,6,11,14,0,41
2024-03-16 06:30:00,16,5,7,9,0,37
2024-03-16 06:40:00,9,2,7,9,0,27
2024-03-16 06:50:00,6,1,4,6,0,17
2024-03-16 07:00:00,12,4,11,9,2,38
2024-03-16 07:10:00,19,2,8,10,1,40
2024-03-16 07:20:00,10,2,5,12,2,31
2024-03-16 07:30:00,13,4,9,6,1,33
2024-03-16 07:40:00,24,13,10,18,2,67
2024-03-16 07:50:00,15,5,16,13,2,51
2024-03-16 08:00:00,15,2,14,10,0,41
2024-03-16 08:10:00,21,4,17,16,0,58
2024-03-16 08:20:00,24,11,12,13,0,60
2024-03-16 08:30:00,29,9,18,17,1,74
2024-03-16 08:40:00,33,10,18,23,1,85
2024-03-16 08:50:00,30,17,21,23,1,92
2024-03-16 09:00:00,27,13,14,21,3,78
2024-03-16 09:10:00,22,18,17,19,6,82
2024-03-16 09:20:00,38,15,18,23,3,97
2024-03-16 09:30:00,32,16,23,21,8,100
2024-03-16 09:40:00,40,15,17,38,3,113
2024-03-16 09:50:00,34,21,30,31,3,119
2024-03-16 10:00:00,35,22,26,37,3,123
2024-03-16 10:10:00,28,11,15,28,6,88
2024-03-16 10:20:00,40,16,18,31,2,107
2024-03-16 10:30:00,38,20,29,29,9,125
2024-03-16 10:40:00,56,19,30,30,4,139
2024-03-16 10:50:00,33,13,33,27,6,112
2024-03-16 11:00:00,43,22,22,27,4,118
2024-03-16 11:10:00,35,20,24,28,3,110
2024-03-16 11:20:00,39,26,20,27,2,114
2024-03-16 11:30:00,38,21,27,39,2,127
2024-03-16 11:40:00,37,16,23,25,2,103
2024-03-16 11:50:00,42,20,28,31,3,124
2024-03-16 12:00:00,35,20,24,36,5,120
2024-03-16 12:10:00,44,21,24,45,2,136
2024-03-16 12:20:00,41,18,27,40,7,133
2024-03-16 12:30:00,44,18,23,45,2,132
2024-03-16 12:40:00,52,21,28,38,1,140
2024-03-16 12:50:00,43,20,25,42,4,134
2024-03-16 13:00:00,42,21,34,35,0,132
2024-03-16 13:10:00,45,16,32,43,3,139
2024-03-16 13:20:00,47,17,22,52,2,140
2024-03-16 13:30:00,34,25,30,40,7,136
2024-03-16 13:40:00,37,19,36,53,5,150
2024-03-16 13:50:00,40,18,37,53,6,154
2024-03-16 14:00:00,41,16,38,44,7,146
2024-03-16 14:10:00,45,19,25,49,3,141
2024-03-16 14:20:00,50,24,24,41,4,143
2024-03-16 14:30:00,44,18,34,42,3,141
2024-03-16 14:40:00,40,27,27,26,4,124
2024-03-16 14:50:00,50,20,31,41,3,145
2024-03-16 15:00:00,27,10,16,33,2,88
2024-03-16 15:10:00,32,15,21,27,4,99
2024-03-16 15:20:00,39,22,30,29,4,124
2024-03-16 15:30:00,38,16,25,30,5,114
2024-03-16 15:40:00,39,12,17,39,1,108
2024-03-16 15:50:00,36,19,17,14,2,88
2024-03-16 16:00:00,25,16,24,29,3,97
2024-03-16 16:10:00,41,15,20,30,4,110
2024-03-16 16:20:00,39,18,31,39,3,130
2024-03-16 16:30:00,36,11,31,38,3,119
2024-03-16 16:40:00,29,12,20,26,6,93
2024-03-16 16:50:00,38,15,32,29,3,117
2024-03-16 17:00:00,46,21,22,36,0,125
2024-03-16 17:10:00,32,19,34,36,3,124
2024-03-16 17:20:00,44,15,24,26,1,110
2024-03-16 17:30:00,30,24,21,26,6,107
2024-03-16 17:40:00,52,24,23,27,2,128
2024-03-16 17:50:00,61,21,21,33,5,141
2024-03-16 18:00:00,51,19,16,36,6,128
2024-03-16 18:10:00,53,25,24,33,4,139
2024-03-16 18:20:00,44,28,23,30,6,131
2024-03-16 18:30:00,42,26,29,22,4,123
2024-03-16 18:40:00,57,26,22,28,3,136
2024-03-16 18:50:00,53,26,36,40,2,157
2024-03-16 19:00:00,48,27,38,37,1,151
2024-03-16 19:10:00,42,27,34,45,3,151
2024-03-16 19:20:00,37,23,23,35,1,119
2024-03-16 19:30:00,46,33,37,33,2,151
2024-03-16 19:40:00,44,26,20,35,3,128
2024-03-16 19:50:00,35,27,23,22,4,111
2024-03-16 20:00:00,36,19,19,46,1,121
2024-03-16 20:10:00,36,11,21,34,2,104
2024-03-16 20:20:00,18,14,18,34,0,84
2024-03-16 20:30:00,23,21,41,34,2,121
2024-03-16 20:40:00,15,13,23,36,4,91
2024-03-16 20:50:00,25,11,27,32,1,96
2024-03-16 21:00:00,31,20,8,27,2,88
2024-03-16 21:10:00,22,10,25,19,0,76
2024-03-16 21:20:00,20,13,14,27,0,74
2024-03-16 21:30:00,18,18,20,25,0,81
2024-03-16 21:40:00,21,15,20,25,0,81
2024-03-16 21:50:00,28,5,5,37,0,75
2024-03-16 22:00:00,29,10,15,20,3,77
2024-03-16 22:10:00,13,9,10,19,0,51
2024-03-16 22:20:00,24,10,16,18,1,69
2024-03-16 22:30:00,25,1,15,20,0,61
2024-03-16 22:40:00,20,8,18,21,0,67
2024-03-16 22:50:00,23,6,18,26,0,73
2024-03-16 23:00:00,25,8,11,23,0,67
2024-03-16 23:10:00,14,12,13,23,0,62
2024-03-16 23:20:00,19,8,5,29,1,62
2024-03-16 23:30:00,19,9,12,21,0,61
2024-03-16 23:40:00,17,7,3,16,1,44
2024-03-16 23:50:00,24,10,11,18,1,64
2024-03-17 00:00:00,15,4,10,15,0,44
2024-03-17 00:10:00,21,4,15,14,0,54
2024-03-17 00:20:00,17,2,8,12,0,39
2024-03-17 00:30:00,18,2,5,10,1,36
2024-03-17 00:40:00,14,1,6,7,0,28
2024-03-17 00:50:00,3,0,9,17,0,29
2024-03-17 01:00:00,14,5,4,5,0,28
2024-03-17 01:10:00,4,6,0,12,0,22
2024-03-17 01:20:00,6,2,5,13,1,27
2024-03-17 01:30:00,13,6,6,12,0,37
2024-03-17 01:40:00,15,2,10,8,0,35
2024-03-17 01:50:00,17,3,4,6,0,30
2024-03-17 02:00:00,2,5,2,2,1,12
2024-03-17 02:10:00,5,4,1,9,0,19
2024-03-17 02:20:00,5,1,6,7,1,20
2024-03-17 02:30:00,14,5,2,10,0,31
2024-03-17 02:40:00,4,0,4,13,0,21
2024-03-17 02:50:00,1,1,2,9,0,13
2024-03-17 03:00:00,8,2,0,2,0,12
2024-03-17 03:10:00,5,3,0,3,0,11
2024-03-17 03:20:00,7,0,0,8,1,16
2024-03-17 03:30:00,4,0,1,4,0,9
2024-03-17 03:40:00,6,1,3,3,0,13
2024-03-17 03:50:00,4,0,2,0,0,6
2024-03-17 04:00:00,3,1,4,0,0,8
2024-03-17 04:10:00,14,0,5,4,0,23
2024-03-17 04:20:00,3,4,2,2,0,11
2024-03-17 04:30:00,3,0,2,7,0,12
2024-03-17 04:40:00,3,4,4,1,1,13
2024-03-17 04:50:00,4,1,1,2,0,8
2024-03-17 05:00:00,7,2,1,2,0,12
2024-03-17 05:10:00,4,4,0,4,0,12
2024-03-17 05:20:00,4,7,4,1,0,16
2024-03-17 05:30:00,2,4,3,4,0,13
2024-03-17 05:40:00,6,3,1,7,1,18
2024-03-17 05:50:00,6,5,6,7,1,25
2024-03-17 06:00:00,1,3,6,6,0,16
2024-03-17 06:10:00,13,0,5,5,0,23
2024-03-17 06:20:00,3,1,1,10,0,15
2024-03-17 06:30:00,1,2,1,0,0,4
2024-03-17 06:40:00,3,0,1,2,0,6
2024-03-17 06:50:00,7,3,3,4,1,18
2024-03-17 07:00:00,6,2,2,5,0,15
2024-03-17 07:10:00,5,1,3,5,0,14
2024-03-17 07:20:00,7,2,0,3,3,15
2024-03-17 07:30:00,5,4,3,4,1,17
2024-03-17 07:40:00,9,1,6,5,0,21
2024-03-17 07:50:00,6,8,5,7,0,26
2024-03-17 08:00:00,5,1,7,10,2,25
2024-03-17 08:10:00,14,4,5,12,0,35
2024-03-17 08:20:00,14,6,7,11,1,39
2024-03-17 08:30:00,15,6,7,9,0,37
2024-03-17 08:40:00,23,6,7,11,0,47
2024-03-17 08:50:00,15,6,14,14,3,52
2024-03-17 09:00:00,15,7,11,17,0,50
2024-03-17 09:10:00,17,9,17,16,4,63
2024-03-17 09:20:00,17,9,14,16,1,57
2024-03-17 09:30:00,25,10,18,21,1,75
2024-03-17 09:40:00,25,9,18,23,1,76
2024-03-17 09:50:00,27,15,17,14,3,76
2024-03-17 10:00:00,23,12,18,18,6,77
2024-03-17 10:10:00,22,13,13,21,0,69
2024-03-17 10:20:00,26,13,16,10,1,66
2024-03-17 10:30:00,34,16,10,21,1,82
2024-03-17 10:40:00,26,12,25,16,2,81
2024-03-17 10:50:00,24,11,16,24,1,76
2024-03-17 11:00:00,27,10,16,17,4,74
2024-03-17 11:10:00,30,11,21,28,4,94
2024-03-17 11:20:00,34,18,20,26,3,101
2024-03-17 11:30:00,21,17,18,19,3,78
2024-03-17 11:40:00,34,28,24,31,2,119
2024-03-17 11:50:00,36,17,15,21,3,92
2024-03-17 12:00:00,27,14,21,19,3,84
2024-03-17 12:10:00,30,23,12,31,2,98
2024-03-17 12:20:00,36,16,24,23,1,100
2024-03-17 12:30:00,29,18,35,25,3,110
2024-03-17 12:40:00,32,22,32,24,2,112
2024-03-17 12:50:00,30,14,17,23,4,88
2024-03-17 13:00:00,42,11,26,24,1,104
2024-03-17 13:10:00,23,21,25,25,1,95
2024-03-17 13:20:00,39,23,23,27,4,116
2024-03-17 13:30:00,34,17,26,26,2,105
2024-03-17 13:40:00,42,12,27,28,4,113
2024-03-17 13:50:00,31,17,25,28,3,104
2024-03-17 14:00:00,42,17,29,25,1,114
2024-03-17 14:10:00,29,22,24,31,5,111
2024-03-17 14:20:00,30,15,25,41,3,114
2024-03-17 14:30:00,36,22,19,32,4,113
2024-03-17 14:40:00,33,21,24,32,2,112
2024-03-17 14:50:00,44,17,21,30,1,113
2024-03-17 15:00:00,34,13,19,27,1,94
2024-03-17 15:10:00,31,15,18,30,4,98
2024-03-17 15:20:00,30,13,12,26,2,83
2024-03-17 15:30:00,26,13,30,31,5,105
2024-03-17 15:40:00,39,21,22,22,6,110
2024-03-17 15:50:00,33,18,19,24,5,99
2024-03-17 16:00:00,34,22,19,27,4,106
2024-03-17 16:10:00,47,19,17,23,4,110
2024-03-17 16:20:00,28,17,18,26,3,92
2024-03-17 16:30:00,27,21,17,30,5,100
2024-03-17 16:40:00,25,16,15,16,5,77
2024-03-17 16:50:00,47,9,12,25,1,94
2024-03-17 17:00:00,50,23,15,34,4,126
2024-03-17 17:10:00,37,17,28,21,2,105
2024-03-17 17:20:00,34,16,19,34,4,107
2024-03-17 17:30:00,29,23,11,29,4,96
2024-03-17 17:40:00,38,29,20,31,5,123
2024-03-17 17:50:00,36,31,15,36,4,122
2024-03-17 18:00:00,34,22,19,27,3,105
2024-03-17 18:10:00,36,19,14,31,4,104
2024-03-17 18:20:00,47,24,20,34,5,130
2024-03-17 18:30:00,29,18,15,23,5,90
2024-03-17 18:40:00,35,18,19,25,2,99
2024-03-17 18:50:00,34,22,23,25,2,106
2024-03-17 19:00:00,31,15,22,25,2,95
2024-03-17 19:10:00,31,21,22,24,6,104
2024-03-17 19:20:00,31,22,19,28,3,103
2024-03-17 19:30:00,30,12,16,22,2,82
2024-03-17 19:40:00,35,13,31,29,0,108
2024-03-17 19:50:00,35,11,35,25,3,109
2024-03-17 20:00:00,31,13,20,25,1,90
2024-03-17 20:10:00,30,16,12,29,0,87
2024-03-17 20:20:00,28,16,15,25,3,87
2024-03-17 20:30:00,32,17,16,19,4,88
2024-03-17 20:40:00,24,14,14,33,0,85
2024-03-17 20:50:00,9,18,22,13,1,63
2024-03-17 21:00:00,12,15,18,26,1,72
2024-03-17 21:10:00,14,10,26,16,0,66
2024-03-17 21:20:00,20,16,12,24,1,73
2024-03-17 21:30:00,28,3,8,29,2,70
2024-03-17 21:40:00,16,6,18,21,1,62
2024-03-17 21:50:00,19,10,19,10,0,58
2024-03-17 22:00:00,25,5,23,11,1,65
2024-03-17 22:10:00,24,7,17,17,0,65
2024-03-17 22:20:00,5,5,10,9,0,29
2024-03-17 22:30:00,19,4,10,9,0,42
2024-03-17 22:40:00,5,6,24,14,3,52
2024-03-17 22:50:00,5,8,14,5,2,34
2024-03-17 23:00:00,11,7,11,13,0,42
2024-03-17 23:10:00,15,0,14,10,0,39
2024-03-17 23:20:00,9,3,20,7,1,40
2024-03-17 23:30:00,6,2,11,1,0,20
2024-03-17 23:40:00,7,0,6,3,0,16
2024-03-17 23:50:00,1,1,11,2,0,15
2024-03-18 00:00:00,2,2,8,2,0,14
2024-03-18 00:10:00,4,4,10,2,0,20
2024-03-18 00:20:00,10,7,0,6,0,23
2024-03-18 00:30:00,1,0,3,3,0,7
2024-03-18 00:40:00,5,0,4,0,0,9
2024-03-18 00:50:00,6,0,2,4,0,12
2024-03-18 01:00:00,7,2,4,1,0,14
2024-03-18 01:10:00,4,2,0,0,0,6
2024-03-18 01:20:00,5,3,0,2,0,10
2024-03-18 01:30:00,3,0,0,3,0,6
2024-03-18 01:40:00,0,0,3,3,0,6
2024-03-18 01:50:00,4,2,0,4,0,10
2024-03-18 02:00:00,1,0,2,0,0,3
2024-03-18 02:10:00,2,0,2,1,0,5
2024-03-18 02:20:00,4,0,1,0,0,5
2024-03-18 02:30:00,0,0,6,0,0,6
2024-03-18 02:40:00,1,0,3,4,0,8
2024-03-18 02:50:00,3,3,1,4,0,11
2024-03-18 03:00:00,3,0,2,3,2,10
2024-03-18 03:10:00,2,1,2,0,0,5
2024-03-18 03:20:00,2,0,3,1,0,6
2024-03-18 03:30:00,5,2,4,1,0,12
2024-03-18 03:40:00,5,0,6,1,0,12
2024-03-18 03:50:00,5,1,2,0,0,8
2024-03-18 04:00:00,1,0,1,2,0,4
2024-03-18 04:10:00,5,0,3,1,0,9
2024-03-18 04:20:00,5,2,0,0,0,7
2024-03-18 04:30:00,9,3,3,3,0,18
2024-03-18 04:40:00,4,5,10,3,0,22
2024-03-18 04:50:00,18,4,9,4,0,35
2024-03-18 05:00:00,13,4,7,8,0,32
2024-03-18 05:10:00,15,8,12,6,0,41
2024-03-18 05:20:00,28,14,11,6,0,59
2024-03-18 05:30:00,28,21,18,6,0,73
2024-03-18 05:40:00,32,16,26,12,4,90
2024-03-18 05:50:00,29,24,28,11,0,92
2024-03-18 06:00:00,37,19,31,11,0,98
2024-03-18 06:10:00,37,16,40,14,0,107
2024-03-18 06:20:00,50,23,33,18,0,124
2024-03-18 06:30:00,47,21,24,7,1,100
2024-03-18 06:40:00,46,21,34,19,0,120
2024-03-18 06:50:00,40,20,26,24,3,113
2024-03-18 07:00:00,56,25,37,17,2,137
2024-03-18 07:10:00,60,33,37,26,5,161
2024-03-18 07:20:00,51,27,31,21,7,137
2024-03-18 07:30:00,34,26,41,41,10,152
2024-03-18 07:40:00,50,32,40,32,8,162
2024-03-18 07:50:00,78,43,32,47,7,207
2024-03-18 08:00:00,63,26,39,25,1,154
2024-03-18 08:10:00,42,21,39,27,6,135
2024-03-18 08:20:00,55,21,34,22,5,137
2024-03-18 08:30:00,35,48,34,34,2,153
2024-03-18 08:40:00,50,27,42,26,2,147
2024-03-18 08:50:00,63,35,35,27,5,165
2024-03-18 09:00:00,46,20,30,14,5,115
2024-03-18 09:10:00,49,13,29,30,3,124
2024-03-18 09:20:00,57,23,41,22,1,144
2024-03-18 09:30:00,40,9,40,26,1,116
2024-03-18 09:40:00,48,26,37,21,3,135
2024-03-18 09:50:00,53,15,39,16,4,127
2024-03-18 10:00:00,39,18,28,22,5,112
2024-03-18 10:10:00,32,15,35,18,1,101
2024-03-18 10:20:00,34,17,25,10,4,90
2024-03-18 10:30:00,40,19,31,13,4,107
2024-03-18 10:40:00,40,12,33,13,0,98
2024-03-18 10:50:00,36,15,34,20,5,110
2024-03-18 11:00:00,28,17,35,19,4,103
2024-03-18 11:10:00,44,23,25,19,2,113
2024-03-18 11:20:00,37,23,34,18,4,116
2024-03-18 11:30:00,42,14,23,16,3,98
2024-03-18 11:40:00,43,11,30,23,0,107
2024-03-18 11:50:00,46,16,31,16,1,110
2024-03-18 12:00:00,45,14,36,16,1,112
2024-03-18 12:10:00,38,17,40,18,4,117
2024-03-18 12:20:00,37,19,41,27,3,127
2024-03-18 12:30:00,40,17,26,18,4,105
2024-03-18 12:40:00,46,22,28,22,5,123
2024-03-18 12:50:00,41,17,29,30,6,123
2024-03-18 13:00:00,43,19,36,25,5,128
2024-03-18 13:10:00,29,17,39,24,9,118
2024-03-18 13:20:00,34,20,32,27,7,120
2024-03-18 13:30:00,43,27,37,19,3,129
2024-03-18 13:40:00,43,26,39,27,4,139
2024-03-18 13:50:00,46,25,34,12,4,121
2024-03-18 14:00:00,43,18,35,30,6,132
2024-03-18 14:10:00,45,21,39,26,5,136
2024-03-18 14:20:00,48,20,37,29,2,136
2024-03-18 14:30:00,43,15,35,27,3,123
2024-03-18 14:40:00,39,15,33,27,6,120
2024-03-18 14:50:00,34,16,43,34,3,130
2024-03-18 15:00:00,41,28,38,29,10,146
2024-03-18 15:10:00,54,26,50,32,3,165
2024-03-18 15:20:00,41,21,36,43,6,147
2024-03-18 15:30:00,42,22,35,23,5,127
2024-03-18 15:40:00,59,26,30,29,7,151
2024-03-18 15:50:00,45,25,31,35,6,142
2024-03-18 16:00:00,56,20,45,44,4,169
2024-03-18 16:10:00,42,37,46,42,4,171
2024-03-18 16:20:00,49,21,34,31,4,139
2024-03-18 16:30:00,46,29,26,20,5,126
2024-03-18 16:40:00,53,22,18,20,8,121
2024-03-18 16:50:00,56,25,2,0,8,91
2024-03-18 17:00:00,48,19,3,6,5,81
2024-03-18 17:10:00,37,23,0,0,5,65
2024-03-18 17:20:00,62,29,9,13,8,121
2024-03-18 17:30:00,40,23,36,35,9,143
2024-03-18 17:40:00,55,27,42,36,5,165
2024-03-18 17:50:00,35,24,45,36,3,143
2024-03-18 18:00:00,54,13,44,33,7,151
2024-03-18 18:10:00,48,24,42,33,6,153
2024-03-18 18:20:00,55,22,52,37,4,170
2024-03-18 18:30:00,32,18,36,33,4,123
2024-03-18 18:40:00,31,17,27,25,8,108
2024-03-18 18:50:00,30,16,50,34,5,135
2024-03-18 19:00:00,33,20,37,22,5,117
2024-03-18 19:10:00,40,14,47,23,5,129
2024-03-18 19:20:00,38,25,58,41,7,169
2024-03-18 19:30:00,34,15,49,23,3,124
2024-03-18 19:40:00,29,14,41,26,2,112
2024-03-18 19:50:00,40,21,38,28,4,131
2024-03-18 20:00:00,41,18,42,34,2,137
2024-03-18 20:10:00,33,15,40,26,2,116
2024-03-18 20:20:00,32,10,46,25,1,114
2024-03-18 20:30:00,19,21,28,24,1,93
2024-03-18 20:40:00,24,14,28,27,2,95
2024-03-18 20:50:00,19,14,30,17,1,81
2024-03-18 21:00:00,25,13,42,16,2,98
2024-03-18 21:10:00,21,12,30,15,2,80
2024-03-18 21:20:00,29,17,35,19,1,101
2024-03-18 21:30:00,17,5,16,10,1,49
2024-03-18 21:40:00,17,5,20,7,4,53
2024-03-18 21:50:00,13,6,17,9,0,45
2024-03-18 22:00:00,15,9,30,9,2,65
2024-03-18 22:10:00,13,8,23,10,1,55
2024-03-18 22:20:00,19,3,21,7,1,51
2024-03-18 22:30:00,10,5,7,8,0,30
2024-03-18 22:40:00,10,8,20,10,0,48
2024-03-18 22:50:00,13,4,13,5,0,35
2024-03-18 23:00:00,18,3,22,5,1,49
2024-03-18 23:10:00,5,1,12,8,0,26
2024-03-18 23:20:00,5,1,2,2,0,10
2024-03-18 23:30:00,5,5,16,9,1,36
2024-03-18 23:40:00,7,5,9,2,1,24
2024-03-18 23:50:00,3,2,7,4,0,16
2024-03-19 00:00:00,9,7,11,5,0,32
2024-03-19 00:10:00,6,5,6,3,0,20
2024-03-19 00:20:00,5,1,5,10,0,21
2024-03-19 00:30:00,10,2,8,10,0,30
2024-03-19 00:40:00,3,2,2,3,0,10
2024-03-19 00:50:00,6,0,4,3,0,13
2024-03-19 01:00:00,1,0,1,7,0,9
2024-03-19 01:10:00,8,0,7,1,0,16
2024-03-19 01:20:00,4,0,4,0,1,9
2024-03-19 01:30:00,5,0,2,5,0,12
2024-03-19 01:40:00,2,0,0,0,0,2
2024-03-19 01:50:00,2,0,2,0,0,4
2024-03-19 02:00:00,1,1,0,0,0,2
2024-03-19 02:10:00,5,5,0,2,0,12
2024-03-19 02:20:00,5,0,0,1,0,6
2024-03-19 02:30:00,5,0,3,4,0,12
2024-03-19 02:40:00,3,0,2,1,0,6
2024-03-19 02:50:00,3,3,3,0,0,9
2024-03-19 03:00:00,3,1,6,4,0,14
2024-03-19 03:10:00,3,1,1,1,0,6
2024-03-19 03:20:00,2,0,4,0,1,7
2024-03-19 03:30:00,3,0,3,0,0,6
2024-03-19 03:40:00,5,0,6,2,0,13
2024-03-19 03:50:00,4,0,5,1,0,10
2024-03-19 04:00:00,7,2,5,1,0,15
2024-03-19 04:10:00,6,2,2,0,0,10
2024-03-19 04:20:00,4,4,13,0,0,21
2024-03-19 04:30:00,8,3,3,4,0,18
2024-03-19 04:40:00,4,3,3,7,0,17
2024-03-19 04:50:00,17,8,13,2,0,40
2024-03-19 05:00:00,12,4,14,0,0,30
2024-03-19 05:10:00,23,10,15,7,0,55
2024-03-19 05:20:00,29,15,20,1,0,65
2024-03-19 05:30:00,30,19,25,6,0,80
2024-03-19 05:40:00,42,34,21,9,4,110
2024-03-19 05:50:00,34,18,35,13,0,100
2024-03-19 06:00:00,47,12,21,8,1,89
2024-03-19 06:10:00,42,17,44,13,0,116
2024-03-19 06:20:00,42,28,25,20,0,115
2024-03-19 06:30:00,41,26,28,8,2,105
2024-03-19 06:40:00,50,33,41,21,1,146
2024-03-19 06:50:00,32,14,36,24,3,109
2024-03-19 07:00:00,56,29,36,23,4,148
2024-03-19 07:10:00,45,38,38,25,7,153
2024-03-19 07:20:00,57,28,42,28,6,161
2024-03-19 07:30:00,59,32,39,26,12,168
2024-03-19 07:40:00,56,46,51,49,6,208
2024-03-19 07:50:00,53,25,36,35,7,156
2024-03-19 08:00:00,48,17,24,29,6,124
2024-03-19 08:10:00,77,26,33,28,3,167
2024-03-19 08:20:00,71,46,28,18,5,168
2024-03-19 08:30:00,64,32,34,26,4,160
2024-03-19 08:40:00,42,27,37,28,4,138
2024-03-19 08:50:00,59,25,38,21,3,146
2024-03-19 09:00:00,39,40,40,15,3,137
2024-03-19 09:10:00,28,58,29,21,5,141
2024-03-19 09:20:00,35,11,24,18,5,93
2024-03-19 09:30:00,54,30,30,21,5,140
2024-03-19 09:40:00,47,17,33,16,2,115
2024-03-19 09:50:00,55,20,26,21,2,124
2024-03-19 10:00:00,37,14,32,9,5,97
2024-03-19 10:10:00,55,18,36,17,2,128
2024-03-19 10:20:00,44,9,25,16,3,97
2024-03-19 10:30:00,31,8,35,17,3,94
2024-03-19 10:40:00,35,8,36,14,4,97
2024-03-19 10:50:00,53,23,33,14,2,125
2024-03-19 11:00:00,47,15,37,22,2,123
2024-03-19 11:10:00,41,10,34,22,5,112
2024-03-19 11:20:00,48,19,30,19,6,122
2024-03-19 11:30:00,47,17,29,25,3,121
2024-03-19 11:40:00,33,19,26,27,3,108
2024-03-19 11:50:00,45,21,30,14,2,112
2024-03-19 12:00:00,42,15,41,18,1,117
2024-03-19 12:10:00,51,23,48,25,1,148
2024-03-19 12:20:00,44,25,29,17,5,120
2024-03-19 12:30:00,31,27,45,22,4,129
2024-03-19 12:40:00,49,26,32,28,4,139
2024-03-19 12:50:00,55,19,48,16,2,140
2024-03-19 13:00:00,36,9,46,30,7,128
2024-03-19 13:10:00,40,26,43,15,6,130
2024-03-19 13:20:00,34,21,34,24,8,121
2024-03-19 13:30:00,51,18,39,19,9,136
2024-03-19 13:40:00,48,26,58,23,5,160
2024-03-19 13:50:00,39,19,44,29,5,136
2024-03-19 14:00:00,33,12,35,22,8,110
2024-03-19 14:10:00,47,19,34,35,8,143
2024-03-19 14:20:00,40,20,37,37,7,141
2024-03-19 14:30:00,46,26,44,27,6,149
2024-03-19 14:40:00,52,18,43,22,5,140
2024-03-19 14:50:00,53,22,38,30,10,153
2024-03-19 15:00:00,36,19,40,26,6,127
2024-03-19 15:10:00,51,19,39,27,3,139
2024-03-19 15:20:00,45,25,42,32,6,150
2024-03-19 15:30:00,50,30,46,32,8,166
2024-03-19 15:40:00,50,32,36,35,2,155
2024-03-19 15:50:00,39,19,40,34,6,138
2024-03-19 16:00:00,44,20,49,18,6,137
2024-03-19 16:10:00,53,27,35,27,9,151
2024-03-19 16:20:00,50,27,47,34,2,160
2024-03-19 16:30:00,42,33,32,32,4,143
2024-03-19 16:40:00,63,29,39,30,9,170
2024-03-19 16:50:00,54,31,39,31,7,162
2024-03-19 17:00:00,50,22,41,27,5,145
2024-03-19 17:10:00,42,19,35,37,9,142
2024-03-19 17:20:00,66,40,34,27,4,171
2024-03-19 17:30:00,43,29,41,24,4,141
2024-03-19 17:40:00,43,31,49,36,4,163
2024-03-19 17:50:00,44,20,33,37,4,138
2024-03-19 18:00:00,57,20,32,24,4,137
2024-03-19 18:10:00,41,18,45,30,6,140
2024-03-19 18:20:00,47,29,54,32,2,164
2024-03-19 18:30:00,52,25,33,24,6,140
2024-03-19 18:40:00,35,17,35,27,8,122
2024-03-19 18:50:00,32,23,40,30,7,132
2024-03-19 19:00:00,46,29,36,30,9,150
2024-03-19 19:10:00,35,30,70,37,3,175
2024-03-19 19:20:00,37,16,60,38,2,153
2024-03-19 19:30:00,42,26,53,22,4,147
2024-03-19 19:40:00,31,22,42,19,7,121
2024-03-19 19:50:00,41,14,49,25,4,133
2024-03-19 20:00:00,48,31,40,28,3,150
2024-03-19 20:10:00,24,19,45,30,3,121
2024-03-19 20:20:00,29,27,37,21,2,116
2024-03-19 20:30:00,29,11,28,23,2,93
2024-03-19 20:40:00,40,29,32,23,2,126
2024-03-19 20:50:00,25,1,39,18,0,83
2024-03-19 21:00:00,22,14,38,18,1,93
2024-03-19 21:10:00,30,19,48,21,3,121
2024-03-19 21:20:00,34,18,32,27,0,111
2024-03-19 21:30:00,22,5,24,25,0,76
2024-03-19 21:40:00,29,8,35,31,0,103
2024-03-19 21:50:00,22,5,33,21,0,81
2024-03-19 22:00:00,16,3,37,18,1,75
2024-03-19 22:10:00,31,13,33,27,2,106
2024-03-19 22:20:00,22,14,46,17,0,99
2024-03-19 22:30:00,20,5,28,16,0,69
2024-03-19 22:40:00,12,0,15,11,2,40
2024-03-19 22:50:00,19,8,17,18,1,63
2024-03-19 23:00:00,11,8,13,9,0,41
2024-03-19 23:10:00,18,5,15,13,0,51
2024-03-19 23:20:00,14,3,14,13,0,44
2024-03-19 23:30:00,15,12,17,3,0,47
2024-03-19 23:40:00,8,0,12,7,0,27
2024-03-19 23:50:00,12,5,2,6,0,25
2024-03-20 00:00:00,4,0,14,7,0,25
2024-03-20 00:10:00,10,0,19,2,0,31
2024-03-20 00:20:00,5,1,8,9,0,23
2024-03-20 00:30:00,4,1,6,5,0,16
2024-03-20 00:40:00,1,0,3,3,1,8
2024-03-20 00:50:00,2,0,4,7,0,13
2024-03-20 01:00:00,3,1,5,2,0,11
2024-03-20 01:10:00,3,0,3,0,1,7
2024-03-20 01:20:00,1,0,1,0,0,2
2024-03-20 01:30:00,0,2,4,3,0,9
2024-03-20 01:40:00,2,1,0,2,0,5
2024-03-20 01:50:00,0,1,1,0,0,2
2024-03-20 02:00:00,1,0,3,0,0,4
2024-03-20 02:10:00,3,0,1,2,0,6
2024-03-20 02:20:00,9,2,2,4,0,17
2024-03-20 02:30:00,0,0,3,0,0,3
2024-03-20 02:40:00,4,3,2,2,0,11
2024-03-20 02:50:00,3,0,0,0,0,3
2024-03-20 03:00:00,3,1,1,1,0,6
2024-03-20 03:10:00,2,0,6,3,0,11
2024-03-20 03:20:00,0,2,3,0,1,6
2024-03-20 03:30:00,5,0,0,0,0,5
2024-03-20 03:40:00,4,2,2,4,0,12
2024-03-20 03:50:00,2,0,3,0,0,5
2024-03-20 04:00:00,5,3,1,2,0,11
2024-03-20 04:10:00,6,2,4,0,0,12
2024-03-20 04:20:00,7,4,4,2,0,17
2024-03-20 04:30:00,7,3,8,0,0,18
2024-03-20 04:40:00,8,3,4,3,1,19
2024-03-20 04:50:00,9,7,6,9,0,31
2024-03-20 05:00:00,10,2,9,4,0,25
2024-03-20 05:10:00,26,10,24,1,0,61
2024-03-20 05:20:00,22,17,14,3,0,56
2024-03-20 05:30:00,23,20,24,4,0,71
2024-03-20 05:40:00,23,23,37,10,3,96
2024-03-20 05:50:00,35,28,30,11,2,106
2024-03-20 06:00:00,37,16,22,23,0,98
2024-03-20 06:10:00,41,14,37,13,2,107
2024-03-20 06:20:00,37,25,23,14,3,102
2024-03-20 06:30:00,36,14,30,11,1,92
2024-03-20 06:40:00,41,23,35,20,3,122
2024-03-20 06:50:00,56,20,36,28,3,143
2024-03-20 07:00:00,61,31,34,23,5,154
2024-03-20 07:10:00,62,41,30,34,7,174
2024-03-20 07:20:00,58,36,40,21,9,164
2024-03-20 07:30:00,43,31,32,21,13,140
2024-03-20 07:40:00,57,30,30,35,9,161
2024-03-20 07:50:00,56,36,45,21,1,159
2024-03-20 08:00:00,46,30,43,15,4,138
2024-03-20 08:10:00,47,29,49,32,8,165
2024-03-20 08:20:00,56,24,42,20,1,143
2024-03-20 08:30:00,52,26,33,26,5,142
2024-03-20 08:40:00,51,30,48,17,2,148
2024-03-20 08:50:00,55,16,38,21,2,132
2024-03-20 09:00:00,44,18,40,22,6,130
2024-03-20 09:10:00,42,16,25,18,9,110
2024-03-20 09:20:00,45,23,37,20,3,128
2024-03-20 09:30:00,46,19,42,21,5,133
2024-03-20 09:40:00,48,9,22,40,2,121
2024-03-20 09:50:00,52,11,40,17,4,124
2024-03-20 10:00:00,37,18,27,14,3,99
2024-03-20 10:10:00,40,20,35,12,5,112
2024-03-20 10:20:00,41,21,39,18,5,124
2024-03-20 10:30:00,39,12,40,23,5,119
2024-03-20 10:40:00,41,21,53,14,4,133
2024-03-20 10:50:00,35,12,47,24,2,120
2024-03-20 11:00:00,52,32,43,19,2,148
2024-03-20 11:10:00,47,19,47,19,3,135
2024-03-20 11:20:00,39,20,33,20,5,117
2024-03-20 11:30:00,41,19,27,24,3,114
2024-03-20 11:40:00,38,19,31,31,6,125
2024-03-20 11:50:00,41,12,40,32,3,128
2024-03-20 12:00:00,48,21,46,23,8,146
2024-03-20 12:10:00,53,16,47,30,4,150
2024-03-20 12:20:00,47,14,54,26,3,144
2024-03-20 12:30:00,33,20,51,29,4,137
2024-03-20 12:40:00,53,25,52,22,3,155
2024-03-20 12:50:00,54,14,42,21,3,134
2024-03-20 13:00:00,50,17,50,22,3,142
2024-03-20 13:10:00,32,26,39,36,10,143
2024-03-20 13:20:00,41,25,45,28,5,144
2024-03-20 13:30:00,46,18,31,36,6,137
2024-03-20 13:40:00,51,22,10,46,8,137
2024-03-20 13:50:00,44,23,36,27,5,135
2024-03-20 14:00:00,45,22,45,24,4,140
2024-03-20 14:10:00,40,20,29,31,10,130
2024-03-20 14:20:00,38,22,49,31,4,144
2024-03-20 14:30:00,34,28,37,19,9,127
2024-03-20 14:40:00,43,21,37,41,7,149
2024-03-20 14:50:00,52,24,46,39,4,165
2024-03-20 15:00:00,34,16,41,25,4,120
2024-03-20 15:10:00,42,21,41,38,8,150
2024-03-20 15:20:00,47,28,42,27,8,152
2024-03-20 15:30:00,52,19,39,30,5,145
2024-03-20 15:40:00,44,20,40,22,7,133
2024-03-20 15:50:00,46,15,34,38,7,140
2024-03-20 16:00:00,36,21,35,34,10,136
2024-03-20 16:10:00,67,21,37,31,5,161
2024-03-20 16:20:00,55,22,12,10,9,108
2024-03-20 16:30:00,47,22,1,3,9,82
2024-03-20 16:40:00,50,24,13,26,8,121
2024-03-20 16:50:00,56,40,38,30,10,174
2024-03-20 17:00:00,61,26,53,37,8,185
2024-03-20 17:10:00,46,20,33,35,5,139
2024-03-20 17:20:00,46,25,8,30,8,117
2024-03-20 17:30:00,43,28,40,25,8,144
2024-03-20 17:40:00,47,29,36,26,6,144
2024-03-20 17:50:00,37,28,32,28,6,131
2024-03-20 18:00:00,46,26,46,28,6,152
2024-03-20 18:10:00,49,31,48,29,7,164
2024-03-20 18:20:00,43,31,38,24,8,144
2024-03-20 18:30:00,41,22,25,31,8,127
2024-03-20 18:40:00,42,26,40,22,4,134
2024-03-20 18:50:00,34,19,28,29,7,117
2024-03-20 19:00:00,45,28,48,28,6,155
2024-03-20 19:10:00,46,16,54,41,5,162
2024-03-20 19:20:00,41,12,55,45,4,157
2024-03-20 19:30:00,30,24,42,40,3,139
2024-03-20 19:40:00,30,33,35,19,2,119
2024-03-20 19:50:00,33,22,43,40,3,141
2024-03-20 20:00:00,41,25,58,15,2,141
2024-03-20 20:10:00,32,18,41,34,4,129
2024-03-20 20:20:00,40,25,35,32,2,134
2024-03-20 20:30:00,26,19,49,23,0,117
2024-03-20 20:40:00,23,7,35,30,0,95
2024-03-20 20:50:00,26,18,37,18,1,100
2024-03-20 21:00:00,29,6,35,15,3,88
2024-03-20 21:10:00,35,9,29,18,2,93
2024-03-20 21:20:00,31,19,36,23,0,109
2024-03-20 21:30:00,29,8,48,22,3,110
2024-03-20 21:40:00,29,18,57,25,0,129
2024-03-20 21:50:00,16,7,26,18,1,68
2024-03-20 22:00:00,17,10,30,16,1,74
2024-03-20 22:10:00,29,15,34,24,0,102
2024-03-20 22:20:00,17,7,56,22,2,104
2024-03-20 22:30:00,17,4,31,18,1,71
2024-03-20 22:40:00,21,5,29,14,1,70
2024-03-20 22:50:00,19,7,8,18,0,52
2024-03-20 23:00:00,31,6,29,15,0,81
2024-03-20 23:10:00,13,6,10,16,3,48
2024-03-20 23:20:00,13,10,13,7,0,43
2024-03-20 23:30:00,10,14,9,2,3,38
2024-03-20 23:40:00,9,3,22,4,1,39
2024-03-20 23:50:00,13,0,15,4,0,32
2024-03-21 00:00:00,10,3,13,3,0,29
2024-03-21 00:10:00,8,2,10,6,0,26
2024-03-21 00:20:00,8,2,2,1,0,13
2024-03-21 00:30:00,6,5,6,4,0,21
2024-03-21 00:40:00,5,7,11,7,0,30
2024-03-21 00:50:00,3,0,6,3,0,12
2024-03-21 01:00:00,1,0,2,2,0,5
2024-03-21 01:10:00,6,0,3,0,0,9
2024-03-21 01:20:00,3,0,0,0,1,4
2024-03-21 01:30:00,5,0,4,6,0,15
2024-03-21 01:40:00,4,3,2,3,0,12
2024-03-21 01:50:00,6,1,7,2,0,16
2024-03-21 02:00:00,2,0,0,0,0,2
2024-03-21 02:10:00,6,0,3,3,0,12
2024-03-21 02:20:00,1,0,0,3,0,4
2024-03-21 02:30:00,5,1,2,2,0,10
2024-03-21 02:40:00,0,0,10,4,0,14
2024-03-21 02:50:00,2,1,1,2,0,6
2024-03-21 03:00:00,7,0,5,0,0,12
2024-03-21 03:10:00,1,1,4,0,0,6
2024-03-21 03:20:00,0,0,6,0,1,7
2024-03-21 03:30:00,5,1,6,0,0,12
2024-03-21 03:40:00,4,2,4,2,0,12
2024-03-21 03:50:00,2,3,5,0,0,10
2024-03-21 04:00:00,5,1,2,2,0,10
2024-03-21 04:10:00,12,0,3,0,0,15
2024-03-21 04:20:00,6,5,2,1,0,14
2024-03-21 04:30:00,3,2,5,3,0,13
2024-03-21 04:40:00,6,3,13,7,0,29
2024-03-21 04:50:00,11,8,5,9,0,33
2024-03-21 05:00:00,10,4,8,3,0,25
2024-03-21 05:10:00,24,12,17,6,0,59
2024-03-21 05:20:00,36,10,15,5,1,67
2024-03-21 05:30:00,28,17,19,9,0,73
2024-03-21 05:40:00,41,22,47,14,2,126
2024-03-21 05:50:00,34,14,33,17,0,98
2024-03-21 06:00:00,36,12,28,12,0,88
2024-03-21 06:10:00,46,14,34,14,1,109
2024-03-21 06:20:00,42,27,24,14,1,108
2024-03-21 06:30:00,37,22,25,13,1,98
2024-03-21 06:40:00,47,26,29,21,1,124
2024-03-21 06:50:00,47,39,31,23,5,145
2024-03-21 07:00:00,44,20,36,15,3,118
2024-03-21 07:10:00,45,35,45,36,5,166
2024-03-21 07:20:00,44,30,34,23,14,145
2024-03-21 07:30:00,50,25,39,34,9,157
2024-03-21 07:40:00,49,32,37,41,7,166
2024-03-21 07:50:00,53,32,48,25,4,162
2024-03-21 08:00:00,53,28,41,28,7,157
2024-03-21 08:10:00,65,26,36,23,4,154
2024-03-21 08:20:00,55,23,40,19,7,144
2024-03-21 08:30:00,52,19,35,23,4,133
2024-03-21 08:40:00,49,25,29,26,5,134
2024-03-21 08:50:00,55,19,42,23,4,143
2024-03-21 09:00:00,47,21,25,20,6,119
2024-03-21 09:10:00,39,17,41,27,4,128
2024-03-21 09:20:00,49,22,34,22,2,129
2024-03-21 09:30:00,43,23,39,23,5,133
2024-03-21 09:40:00,58,27,38,20,0,143
2024-03-21 09:50:00,42,18,48,29,2,139
2024-03-21 10:00:00,34,16,33,27,4,114
2024-03-21 10:10:00,43,14,35,22,2,116
2024-03-21 10:20:00,41,17,30,16,4,108
2024-03-21 10:30:00,46,13,35,19,4,117
2024-03-21 10:40:00,37,15,45,18,2,117
2024-03-21 10:50:00,34,21,23,38,2,118
2024-03-21 11:00:00,37,18,36,22,0,113
2024-03-21 11:10:00,39,31,33,27,2,132
2024-03-21 11:20:00,38,17,34,21,4,114
2024-03-21 11:30:00,34,22,46,22,6,130
2024-03-21 11:40:00,40,21,29,31,4,125
2024-03-21 11:50:00,35,21,35,24,5,120
2024-03-21 12:00:00,46,24,38,23,4,135
2024-03-21 12:10:00,46,17,41,29,1,134
2024-03-21 12:20:00,41,20,29,25,3,118
2024-03-21 12:30:00,37,24,46,28,4,139
2024-03-21 12:40:00,40,21,38,35,7,141
2024-03-21 12:50:00,43,19,46,18,7,133
2024-03-21 13:00:00,42,9,28,25,6,110
2024-03-21 13:10:00,42,20,30,18,11,121
2024-03-21 13:20:00,41,31,34,27,8,141
2024-03-21 13:30:00,44,24,46,25,6,145
2024-03-21 13:40:00,31,26,31,20,7,115
2024-03-21 13:50:00,43,23,37,15,7,125
2024-03-21 14:00:00,47,23,34,31,6,141
2024-03-21 14:10:00,53,23,31,34,6,147
2024-03-21 14:20:00,36,25,31,30,9,131
2024-03-21 14:30:00,39,20,46,36,6,147
2024-03-21 14:40:00,52,32,36,30,6,156
2024-03-21 14:50:00,43,27,42,37,5,154
2024-03-21 15:00:00,44,21,42,25,8,140
2024-03-21 15:10:00,40,29,41,29,4,143
2024-03-21 15:20:00,46,23,38,25,7,139
2024-03-21 15:30:00,45,30,42,31,4,152
2024-03-21 15:40:00,39,34,34,29,7,143
2024-03-21 15:50:00,59,32,36,29,8,164
2024-03-21 16:00:00,44,21,39,34,6,144
2024-03-21 16:10:00,62,27,24,37,7,157
2024-03-21 16:20:00,36,23,42,45,10,156
2024-03-21 16:30:00,54,20,40,27,4,145
2024-03-21 16:40:00,37,23,19,26,12,117
2024-03-21 16:50:00,37,26,5,6,10,84
2024-03-21 17:00:00,49,26,0,0,5,80
2024-03-21 17:10:00,49,22,2,0,7,80
2024-03-21 17:20:00,58,24,5,15,4,106
2024-03-21 17:30:00,43,26,46,35,11,161
2024-03-21 17:40:00,50,23,33,28,6,140
2024-03-21 17:50:00,44,31,37,27,6,145
2024-03-21 18:00:00,41,30,42,25,6,144
2024-03-21 18:10:00,43,21,39,41,5,149
2024-03-21 18:20:00,42,23,48,39,7,159
2024-03-21 18:30:00,43,22,30,31,4,130
2024-03-21 18:40:00,27,28,38,33,8,134
2024-03-21 18:50:00,31,14,50,32,4,131
2024-03-21 19:00:00,48,24,63,38,2,175
2024-03-21 19:10:00,24,22,56,34,8,144
2024-03-21 19:20:00,24,21,57,41,6,149
2024-03-21 19:30:00,43,24,57,27,2,153
2024-03-21 19:40:00,38,20,43,20,2,123
2024-03-21 19:50:00,49,20,32,24,3,128
2024-03-21 20:00:00,34,25,37,25,1,122
2024-03-21 20:10:00,46,13,41,19,5,124
2024-03-21 20:20:00,30,17,19,25,4,95
2024-03-21 20:30:00,24,16,17,25,0,82
2024-03-21 20:40:00,30,12,24,31,3,100
2024-03-21 20:50:00,26,16,31,35,2,110
2024-03-21 21:00:00,40,20,32,28,1,121
2024-03-21 21:10:00,31,20,31,23,1,106
2024-03-21 21:20:00,34,16,24,17,0,91
2024-03-21 21:30:00,27,7,29,22,1,86
2024-03-21 21:40:00,30,9,25,29,2,95
2024-03-21 21:50:00,20,11,33,27,1,92
2024-03-21 22:00:00,27,11,25,32,1,96
2024-03-21 22:10:00,22,9,24,22,1,78
2024-03-21 22:20:00,21,14,26,26,0,87
2024-03-21 22:30:00,16,8,25,22,2,73
2024-03-21 22:40:00,15,6,20,10,0,51
2024-03-21 22:50:00,27,8,24,20,1,80
2024-03-21 23:00:00,20,11,24,11,0,66
2024-03-21 23:10:00,15,5,5,21,0,46
2024-03-21 23:20:00,12,9,13,20,0,54
2024-03-21 23:30:00,8,8,4,9,1,30
2024-03-21 23:40:00,8,5,14,8,0,35
2024-03-21 23:50:00,18,2,9,8,1,38
2024-03-22 00:00:00,10,0,7,6,0,23
2024-03-22 00:10:00,7,1,5,7,0,20
2024-03-22 00:20:00,7,4,0,4,0,15
2024-03-22 00:30:00,9,5,8,3,0,25
2024-03-22 00:40:00,6,0,8,7,0,21
2024-03-22 00:50:00,5,0,6,6,0,17
2024-03-22 01:00:00,3,1,6,3,0,13
2024-03-22 01:10:00,2,0,3,4,0,9
2024-03-22 01:20:00,5,4,1,3,0,13
2024-03-22 01:30:00,4,0,4,4,0,12
2024-03-22 01:40:00,3,1,1,2,0,7
2024-03-22 01:50:00,3,0,2,0,0,5
2024-03-22 02:00:00,2,2,2,2,0,8
2024-03-22 02:10:00,8,0,5,2,0,15
2024-03-22 02:20:00,3,0,0,0,0,3
2024-03-22 02:30:00,2,0,0,2,0,4
2024-03-22 02:40:00,3,5,6,0,0,14
2024-03-22 02:50:00,4,2,3,0,0,9
2024-03-22 03:00:00,2,0,2,0,0,4
2024-03-22 03:10:00,3,0,6,0,1,10
2024-03-22 03:20:00,3,4,5,4,0,16
2024-03-22 03:30:00,3,0,2,1,0,6
2024-03-22 03:40:00,6,0,0,3,0,9
2024-03-22 03:50:00,3,0,13,0,0,16
2024-03-22 04:00:00,4,2,4,0,0,10
2024-03-22 04:10:00,4,1,6,2,0,13
2024-03-22 04:20:00,6,5,1,4,0,16
2024-03-22 04:30:00,11,2,0,0,0,13
2024-03-22 04:40:00,13,4,3,0,0,20
2024-03-22 04:50:00,6,2,9,4,0,21
2024-03-22 05:00:00,12,4,10,2,0,28
2024-03-22 05:10:00,24,11,13,6,0,54
2024-03-22 05:20:00,16,9,13,4,0,42
2024-03-22 05:30:00,35,18,28,6,0,87
2024-03-22 05:40:00,31,16,44,13,2,106
2024-03-22 05:50:00,34,29,28,16,1,108
2024-03-22 06:00:00,40,18,32,13,0,103
2024-03-22 06:10:00,33,16,26,9,0,84
2024-03-22 06:20:00,46,16,24,13,0,99
2024-03-22 06:30:00,44,16,25,12,1,98
2024-03-22 06:40:00,50,24,27,18,3,122
2024-03-22 06:50:00,43,29,39,16,2,129
2024-03-22 07:00:00,47,31,37,19,2,136
2024-03-22 07:10:00,45,28,25,26,8,132
2024-03-22 07:20:00,43,25,33,26,8,135
2024-03-22 07:30:00,45,26,49,32,11,163
2024-03-22 07:40:00,55,36,36,42,10,179
2024-03-22 07:50:00,48,26,50,21,4,149
2024-03-22 08:00:00,38,25,43,18,5,129
2024-03-22 08:10:00,49,27,33,27,4,140
2024-03-22 08:20:00,39,29,33,27,7,135
2024-03-22 08:30:00,47,28,35,24,5,139
2024-03-22 08:40:00,46,20,39,23,5,133
2024-03-22 08:50:00,56,20,31,26,6,139
2024-03-22 09:00:00,39,15,26,25,1,106
2024-03-22 09:10:00,41,29,30,20,5,125
2024-03-22 09:20:00,39,17,24,39,5,124
2024-03-22 09:30:00,53,14,18,38,1,124
2024-03-22 09:40:00,43,19,36,27,3,128
2024-03-22 09:50:00,0,40,30,27,4,101
2024-03-22 10:00:00,0,45,44,21,2,112
2024-03-22 10:10:00,36,19,33,29,6,123
2024-03-22 10:20:00,34,20,31,24,6,115
2024-03-22 10:30:00,45,14,35,21,4,119
2024-03-22 10:40:00,31,17,36,25,9,118
2024-03-22 10:50:00,43,21,50,36,9,159
2024-03-22 11:00:00,41,15,40,19,3,118
2024-03-22 11:10:00,43,22,33,15,4,117
2024-03-22 11:20:00,35,23,44,23,5,130
2024-03-22 11:30:00,48,26,30,19,4,127
2024-03-22 11:40:00,41,24,36,26,4,131
2024-03-22 11:50:00,40,24,28,28,4,124
2024-03-22 12:00:00,47,9,41,29,1,127
2024-03-22 12:10:00,39,22,33,28,7,129
2024-03-22 12:20:00,48,17,35,24,9,133
2024-03-22 12:30:00,36,16,48,27,6,133
2024-03-22 12:40:00,33,18,37,24,8,120
2024-03-22 12:50:00,52,16,42,24,5,139
2024-03-22 13:00:00,38,20,27,30,2,117
2024-03-22 13:10:00,37,22,34,28,5,126
2024-03-22 13:20:00,46,36,43,27,5,157
2024-03-22 13:30:00,53,22,35,27,5,142
2024-03-22 13:40:00,42,18,34,38,6,138
2024-03-22 13:50:00,53,13,26,33,4,129
2024-03-22 14:00:00,35,23,17,36,7,118
2024-03-22 14:10:00,44,31,36,38,2,151
2024-03-22 14:20:00,43,27,32,34,8,144
2024-03-22 14:30:00,45,23,38,21,4,131
2024-03-22 14:40:00,31,18,41,37,5,132
2024-03-22 14:50:00,37,18,55,40,5,155
2024-03-22 15:00:00,51,24,50,34,1,160
2024-03-22 15:10:00,49,19,36,42,4,150
2024-03-22 15:20:00,51,24,37,36,3,151
2024-03-22 15:30:00,40,22,30,43,7,142
2024-03-22 15:40:00,35,25,51,39,7,157
2024-03-22 15:50:00,47,29,41,32,5,154
2024-03-22 16:00:00,39,14,42,28,3,126
2024-03-22 16:10:00,57,26,50,30,4,167
2024-03-22 16:20:00,50,19,35,38,4,146
2024-03-22 16:30:00,49,20,32,33,7,141
2024-03-22 16:40:00,42,18,37,28,8,133
2024-03-22 16:50:00,51,28,54,36,6,175
2024-03-22 17:00:00,47,26,56,28,4,161
2024-03-22 17:10:00,54,26,34,44,5,163
2024-03-22 17:20:00,53,26,44,33,6,162
2024-03-22 17:30:00,46,31,44,18,7,146
2024-03-22 17:40:00,40,23,46,42,6,157
2024-03-22 17:50:00,29,21,31,35,6,122
2024-03-22 18:00:00,49,21,38,25,3,136
2024-03-22 18:10:00,47,25,40,27,6,145
2024-03-22 18:20:00,51,23,38,33,4,149
2024-03-22 18:30:00,13,9,19,11,2,54
2024-03-22 18:40:00,14,8,11,8,2,43
2024-03-22 18:50:00,26,13,16,17,5,77
2024-03-22 19:00:00,43,24,31,24,4,126
2024-03-22 19:10:00,44,21,58,32,3,158
2024-03-22 19:20:00,30,15,51,31,2,129
2024-03-22 19:30:00,49,22,66,22,1,160
2024-03-22 19:40:00,28,15,50,33,4,130
2024-03-22 19:50:00,38,25,50,39,0,152
2024-03-22 20:00:00,50,20,18,25,4,117
2024-03-22 20:10:00,30,28,33,30,4,125
2024-03-22 20:20:00,30,18,30,32,3,113
2024-03-22 20:30:00,29,22,22,39,2,114
2024-03-22 20:40:00,31,7,27,31,0,96
2024-03-22 20:50:00,29,15,22,28,2,96
2024-03-22 21:00:00,24,8,20,29,2,83
2024-03-22 21:10:00,34,9,19,38,1,101
2024-03-22 21:20:00,36,24,24,24,0,108
2024-03-22 21:30:00,31,14,28,34,1,108
2024-03-22 21:40:00,29,21,34,23,0,107
2024-03-22 21:50:00,18,13,16,25,3,75
2024-03-22 22:00:00,23,6,24,27,1,81
2024-03-22 22:10:00,27,12,21,31,2,93
2024-03-22 22:20:00,33,3,16,27,1,80
2024-03-22 22:30:00,19,11,25,19,2,76
2024-03-22 22:40:00,25,12,14,24,0,75
2024-03-22 22:50:00,20,8,17,16,2,63
2024-03-22 23:00:00,22,6,16,33,2,79
2024-03-22 23:10:00,19,9,14,14,0,56
2024-03-22 23:20:00,11,10,10,17,1,49
2024-03-22 23:30:00,14,7,8,16,1,46
2024-03-22 23:40:00,14,9,16,12,2,53
2024-03-22 23:50:00,19,5,12,15,1,52
2024-03-23 00:00:00,8,3,9,15,0,35
2024-03-23 00:10:00,17,6,7,20,4,54
2024-03-23 00:20:00,16,5,9,12,0,42
2024-03-23 00:30:00,8,4,8,7,0,27
2024-03-23 00:40:00,10,5,11,11,0,37
2024-03-23 00:50:00,9,3,9,10,0,31
2024-03-23 01:00:00,9,4,9,10,1,33
2024-03-23 01:10:00,11,2,10,8,0,31
2024-03-23 01:20:00,5,5,3,7,1,21
2024-03-23 01:30:00,6,4,8,5,0,23
2024-03-23 01:40:00,5,2,2,4,0,13
2024-03-23 01:50:00,9,1,3,11,0,24
2024-03-23 02:00:00,10,0,0,3,0,13
2024-03-23 02:10:00,4,0,2,8,0,14
2024-03-23 02:20:00,9,3,5,2,0,19
2024-03-23 02:30:00,10,0,2,6,0,18
2024-03-23 02:40:00,12,0,6,3,1,22
2024-03-23 02:50:00,2,3,3,10,0,18
2024-03-23 03:00:00,5,0,4,5,0,14
2024-03-23 03:10:00,3,2,2,3,0,10
2024-03-23 03:20:00,7,0,1,6,1,15
2024-03-23 03:30:00,5,3,1,5,0,14
2024-03-23 03:40:00,4,0,9,5,0,18
2024-03-23 03:50:00,8,0,2,4,0,14
2024-03-23 04:00:00,6,2,5,14,1,28
2024-03-23 04:10:00,7,3,1,1,0,12
2024-03-23 04:20:00,7,8,0,7,0,22
2024-03-23 04:30:00,7,2,6,2,1,18
2024-03-23 04:40:00,11,8,11,2,0,32
2024-03-23 04:50:00,6,2,0,3,0,11
2024-03-23 05:00:00,12,7,10,5,0,34
2024-03-23 05:10:00,10,5,6,7,0,28
2024-03-23 05:20:00,20,3,4,9,0,36
2024-03-23 05:30:00,14,5,7,8,0,34
2024-03-23 05:40:00,13,9,5,11,0,38
2024-03-23 05:50:00,8,6,6,11,0,31
2024-03-23 06:00:00,5,5,4,6,0,20
2024-03-23 06:10:00,7,2,6,12,0,27
2024-03-23 06:20:00,7,4,8,12,0,31
2024-03-23 06:30:00,11,3,3,9,0,26
2024-03-23 06:40:00,13,3,8,9,1,34
2024-03-23 06:50:00,19,5,6,8,0,38
2024-03-23 07:00:00,6,7,14,10,1,38
2024-03-23 07:10:00,13,4,5,7,0,29
2024-03-23 07:20:00,13,2,11,10,0,36
2024-03-23 07:30:00,11,5,13,8,2,39
2024-03-23 07:40:00,10,6,9,13,2,40
2024-03-23 07:50:00,19,5,16,14,0,54
2024-03-23 08:00:00,18,3,14,13,1,49
2024-03-23 08:10:00,17,5,9,16,1,48
2024-03-23 08:20:00,29,12,11,16,0,68
2024-03-23 08:30:00,25,9,17,8,1,60
2024-03-23 08:40:00,24,11,12,20,1,68
2024-03-23 08:50:00,27,10,14,20,1,72
2024-03-23 09:00:00,24,14,19,22,2,81
2024-03-23 09:10:00,24,8,19,18,2,71
2024-03-23 09:20:00,34,16,17,20,0,87
2024-03-23 09:30:00,32,17,24,25,2,100
2024-03-23 09:40:00,35,13,30,29,7,114
2024-03-23 09:50:00,40,17,21,26,4,108
2024-03-23 10:00:00,38,16,14,37,3,108
2024-03-23 10:10:00,42,16,18,28,1,105
2024-03-23 10:20:00,30,16,16,26,0,88
2024-03-23 10:30:00,39,16,29,27,0,111
2024-03-23 10:40:00,37,21,24,19,5,106
2024-03-23 10:50:00,33,17,27,28,3,108
2024-03-23 11:00:00,43,15,26,35,1,120
2024-03-23 11:10:00,40,12,30,28,4,114
2024-03-23 11:20:00,45,18,35,31,3,132
2024-03-23 11:30:00,39,20,24,29,5,117
2024-03-23 11:40:00,41,23,20,24,4,112
2024-03-23 11:50:00,42,16,29,32,4,123
2024-03-23 12:00:00,44,17,35,22,3,121
2024-03-23 12:10:00,44,23,41,19,3,130
2024-03-23 12:20:00,40,21,43,20,3,127
2024-03-23 12:30:00,33,25,36,21,3,118
2024-03-23 12:40:00,51,20,22,34,4,131
2024-03-23 12:50:00,44,21,35,20,0,120
2024-03-23 13:00:00,37,36,25,21,3,122
2024-03-23 13:10:00,40,21,32,28,5,126
2024-03-23 13:20:00,36,20,36,22,5,119
2024-03-23 13:30:00,37,17,29,29,2,114
2024-03-23 13:40:00,41,17,23,26,2,109
2024-03-23 13:50:00,39,18,35,34,4,130
2024-03-23 14:00:00,44,19,29,37,3,132
2024-03-23 14:10:00,43,18,21,25,3,110
2024-03-23 14:20:00,44,23,25,30,0,122
2024-03-23 14:30:00,32,23,26,24,3,108
2024-03-23 14:40:00,43,15,22,34,3,117
2024-03-23 14:50:00,38,19,24,28,4,113
2024-03-23 15:00:00,47,19,15,35,5,121
2024-03-23 15:10:00,33,9,27,37,2,108
2024-03-23 15:20:00,33,12,20,34,4,103
2024-03-23 15:30:00,46,18,19,27,3,113
2024-03-23 15:40:00,44,24,18,27,2,115
2024-03-23 15:50:00,38,16,28,24,2,108
2024-03-23 16:00:00,37,24,29,31,4,125
2024-03-23 16:10:00,28,14,21,23,5,91
2024-03-23 16:20:00,38,19,19,28,3,107
2024-03-23 16:30:00,40,14,27,26,2,109
2024-03-23 16:40:00,27,18,28,39,5,117
2024-03-23 16:50:00,42,12,26,45,2,127
2024-03-23 17:00:00,43,19,21,37,7,127
2024-03-23 17:10:00,41,21,23,40,4,129
2024-03-23 17:20:00,39,14,22,35,2,112
2024-03-23 17:30:00,32,14,29,34,6,115
2024-03-23 17:40:00,42,23,22,45,5,137
2024-03-23 17:50:00,49,22,18,38,5,132
2024-03-23 18:00:00,32,18,14,42,2,108
2024-03-23 18:10:00,30,15,24,43,4,116
2024-03-23 18:20:00,41,13,21,41,0,116
2024-03-23 18:30:00,35,17,20,25,1,98
2024-03-23 18:40:00,34,12,14,43,0,103
2024-03-23 18:50:00,33,22,16,32,1,104
2024-03-23 19:00:00,35,22,13,34,3,107
2024-03-23 19:10:00,30,16,33,30,3,112
2024-03-23 19:20:00,39,21,39,25,1,125
2024-03-23 19:30:00,32,22,16,40,5,115
2024-03-23 19:40:00,33,8,16,33,1,91
2024-03-23 19:50:00,31,9,17,41,1,99
2024-03-23 20:00:00,24,4,38,33,1,100
2024-03-23 20:10:00,27,9,25,33,2,96
2024-03-23 20:20:00,26,16,19,22,3,86
2024-03-23 20:30:00,22,19,28,27,4,100
2024-03-23 20:40:00,18,11,15,22,0,66
2024-03-23 20:50:00,21,10,20,18,0,69
2024-03-23 21:00:00,26,18,12,33,2,91
2024-03-23 21:10:00,16,9,16,18,0,59
2024-03-23 21:20:00,15,11,20,13,1,60
2024-03-23 21:30:00,19,7,15,11,0,52
2024-03-23 21:40:00,19,10,15,16,1,61
2024-03-23 21:50:00,21,4,20,13,0,58
2024-03-23 22:00:00,18,5,17,11,0,51
2024-03-23 22:10:00,26,12,13,13,2,66
2024-03-23 22:20:00,19,10,14,17,0,60
2024-03-23 22:30:00,15,4,9,19,1,48
2024-03-23 22:40:00,24,8,8,14,4,58
2024-03-23 22:50:00,34,1,4,23,0,62
2024-03-23 23:00:00,23,3,2,19,0,47
2024-03-23 23:10:00,12,16,11,12,0,51
2024-03-23 23:20:00,24,11,14,20,1,70
2024-03-23 23:30:00,13,11,8,15,1,48
2024-03-23 23:40:00,12,6,11,32,1,62
2024-03-23 23:50:00,17,0,6,16,0,39
2024-03-24 00:00:00,6,1,6,15,0,28
2024-03-24 00:10:00,9,2,6,16,0,33
2024-03-24 00:20:00,14,6,9,8,0,37
2024-03-24 00:30:00,7,0,6,8,0,21
2024-03-24 00:40:00,13,3,5,5,1,27
2024-03-24 00:50:00,7,2,4,8,0,21
2024-03-24 01:00:00,6,6,8,10,1,31
2024-03-24 01:10:00,6,3,3,5,0,17
2024-03-24 01:20:00,8,1,0,2,0,11
2024-03-24 01:30:00,9,3,2,4,1,19
2024-03-24 01:40:00,9,2,6,9,0,26
2024-03-24 01:50:00,6,2,3,9,0,20
2024-03-24 02:00:00,15,1,4,3,0,23
2024-03-24 02:10:00,15,3,5,10,0,33
2024-03-24 02:20:00,5,3,4,4,0,16
2024-03-24 02:30:00,7,1,1,4,0,13
2024-03-24 02:40:00,8,2,4,5,0,19
2024-03-24 02:50:00,3,0,4,4,0,11
2024-03-24 03:00:00,6,0,4,2,0,12
2024-03-24 03:10:00,8,0,0,14,0,22
2024-03-24 03:20:00,6,2,3,2,0,13
2024-03-24 03:30:00,4,4,0,5,0,13
2024-03-24 03:40:00,6,3,2,7,0,18
2024-03-24 03:50:00,1,3,2,5,0,11
2024-03-24 04:00:00,2,2,4,6,0,14
2024-03-24 04:10:00,2,3,4,2,0,11
2024-03-24 04:20:00,5,4,0,3,0,12
2024-03-24 04:30:00,1,1,0,1,0,3
2024-03-24 04:40:00,3,2,0,1,0,6
2024-03-24 04:50:00,8,0,2,8,0,18
2024-03-24 05:00:00,10,0,6,2,0,18
2024-03-24 05:10:00,6,2,4,3,0,15
2024-03-24 05:20:00,8,1,1,7,0,17
2024-03-24 05:30:00,1,2,2,5,1,11
2024-03-24 05:40:00,8,3,6,3,0,20
2024-03-24 05:50:00,7,2,3,5,0,17
2024-03-24 06:00:00,9,4,6,4,0,23
2024-03-24 06:10:00,6,0,2,4,0,12
2024-03-24 06:20:00,4,0,2,2,0,8
2024-03-24 06:30:00,13,0,3,3,0,19
2024-03-24 06:40:00,6,3,0,4,0,13
2024-03-24 06:50:00,8,1,1,5,0,15
2024-03-24 07:00:00,5,3,3,3,0,14
2024-03-24 07:10:00,2,2,1,6,0,11
2024-03-24 07:20:00,7,2,4,3,0,16
2024-03-24 07:30:00,14,5,1,5,0,25
2024-03-24 07:40:00,3,1,5,5,0,14
2024-03-24 07:50:00,6,1,7,3,0,17
2024-03-24 08:00:00,12,4,4,12,0,32
2024-03-24 08:10:00,5,1,3,7,0,16
2024-03-24 08:20:00,5,2,6,5,1,19
2024-03-24 08:30:00,14,10,7,8,1,40
2024-03-24 08:40:00,16,6,6,10,0,38
2024-03-24 08:50:00,18,5,7,7,1,38
2024-03-24 09:00:00,11,4,5,7,2,29
2024-03-24 09:10:00,16,3,12,16,1,48
2024-03-24 09:20:00,20,6,7,10,2,45
2024-03-24 09:30:00,23,13,10,9,0,55
2024-03-24 09:40:00,22,10,12,12,1,57
2024-03-24 09:50:00,26,7,9,17,2,61
2024-03-24 10:00:00,27,12,7,14,1,61
2024-03-24 10:10:00,27,9,11,16,4,67
2024-03-24 10:20:00,20,10,11,15,2,58
2024-03-24 10:30:00,38,12,7,17,1,75
2024-03-24 10:40:00,29,5,13,22,2,71
2024-03-24 10:50:00,31,10,9,14,2,66
2024-03-24 11:00:00,31,7,15,21,2,76
2024-03-24 11:10:00,30,4,13,10,0,57
2024-03-24 11:20:00,30,18,25,26,1,100
2024-03-24 11:30:00,27,25,14,17,2,85
2024-03-24 11:40:00,31,25,22,31,2,111
2024-03-24 11:50:00,21,15,15,24,7,82
2024-03-24 12:00:00,33,25,25,33,0,116
2024-03-24 12:10:00,25,18,17,20,1,81
2024-03-24 12:20:00,31,24,12,17,0,84
2024-03-24 12:30:00,36,17,26,13,2,94
2024-03-24 12:40:00,30,12,17,21,0,80
2024-03-24 12:50:00,28,14,18,30,2,92
2024-03-24 13:00:00,37,16,18,26,1,98
2024-03-24 13:10:00,21,14,17,21,3,76
2024-03-24 13:20:00,29,10,19,24,0,82
2024-03-24 13:30:00,35,16,17,19,2,89
2024-03-24 13:40:00,33,23,26,17,1,100
2024-03-24 13:50:00,27,15,22,23,3,90
2024-03-24 14:00:00,44,16,23,21,3,107
2024-03-24 14:10:00,28,17,19,25,2,91
2024-03-24 14:20:00,34,18,29,28,4,113
2024-03-24 14:30:00,29,11,16,32,6,94
2024-03-24 14:40:00,37,16,30,38,5,126
2024-03-24 14:50:00,40,18,26,31,2,117
2024-03-24 15:00:00,38,9,22,28,3,100
2024-03-24 15:10:00,32,14,16,35,2,99
2024-03-24 15:20:00,43,16,21,29,4,113
2024-03-24 15:30:00,32,16,20,26,2,96
2024-03-24 15:40:00,33,17,24,35,3,112
2024-03-24 15:50:00,40,24,22,29,1,116
2024-03-24 16:00:00,45,23,23,25,2,118
2024-03-24 16:10:00,41,19,17,31,3,111
2024-03-24 16:20:00,42,14,16,28,1,101
2024-03-24 16:30:00,29,17,17,26,1,90
2024-03-24 16:40:00,34,17,20,19,2,92
2024-03-24 16:50:00,36,28,18,27,3,112
2024-03-24 17:00:00,25,15,11,20,1,72
2024-03-24 17:10:00,31,13,23,35,3,105
2024-03-24 17:20:00,26,16,17,19,6,84
2024-03-24 17:30:00,30,17,23,23,2,95
2024-03-24 17:40:00,31,9,20,33,4,97
2024-03-24 17:50:00,37,18,30,42,2,129
2024-03-24 18:00:00,36,15,17,28,0,96
2024-03-24 18:10:00,38,13,15,26,3,95
2024-03-24 18:20:00,40,18,14,24,1,97
2024-03-24 18:30:00,30,13,18,35,3,99
2024-03-24 18:40:00,24,12,17,25,3,81
2024-03-24 18:50:00,25,21,22,24,3,95
2024-03-24 19:00:00,26,11,11,17,2,67
2024-03-24 19:10:00,28,9,20,19,3,79
2024-03-24 19:20:00,25,10,9,13,1,58
2024-03-24 19:30:00,22,11,16,23,3,75
2024-03-24 19:40:00,23,9,16,20,3,71
2024-03-24 19:50:00,20,11,14,16,7,68
2024-03-24 20:00:00,36,10,17,10,0,73
2024-03-24 20:10:00,20,8,10,17,2,57
2024-03-24 20:20:00,31,3,14,13,0,61
2024-03-24 20:30:00,32,8,7,9,0,56
2024-03-24 20:40:00,23,6,24,15,1,69
2024-03-24 20:50:00,22,5,10,15,0,52
2024-03-24 21:00:00,21,12,9,22,1,65
2024-03-24 21:10:00,22,8,16,17,0,63
2024-03-24 21:20:00,27,6,8,27,0,68
2024-03-24 21:30:00,33,7,13,26,0,79
2024-03-24 21:40:00,23,15,11,17,5,71
2024-03-24 21:50:00,19,14,18,16,1,68
2024-03-24 22:00:00,8,2,13,26,2,51
2024-03-24 22:10:00,25,9,9,18,2,63
2024-03-24 22:20:00,10,4,9,18,1,42
2024-03-24 22:30:00,13,7,9,12,0,41
2024-03-24 22:40:00,8,10,11,13,0,42
2024-03-24 22:50:00,17,0,6,15,0,38
2024-03-24 23:00:00,10,2,5,14,1,32
2024-03-24 23:10:00,5,0,12,13,0,30
2024-03-24 23:20:00,9,0,3,6,0,18
2024-03-24 23:30:00,2,1,4,10,1,18
2024-03-24 23:40:00,5,0,7,13,0,25
2024-03-24 23:50:00,7,1,6,13,0,27
2024-03-25 00:00:00,1,2,2,3,0,8
2024-03-25 00:10:00,8,2,0,5,0,15
2024-03-25 00:20:00,4,2,14,8,0,28
2024-03-25 00:30:00,1,1,4,0,0,6
2024-03-25 00:40:00,5,1,8,5,0,19
2024-03-25 00:50:00,3,0,0,6,0,9
2024-03-25 01:00:00,7,1,5,5,0,18
2024-03-25 01:10:00,2,0,0,4,0,6
2024-03-25 01:20:00,2,1,2,2,0,7
2024-03-25 01:30:00,1,4,2,0,0,7
2024-03-25 01:40:00,1,1,2,1,0,5
2024-03-25 01:50:00,4,2,0,1,0,7
2024-03-25 02:00:00,1,2,2,3,0,8
2024-03-25 02:10:00,3,0,0,2,0,5
2024-03-25 02:20:00,4,2,2,0,0,8
2024-03-25 02:30:00,4,0,2,2,0,8
2024-03-25 02:40:00,0,0,2,0,0,2
2024-03-25 02:50:00,4,0,2,2,0,8
2024-03-25 03:00:00,1,1,2,7,0,11
2024-03-25 03:10:00,5,0,1,2,1,9
2024-03-25 03:20:00,1,1,5,3,0,10
2024-03-25 03:30:00,2,1,0,1,0,4
2024-03-25 03:40:00,2,2,2,1,0,7
2024-03-25 03:50:00,0,2,4,2,0,8
2024-03-25 04:00:00,2,2,7,2,0,13
2024-03-25 04:10:00,5,0,4,3,0,12
2024-03-25 04:20:00,8,2,4,1,0,15
2024-03-25 04:30:00,11,3,1,6,0,21
2024-03-25 04:40:00,6,10,7,4,0,27
2024-03-25 04:50:00,6,3,7,3,0,19
2024-03-25 05:00:00,11,6,7,10,0,34
2024-03-25 05:10:00,15,4,7,10,0,36
2024-03-25 05:20:00,22,20,15,16,0,73
2024-03-25 05:30:00,33,28,17,9,0,87
2024-03-25 05:40:00,30,13,31,24,0,98
2024-03-25 05:50:00,32,23,26,14,3,98
2024-03-25 06:00:00,26,8,23,16,0,73
2024-03-25 06:10:00,34,16,16,14,0,80
2024-03-25 06:20:00,45,14,26,20,2,107
2024-03-25 06:30:00,33,21,21,13,1,89
2024-03-25 06:40:00,52,20,28,23,0,123
2024-03-25 06:50:00,56,31,18,21,3,129
2024-03-25 07:00:00,81,25,33,24,2,165
2024-03-25 07:10:00,75,22,23,18,3,141
2024-03-25 07:20:00,53,32,25,19,4,133
2024-03-25 07:30:00,66,26,32,45,2,171
2024-03-25 07:40:00,73,23,30,26,4,156
2024-03-25 07:50:00,44,22,32,29,1,128
2024-03-25 08:00:00,23,24,40,34,4,125
2024-03-25 08:10:00,31,21,37,18,6,113
2024-03-25 08:20:00,45,18,32,25,5,125
2024-03-25 08:30:00,57,20,38,26,1,142
2024-03-25 08:40:00,44,18,35,22,6,125
2024-03-25 08:50:00,41,20,32,36,4,133
2024-03-25 09:00:00,49,21,26,26,3,125
2024-03-25 09:10:00,37,19,34,22,6,118
2024-03-25 09:20:00,39,19,25,23,0,106
2024-03-25 09:30:00,55,18,32,23,4,132
2024-03-25 09:40:00,39,16,17,24,2,98
2024-03-25 09:50:00,46,15,41,25,1,128
2024-03-25 10:00:00,33,18,26,24,2,103
2024-03-25 10:10:00,43,14,35,23,6,121
2024-03-25 10:20:00,35,18,25,23,4,105
2024-03-25 10:30:00,46,15,35,27,4,127
2024-03-25 10:40:00,36,14,38,29,1,118
2024-03-25 10:50:00,46,8,33,22,0,109
2024-03-25 11:00:00,43,21,32,22,2,120
2024-03-25 11:10:00,38,20,30,26,1,115
2024-03-25 11:20:00,44,10,26,29,3,112
2024-03-25 11:30:00,34,16,33,19,3,105
2024-03-25 11:40:00,53,27,29,26,2,137
2024-03-25 11:50:00,39,17,24,24,4,108
2024-03-25 12:00:00,46,21,24,28,2,121
2024-03-25 12:10:00,34,18,39,20,5,116
2024-03-25 12:20:00,26,18,21,34,4,103
2024-03-25 12:30:00,39,21,43,35,3,141
2024-03-25 12:40:00,43,10,25,24,1,103
2024-03-25 12:50:00,35,13,34,37,3,122
2024-03-25 13:00:00,37,12,31,31,3,114
2024-03-25 13:10:00,48,14,29,28,2,121
2024-03-25 13:20:00,46,15,34,39,1,135
2024-03-25 13:30:00,48,13,37,30,5,133
2024-03-25 13:40:00,47,18,27,25,4,121
2024-03-25 13:50:00,41,16,26,31,1,115
2024-03-25 14:00:00,47,25,30,28,2,132
2024-03-25 14:10:00,46,13,38,36,3,136
2024-03-25 14:20:00,52,21,43,32,2,150
2024-03-25 14:30:00,48,14,37,36,4,139
2024-03-25 14:40:00,50,21,28,40,3,142
2024-03-25 14:50:00,41,20,48,34,5,148
2024-03-25 15:00:00,33,15,32,30,5,115
2024-03-25 15:10:00,41,17,32,25,5,120
2024-03-25 15:20:00,45,18,44,29,4,140
2024-03-25 15:30:00,49,16,25,35,5,130
2024-03-25 15:40:00,54,22,46,28,6,156
2024-03-25 15:50:00,44,25,59,35,6,169
2024-03-25 16:00:00,45,22,53,38,10,168
2024-03-25 16:10:00,75,31,44,36,1,187
2024-03-25 16:20:00,35,36,37,28,10,146
2024-03-25 16:30:00,48,17,38,25,6,134
2024-03-25 16:40:00,56,23,44,29,10,162
2024-03-25 16:50:00,46,21,54,37,4,162
2024-03-25 17:00:00,49,29,43,24,3,148
2024-03-25 17:10:00,50,25,42,24,6,147
2024-03-25 17:20:00,51,21,53,24,4,153
2024-03-25 17:30:00,41,27,44,26,5,143
2024-03-25 17:40:00,39,15,58,46,7,165
2024-03-25 17:50:00,39,20,80,44,4,187
2024-03-25 18:00:00,42,21,37,26,3,129
2024-03-25 18:10:00,38,23,34,30,5,130
2024-03-25 18:20:00,53,15,40,40,1,149
2024-03-25 18:30:00,40,22,36,27,3,128
2024-03-25 18:40:00,35,19,37,20,7,118
2024-03-25 18:50:00,27,13,31,20,3,94
2024-03-25 19:00:00,30,18,31,19,5,103
2024-03-25 19:10:00,42,17,30,31,4,124
2024-03-25 19:20:00,32,15,39,27,3,116
2024-03-25 19:30:00,36,19,45,24,3,127
2024-03-25 19:40:00,20,11,33,27,2,93
2024-03-25 19:50:00,36,12,45,37,2,132
2024-03-25 20:00:00,23,25,30,22,1,101
2024-03-25 20:10:00,30,28,32,23,2,115
2024-03-25 20:20:00,15,8,33,16,2,74
2024-03-25 20:30:00,28,9,33,16,2,88
2024-03-25 20:40:00,22,13,27,31,1,94
2024-03-25 20:50:00,13,18,21,18,2,72
2024-03-25 21:00:00,26,14,22,17,1,80
2024-03-25 21:10:00,29,17,31,31,0,108
2024-03-25 21:20:00,20,13,26,19,1,79
2024-03-25 21:30:00,27,17,31,20,1,96
2024-03-25 21:40:00,21,6,19,24,1,71
2024-03-25 21:50:00,15,5,26,10,2,58
2024-03-25 22:00:00,16,7,35,20,0,78
2024-03-25 22:10:00,21,5,53,21,0,100
2024-03-25 22:20:00,17,5,26,24,0,72
2024-03-25 22:30:00,11,6,24,13,0,54
2024-03-25 22:40:00,15,8,24,14,0,61
2024-03-25 22:50:00,7,3,18,16,1,45
2024-03-25 23:00:00,12,1,4,4,0,21
2024-03-25 23:10:00,4,6,10,6,1,27
2024-03-25 23:20:00,5,2,13,2,0,22
2024-03-25 23:30:00,8,6,14,6,1,35
2024-03-25 23:40:00,2,2,8,10,0,22
2024-03-25 23:50:00,11,4,5,3,0,23
2024-03-26 00:00:00,5,0,17,7,0,29
2024-03-26 00:10:00,6,2,7,1,0,16
2024-03-26 00:20:00,6,2,4,0,0,12
2024-03-26 00:30:00,1,3,4,5,0,13
2024-03-26 00:40:00,6,3,4,4,0,17
2024-03-26 00:50:00,7,2,5,4,0,18
2024-03-26 01:00:00,6,2,2,1,0,11
2024-03-26 01:10:00,2,1,2,0,0,5
2024-03-26 01:20:00,1,3,0,0,0,4
2024-03-26 01:30:00,4,3,1,0,0,8
2024-03-26 01:40:00,3,1,2,3,0,9
2024-03-26 01:50:00,3,3,2,0,0,8
2024-03-26 02:00:00,0,1,1,0,0,2
2024-03-26 02:10:00,6,0,1,0,0,7
2024-03-26 02:20:00,1,1,3,0,0,5
2024-03-26 02:30:00,4,2,3,0,1,10
2024-03-26 02:40:00,2,0,1,0,0,3
2024-03-26 02:50:00,2,0,2,2,0,6
2024-03-26 03:00:00,1,0,3,4,0,8
2024-03-26 03:10:00,2,1,2,2,0,7
2024-03-26 03:20:00,0,0,2,0,1,3
2024-03-26 03:30:00,4,3,5,2,0,14
2024-03-26 03:40:00,2,3,3,2,0,10
2024-03-26 03:50:00,6,0,4,0,0,10
2024-03-26 04:00:00,6,0,7,2,0,15
2024-03-26 04:10:00,2,0,8,1,0,11
2024-03-26 04:20:00,3,5,5,0,0,13
2024-03-26 04:30:00,7,3,3,1,0,14
2024-03-26 04:40:00,8,4,4,1,0,17
2024-03-26 04:50:00,7,3,2,3,0,15
2024-03-26 05:00:00,8,12,8,2,0,30
2024-03-26 05:10:00,12,5,12,2,0,31
2024-03-26 05:20:00,21,17,20,4,0,62
2024-03-26 05:30:00,23,27,30,4,0,84
2024-03-26 05:40:00,28,18,29,23,0,98
2024-03-26 05:50:00,29,14,22,12,0,77
2024-03-26 06:00:00,26,10,21,6,1,64
2024-03-26 06:10:00,35,13,19,10,0,77
2024-03-26 06:20:00,35,13,25,14,1,88
2024-03-26 06:30:00,41,20,27,16,1,105
2024-03-26 06:40:00,53,22,29,13,3,120
2024-03-26 06:50:00,39,15,31,15,3,103
2024-03-26 07:00:00,33,28,30,13,6,110
2024-03-26 07:10:00,37,21,30,14,4,106
2024-03-26 07:20:00,44,24,28,18,2,116
2024-03-26 07:30:00,48,27,47,21,2,145
2024-03-26 07:40:00,61,25,59,25,5,175
2024-03-26 07:50:00,39,23,40,21,2,125
2024-03-26 08:00:00,41,19,43,20,1,124
2024-03-26 08:10:00,66,29,31,21,4,151
2024-03-26 08:20:00,53,26,25,25,5,134
2024-03-26 08:30:00,64,25,37,26,5,157
2024-03-26 08:40:00,43,29,34,26,3,135
2024-03-26 08:50:00,38,16,34,23,2,113
2024-03-26 09:00:00,28,18,34,23,3,106
2024-03-26 09:10:00,51,20,31,18,2,122
2024-03-26 09:20:00,45,17,27,19,1,109
2024-03-26 09:30:00,40,14,27,15,4,100
2024-03-26 09:40:00,41,13,42,21,2,119
2024-03-26 09:50:00,45,11,27,21,0,104
2024-03-26 10:00:00,48,11,23,15,4,101
2024-03-26 10:10:00,45,16,24,11,1,97
2024-03-26 10:20:00,39,12,41,19,2,113
2024-03-26 10:30:00,40,15,26,19,2,102
2024-03-26 10:40:00,42,15,26,16,3,102
2024-03-26 10:50:00,38,16,30,14,3,101
2024-03-26 11:00:00,40,21,36,17,2,116
2024-03-26 11:10:00,33,17,26,17,4,97
2024-03-26 11:20:00,44,18,34,20,2,118
2024-03-26 11:30:00,51,17,31,24,1,124
2024-03-26 11:40:00,38,15,30,28,3,114
2024-03-26 11:50:00,36,15,41,22,2,116
2024-03-26 12:00:00,32,16,32,32,2,114
2024-03-26 12:10:00,40,15,32,21,4,112
2024-03-26 12:20:00,40,15,47,19,0,121
2024-03-26 12:30:00,36,14,38,30,2,120
2024-03-26 12:40:00,37,17,42,17,2,115
2024-03-26 12:50:00,54,19,34,25,2,134
2024-03-26 13:00:00,50,17,36,17,2,122
2024-03-26 13:10:00,55,14,46,18,3,136
2024-03-26 13:20:00,47,19,38,16,3,123
2024-03-26 13:30:00,35,15,40,27,5,122
2024-03-26 13:40:00,40,19,43,25,2,129
2024-03-26 13:50:00,30,20,39,18,4,111
2024-03-26 14:00:00,41,15,34,25,4,119
2024-03-26 14:10:00,39,26,44,28,4,141
2024-03-26 14:20:00,46,18,35,19,5,123
2024-03-26 14:30:00,46,28,44,29,6,153
2024-03-26 14:40:00,51,23,42,40,2,158
2024-03-26 14:50:00,38,23,41,41,3,146
2024-03-26 15:00:00,38,19,41,23,2,123
2024-03-26 15:10:00,42,17,28,36,8,131
2024-03-26 15:20:00,47,30,40,29,6,152
2024-03-26 15:30:00,46,23,40,37,4,150
2024-03-26 15:40:00,52,30,39,30,5,156
2024-03-26 15:50:00,40,28,39,34,9,150
2024-03-26 16:00:00,52,24,36,37,4,153
2024-03-26 16:10:00,62,19,46,25,5,157
2024-03-26 16:20:00,45,28,34,33,7,147
2024-03-26 16:30:00,48,18,34,32,4,136
2024-03-26 16:40:00,40,19,40,36,7,142
2024-03-26 16:50:00,52,34,37,36,6,165
2024-03-26 17:00:00,36,19,45,18,5,123
2024-03-26 17:10:00,39,28,37,33,5,142
2024-03-26 17:20:00,66,15,60,31,1,173
2024-03-26 17:30:00,41,14,40,27,8,130
2024-03-26 17:40:00,47,25,44,38,3,157
2024-03-26 17:50:00,49,20,49,35,2,155
2024-03-26 18:00:00,51,23,37,34,6,151
2024-03-26 18:10:00,42,17,38,30,5,132
2024-03-26 18:20:00,49,24,39,33,2,147
2024-03-26 18:30:00,39,24,32,31,3,129
2024-03-26 18:40:00,29,21,33,27,8,118
2024-03-26 18:50:00,37,15,29,34,3,118
2024-03-26 19:00:00,30,15,25,17,5,92
2024-03-26 19:10:00,33,13,48,40,2,136
2024-03-26 19:20:00,25,14,45,35,6,125
2024-03-26 19:30:00,39,28,32,27,2,128
2024-03-26 19:40:00,33,13,31,33,0,110
2024-03-26 19:50:00,28,14,28,31,2,103
2024-03-26 20:00:00,34,16,23,30,0,103
2024-03-26 20:10:00,42,27,26,27,2,124
2024-03-26 20:20:00,30,17,36,29,2,114
2024-03-26 20:30:00,27,12,27,20,1,87
2024-03-26 20:40:00,27,23,25,22,6,103
2024-03-26 20:50:00,19,8,27,15,1,70
2024-03-26 21:00:00,19,5,21,20,1,66
2024-03-26 21:10:00,23,11,21,17,0,72
2024-03-26 21:20:00,30,17,25,17,1,90
2024-03-26 21:30:00,25,14,37,16,1,93
2024-03-26 21:40:00,17,6,24,10,0,57
2024-03-26 21:50:00,19,18,28,10,0,75
2024-03-26 22:00:00,17,4,29,21,1,72
2024-03-26 22:10:00,23,9,39,16,2,89
2024-03-26 22:20:00,17,7,23,17,0,64
2024-03-26 22:30:00,22,8,14,15,0,59
2024-03-26 22:40:00,16,5,20,15,1,57
2024-03-26 22:50:00,13,7,7,13,0,40
2024-03-26 23:00:00,9,9,11,12,0,41
2024-03-26 23:10:00,9,1,15,7,0,32
2024-03-26 23:20:00,10,6,15,6,0,37
2024-03-26 23:30:00,15,5,18,17,0,55
2024-03-26 23:40:00,7,10,9,15,0,41
2024-03-26 23:50:00,4,0,7,3,0,14
2024-03-27 00:00:00,9,0,13,6,0,28
2024-03-27 00:10:00,4,3,11,8,0,26
2024-03-27 00:20:00,5,0,8,8,0,21
2024-03-27 00:30:00,5,2,4,5,0,16
2024-03-27 00:40:00,1,1,7,4,0,13
2024-03-27 00:50:00,2,3,4,9,0,18
2024-03-27 01:00:00,7,0,6,4,0,17
2024-03-27 01:10:00,4,2,3,4,0,13
2024-03-27 01:20:00,5,0,2,2,0,9
2024-03-27 01:30:00,2,3,2,0,0,7
2024-03-27 01:40:00,1,0,4,4,0,9
2024-03-27 01:50:00,2,2,1,2,0,7
2024-03-27 02:00:00,0,0,2,2,0,4
2024-03-27 02:10:00,2,4,1,0,0,7
2024-03-27 02:20:00,3,2,0,3,0,8
2024-03-27 02:30:00,1,0,4,0,0,5
2024-03-27 02:40:00,3,1,1,1,0,6
2024-03-27 02:50:00,3,0,3,2,0,8
2024-03-27 03:00:00,4,0,2,5,0,11
2024-03-27 03:10:00,2,3,1,1,1,8
2024-03-27 03:20:00,1,1,3,2,0,7
2024-03-27 03:30:00,5,2,0,0,0,7
2024-03-27 03:40:00,1,0,2,1,0,4
2024-03-27 03:50:00,2,2,4,3,0,11
2024-03-27 04:00:00,6,1,0,0,0,7
2024-03-27 04:10:00,4,0,2,2,0,8
2024-03-27 04:20:00,3,3,6,2,0,14
2024-03-27 04:30:00,8,0,4,2,0,14
2024-03-27 04:40:00,4,5,7,3,0,19
2024-03-27 04:50:00,10,10,4,2,0,26
2024-03-27 05:00:00,10,7,11,4,0,32
2024-03-27 05:10:00,14,17,10,8,0,49
2024-03-27 05:20:00,27,15,15,5,0,62
2024-03-27 05:30:00,74,27,29,7,0,137
2024-03-27 05:40:00,25,17,39,15,0,96
2024-03-27 05:50:00,37,22,23,12,0,94
2024-03-27 06:00:00,27,13,37,12,1,90
2024-03-27 06:10:00,33,16,21,17,0,87
2024-03-27 06:20:00,34,19,22,15,2,92
2024-03-27 06:30:00,36,14,26,12,0,88
2024-03-27 06:40:00,53,19,30,17,3,122
2024-03-27 06:50:00,40,16,34,26,2,118
2024-03-27 07:00:00,51,18,34,18,1,122
2024-03-27 07:10:00,41,17,43,17,3,121
2024-03-27 07:20:00,55,25,32,21,6,139
2024-03-27 07:30:00,51,25,39,17,2,134
2024-03-27 07:40:00,51,18,39,24,3,135
2024-03-27 07:50:00,37,24,38,27,5,131
2024-03-27 08:00:00,48,34,37,26,4,149
2024-03-27 08:10:00,45,27,30,25,4,131
2024-03-27 08:20:00,57,20,37,19,6,139
2024-03-27 08:30:00,41,34,36,22,5,138
2024-03-27 08:40:00,56,28,47,30,4,165
2024-03-27 08:50:00,49,21,37,16,4,127
2024-03-27 09:00:00,31,17,33,11,5,97
2024-03-27 09:10:00,53,18,33,14,2,120
2024-03-27 09:20:00,37,14,25,26,2,104
2024-03-27 09:30:00,41,22,36,21,5,125
2024-03-27 09:40:00,41,17,36,22,3,119
2024-03-27 09:50:00,43,20,29,24,3,119
2024-03-27 10:00:00,44,15,31,18,5,113
2024-03-27 10:10:00,32,14,33,26,4,109
2024-03-27 10:20:00,44,24,38,19,2,127
2024-03-27 10:30:00,41,17,33,18,4,113
2024-03-27 10:40:00,36,15,35,24,5,115
2024-03-27 10:50:00,46,17,31,23,3,120
2024-03-27 11:00:00,48,16,43,30,1,138
2024-03-27 11:10:00,42,14,28,29,2,115
2024-03-27 11:20:00,38,14,30,20,2,104
2024-03-27 11:30:00,45,14,29,17,5,110
2024-03-27 11:40:00,42,14,42,25,2,125
2024-03-27 11:50:00,44,23,29,22,4,122
2024-03-27 12:00:00,40,17,38,23,2,120
2024-03-27 12:10:00,36,22,35,25,6,124
2024-03-27 12:20:00,46,18,45,23,7,139
2024-03-27 12:30:00,46,25,37,19,4,131
2024-03-27 12:40:00,37,18,31,21,6,113
2024-03-27 12:50:00,29,19,33,23,0,104
2024-03-27 13:00:00,37,14,29,16,6,102
2024-03-27 13:10:00,47,25,33,18,6,129
2024-03-27 13:20:00,47,23,33,19,2,124
2024-03-27 13:30:00,57,21,33,25,1,137
2024-03-27 13:40:00,47,23,39,27,2,138
2024-03-27 13:50:00,48,17,35,26,4,130
2024-03-27 14:00:00,33,16,51,22,3,125
2024-03-27 14:10:00,47,22,44,35,5,153
2024-03-27 14:20:00,45,26,35,37,3,146
2024-03-27 14:30:00,35,28,33,40,5,141
2024-03-27 14:40:00,46,23,41,22,5,137
2024-03-27 14:50:00,37,25,33,24,5,124
2024-03-27 15:00:00,65,23,51,22,2,163
2024-03-27 15:10:00,46,14,38,31,5,134
2024-03-27 15:20:00,49,20,44,27,2,142
2024-03-27 15:30:00,55,35,49,25,3,167
2024-03-27 15:40:00,43,23,47,31,4,148
2024-03-27 15:50:00,35,28,33,29,8,133
2024-03-27 16:00:00,43,12,40,46,8,149
2024-03-27 16:10:00,61,37,44,34,3,179
2024-03-27 16:20:00,54,28,36,41,4,163
2024-03-27 16:30:00,45,22,48,37,2,154
2024-03-27 16:40:00,48,16,57,37,7,165
2024-03-27 16:50:00,41,19,43,36,2,141
2024-03-27 17:00:00,38,25,37,37,7,144
2024-03-27 17:10:00,36,23,39,29,3,130
2024-03-27 17:20:00,37,19,43,24,5,128
2024-03-27 17:30:00,35,26,38,28,3,130
2024-03-27 17:40:00,37,16,38,28,1,120
2024-03-27 17:50:00,30,26,26,29,4,115
2024-03-27 18:00:00,40,20,40,25,2,127
2024-03-27 18:10:00,34,22,35,25,2,118
2024-03-27 18:20:00,40,21,33,24,2,120
2024-03-27 18:30:00,23,16,42,27,4,112
2024-03-27 18:40:00,26,15,33,21,4,99
2024-03-27 18:50:00,34,43,35,29,2,143
2024-03-27 19:00:00,17,23,28,17,2,87
2024-03-27 19:10:00,28,12,31,21,2,94
2024-03-27 19:20:00,21,14,34,21,5,95
2024-03-27 19:30:00,31,16,28,12,3,90
2024-03-27 19:40:00,30,17,21,23,1,92
2024-03-27 19:50:00,25,18,30,24,3,100
2024-03-27 20:00:00,25,13,27,14,0,79
2024-03-27 20:10:00,29,10,32,20,1,92
2024-03-27 20:20:00,24,12,19,16,5,76
2024-03-27 20:30:00,24,8,17,16,1,66
2024-03-27 20:40:00,21,9,29,15,4,78
2024-03-27 20:50:00,22,12,19,16,3,72
2024-03-27 21:00:00,21,7,15,20,1,64
2024-03-27 21:10:00,28,9,7,17,1,62
2024-03-27 21:20:00,34,10,13,15,0,72
2024-03-27 21:30:00,29,11,13,14,2,69
2024-03-27 21:40:00,26,11,12,16,2,67
2024-03-27 21:50:00,11,10,22,15,1,59
2024-03-27 22:00:00,14,5,15,15,2,51
2024-03-27 22:10:00,16,6,17,15,2,56
2024-03-27 22:20:00,30,8,17,18,1,74
2024-03-27 22:30:00,25,6,24,18,1,74
2024-03-27 22:40:00,22,5,12,10,0,49
2024-03-27 22:50:00,15,6,8,9,0,38
2024-03-27 23:00:00,24,3,7,8,0,42
2024-03-27 23:10:00,19,6,10,6,1,42
2024-03-27 23:20:00,13,2,10,5,0,30
2024-03-27 23:30:00,11,8,4,4,0,27
2024-03-27 23:40:00,10,2,7,4,0,23
2024-03-27 23:50:00,8,2,11,5,1,27
2024-03-28 00:00:00,14,1,13,4,1,33
2024-03-28 00:10:00,12,0,8,2,0,22
2024-03-28 00:20:00,10,4,5,2,0,21
2024-03-28 00:30:00,11,0,3,7,0,21
2024-03-28 00:40:00,8,2,10,3,0,23
2024-03-28 00:50:00,2,0,4,6,0,12
2024-03-28 01:00:00,5,3,2,5,0,15
2024-03-28 01:10:00,3,2,3,9,0,17
2024-03-28 01:20:00,4,2,3,4,0,13
2024-03-28 01:30:00,6,2,3,5,0,16
2024-03-28 01:40:00,4,0,0,2,0,6
2024-03-28 01:50:00,2,5,1,4,0,12
2024-03-28 02:00:00,4,2,2,1,0,9
2024-03-28 02:10:00,1,0,0,0,1,2
2024-03-28 02:20:00,4,1,2,1,0,8
2024-03-28 02:30:00,0,2,2,0,0,4
2024-03-28 02:40:00,1,0,2,0,0,3
2024-03-28 02:50:00,5,0,1,1,0,7
2024-03-28 03:00:00,2,0,0,0,0,2
2024-03-28 03:10:00,0,1,2,0,0,3
2024-03-28 03:20:00,3,0,5,4,0,12
2024-03-28 03:30:00,2,0,0,1,0,3
2024-03-28 03:40:00,6,4,2,1,0,13
2024-03-28 03:50:00,3,0,7,0,0,10
2024-03-28 04:00:00,3,0,4,6,0,13
2024-03-28 04:10:00,3,2,4,0,0,9
2024-03-28 04:20:00,3,2,10,2,0,17
2024-03-28 04:30:00,6,2,8,5,0,21
2024-03-28 04:40:00,20,5,9,4,0,38
2024-03-28 04:50:00,6,4,7,4,0,21
2024-03-28 05:00:00,11,8,14,5,0,38
2024-03-28 05:10:00,15,5,15,5,0,40
2024-03-28 05:20:00,18,12,10,7,0,47
2024-03-28 05:30:00,36,23,33,3,0,95
2024-03-28 05:40:00,23,20,26,15,2,86
2024-03-28 05:50:00,30,12,28,8,1,79
2024-03-28 06:00:00,29,14,19,9,0,71
2024-03-28 06:10:00,24,11,27,16,0,78
2024-03-28 06:20:00,34,16,20,15,1,86
2024-03-28 06:30:00,33,9,29,12,1,84
2024-03-28 06:40:00,54,19,26,19,0,118
2024-03-28 06:50:00,42,9,32,17,2,102
2024-03-28 07:00:00,50,28,23,17,1,119
2024-03-28 07:10:00,53,21,23,13,4,114
2024-03-28 07:20:00,42,23,24,21,3,113
2024-03-28 07:30:00,49,19,29,19,1,117
2024-03-28 07:40:00,52,21,49,26,5,153
2024-03-28 07:50:00,44,25,39,28,2,138
2024-03-28 08:00:00,34,22,32,27,6,121
2024-03-28 08:10:00,45,23,29,25,6,128
2024-03-28 08:20:00,53,23,39,20,3,138
2024-03-28 08:30:00,41,23,30,24,3,121
2024-03-28 08:40:00,49,27,36,19,3,134
2024-03-28 08:50:00,41,32,31,23,4,131
2024-03-28 09:00:00,33,12,42,11,5,103
2024-03-28 09:10:00,43,20,31,15,5,114
2024-03-28 09:20:00,31,21,33,19,2,106
2024-03-28 09:30:00,50,17,32,21,6,126
2024-03-28 09:40:00,40,22,33,15,6,116
2024-03-28 09:50:00,43,13,34,27,4,121
2024-03-28 10:00:00,44,20,31,15,3,113
2024-03-28 10:10:00,41,12,37,17,2,109
2024-03-28 10:20:00,43,21,30,17,5,116
2024-03-28 10:30:00,36,17,32,17,4,106
2024-03-28 10:40:00,53,19,32,17,1,122
2024-03-28 10:50:00,52,12,44,20,0,128
2024-03-28 11:00:00,49,16,40,23,0,128
2024-03-28 11:10:00,42,12,52,31,2,139
2024-03-28 11:20:00,57,21,26,28,4,136
2024-03-28 11:30:00,42,27,41,28,1,139
2024-03-28 11:40:00,41,18,32,25,5,121
2024-03-28 11:50:00,29,16,35,37,4,121
2024-03-28 12:00:00,53,14,47,38,1,153
2024-03-28 12:10:00,34,19,35,39,6,133
2024-03-28 12:20:00,41,24,38,24,3,130
2024-03-28 12:30:00,38,20,31,28,4,121
2024-03-28 12:40:00,46,33,32,10,3,124
2024-03-28 12:50:00,51,28,48,26,6,159
2024-03-28 13:00:00,46,14,30,28,5,123
2024-03-28 13:10:00,48,20,45,34,5,152
2024-03-28 13:20:00,42,22,42,25,6,137
2024-03-28 13:30:00,58,26,39,37,3,163
2024-03-28 13:40:00,51,29,56,25,4,165
2024-03-28 13:50:00,34,14,40,26,1,115
2024-03-28 14:00:00,61,23,41,25,3,153
2024-03-28 14:10:00,52,23,38,24,7,144
2024-03-28 14:20:00,53,18,40,51,3,165
2024-03-28 14:30:00,63,29,41,32,3,168
2024-03-28 14:40:00,37,20,45,26,4,132
2024-03-28 14:50:00,52,24,40,26,4,146
2024-03-28 15:00:00,41,19,50,27,6,143
2024-03-28 15:10:00,50,24,48,35,7,164
2024-03-28 15:20:00,57,20,37,35,5,154
2024-03-28 15:30:00,39,20,39,32,9,139
2024-03-28 15:40:00,45,26,31,33,4,139
2024-03-28 15:50:00,45,19,50,32,3,149
2024-03-28 16:00:00,50,19,48,37,2,156
2024-03-28 16:10:00,51,19,44,39,3,156
2024-03-28 16:20:00,40,25,39,35,5,144
2024-03-28 16:30:00,51,25,49,43,5,173
2024-03-28 16:40:00,51,23,35,34,5,148
2024-03-28 16:50:00,64,21,39,37,5,166
2024-03-28 17:00:00,41,24,37,41,4,147
2024-03-28 17:10:00,37,21,40,46,4,148
2024-03-28 17:20:00,51,29,20,17,7,124
2024-03-28 17:30:00,50,28,42,37,4,161
2024-03-28 17:40:00,52,27,58,49,2,188
2024-03-28 17:50:00,27,23,41,38,6,135
2024-03-28 18:00:00,53,20,34,40,2,149
2024-03-28 18:10:00,36,23,32,36,5,132
2024-03-28 18:20:00,57,17,49,48,3,174
2024-03-28 18:30:00,39,18,52,29,3,141
2024-03-28 18:40:00,41,33,36,31,4,145
2024-03-28 18:50:00,43,19,49,37,1,149
2024-03-28 19:00:00,43,24,27,25,2,121
2024-03-28 19:10:00,29,22,35,30,7,123
2024-03-28 19:20:00,42,24,68,27,4,165
2024-03-28 19:30:00,45,21,64,33,3,166
2024-03-28 19:40:00,37,16,62,24,3,142
2024-03-28 19:50:00,34,20,53,26,3,136
2024-03-28 20:00:00,42,27,57,30,1,157
2024-03-28 20:10:00,43,16,47,23,4,133
2024-03-28 20:20:00,33,22,60,24,1,140
2024-03-28 20:30:00,31,22,21,39,3,116
2024-03-28 20:40:00,48,17,27,34,5,131
2024-03-28 20:50:00,31,14,25,36,3,109
2024-03-28 21:00:00,26,15,24,31,2,98
2024-03-28 21:10:00,25,9,27,19,0,80
2024-03-28 21:20:00,30,13,19,28,1,91
2024-03-28 21:30:00,19,11,36,19,1,86
2024-03-28 21:40:00,37,15,25,27,3,107
2024-03-28 21:50:00,27,11,19,24,1,82
2024-03-28 22:00:00,16,18,15,23,2,74
2024-03-28 22:10:00,32,4,25,22,0,83
2024-03-28 22:20:00,23,14,22,20,0,79
2024-03-28 22:30:00,33,5,9,26,1,74
2024-03-28 22:40:00,14,5,12,23,0,54
2024-03-28 22:50:00,20,10,8,11,0,49
2024-03-28 23:00:00,26,9,8,23,1,67
2024-03-28 23:10:00,16,2,14,24,0,56
2024-03-28 23:20:00,7,2,12,14,0,35
2024-03-28 23:30:00,20,11,9,19,0,59
2024-03-28 23:40:00,22,6,9,9,0,46
2024-03-28 23:50:00,16,7,7,10,0,40
2024-03-29 00:00:00,15,7,13,7,0,42
2024-03-29 00:10:00,10,4,9,13,0,36
2024-03-29 00:20:00,12,2,4,7,0,25
2024-03-29 00:30:00,4,4,8,21,0,37
2024-03-29 00:40:00,12,3,7,9,0,31
2024-03-29 00:50:00,11,2,8,13,1,35
2024-03-29 01:00:00,7,2,10,13,0,32
2024-03-29 01:10:00,18,2,5,7,0,32
2024-03-29 01:20:00,11,1,2,9,0,23
2024-03-29 01:30:00,11,0,7,15,0,33
2024-03-29 01:40:00,11,1,2,1,1,16
2024-03-29 01:50:00,15,5,2,1,0,23
2024-03-29 02:00:00,4,0,2,4,0,10
2024-03-29 02:10:00,10,0,2,4,0,16
2024-03-29 02:20:00,8,2,0,3,0,13
2024-03-29 02:30:00,8,0,0,17,0,25
2024-03-29 02:40:00,6,0,0,4,0,10
2024-03-29 02:50:00,2,3,4,6,0,15
2024-03-29 03:00:00,6,1,1,0,0,8
2024-03-29 03:10:00,2,2,0,1,0,5
2024-03-29 03:20:00,5,2,2,8,0,17
2024-03-29 03:30:00,3,0,4,8,0,15
2024-03-29 03:40:00,2,1,1,1,0,5
2024-03-29 03:50:00,7,3,0,2,0,12
2024-03-29 04:00:00,7,0,0,2,0,9
2024-03-29 04:10:00,7,1,2,3,0,13
2024-03-29 04:20:00,4,0,0,1,0,5
2024-03-29 04:30:00,3,0,0,1,0,4
2024-03-29 04:40:00,3,0,1,1,0,5
2024-03-29 04:50:00,7,0,2,2,0,11
2024-03-29 05:00:00,4,2,1,4,0,11
2024-03-29 05:10:00,14,5,1,2,0,22
2024-03-29 05:20:00,9,4,2,2,0,17
2024-03-29 05:30:00,10,1,3,6,0,20
2024-03-29 05:40:00,6,4,2,7,0,19
2024-03-29 05:50:00,8,2,0,5,0,15
2024-03-29 06:00:00,10,4,2,5,1,22
2024-03-29 06:10:00,10,7,13,15,0,45
2024-03-29 06:20:00,4,1,5,3,0,13
2024-03-29 06:30:00,8,6,2,7,1,24
2024-03-29 06:40:00,7,2,4,6,0,19
2024-03-29 06:50:00,11,2,2,7,0,22
2024-03-29 07:00:00,9,6,1,7,2,25
2024-03-29 07:10:00,4,3,2,1,1,11
2024-03-29 07:20:00,8,4,2,2,2,18
2024-03-29 07:30:00,12,8,0,7,1,28
2024-03-29 07:40:00,8,3,5,4,2,22
2024-03-29 07:50:00,4,3,4,5,0,16
2024-03-29 08:00:00,12,4,2,5,0,23
2024-03-29 08:10:00,8,3,6,7,0,24
2024-03-29 08:20:00,6,6,5,9,0,26
2024-03-29 08:30:00,13,4,6,5,0,28
2024-03-29 08:40:00,8,6,5,9,1,29
2024-03-29 08:50:00,13,5,5,12,0,35
2024-03-29 09:00:00,19,8,13,18,2,60
2024-03-29 09:10:00,20,6,11,7,1,45
2024-03-29 09:20:00,15,4,13,7,0,39
2024-03-29 09:30:00,23,8,9,12,2,54
2024-03-29 09:40:00,20,10,11,13,2,56
2024-03-29 09:50:00,25,4,6,13,1,49
2024-03-29 10:00:00,15,5,11,11,2,44
2024-03-29 10:10:00,20,6,11,17,2,56
2024-03-29 10:20:00,18,7,14,19,0,58
2024-03-29 10:30:00,20,11,11,19,2,63
2024-03-29 10:40:00,25,8,15,13,1,62
2024-03-29 10:50:00,26,8,8,18,0,60
2024-03-29 11:00:00,25,9,18,20,1,73
2024-03-29 11:10:00,21,13,9,14,2,59
2024-03-29 11:20:00,24,5,8,14,0,51
2024-03-29 11:30:00,22,7,13,20,0,62
2024-03-29 11:40:00,22,9,11,11,1,54
2024-03-29 11:50:00,30,9,20,22,0,81
2024-03-29 12:00:00,25,5,10,15,2,57
2024-03-29 12:10:00,27,10,18,23,3,81
2024-03-29 12:20:00,30,8,17,17,3,75
2024-03-29 12:30:00,33,6,5,18,0,62
2024-03-29 12:40:00,36,13,17,22,3,91
2024-03-29 12:50:00,21,13,12,20,4,70
2024-03-29 13:00:00,28,8,14,15,1,66
2024-03-29 13:10:00,27,11,7,27,2,74
2024-03-29 13:20:00,20,12,17,28,2,79
2024-03-29 13:30:00,34,13,19,23,0,89
2024-03-29 13:40:00,28,8,18,20,1,75
2024-03-29 13:50:00,27,9,20,20,4,80
2024-03-29 14:00:00,23,15,17,22,0,77
2024-03-29 14:10:00,23,15,21,36,2,97
2024-03-29 14:20:00,30,10,23,21,2,86
2024-03-29 14:30:00,21,10,19,32,4,86
2024-03-29 14:40:00,23,17,15,24,6,85
2024-03-29 14:50:00,19,13,19,29,3,83
2024-03-29 15:00:00,17,15,17,22,1,72
2024-03-29 15:10:00,30,14,17,16,1,78
2024-03-29 15:20:00,24,12,11,29,3,79
2024-03-29 15:30:00,25,14,7,20,0,66
2024-03-29 15:40:00,28,3,15,15,2,63
2024-03-29 15:50:00,29,7,14,24,2,76
2024-03-29 16:00:00,21,7,12,19,1,60
2024-03-29 16:10:00,36,17,18,16,4,91
2024-03-29 16:20:00,29,10,12,24,2,77
2024-03-29 16:30:00,25,10,15,21,4,75
2024-03-29 16:40:00,32,9,15,14,2,72
2024-03-29 16:50:00,28,15,20,29,2,94
2024-03-29 17:00:00,27,7,8,18,3,63
2024-03-29 17:10:00,26,12,18,26,3,85
2024-03-29 17:20:00,29,16,14,27,1,87
2024-03-29 17:30:00,30,12,15,26,4,87
2024-03-29 17:40:00,33,17,14,26,2,92
2024-03-29 17:50:00,25,7,14,25,3,74
2024-03-29 18:00:00,24,12,11,20,3,70
2024-03-29 18:10:00,28,14,17,24,5,88
2024-03-29 18:20:00,28,16,18,18,3,83
2024-03-29 18:30:00,20,17,13,23,1,74
2024-03-29 18:40:00,34,9,20,25,0,88
2024-03-29 18:50:00,20,9,12,30,2,73
2024-03-29 19:00:00,18,22,10,15,1,66
2024-03-29 19:10:00,22,15,13,19,3,72
2024-03-29 19:20:00,18,13,9,12,3,55
2024-03-29 19:30:00,23,13,14,18,4,72
2024-03-29 19:40:00,9,9,9,16,1,44
2024-03-29 19:50:00,14,7,9,14,3,47
2024-03-29 20:00:00,21,10,6,15,2,54
2024-03-29 20:10:00,18,13,10,20,0,61
2024-03-29 20:20:00,23,10,17,11,2,63
2024-03-29 20:30:00,18,7,11,23,2,61
2024-03-29 20:40:00,22,9,12,15,2,60
2024-03-29 20:50:00,20,14,7,12,0,53
2024-03-29 21:00:00,14,8,9,16,1,48
2024-03-29 21:10:00,18,3,10,16,0,47
2024-03-29 21:20:00,16,8,8,10,0,42
2024-03-29 21:30:00,12,4,10,17,0,43
2024-03-29 21:40:00,14,7,14,14,2,51
2024-03-29 21:50:00,17,5,10,19,0,51
2024-03-29 22:00:00,18,6,12,15,1,52
2024-03-29 22:10:00,11,3,6,15,0,35
2024-03-29 22:20:00,13,3,14,13,0,43
2024-03-29 22:30:00,15,6,8,11,0,40
2024-03-29 22:40:00,13,4,13,14,0,44
2024-03-29 22:50:00,21,0,6,11,0,38
2024-03-29 23:00:00,11,5,7,11,1,35
2024-03-29 23:10:00,10,4,6,9,0,29
2024-03-29 23:20:00,8,4,6,10,1,29
2024-03-29 23:30:00,10,4,4,10,1,29
2024-03-29 23:40:00,3,3,4,6,0,16
2024-03-29 23:50:00,6,4,2,6,0,18
2024-03-30 00:00:00,7,4,11,12,0,34
2024-03-30 00:10:00,6,3,1,3,0,13
2024-03-30 00:20:00,6,1,8,6,0,21
2024-03-30 00:30:00,9,0,6,5,0,20
2024-03-30 00:40:00,9,3,1,11,0,24
2024-03-30 00:50:00,4,2,4,6,0,16
2024-03-30 01:00:00,6,6,2,2,0,16
2024-03-30 01:10:00,4,1,1,4,1,11
2024-03-30 01:20:00,3,1,0,3,0,7
2024-03-30 01:30:00,0,1,2,2,0,5
2024-03-30 01:40:00,10,3,0,5,0,18
2024-03-30 01:50:00,9,2,3,3,0,17
2024-03-30 02:00:00,4,2,0,4,0,10
2024-03-30 02:10:00,5,1,3,4,0,13
2024-03-30 02:20:00,4,3,1,2,0,10
2024-03-30 02:30:00,2,0,3,6,0,11
2024-03-30 02:40:00,12,1,2,5,0,20
2024-03-30 02:50:00,4,3,1,3,0,11
2024-03-30 03:00:00,5,0,2,3,0,10
2024-03-30 03:10:00,3,1,0,3,1,8
2024-03-30 03:20:00,2,1,1,2,0,6
2024-03-30 03:30:00,1,1,1,0,0,3
2024-03-30 03:40:00,3,1,1,0,0,5
2024-03-30 03:50:00,3,1,1,3,0,8
2024-03-30 04:00:00,8,3,2,0,0,13
2024-03-30 04:10:00,5,3,0,1,0,9
2024-03-30 04:20:00,3,2,5,3,0,13
2024-03-30 04:30:00,5,2,1,3,0,11
2024-03-30 04:40:00,7,4,3,4,0,18
2024-03-30 04:50:00,10,2,5,7,0,24
2024-03-30 05:00:00,10,1,4,5,0,20
2024-03-30 05:10:00,8,6,4,5,0,23
2024-03-30 05:20:00,14,2,1,4,0,21
2024-03-30 05:30:00,3,3,3,5,0,14
2024-03-30 05:40:00,12,2,4,6,0,24
2024-03-30 05:50:00,7,5,8,8,0,28
2024-03-30 06:00:00,9,5,4,7,1,26
2024-03-30 06:10:00,8,1,9,10,0,28
2024-03-30 06:20:00,10,4,5,7,0,26
2024-03-30 06:30:00,5,5,2,4,1,17
2024-03-30 06:40:00,8,4,5,10,2,29
2024-03-30 06:50:00,17,5,8,4,1,35
2024-03-30 07:00:00,15,3,10,9,0,37
2024-03-30 07:10:00,10,5,6,6,1,28
2024-03-30 07:20:00,12,3,9,8,0,32
2024-03-30 07:30:00,17,5,8,8,2,40
2024-03-30 07:40:00,19,3,11,9,3,45
2024-03-30 07:50:00,15,1,10,17,1,44
2024-03-30 08:00:00,26,13,15,13,1,68
2024-03-30 08:10:00,21,11,11,12,1,56
2024-03-30 08:20:00,15,10,15,8,1,49
2024-03-30 08:30:00,27,14,12,18,0,71
2024-03-30 08:40:00,30,11,9,18,3,71
2024-03-30 08:50:00,28,18,16,21,3,86
2024-03-30 09:00:00,33,12,18,19,1,83
2024-03-30 09:10:00,25,10,12,27,0,74
2024-03-30 09:20:00,31,15,16,19,1,82
2024-03-30 09:30:00,28,19,24,26,3,100
2024-03-30 09:40:00,38,21,23,27,6,115
2024-03-30 09:50:00,43,10,27,38,2,120
2024-03-30 10:00:00,37,17,24,25,3,106
2024-03-30 10:10:00,39,19,30,28,3,119
2024-03-30 10:20:00,33,19,25,16,6,99
2024-03-30 10:30:00,38,24,23,27,3,115
2024-03-30 10:40:00,44,27,32,26,6,135
2024-03-30 10:50:00,50,19,16,33,2,120
2024-03-30 11:00:00,43,22,26,17,5,113
2024-03-30 11:10:00,37,15,24,19,6,101
2024-03-30 11:20:00,41,17,25,17,5,105
2024-03-30 11:30:00,35,13,21,25,2,96
2024-03-30 11:40:00,37,16,23,28,5,109
2024-03-30 11:50:00,35,15,27,28,4,109
2024-03-30 12:00:00,33,24,30,23,3,113
2024-03-30 12:10:00,49,17,28,45,4,143
2024-03-30 12:20:00,37,19,27,24,2,109
2024-03-30 12:30:00,48,19,32,30,2,131
2024-03-30 12:40:00,37,26,21,30,4,118
2024-03-30 12:50:00,43,24,35,31,2,135
2024-03-30 13:00:00,43,22,23,27,4,119
2024-03-30 13:10:00,30,17,14,32,5,98
2024-03-30 13:20:00,49,13,7,53,1,123
2024-03-30 13:30:00,52,18,33,32,1,136
2024-03-30 13:40:00,45,16,23,37,1,122
2024-03-30 13:50:00,35,27,20,28,5,115
2024-03-30 14:00:00,44,15,19,32,0,110
2024-03-30 14:10:00,42,26,29,50,3,150
2024-03-30 14:20:00,44,15,27,27,3,116
2024-03-30 14:30:00,37,20,23,37,3,120
2024-03-30 14:40:00,46,22,23,34,1,126
2024-03-30 14:50:00,32,21,21,26,3,103
2024-03-30 15:00:00,39,24,25,27,2,117
2024-03-30 15:10:00,38,26,13,29,5,111
2024-03-30 15:20:00,39,15,20,28,2,104
2024-03-30 15:30:00,37,18,20,27,5,107
2024-03-30 15:40:00,40,22,15,39,3,119
2024-03-30 15:50:00,40,13,13,40,1,107
2024-03-30 16:00:00,40,18,26,33,5,122
2024-03-30 16:10:00,33,12,22,29,3,99
2024-03-30 16:20:00,39,17,16,12,4,88
2024-03-30 16:30:00,40,14,24,18,3,99
2024-03-30 16:40:00,33,14,11,23,4,85
2024-03-30 16:50:00,36,18,28,27,3,112
2024-03-30 17:00:00,37,19,16,32,2,106
2024-03-30 17:10:00,37,27,22,30,4,120
2024-03-30 17:20:00,31,20,22,37,6,116
2024-03-30 17:30:00,35,18,22,26,4,105
2024-03-30 17:40:00,43,11,20,31,2,107
2024-03-30 17:50:00,36,16,26,32,1,111
2024-03-30 18:00:00,32,22,16,36,4,110
2024-03-30 18:10:00,41,16,30,30,3,120
2024-03-30 18:20:00,39,18,19,27,1,104
2024-03-30 18:30:00,36,24,20,24,2,106
2024-03-30 18:40:00,55,14,11,26,1,107
2024-03-30 18:50:00,34,14,17,28,3,96
2024-03-30 19:00:00,27,9,12,19,2,69
2024-03-30 19:10:00,40,14,25,28,3,110
2024-03-30 19:20:00,20,16,16,35,3,90
2024-03-30 19:30:00,29,20,23,25,4,101
2024-03-30 19:40:00,41,22,22,23,0,108
2024-03-30 19:50:00,26,13,24,27,3,93
2024-03-30 20:00:00,26,25,32,22,3,108
2024-03-30 20:10:00,32,10,16,38,2,98
2024-03-30 20:20:00,26,9,17,32,3,87
2024-03-30 20:30:00,31,16,29,28,5,109
2024-03-30 20:40:00,32,9,20,40,3,104
2024-03-30 20:50:00,22,8,18,35,1,84
2024-03-30 21:00:00,25,14,19,16,0,74
2024-03-30 21:10:00,18,4,18,13,0,53
2024-03-30 21:20:00,21,9,16,22,1,69
2024-03-30 21:30:00,18,14,12,21,0,65
2024-03-30 21:40:00,23,13,25,17,1,79
2024-03-30 21:50:00,11,11,13,20,0,55
2024-03-30 22:00:00,24,7,10,26,0,67
2024-03-30 22:10:00,21,3,11,14,0,49
2024-03-30 22:20:00,17,6,15,21,1,60
2024-03-30 22:30:00,17,3,10,22,1,53
2024-03-30 22:40:00,14,6,13,27,0,60
2024-03-30 22:50:00,20,7,8,29,0,64
2024-03-30 23:00:00,20,14,16,18,0,68
2024-03-30 23:10:00,16,11,9,14,1,51
2024-03-30 23:20:00,16,9,16,25,0,66
2024-03-30 23:30:00,16,10,8,18,1,53
2024-03-30 23:40:00,15,3,3,22,1,44
2024-03-30 23:50:00,14,4,1,18,0,37
2024-03-31 00:00:00,8,12,3,12,0,35
2024-03-31 00:10:00,16,3,8,20,0,47
2024-03-31 00:20:00,6,2,5,17,0,30
2024-03-31 00:30:00,10,3,5,13,0,31
2024-03-31 00:40:00,6,3,8,6,0,23
2024-03-31 00:50:00,5,1,11,5,0,22
2024-03-31 01:00:00,5,3,0,6,0,14
2024-03-31 01:10:00,9,1,3,6,1,20
2024-03-31 01:20:00,7,1,3,6,2,19
2024-03-31 01:30:00,3,3,2,2,0,10
2024-03-31 01:40:00,3,4,1,4,1,13
2024-03-31 01:50:00,5,2,3,6,0,16
2024-03-31 02:00:00,0,0,0,0,0,0
2024-03-31 02:10:00,0,0,0,0,0,0
2024-03-31 02:20:00,0,0,0,0,0,0
2024-03-31 02:30:00,0,0,0,0,0,0
2024-03-31 02:40:00,0,0,0,0,0,0
2024-03-31 02:50:00,0,0,0,0,0,0
2024-03-31 03:00:00,0,0,0,0,0,0
2024-03-31 03:10:00,0,0,0,0,0,0
2024-03-31 03:20:00,0,0,0,0,0,0
2024-03-31 03:30:00,0,0,0,0,0,0
2024-03-31 03:40:00,0,0,0,0,0,0
2024-03-31 03:50:00,0,0,0,0,0,0
2024-03-31 04:00:00,4,2,3,5,0,14
2024-03-31 04:10:00,2,4,0,1,0,7
2024-03-31 04:20:00,9,0,3,3,0,15
2024-03-31 04:30:00,9,3,0,6,0,18
2024-03-31 04:40:00,4,1,1,4,0,10
2024-03-31 04:50:00,8,1,0,4,0,13
2024-03-31 05:00:00,7,2,0,5,0,14
2024-03-31 05:10:00,1,2,4,9,0,16
2024-03-31 05:20:00,11,1,1,3,0,16
2024-03-31 05:30:00,5,1,2,5,0,13
2024-03-31 05:40:00,3,1,2,3,0,9
2024-03-31 05:50:00,1,1,4,9,0,15
2024-03-31 06:00:00,5,4,4,6,0,19
2024-03-31 06:10:00,4,0,2,4,0,10
2024-03-31 06:20:00,6,2,7,4,0,19
2024-03-31 06:30:00,9,1,3,9,0,22
2024-03-31 06:40:00,4,0,3,4,0,11
2024-03-31 06:50:00,4,3,1,1,0,9
2024-03-31 07:00:00,8,1,1,4,0,14
2024-03-31 07:10:00,2,0,1,4,0,7
2024-03-31 07:20:00,5,2,1,1,0,9
2024-03-31 07:30:00,3,1,3,4,0,11
2024-03-31 07:40:00,9,2,2,3,0,16
2024-03-31 07:50:00,4,3,5,8,0,20
2024-03-31 08:00:00,2,0,1,7,0,10
2024-03-31 08:10:00,7,3,2,5,0,17
2024-03-31 08:20:00,9,2,3,5,0,19
2024-03-31 08:30:00,4,1,3,4,0,12
2024-03-31 08:40:00,13,5,7,5,1,31
2024-03-31 08:50:00,14,5,5,5,2,31
2024-03-31 09:00:00,12,8,4,8,0,32
2024-03-31 09:10:00,19,6,3,15,0,43
2024-03-31 09:20:00,21,6,18,12,0,57
2024-03-31 09:30:00,13,3,8,9,1,34
2024-03-31 09:40:00,28,11,5,10,0,54
2024-03-31 09:50:00,19,12,9,11,1,52
2024-03-31 10:00:00,18,10,11,17,1,57
2024-03-31 10:10:00,25,15,13,12,2,67
2024-03-31 10:20:00,23,6,15,18,0,62
2024-03-31 10:30:00,28,15,18,15,1,77
2024-03-31 10:40:00,39,15,14,28,1,97
2024-03-31 10:50:00,25,9,6,22,4,66
2024-03-31 11:00:00,21,12,10,25,2,70
2024-03-31 11:10:00,24,11,15,30,2,82
2024-03-31 11:20:00,21,7,14,19,2,63
2024-03-31 11:30:00,28,17,18,33,0,96
2024-03-31 11:40:00,43,15,17,34,3,112
2024-03-31 11:50:00,26,12,17,24,6,85
2024-03-31 12:00:00,25,12,20,30,6,93
2024-03-31 12:10:00,29,12,16,31,1,89
2024-03-31 12:20:00,38,23,24,34,5,124
2024-03-31 12:30:00,36,15,13,32,7,103
2024-03-31 12:40:00,36,21,26,24,4,111
2024-03-31 12:50:00,26,15,15,24,2,82
2024-03-31 13:00:00,29,2,12,15,0,58
2024-03-31 13:10:00,24,18,14,28,2,86
2024-03-31 13:20:00,35,14,18,29,2,98
2024-03-31 13:30:00,30,21,16,24,0,91
2024-03-31 13:40:00,31,21,17,23,1,93
2024-03-31 13:50:00,27,18,12,37,2,96
2024-03-31 14:00:00,24,21,16,27,4,92
2024-03-31 14:10:00,35,16,19,34,2,106
2024-03-31 14:20:00,26,16,12,24,4,82
2024-03-31 14:30:00,19,16,14,15,4,68
2024-03-31 14:40:00,35,18,13,31,4,101
2024-03-31 14:50:00,31,17,20,31,0,99
2024-03-31 15:00:00,29,14,17,27,6,93
2024-03-31 15:10:00,35,12,20,19,5,91
2024-03-31 15:20:00,35,11,16,25,2,89
2024-03-31 15:30:00,34,14,15,24,3,90
2024-03-31 15:40:00,32,20,9,19,1,81
2024-03-31 15:50:00,30,16,17,26,3,92
2024-03-31 16:00:00,27,15,20,27,4,93
2024-03-31 16:10:00,30,15,15,29,4,93
2024-03-31 16:20:00,35,14,15,17,3,84
2024-03-31 16:30:00,21,10,20,29,3,83
2024-03-31 16:40:00,46,17,11,27,2,103
2024-03-31 16:50:00,27,12,8,29,1,77
2024-03-31 17:00:00,23,25,21,19,6,94
2024-03-31 17:10:00,36,11,14,19,2,82
2024-03-31 17:20:00,41,18,11,27,2,99
2024-03-31 17:30:00,39,14,18,31,2,104
2024-03-31 17:40:00,33,19,10,22,3,87
2024-03-31 17:50:00,32,17,19,35,3,106
2024-03-31 18:00:00,44,28,17,29,4,122
2024-03-31 18:10:00,30,14,13,26,3,86
2024-03-31 18:20:00,25,16,14,33,1,89
2024-03-31 18:30:00,35,17,21,32,3,108
2024-03-31 18:40:00,43,4,24,28,4,103
2024-03-31 18:50:00,39,12,6,28,0,85
2024-03-31 19:00:00,23,15,20,26,2,86
2024-03-31 19:10:00,31,13,18,19,3,84
2024-03-31 19:20:00,27,20,11,15,4,77
2024-03-31 19:30:00,30,6,7,23,3,69
2024-03-31 19:40:00,28,18,10,21,2,79
2024-03-31 19:50:00,31,14,19,20,4,88
2024-03-31 20:00:00,18,11,14,17,1,61
2024-03-31 20:10:00,22,11,25,28,3,89
2024-03-31 20:20:00,32,14,14,28,0,88
2024-03-31 20:30:00,33,8,21,21,2,85
2024-03-31 20:40:00,24,10,16,30,1,81
2024-03-31 20:50:00,19,15,19,18,1,72
2024-03-31 21:00:00,31,20,17,24,2,94
2024-03-31 21:10:00,37,16,18,25,1,97
2024-03-31 21:20:00,27,11,10,24,0,72
2024-03-31 21:30:00,21,14,18,22,2,77
2024-03-31 21:40:00,30,20,7,19,2,78
2024-03-31 21:50:00,26,7,22,38,3,96
2024-03-31 22:00:00,31,4,6,18,1,60
2024-03-31 22:10:00,22,13,11,32,0,78
2024-03-31 22:20:00,25,3,17,20,2,67
2024-03-31 22:30:00,19,4,13,22,1,59
2024-03-31 22:40:00,15,6,11,19,1,52
2024-03-31 22:50:00,12,14,5,14,0,45
2024-03-31 23:00:00,8,4,7,12,2,33
2024-03-31 23:10:00,9,2,11,11,2,35
2024-03-31 23:20:00,5,6,1,8,2,22
2024-03-31 23:30:00,11,5,6,13,1,36
2024-03-31 23:40:00,14,3,9,13,1,40
2024-03-31 23:50:00,13,6,5,4,0,28
2024-04-01 00:00:00,9,3,4,10,0,26
2024-04-01 00:10:00,3,7,1,10,1,22
2024-04-01 00:20:00,14,4,6,8,1,33
2024-04-01 00:30:00,4,5,3,7,0,19
2024-04-01 00:40:00,7,3,4,10,0,24
2024-04-01 00:50:00,7,1,2,7,0,17
2024-04-01 01:00:00,2,3,4,12,0,21
2024-04-01 01:10:00,7,2,3,8,0,20
2024-04-01 01:20:00,12,4,4,9,0,29
2024-04-01 01:30:00,5,1,2,3,0,11
2024-04-01 01:40:00,7,4,4,5,0,20
2024-04-01 01:50:00,7,4,0,4,0,15
2024-04-01 02:00:00,2,1,1,4,0,8
2024-04-01 02:10:00,8,2,1,2,0,13
2024-04-01 02:20:00,6,2,3,2,0,13
2024-04-01 02:30:00,2,3,0,3,0,8
2024-04-01 02:40:00,0,3,2,2,0,7
2024-04-01 02:50:00,2,0,2,3,0,7
2024-04-01 03:00:00,7,1,3,3,0,14
2024-04-01 03:10:00,3,2,2,4,0,11
2024-04-01 03:20:00,4,3,1,3,0,11
2024-04-01 03:30:00,5,1,2,2,0,10
2024-04-01 03:40:00,6,0,4,5,2,17
2024-04-01 03:50:00,3,3,1,4,0,11
2024-04-01 04:00:00,6,2,3,2,0,13
2024-04-01 04:10:00,8,2,0,6,0,16
2024-04-01 04:20:00,3,3,0,2,0,8
2024-04-01 04:30:00,6,2,3,5,0,16
2024-04-01 04:40:00,1,1,0,1,0,3
2024-04-01 04:50:00,7,1,2,7,0,17
2024-04-01 05:00:00,7,3,3,2,0,15
2024-04-01 05:10:00,7,6,1,4,0,18
2024-04-01 05:20:00,8,3,2,4,0,17
2024-04-01 05:30:00,4,1,1,6,0,12
2024-04-01 05:40:00,12,3,2,7,0,24
2024-04-01 05:50:00,5,0,4,10,0,19
2024-04-01 06:00:00,4,2,3,5,1,15
2024-04-01 06:10:00,3,1,5,6,2,17
2024-04-01 06:20:00,5,2,6,15,1,29
2024-04-01 06:30:00,3,0,2,5,0,10
2024-04-01 06:40:00,6,2,3,7,0,18
2024-04-01 06:50:00,7,1,0,4,0,12
2024-04-01 07:00:00,5,1,1,1,0,8
2024-04-01 07:10:00,4,3,3,4,0,14
2024-04-01 07:20:00,5,2,4,6,0,17
2024-04-01 07:30:00,5,1,4,5,0,15
2024-04-01 07:40:00,7,2,4,9,1,23
2024-04-01 07:50:00,4,1,4,6,0,15
2024-04-01 08:00:00,8,2,1,4,0,15
2024-04-01 08:10:00,11,8,4,12,0,35
2024-04-01 08:20:00,8,2,2,9,1,22
2024-04-01 08:30:00,10,5,3,9,0,27
2024-04-01 08:40:00,11,7,8,11,0,37
2024-04-01 08:50:00,14,4,4,9,0,31
2024-04-01 09:00:00,10,7,4,6,0,27
2024-04-01 09:10:00,17,2,7,17,0,43
2024-04-01 09:20:00,10,8,8,5,0,31
2024-04-01 09:30:00,13,6,9,16,0,44
2024-04-01 09:40:00,16,10,7,12,0,45
2024-04-01 09:50:00,18,12,12,14,0,56
2024-04-01 10:00:00,15,8,7,14,2,46
2024-04-01 10:10:00,24,10,13,12,0,59
2024-04-01 10:20:00,21,5,7,16,1,50
2024-04-01 10:30:00,24,12,7,19,1,63
2024-04-01 10:40:00,29,9,15,19,1,73
2024-04-01 10:50:00,31,4,16,17,1,69
2024-04-01 11:00:00,17,3,13,12,3,48
2024-04-01 11:10:00,20,12,10,21,2,65
2024-04-01 11:20:00,26,12,14,18,0,70
2024-04-01 11:30:00,21,3,16,20,1,61
2024-04-01 11:40:00,32,13,24,25,5,99
2024-04-01 11:50:00,32,17,15,26,2,92
2024-04-01 12:00:00,24,10,19,21,1,75
2024-04-01 12:10:00,35,14,20,35,3,107
2024-04-01 12:20:00,29,14,13,23,1,80
2024-04-01 12:30:00,29,13,5,22,4,73
2024-04-01 12:40:00,24,10,13,28,4,79
2024-04-01 12:50:00,32,7,10,19,2,70
2024-04-01 13:00:00,26,15,11,24,0,76
2024-04-01 13:10:00,31,13,15,18,4,81
2024-04-01 13:20:00,27,19,8,23,0,77
2024-04-01 13:30:00,36,10,17,17,5,85
2024-04-01 13:40:00,36,15,17,26,2,96
2024-04-01 13:50:00,34,17,16,21,0,88
2024-04-01 14:00:00,27,14,22,24,2,89
2024-04-01 14:10:00,27,19,23,29,3,101
2024-04-01 14:20:00,26,10,24,23,3,86
2024-04-01 14:30:00,31,15,15,23,0,84
2024-04-01 14:40:00,41,16,16,31,2,106
2024-04-01 14:50:00,34,15,19,25,1,94
2024-04-01 15:00:00,35,16,12,23,1,87
2024-04-01 15:10:00,25,8,13,29,2,77
2024-04-01 15:20:00,27,16,12,21,3,79
2024-04-01 15:30:00,29,11,17,26,1,84
2024-04-01 15:40:00,33,15,16,31,2,97
2024-04-01 15:50:00,27,12,20,40,2,101
2024-04-01 16:00:00,22,8,22,28,2,82
2024-04-01 16:10:00,25,11,14,21,4,75
2024-04-01 16:20:00,26,10,16,20,4,76
2024-04-01 16:30:00,34,12,19,18,0,83
2024-04-01 16:40:00,22,24,16,24,4,90
2024-04-01 16:50:00,40,16,24,23,2,105
2024-04-01 17:00:00,27,15,12,36,1,91
2024-04-01 17:10:00,36,16,16,21,3,92
2024-04-01 17:20:00,24,24,16,21,7,92
2024-04-01 17:30:00,39,25,12,27,2,105
2024-04-01 17:40:00,26,18,24,26,1,95
2024-04-01 17:50:00,34,22,21,19,2,98
2024-04-01 18:00:00,30,19,15,29,0,93
2024-04-01 18:10:00,34,27,19,26,3,109
2024-04-01 18:20:00,34,18,11,28,0,91
2024-04-01 18:30:00,26,17,23,21,3,90
2024-04-01 18:40:00,28,22,16,23,4,93
2024-04-01 18:50:00,31,13,8,24,2,78
2024-04-01 19:00:00,32,20,20,19,2,93
2024-04-01 19:10:00,25,22,16,18,1,82
2024-04-01 19:20:00,23,21,13,23,2,82
2024-04-01 19:30:00,26,22,8,27,5,88
2024-04-01 19:40:00,18,14,16,25,2,75
2024-04-01 19:50:00,32,22,22,17,1,94
2024-04-01 20:00:00,29,19,11,18,0,77
2024-04-01 20:10:00,20,21,16,16,4,77
2024-04-01 20:20:00,20,12,16,21,1,70
2024-04-01 20:30:00,26,9,12,20,1,68
2024-04-01 20:40:00,14,6,16,18,2,56
2024-04-01 20:50:00,23,5,14,23,1,66
2024-04-01 21:00:00,26,7,12,23,1,69
2024-04-01 21:10:00,20,4,17,18,0,59
2024-04-01 21:20:00,22,9,13,19,2,65
2024-04-01 21:30:00,19,9,16,16,5,65
2024-04-01 21:40:00,13,2,5,13,3,36
2024-04-01 21:50:00,16,4,7,11,3,41
2024-04-01 22:00:00,18,6,14,16,2,56
2024-04-01 22:10:00,29,9,11,14,0,63
2024-04-01 22:20:00,18,4,13,11,0,46
2024-04-01 22:30:00,5,6,13,12,0,36
2024-04-01 22:40:00,16,2,19,8,1,46
2024-04-01 22:50:00,6,3,10,9,0,28
2024-04-01 23:00:00,13,7,2,8,0,30
2024-04-01 23:10:00,14,4,10,7,1,36
2024-04-01 23:20:00,17,5,11,8,0,41
2024-04-01 23:30:00,10,2,4,8,1,25
2024-04-01 23:40:00,13,4,7,13,0,37
2024-04-01 23:50:00,6,1,3,6,1,17
2024-04-02 00:00:00,9,5,3,3,0,20
2024-04-02 00:10:00,7,2,2,5,0,16
2024-04-02 00:20:00,15,1,7,5,0,28
2024-04-02 00:30:00,8,1,11,9,0,29
2024-04-02 00:40:00,11,0,3,4,0,18
2024-04-02 00:50:00,6,0,3,3,0,12
2024-04-02 01:00:00,9,4,6,9,0,28
2024-04-02 01:10:00,4,0,0,2,0,6
2024-04-02 01:20:00,4,0,0,5,0,9
2024-04-02 01:30:00,7,0,3,1,0,11
2024-04-02 01:40:00,7,0,2,2,0,11
2024-04-02 01:50:00,5,7,4,1,0,17
2024-04-02 02:00:00,2,0,1,1,0,4
2024-04-02 02:10:00,2,1,2,1,0,6
2024-04-02 02:20:00,4,4,2,0,0,10
2024-04-02 02:30:00,6,0,2,2,0,10
2024-04-02 02:40:00,4,0,2,1,0,7
2024-04-02 02:50:00,2,2,0,2,0,6
2024-04-02 03:00:00,6,0,1,2,0,9
2024-04-02 03:10:00,0,1,3,1,0,5
2024-04-02 03:20:00,3,2,2,1,0,8
2024-04-02 03:30:00,6,4,2,2,0,14
2024-04-02 03:40:00,5,0,0,1,0,6
2024-04-02 03:50:00,0,0,6,2,0,8
2024-04-02 04:00:00,9,0,6,3,0,18
2024-04-02 04:10:00,2,0,7,0,0,9
2024-04-02 04:20:00,5,1,4,3,0,13
2024-04-02 04:30:00,7,2,4,0,0,13
2024-04-02 04:40:00,12,4,13,8,0,37
2024-04-02 04:50:00,2,9,7,4,0,22
2024-04-02 05:00:00,9,9,3,1,1,23
2024-04-02 05:10:00,14,4,15,5,0,38
2024-04-02 05:20:00,29,10,12,2,0,53
2024-04-02 05:30:00,34,20,22,2,0,78
2024-04-02 05:40:00,32,16,25,7,0,80
2024-04-02 05:50:00,29,26,31,18,1,105
2024-04-02 06:00:00,32,23,28,9,0,92
2024-04-02 06:10:00,44,12,40,11,2,109
2024-04-02 06:20:00,38,25,51,19,5,138
2024-04-02 06:30:00,51,24,34,18,1,128
2024-04-02 06:40:00,50,28,33,23,1,135
2024-04-02 06:50:00,44,24,47,15,2,132
2024-04-02 07:00:00,43,14,36,20,3,116
2024-04-02 07:10:00,40,12,33,14,4,103
2024-04-02 07:20:00,50,32,22,14,5,123
2024-04-02 07:30:00,56,22,29,24,2,133
2024-04-02 07:40:00,46,22,38,22,4,132
2024-04-02 07:50:00,38,18,32,25,3,116
2024-04-02 08:00:00,52,26,35,18,2,133
2024-04-02 08:10:00,52,14,40,28,3,137
2024-04-02 08:20:00,57,26,42,16,2,143
2024-04-02 08:30:00,45,30,27,23,4,129
2024-04-02 08:40:00,52,17,39,25,5,138
2024-04-02 08:50:00,39,14,31,19,4,107
2024-04-02 09:00:00,49,17,32,16,3,117
2024-04-02 09:10:00,44,17,29,19,1,110
2024-04-02 09:20:00,46,14,33,17,1,111
2024-04-02 09:30:00,35,15,28,19,2,99
2024-04-02 09:40:00,48,17,24,18,2,109
2024-04-02 09:50:00,18,38,42,23,0,121
2024-04-02 10:00:00,27,23,22,18,3,93
2024-04-02 10:10:00,33,15,39,25,3,115
2024-04-02 10:20:00,35,10,31,16,5,97
2024-04-02 10:30:00,42,16,41,15,1,115
2024-04-02 10:40:00,43,12,34,17,0,106
2024-04-02 10:50:00,42,16,26,15,3,102
2024-04-02 11:00:00,45,21,31,12,2,111
2024-04-02 11:10:00,39,13,37,22,4,115
2024-04-02 11:20:00,36,10,35,18,1,100
2024-04-02 11:30:00,53,9,39,20,1,122
2024-04-02 11:40:00,42,19,33,18,2,114
2024-04-02 11:50:00,47,11,37,15,1,111
2024-04-02 12:00:00,25,21,36,25,3,110
2024-04-02 12:10:00,36,14,41,26,3,120
2024-04-02 12:20:00,54,20,36,21,4,135
2024-04-02 12:30:00,44,19,36,26,2,127
2024-04-02 12:40:00,40,12,44,19,4,119
2024-04-02 12:50:00,41,25,29,23,2,120
2024-04-02 13:00:00,48,17,36,22,3,126
2024-04-02 13:10:00,46,13,40,26,3,128
2024-04-02 13:20:00,41,16,31,20,3,111
2024-04-02 13:30:00,45,19,34,49,3,150
2024-04-02 13:40:00,34,21,42,15,5,117
2024-04-02 13:50:00,47,21,44,20,1,133
2024-04-02 14:00:00,38,12,36,28,7,121
2024-04-02 14:10:00,31,16,37,29,3,116
2024-04-02 14:20:00,54,23,36,20,2,135
2024-04-02 14:30:00,31,13,18,48,2,112
2024-04-02 14:40:00,44,29,36,23,3,135
2024-04-02 14:50:00,39,19,37,19,4,118
2024-04-02 15:00:00,56,20,45,24,3,148
2024-04-02 15:10:00,44,22,34,20,8,128
2024-04-02 15:20:00,52,26,38,26,2,144
2024-04-02 15:30:00,45,25,32,23,3,128
2024-04-02 15:40:00,34,24,43,19,4,124
2024-04-02 15:50:00,41,24,26,31,6,128
2024-04-02 16:00:00,50,29,37,26,5,147
2024-04-02 16:10:00,42,22,26,21,5,116
2024-04-02 16:20:00,38,18,45,29,2,132
2024-04-02 16:30:00,39,21,34,30,5,129
2024-04-02 16:40:00,30,16,42,30,9,127
2024-04-02 16:50:00,54,31,53,32,5,175
2024-04-02 17:00:00,32,22,20,26,5,105
2024-04-02 17:10:00,44,23,47,32,1,147
2024-04-02 17:20:00,49,14,57,30,1,151
2024-04-02 17:30:00,43,23,37,23,4,130
2024-04-02 17:40:00,34,26,40,31,7,138
2024-04-02 17:50:00,31,12,67,33,6,149
2024-04-02 18:00:00,48,21,42,30,4,145
2024-04-02 18:10:00,52,12,54,28,5,151
2024-04-02 18:20:00,51,20,64,29,2,166
2024-04-02 18:30:00,46,15,54,26,6,147
2024-04-02 18:40:00,43,27,43,25,2,140
2024-04-02 18:50:00,43,18,34,25,4,124
2024-04-02 19:00:00,32,17,43,23,2,117
2024-04-02 19:10:00,35,14,28,21,4,102
2024-04-02 19:20:00,36,18,38,26,6,124
2024-04-02 19:30:00,38,27,29,24,4,122
2024-04-02 19:40:00,24,12,21,26,1,84
2024-04-02 19:50:00,34,8,22,17,2,83
2024-04-02 20:00:00,19,6,15,21,1,62
2024-04-02 20:10:00,29,10,18,13,1,71
2024-04-02 20:20:00,29,12,24,25,2,92
2024-04-02 20:30:00,18,24,20,27,4,93
2024-04-02 20:40:00,37,12,21,17,4,91
2024-04-02 20:50:00,23,19,23,21,1,87
2024-04-02 21:00:00,31,14,37,25,1,108
2024-04-02 21:10:00,30,15,18,18,0,81
2024-04-02 21:20:00,17,23,25,21,2,88
2024-04-02 21:30:00,18,12,16,19,1,66
2024-04-02 21:40:00,26,6,26,18,1,77
2024-04-02 21:50:00,26,16,8,31,0,81
2024-04-02 22:00:00,30,3,23,32,0,88
2024-04-02 22:10:00,19,3,26,20,3,71
2024-04-02 22:20:00,10,10,29,23,1,73
2024-04-02 22:30:00,17,7,30,27,2,83
2024-04-02 22:40:00,10,3,7,10,0,30
2024-04-02 22:50:00,15,7,13,15,0,50
2024-04-02 23:00:00,14,6,21,20,0,61
2024-04-02 23:10:00,16,5,10,9,0,40
2024-04-02 23:20:00,22,5,15,6,0,48
2024-04-02 23:30:00,15,5,11,5,0,36
2024-04-02 23:40:00,6,5,10,4,0,25
2024-04-02 23:50:00,9,0,5,3,0,17
2024-04-03 00:00:00,17,7,3,6,1,34
2024-04-03 00:10:00,5,2,10,9,0,26
2024-04-03 00:20:00,9,3,3,5,1,21
2024-04-03 00:30:00,5,1,0,1,0,7
2024-04-03 00:40:00,4,1,2,3,0,10
2024-04-03 00:50:00,10,0,4,3,0,17
2024-04-03 01:00:00,4,1,4,7,0,16
2024-04-03 01:10:00,6,0,5,2,0,13
2024-04-03 01:20:00,2,4,0,0,0,6
2024-04-03 01:30:00,3,2,0,1,0,6
2024-04-03 01:40:00,6,0,0,0,0,6
2024-04-03 01:50:00,4,3,2,2,0,11
2024-04-03 02:00:00,5,0,3,7,0,15
2024-04-03 02:10:00,2,4,0,3,0,9
2024-04-03 02:20:00,3,2,3,4,0,12
2024-04-03 02:30:00,2,2,3,1,0,8
2024-04-03 02:40:00,2,0,0,1,0,3
2024-04-03 02:50:00,5,0,4,3,0,12
2024-04-03 03:00:00,7,0,3,5,0,15
2024-04-03 03:10:00,2,1,0,0,0,3
2024-04-03 03:20:00,5,0,11,2,0,18
2024-04-03 03:30:00,0,5,0,0,0,5
2024-04-03 03:40:00,4,2,2,0,0,8
2024-04-03 03:50:00,3,3,5,2,0,13
2024-04-03 04:00:00,5,1,10,0,0,16
2024-04-03 04:10:00,10,0,5,2,0,17
2024-04-03 04:20:00,7,4,6,0,0,17
2024-04-03 04:30:00,6,1,3,3,0,13
2024-04-03 04:40:00,3,6,5,5,0,19
2024-04-03 04:50:00,7,4,5,2,0,18
2024-04-03 05:00:00,10,9,9,2,0,30
2024-04-03 05:10:00,14,7,13,5,0,39
2024-04-03 05:20:00,26,10,14,9,0,59
2024-04-03 05:30:00,23,11,26,4,0,64
2024-04-03 05:40:00,31,22,24,6,1,84
2024-04-03 05:50:00,21,19,31,15,1,87
2024-04-03 06:00:00,33,22,23,4,0,82
2024-04-03 06:10:00,32,7,31,14,0,84
2024-04-03 06:20:00,40,20,38,28,1,127
2024-04-03 06:30:00,41,13,28,38,2,122
2024-04-03 06:40:00,46,24,37,21,3,131
2024-04-03 06:50:00,35,15,23,13,2,88
2024-04-03 07:00:00,51,20,28,17,2,118
2024-04-03 07:10:00,46,27,34,9,1,117
2024-04-03 07:20:00,37,33,33,19,5,127
2024-04-03 07:30:00,43,21,31,18,3,116
2024-04-03 07:40:00,59,18,39,27,2,145
2024-04-03 07:50:00,50,18,36,19,2,125
2024-04-03 08:00:00,45,26,36,20,2,129
2024-04-03 08:10:00,52,23,30,16,2,123
2024-04-03 08:20:00,53,19,36,27,4,139
2024-04-03 08:30:00,60,21,30,22,2,135
2024-04-03 08:40:00,50,22,40,19,2,133
2024-04-03 08:50:00,59,23,32,25,2,141
2024-04-03 09:00:00,52,20,31,22,2,127
2024-04-03 09:10:00,47,18,29,10,2,106
2024-04-03 09:20:00,35,13,24,15,2,89
2024-04-03 09:30:00,40,15,38,24,3,120
2024-04-03 09:40:00,26,15,28,18,3,90
2024-04-03 09:50:00,43,19,28,25,2,117
2024-04-03 10:00:00,35,15,27,19,1,97
2024-04-03 10:10:00,36,14,41,17,1,109
2024-04-03 10:20:00,37,17,36,18,2,110
2024-04-03 10:30:00,35,18,27,13,3,96
2024-04-03 10:40:00,36,10,31,23,3,103
2024-04-03 10:50:00,38,25,36,19,0,118
2024-04-03 11:00:00,35,10,31,15,2,93
2024-04-03 11:10:00,38,26,46,13,2,125
2024-04-03 11:20:00,41,19,30,28,4,122
2024-04-03 11:30:00,41,4,27,15,1,88
2024-04-03 11:40:00,43,16,42,25,3,129
2024-04-03 11:50:00,37,11,24,12,4,88
2024-04-03 12:00:00,33,10,42,21,4,110
2024-04-03 12:10:00,40,20,34,25,4,123
2024-04-03 12:20:00,38,22,23,20,3,106
2024-04-03 12:30:00,42,16,33,18,4,113
2024-04-03 12:40:00,47,14,25,19,3,108
2024-04-03 12:50:00,37,20,34,17,4,112
2024-04-03 13:00:00,44,20,36,20,2,122
2024-04-03 13:10:00,43,20,43,18,5,129
2024-04-03 13:20:00,43,18,30,22,2,115
2024-04-03 13:30:00,42,19,34,21,3,119
2024-04-03 13:40:00,34,11,45,19,1,110
2024-04-03 13:50:00,43,21,29,18,4,115
2024-04-03 14:00:00,33,11,32,24,3,103
2024-04-03 14:10:00,43,15,43,26,3,130
2024-04-03 14:20:00,39,22,35,28,2,126
2024-04-03 14:30:00,47,16,43,30,1,137
2024-04-03 14:40:00,36,20,47,24,2,129
2024-04-03 14:50:00,36,17,36,18,5,112
2024-04-03 15:00:00,37,21,46,17,1,122
2024-04-03 15:10:00,43,23,37,21,4,128
2024-04-03 15:20:00,40,29,45,27,2,143
2024-04-03 15:30:00,41,15,42,22,4,124
2024-04-03 15:40:00,40,16,30,27,3,116
2024-04-03 15:50:00,38,33,38,23,4,136
2024-04-03 16:00:00,41,19,41,31,6,138
2024-04-03 16:10:00,51,28,51,29,2,161
2024-04-03 16:20:00,33,15,44,31,1,124
2024-04-03 16:30:00,50,20,42,20,4,136
2024-04-03 16:40:00,53,19,43,31,3,149
2024-04-03 16:50:00,37,24,42,34,3,140
2024-04-03 17:00:00,47,25,41,25,7,145
2024-04-03 17:10:00,32,21,35,30,4,122
2024-04-03 17:20:00,35,21,39,33,5,133
2024-04-03 17:30:00,39,15,41,38,4,137
2024-04-03 17:40:00,55,23,35,35,1,149
2024-04-03 17:50:00,31,15,34,33,4,117
2024-04-03 18:00:00,40,22,45,31,3,141
2024-04-03 18:10:00,40,18,49,35,3,145
2024-04-03 18:20:00,38,19,41,36,4,138
2024-04-03 18:30:00,34,14,41,32,4,125
2024-04-03 18:40:00,47,21,34,25,2,129
2024-04-03 18:50:00,38,14,27,22,3,104
2024-04-03 19:00:00,39,23,26,35,1,124
2024-04-03 19:10:00,26,16,24,23,5,94
2024-04-03 19:20:00,22,15,25,26,3,91
2024-04-03 19:30:00,31,17,38,28,0,114
2024-04-03 19:40:00,25,12,22,25,2,86
2024-04-03 19:50:00,22,12,30,21,4,89
2024-04-03 20:00:00,27,17,21,17,3,85
2024-04-03 20:10:00,20,20,34,19,1,94
2024-04-03 20:20:00,25,10,34,22,3,94
2024-04-03 20:30:00,21,9,29,13,1,73
2024-04-03 20:40:00,26,7,20,19,2,74
2024-04-03 20:50:00,23,12,22,19,0,76
2024-04-03 21:00:00,26,12,26,14,2,80
2024-04-03 21:10:00,28,14,22,18,2,84
2024-04-03 21:20:00,40,20,20,14,2,96
2024-04-03 21:30:00,21,3,37,19,2,82
2024-04-03 21:40:00,25,13,22,11,1,72
2024-04-03 21:50:00,29,7,15,5,0,56
2024-04-03 22:00:00,12,6,30,11,0,59
2024-04-03 22:10:00,17,3,18,19,1,58
2024-04-03 22:20:00,19,5,24,7,0,55
2024-04-03 22:30:00,14,9,17,8,1,49
2024-04-03 22:40:00,27,6,14,9,0,56
2024-04-03 22:50:00,16,6,10,14,1,47
2024-04-03 23:00:00,24,13,7,22,1,67
2024-04-03 23:10:00,14,4,2,10,1,31
2024-04-03 23:20:00,8,3,5,10,0,26
2024-04-03 23:30:00,14,7,7,19,0,47
2024-04-03 23:40:00,10,5,2,6,1,24
2024-04-03 23:50:00,11,6,7,9,0,33
2024-04-04 00:00:00,8,1,13,16,0,38
2024-04-04 00:10:00,4,3,9,11,0,27
2024-04-04 00:20:00,10,4,0,2,0,16
2024-04-04 00:30:00,7,1,3,5,0,16
2024-04-04 00:40:00,5,1,2,4,0,12
2024-04-04 00:50:00,5,0,6,8,0,19
2024-04-04 01:00:00,5,5,1,8,0,19
2024-04-04 01:10:00,8,3,5,7,0,23
2024-04-04 01:20:00,3,1,1,2,0,7
2024-04-04 01:30:00,8,1,1,4,0,14
2024-04-04 01:40:00,4,1,1,3,0,9
2024-04-04 01:50:00,0,2,1,4,1,8
2024-04-04 02:00:00,4,0,1,2,0,7
2024-04-04 02:10:00,4,0,0,0,0,4
2024-04-04 02:20:00,5,1,0,1,0,7
2024-04-04 02:30:00,1,1,1,3,0,6
2024-04-04 02:40:00,4,3,0,0,0,7
2024-04-04 02:50:00,2,1,0,3,0,6
2024-04-04 03:00:00,0,0,3,4,0,7
2024-04-04 03:10:00,2,0,5,5,0,12
2024-04-04 03:20:00,2,4,7,8,0,21
2024-04-04 03:30:00,6,2,3,5,0,16
2024-04-04 03:40:00,4,2,2,5,0,13
2024-04-04 03:50:00,4,1,8,7,0,20
2024-04-04 04:00:00,2,1,1,2,0,6
2024-04-04 04:10:00,5,0,0,2,1,8
2024-04-04 04:20:00,7,6,1,4,0,18
2024-04-04 04:30:00,3,4,2,4,0,13
2024-04-04 04:40:00,6,1,2,5,0,14
2024-04-04 04:50:00,12,2,2,5,0,21
2024-04-04 05:00:00,10,4,4,2,1,21
2024-04-04 05:10:00,8,9,7,6,0,30
2024-04-04 05:20:00,15,9,6,10,0,40
2024-04-04 05:30:00,19,11,14,13,0,57
2024-04-04 05:40:00,26,12,17,19,0,74
2024-04-04 05:50:00,27,16,13,22,0,78
2024-04-04 06:00:00,25,18,17,14,0,74
2024-04-04 06:10:00,26,15,27,23,1,92
2024-04-04 06:20:00,40,21,22,27,6,116
2024-04-04 06:30:00,34,19,25,30,2,110
2024-04-04 06:40:00,23,15,28,22,4,92
2024-04-04 06:50:00,33,21,29,25,1,109
2024-04-04 07:00:00,32,11,23,25,0,91
2024-04-04 07:10:00,29,14,17,23,5,88
2024-04-04 07:20:00,25,29,18,17,6,95
2024-04-04 07:30:00,41,21,26,29,4,121
2024-04-04 07:40:00,42,27,34,42,3,148
2024-04-04 07:50:00,52,13,27,32,3,127
2024-04-04 08:00:00,53,28,36,29,2,148
2024-04-04 08:10:00,50,32,23,23,1,129
2024-04-04 08:20:00,54,25,32,19,6,136
2024-04-04 08:30:00,45,27,38,22,4,136
2024-04-04 08:40:00,55,26,36,20,4,141
2024-04-04 08:50:00,47,20,27,21,6,121
2024-04-04 09:00:00,59,26,29,11,2,127
2024-04-04 09:10:00,38,13,35,19,4,109
2024-04-04 09:20:00,42,18,24,23,3,110
2024-04-04 09:30:00,48,17,29,21,6,121
2024-04-04 09:40:00,42,15,32,25,3,117
2024-04-04 09:50:00,54,17,37,22,1,131
2024-04-04 10:00:00,45,15,31,17,2,110
2024-04-04 10:10:00,33,7,27,18,1,86
2024-04-04 10:20:00,45,15,44,17,3,124
2024-04-04 10:30:00,33,12,28,20,3,96
2024-04-04 10:40:00,35,28,25,14,2,104
2024-04-04 10:50:00,21,37,35,13,1,107
2024-04-04 11:00:00,27,27,35,26,2,117
2024-04-04 11:10:00,50,17,32,16,1,116
2024-04-04 11:20:00,41,25,40,29,2,137
2024-04-04 11:30:00,50,21,29,20,3,123
2024-04-04 11:40:00,48,12,38,21,3,122
2024-04-04 11:50:00,38,16,44,26,3,127
2024-04-04 12:00:00,44,18,38,22,2,124
2024-04-04 12:10:00,32,10,44,22,0,108
2024-04-04 12:20:00,40,26,34,18,4,122
2024-04-04 12:30:00,43,16,34,26,2,121
2024-04-04 12:40:00,54,22,25,25,1,127
2024-04-04 12:50:00,45,16,23,24,3,111
2024-04-04 13:00:00,32,14,25,25,1,97
2024-04-04 13:10:00,32,20,26,17,1,96
2024-04-04 13:20:00,35,15,30,24,2,106
2024-04-04 13:30:00,34,10,32,18,2,96
2024-04-04 13:40:00,34,22,34,19,2,111
2024-04-04 13:50:00,40,13,27,21,4,105
2024-04-04 14:00:00,34,8,35,27,4,108
2024-04-04 14:10:00,37,31,35,22,1,126
2024-04-04 14:20:00,49,21,41,26,0,137
2024-04-04 14:30:00,44,18,40,30,0,132
2024-04-04 14:40:00,40,22,30,21,1,114
2024-04-04 14:50:00,30,12,29,34,6,111
2024-04-04 15:00:00,36,29,43,40,1,149
2024-04-04 15:10:00,33,20,34,27,6,120
2024-04-04 15:20:00,29,14,41,29,3,116
2024-04-04 15:30:00,39,18,36,23,3,119
2024-04-04 15:40:00,41,24,44,32,1,142
2024-04-04 15:50:00,40,24,38,27,3,132
2024-04-04 16:00:00,42,18,40,28,3,131
2024-04-04 16:10:00,43,25,37,26,4,135
2024-04-04 16:20:00,38,21,46,37,7,149
2024-04-04 16:30:00,50,20,46,25,0,141
2024-04-04 16:40:00,43,17,38,25,7,130
2024-04-04 16:50:00,61,21,39,30,4,155
2024-04-04 17:00:00,47,19,46,22,3,137
2024-04-04 17:10:00,32,12,44,43,3,134
2024-04-04 17:20:00,43,14,35,33,7,132
2024-04-04 17:30:00,39,20,37,29,6,131
2024-04-04 17:40:00,50,19,52,41,3,165
2024-04-04 17:50:00,44,20,48,28,4,144
2024-04-04 18:00:00,33,21,45,26,6,131
2024-04-04 18:10:00,37,12,46,28,3,126
2024-04-04 18:20:00,44,20,32,23,4,123
2024-04-04 18:30:00,31,12,40,26,3,112
2024-04-04 18:40:00,39,19,35,32,1,126
2024-04-04 18:50:00,33,17,40,27,1,118
2024-04-04 19:00:00,38,17,34,28,3,120
2024-04-04 19:10:00,31,20,38,26,5,120
2024-04-04 19:20:00,25,13,30,22,2,92
2024-04-04 19:30:00,35,13,29,23,1,101
2024-04-04 19:40:00,26,18,24,17,4,89
2024-04-04 19:50:00,26,15,24,16,4,85
2024-04-04 20:00:00,25,15,28,14,0,82
2024-04-04 20:10:00,22,10,14,13,2,61
2024-04-04 20:20:00,26,14,31,27,4,102
2024-04-04 20:30:00,19,9,30,29,3,90
2024-04-04 20:40:00,36,11,20,20,3,90
2024-04-04 20:50:00,33,18,33,17,2,103
2024-04-04 21:00:00,28,14,33,21,2,98
2024-04-04 21:10:00,23,19,27,14,2,85
2024-04-04 21:20:00,30,12,21,9,1,73
2024-04-04 21:30:00,25,15,14,11,0,65
2024-04-04 21:40:00,21,10,16,15,3,65
2024-04-04 21:50:00,15,10,12,13,1,51
2024-04-04 22:00:00,20,8,18,14,0,60
2024-04-04 22:10:00,17,5,24,8,0,54
2024-04-04 22:20:00,14,7,17,8,2,48
2024-04-04 22:30:00,13,3,23,13,1,53
2024-04-04 22:40:00,18,6,9,10,2,45
2024-04-04 22:50:00,22,7,8,13,2,52
2024-04-04 23:00:00,20,6,3,11,1,41
2024-04-04 23:10:00,10,1,5,8,1,25
2024-04-04 23:20:00,13,8,7,17,1,46
2024-04-04 23:30:00,12,4,45,10,1,72
2024-04-04 23:40:00,9,5,9,10,2,35
2024-04-04 23:50:00,9,1,8,13,0,31
2024-04-05 00:00:00,3,1,6,12,0,22
2024-04-05 00:10:00,4,4,8,10,0,26
2024-04-05 00:20:00,3,3,6,6,1,19
2024-04-05 00:30:00,4,1,1,4,0,10
2024-04-05 00:40:00,9,0,5,4,0,18
2024-04-05 00:50:00,7,4,2,7,0,20
2024-04-05 01:00:00,3,2,6,4,0,15
2024-04-05 01:10:00,4,2,1,3,0,10
2024-04-05 01:20:00,6,3,1,3,1,14
2024-04-05 01:30:00,2,0,0,2,0,4
2024-04-05 01:40:00,3,0,3,7,1,14
2024-04-05 01:50:00,5,1,2,1,0,9
2024-04-05 02:00:00,0,0,0,0,0,0
