datetime,D21Z,D22Z,D41Z,D42Z,D11Z,D12Z,D31Z,D32Z,Total
2024-03-01 01:00:00,7,9,7,4,0,0,0,0,27
2024-03-01 01:10:00,4,3,4,2,0,0,0,0,13
2024-03-01 01:20:00,5,5,6,1,0,0,0,0,17
2024-03-01 01:30:00,4,4,3,1,0,0,0,0,12
2024-03-01 01:40:00,1,1,1,0,0,0,1,0,4
2024-03-01 01:50:00,3,2,4,0,0,0,0,0,9
2024-03-01 02:00:00,1,1,1,0,0,0,0,0,3
2024-03-01 02:10:00,3,3,3,1,0,0,0,0,10
2024-03-01 02:20:00,1,2,3,1,0,0,0,0,7
2024-03-01 02:30:00,0,0,0,0,0,0,0,0,0
2024-03-01 02:40:00,0,0,1,1,0,0,0,0,2
2024-03-01 02:50:00,1,1,0,0,0,0,0,0,2
2024-03-01 03:00:00,1,1,3,0,0,0,0,0,5
2024-03-01 03:10:00,2,2,1,0,0,0,0,0,5
2024-03-01 03:20:00,4,4,2,0,0,0,0,0,10
2024-03-01 03:30:00,1,1,4,0,0,0,0,0,6
2024-03-01 03:40:00,3,3,2,0,0,0,0,0,8
2024-03-01 03:50:00,3,3,3,1,0,0,0,0,10
2024-03-01 04:00:00,1,1,1,0,0,0,0,0,3
2024-03-01 04:10:00,2,2,2,0,0,0,0,0,6
2024-03-01 04:20:00,1,1,2,0,0,0,0,0,4
2024-03-01 04:30:00,1,1,0,0,0,0,0,0,2
2024-03-01 04:40:00,1,2,1,0,0,0,0,0,4
2024-03-01 04:50:00,1,1,1,0,0,0,0,0,3
2024-03-01 05:00:00,2,3,1,1,0,0,0,0,7
2024-03-01 05:10:00,6,5,9,0,0,0,1,0,21
2024-03-01 05:20:00,3,3,10,0,0,0,2,0,18
2024-03-01 05:30:00,6,8,3,0,0,0,0,0,17
2024-03-01 05:40:00,7,8,3,0,0,0,0,0,18
2024-03-01 05:50:00,6,6,4,3,0,0,0,0,19
2024-03-01 06:00:00,4,4,10,6,0,0,0,0,24
2024-03-01 06:10:00,10,9,15,7,0,0,1,0,42
2024-03-01 06:20:00,6,5,15,6,0,0,0,0,32
2024-03-01 06:30:00,11,10,19,12,0,0,3,0,55
2024-03-01 06:40:00,18,13,19,13,0,0,1,0,64
2024-03-01 06:50:00,20,17,13,13,0,0,5,0,68
2024-03-01 07:00:00,18,16,18,11,0,0,4,1,68
2024-03-01 07:10:00,28,22,47,7,0,0,5,0,109
2024-03-01 07:20:00,25,19,41,5,0,0,4,0,94
2024-03-01 07:30:00,28,14,25,13,0,0,4,4,88
2024-03-01 07:40:00,41,14,19,7,0,0,6,0,87
2024-03-01 07:50:00,44,34,22,7,0,0,1,0,108
2024-03-01 08:00:00,40,17,21,8,0,0,4,0,90
2024-03-01 08:10:00,39,22,30,6,0,0,2,0,99
2024-03-01 08:20:00,32,17,21,3,0,0,2,0,75
2024-03-01 08:30:00,46,23,23,3,0,0,5,0,100
2024-03-01 08:40:00,48,24,30,5,0,0,4,0,111
2024-03-01 08:50:00,38,28,27,9,0,0,2,0,104
2024-03-01 09:00:00,43,21,21,10,0,0,2,0,97
2024-03-01 09:10:00,46,19,14,2,0,0,4,0,85
2024-03-01 09:20:00,55,35,19,2,0,0,1,0,112
2024-03-01 09:30:00,40,31,26,1,0,0,3,0,101
2024-03-01 09:40:00,41,37,29,2,0,0,1,0,110
2024-03-01 09:50:00,61,39,20,3,0,0,2,0,125
2024-03-01 10:00:00,42,31,18,4,0,0,1,0,96
2024-03-01 10:10:00,46,38,28,4,0,0,2,0,118
2024-03-01 10:20:00,47,34,21,4,0,0,4,1,111
2024-03-01 10:30:00,50,37,22,5,0,0,3,0,117
2024-03-01 10:40:00,39,32,20,2,0,0,2,0,95
2024-03-01 10:50:00,42,33,20,8,0,0,0,0,103
2024-03-01 11:00:00,58,45,25,3,0,0,1,1,133
2024-03-01 11:10:00,81,41,15,1,0,0,7,1,146
2024-03-01 11:20:00,54,24,23,7,0,0,6,1,115
2024-03-01 11:30:00,58,27,18,3,0,0,2,0,108
2024-03-01 11:40:00,68,50,20,9,0,0,1,0,148
2024-03-01 11:50:00,59,44,25,6,0,0,1,0,135
2024-03-01 12:00:00,63,29,25,7,0,0,1,2,127
2024-03-01 12:10:00,68,54,16,5,0,0,2,0,145
2024-03-01 12:20:00,63,43,25,9,0,0,2,0,142
2024-03-01 12:30:00,76,47,33,5,0,0,1,0,162
2024-03-01 12:40:00,57,47,24,12,0,0,5,0,145
2024-03-01 12:50:00,75,54,33,3,0,0,10,0,175
2024-03-01 13:00:00,72,55,29,4,0,0,4,0,164
2024-03-01 13:10:00,84,46,25,2,0,0,7,0,164
2024-03-01 13:20:00,85,54,23,8,0,0,3,1,174
2024-03-01 13:30:00,86,47,23,11,0,0,1,0,168
2024-03-01 13:40:00,58,42,21,4,0,0,6,0,131
2024-03-01 13:50:00,81,49,22,11,0,0,3,4,170
2024-03-01 14:00:00,68,53,27,2,0,0,0,1,151
2024-03-01 14:10:00,83,59,19,3,0,0,1,3,168
2024-03-01 14:20:00,71,46,20,5,0,0,1,0,143
2024-03-01 14:30:00,89,43,25,5,0,0,5,0,167
2024-03-01 14:40:00,68,48,24,3,0,0,9,0,152
2024-03-01 14:50:00,73,48,19,2,0,0,3,1,146
2024-03-01 15:00:00,72,47,15,6,0,0,3,0,143
2024-03-01 15:10:00,78,55,18,4,0,0,5,1,161
2024-03-01 15:20:00,78,57,17,1,0,0,2,0,155
2024-03-01 15:30:00,76,54,17,3,0,0,6,2,158
2024-03-01 15:40:00,53,37,18,2,0,0,4,0,114
2024-03-01 15:50:00,78,55,18,5,0,0,7,0,163
2024-03-01 16:00:00,65,51,27,1,0,0,3,0,147
2024-03-01 16:10:00,77,46,23,1,0,0,3,0,150
2024-03-01 16:20:00,77,50,18,1,0,0,3,0,149
2024-03-01 16:30:00,91,52,21,3,0,0,3,0,170
2024-03-01 16:40:00,74,57,15,2,0,0,1,0,149
2024-03-01 16:50:00,85,50,20,3,0,0,3,0,161
2024-03-01 17:00:00,68,53,16,4,0,0,2,0,143
2024-03-01 17:10:00,60,42,37,0,0,0,4,0,143
2024-03-01 17:20:00,71,55,20,2,0,0,2,1,151
2024-03-01 17:30:00,88,50,31,3,0,0,2,0,174
2024-03-01 17:40:00,68,53,17,1,0,0,0,0,139
2024-03-01 17:50:00,77,53,18,4,0,0,3,0,155
2024-03-01 18:00:00,74,44,26,2,0,0,0,0,146
2024-03-01 18:10:00,76,45,20,6,0,0,4,0,151
2024-03-01 18:20:00,66,39,18,25,0,0,2,0,150
2024-03-01 18:30:00,75,40,16,3,0,0,1,0,135
2024-03-01 18:40:00,54,33,21,2,0,0,2,0,112
2024-03-01 18:50:00,76,45,13,4,0,0,1,0,139
2024-03-01 19:00:00,42,29,17,0,0,0,3,0,91
2024-03-01 19:10:00,47,37,18,5,0,0,1,0,108
2024-03-01 19:20:00,55,40,30,5,0,0,0,0,130
2024-03-01 19:30:00,56,31,15,6,0,0,4,0,112
2024-03-01 19:40:00,65,44,14,2,0,0,1,0,126
2024-03-01 19:50:00,31,29,18,2,0,0,2,0,82
2024-03-01 20:00:00,46,32,11,3,0,0,0,0,92
2024-03-01 20:10:00,40,37,14,1,0,0,1,0,93
2024-03-01 20:20:00,32,27,14,2,0,0,1,0,76
2024-03-01 20:30:00,35,19,11,1,0,0,2,0,68
2024-03-01 20:40:00,36,28,16,3,0,0,3,0,86
2024-03-01 20:50:00,31,27,14,2,0,0,1,1,76
2024-03-01 21:00:00,33,21,13,4,0,0,0,0,71
2024-03-01 21:10:00,35,28,14,5,0,0,0,0,82
2024-03-01 21:20:00,33,26,16,5,0,0,1,0,81
2024-03-01 21:30:00,22,20,12,3,0,0,0,0,57
2024-03-01 21:40:00,42,26,7,0,0,0,0,0,75
2024-03-01 21:50:00,38,35,12,2,0,0,1,0,88
2024-03-01 22:00:00,18,20,7,2,0,0,0,0,47
2024-03-01 22:10:00,38,29,11,4,0,0,0,0,82
2024-03-01 22:20:00,25,28,11,1,0,0,0,0,65
2024-03-01 22:30:00,38,26,5,1,0,0,1,0,71
2024-03-01 22:40:00,26,18,8,6,0,0,0,0,58
2024-03-01 22:50:00,33,28,8,3,0,0,0,0,72
2024-03-01 23:00:00,21,17,8,1,0,0,1,0,48
2024-03-01 23:10:00,20,13,7,2,0,0,0,0,42
2024-03-01 23:20:00,14,12,11,3,0,0,0,0,40
2024-03-01 23:30:00,18,17,7,2,0,0,0,0,44
2024-03-01 23:40:00,20,15,10,1,0,0,0,0,46
2024-03-01 23:50:00,16,15,10,0,0,0,1,0,42
2024-03-02 00:00:00,20,15,7,1,0,0,0,0,43
2024-03-02 00:10:00,15,14,6,3,0,0,0,0,38
2024-03-02 00:20:00,12,10,11,2,0,0,0,0,35
2024-03-02 00:30:00,12,13,5,0,0,0,0,0,30
2024-03-02 00:40:00,11,12,8,1,0,0,0,0,32
2024-03-02 00:50:00,8,7,5,0,0,0,0,0,20
2024-03-02 01:00:00,10,11,4,3,0,0,0,0,28
2024-03-02 01:10:00,10,9,9,3,0,0,0,0,31
2024-03-02 01:20:00,5,6,3,0,0,0,1,0,15
2024-03-02 01:30:00,7,6,4,0,0,0,0,0,17
2024-03-02 01:40:00,6,6,6,0,0,0,0,0,18
2024-03-02 01:50:00,11,11,7,3,0,0,0,0,32
2024-03-02 02:00:00,10,10,1,0,0,0,0,0,21
2024-03-02 02:10:00,5,5,2,1,0,0,0,0,13
2024-03-02 02:20:00,10,12,6,2,0,0,0,0,30
2024-03-02 02:30:00,6,6,2,1,0,0,0,0,15
2024-03-02 02:40:00,6,5,0,0,0,0,0,0,11
2024-03-02 02:50:00,4,3,2,1,0,0,0,0,10
2024-03-02 03:00:00,4,4,1,0,0,0,0,0,9
2024-03-02 03:10:00,3,3,2,1,0,0,0,0,9
2024-03-02 03:20:00,2,2,3,1,0,0,1,0,9
2024-03-02 03:30:00,4,5,3,2,0,0,0,0,14
2024-03-02 03:40:00,6,6,1,1,0,0,0,0,14
2024-03-02 03:50:00,4,4,3,0,0,0,0,0,11
2024-03-02 04:00:00,5,6,3,1,0,0,0,0,15
2024-03-02 04:10:00,1,1,3,1,0,0,0,0,6
2024-03-02 04:20:00,3,2,2,1,0,0,0,0,8
2024-03-02 04:30:00,3,3,4,1,0,0,0,0,11
2024-03-02 04:40:00,1,2,1,1,0,0,0,0,5
2024-03-02 04:50:00,2,3,4,1,0,0,0,0,10
2024-03-02 05:00:00,2,3,4,1,0,0,0,0,10
2024-03-02 05:10:00,0,0,2,0,0,0,1,0,3
2024-03-02 05:20:00,2,2,5,0,0,0,0,0,9
2024-03-02 05:30:00,1,1,3,0,0,0,0,0,5
2024-03-02 05:40:00,5,4,2,1,0,0,0,0,12
2024-03-02 05:50:00,2,2,3,0,0,0,0,0,7
2024-03-02 06:00:00,4,5,2,0,0,0,0,0,11
2024-03-02 06:10:00,3,3,4,1,0,0,0,0,11
2024-03-02 06:20:00,2,1,8,10,0,0,0,0,21
2024-03-02 06:30:00,7,7,7,5,0,0,0,0,26
2024-03-02 06:40:00,8,7,4,2,0,0,0,0,21
2024-03-02 06:50:00,6,7,10,0,0,0,0,0,23
2024-03-02 07:00:00,5,5,4,0,0,0,0,0,14
2024-03-02 07:10:00,6,5,7,2,0,0,2,0,22
2024-03-02 07:20:00,2,2,6,0,0,0,0,0,10
2024-03-02 07:30:00,10,10,10,1,0,0,0,1,32
2024-03-02 07:40:00,14,12,13,1,0,0,1,1,42
2024-03-02 07:50:00,9,9,12,2,0,0,1,0,33
2024-03-02 08:00:00,11,11,11,0,0,0,0,0,33
2024-03-02 08:10:00,14,15,15,0,0,0,0,0,44
2024-03-02 08:20:00,18,17,11,0,0,0,0,0,46
2024-03-02 08:30:00,22,17,11,2,0,0,0,0,52
2024-03-02 08:40:00,26,26,9,0,0,0,1,0,62
2024-03-02 08:50:00,31,29,16,5,0,0,1,0,82
2024-03-02 09:00:00,24,23,8,2,0,0,2,0,59
2024-03-02 09:10:00,29,27,18,1,0,0,0,0,75
2024-03-02 09:20:00,30,23,16,2,0,0,2,0,73
2024-03-02 09:30:00,32,32,14,2,0,0,0,0,80
2024-03-02 09:40:00,39,37,21,13,0,0,1,0,111
2024-03-02 09:50:00,54,41,21,9,0,0,2,0,127
2024-03-02 10:00:00,54,39,18,8,0,0,3,0,122
2024-03-02 10:10:00,46,34,22,6,0,0,1,0,109
2024-03-02 10:20:00,49,43,15,7,0,0,3,0,117
2024-03-02 10:30:00,51,35,22,3,0,0,3,0,114
2024-03-02 10:40:00,41,30,28,5,0,0,2,1,107
2024-03-02 10:50:00,58,36,12,5,0,0,1,0,112
2024-03-02 11:00:00,56,29,16,3,0,0,2,0,106
2024-03-02 11:10:00,46,36,16,3,0,0,5,0,106
2024-03-02 11:20:00,59,49,22,3,0,0,1,0,134
2024-03-02 11:30:00,147,39,16,2,0,0,4,0,208
2024-03-02 11:40:00,53,43,16,3,0,0,4,0,119
2024-03-02 11:50:00,63,45,21,1,0,0,5,1,136
2024-03-02 12:00:00,44,39,19,3,0,0,3,0,108
2024-03-02 12:10:00,70,35,20,2,0,0,3,0,130
2024-03-02 12:20:00,55,37,16,3,0,0,4,0,115
2024-03-02 12:30:00,133,47,13,4,0,0,7,0,204
2024-03-02 12:40:00,56,41,18,4,0,0,3,0,122
2024-03-02 12:50:00,104,31,15,2,0,0,1,1,154
2024-03-02 13:00:00,82,40,30,2,0,0,3,1,158
2024-03-02 13:10:00,58,27,32,1,0,0,2,0,120
2024-03-02 13:20:00,63,33,30,1,0,0,3,0,130
2024-03-02 13:30:00,55,30,24,1,0,0,3,2,115
2024-03-02 13:40:00,60,33,17,1,0,0,2,0,113
2024-03-02 13:50:00,51,34,20,5,0,0,4,0,114
2024-03-02 14:00:00,52,29,25,3,0,0,0,0,109
2024-03-02 14:10:00,57,46,31,4,0,0,3,0,141
2024-03-02 14:20:00,63,42,12,2,0,0,6,0,125
2024-03-02 14:30:00,134,39,20,3,0,0,3,1,200
2024-03-02 14:40:00,61,39,10,6,0,0,4,1,121
2024-03-02 14:50:00,70,45,19,4,0,0,6,1,145
2024-03-02 15:00:00,59,50,25,1,0,0,1,0,136
2024-03-02 15:10:00,176,40,16,2,0,0,2,2,238
2024-03-02 15:20:00,58,42,22,3,0,0,3,2,130
2024-03-02 15:30:00,71,54,29,3,0,0,4,1,162
2024-03-02 15:40:00,56,44,30,4,0,0,5,1,140
2024-03-02 15:50:00,50,39,11,1,0,0,2,1,104
2024-03-02 16:00:00,62,41,13,4,0,0,5,0,125
2024-03-02 16:10:00,52,41,33,3,0,0,3,0,132
2024-03-02 16:20:00,47,33,13,3,0,0,1,0,97
2024-03-02 16:30:00,57,28,15,5,0,0,3,0,108
2024-03-02 16:40:00,35,27,14,3,0,0,4,0,83
2024-03-02 16:50:00,43,26,18,2,0,0,7,0,96
2024-03-02 17:00:00,50,35,17,2,0,0,3,0,107
2024-03-02 17:10:00,165,32,14,2,0,0,0,0,213
2024-03-02 17:20:00,58,33,13,0,0,0,3,0,107
2024-03-02 17:30:00,68,38,21,2,0,0,1,0,130
2024-03-02 17:40:00,98,42,17,4,0,0,2,0,163
2024-03-02 17:50:00,99,41,12,0,0,0,2,0,154
2024-03-02 18:00:00,72,49,18,8,0,0,1,0,148
2024-03-02 18:10:00,57,37,21,3,0,0,7,1,126
2024-03-02 18:20:00,60,37,18,4,0,0,4,0,123
2024-03-02 18:30:00,64,49,23,1,0,0,4,0,141
2024-03-02 18:40:00,77,42,21,2,0,0,3,1,146
2024-03-02 18:50:00,52,37,12,2,0,0,3,0,106
2024-03-02 19:00:00,54,38,10,3,0,0,0,0,105
2024-03-02 19:10:00,53,38,12,5,0,0,4,0,112
2024-03-02 19:20:00,51,49,22,3,0,0,3,0,128
2024-03-02 19:30:00,33,24,20,3,0,0,2,0,82
2024-03-02 19:40:00,45,36,10,3,0,0,1,0,95
2024-03-02 19:50:00,33,32,10,10,0,0,2,0,87
2024-03-02 20:00:00,43,27,14,2,0,0,1,0,87
2024-03-02 20:10:00,29,23,16,4,0,0,0,0,72
2024-03-02 20:20:00,29,24,14,2,0,0,0,0,69
2024-03-02 20:30:00,72,31,11,4,0,0,0,0,118
2024-03-02 20:40:00,33,26,14,3,0,0,1,0,77
2024-03-02 20:50:00,34,33,17,1,0,0,0,0,85
2024-03-02 21:00:00,31,25,8,1,0,0,0,0,65
2024-03-02 21:10:00,37,29,6,3,0,0,1,0,76
2024-03-02 21:20:00,21,16,10,7,0,0,1,0,55
2024-03-02 21:30:00,29,26,6,1,0,0,0,0,62
2024-03-02 21:40:00,26,24,11,8,0,0,0,0,69
2024-03-02 21:50:00,15,13,9,4,0,0,0,0,41
2024-03-02 22:00:00,22,21,15,2,0,0,0,0,60
2024-03-02 22:10:00,26,20,7,3,0,0,0,0,56
2024-03-02 22:20:00,29,25,18,3,0,0,1,0,76
2024-03-02 22:30:00,24,13,7,0,0,0,0,0,44
2024-03-02 22:40:00,28,27,11,0,0,0,0,0,66
2024-03-02 22:50:00,28,21,10,1,0,0,0,0,60
2024-03-02 23:00:00,22,16,8,2,0,0,0,0,48
2024-03-02 23:10:00,21,20,9,2,0,0,1,0,53
2024-03-02 23:20:00,22,18,13,2,0,0,0,0,55
2024-03-02 23:30:00,16,14,7,3,0,0,0,0,40
2024-03-02 23:40:00,14,14,7,3,0,0,0,0,38
2024-03-02 23:50:00,11,11,7,2,0,0,0,0,31
2024-03-03 00:00:00,28,23,6,3,0,0,1,0,61
2024-03-03 00:10:00,8,8,13,2,0,0,0,0,31
2024-03-03 00:20:00,16,16,5,0,0,0,1,0,38
2024-03-03 00:30:00,12,12,6,4,0,0,0,0,34
2024-03-03 00:40:00,14,15,7,1,0,0,0,0,37
2024-03-03 00:50:00,20,19,10,5,0,0,1,0,55
2024-03-03 01:00:00,5,6,3,1,0,0,0,0,15
2024-03-03 01:10:00,12,12,5,0,0,0,0,0,29
2024-03-03 01:20:00,11,11,5,2,0,0,0,0,29
2024-03-03 01:30:00,8,8,3,1,0,0,0,0,20
2024-03-03 01:40:00,11,14,5,0,0,0,0,0,30
2024-03-03 01:50:00,15,14,3,1,0,0,0,0,33
2024-03-03 02:00:00,12,10,6,1,0,0,0,0,29
2024-03-03 02:10:00,10,11,4,1,0,0,0,0,26
2024-03-03 02:20:00,7,9,6,3,0,0,0,0,25
2024-03-03 02:30:00,3,3,4,2,0,0,0,0,12
2024-03-03 02:40:00,3,4,6,0,0,0,0,0,13
2024-03-03 02:50:00,6,7,1,0,0,0,0,0,14
2024-03-03 03:00:00,8,8,5,2,0,0,0,0,23
2024-03-03 03:10:00,7,7,7,0,0,0,0,0,21
2024-03-03 03:20:00,6,7,5,3,0,0,0,0,21
2024-03-03 03:30:00,6,6,5,2,0,0,0,0,19
2024-03-03 03:40:00,2,2,3,0,0,0,0,0,7
2024-03-03 03:50:00,5,7,3,1,0,0,0,0,16
2024-03-03 04:00:00,2,2,4,3,0,0,0,0,11
2024-03-03 04:10:00,5,5,3,1,0,0,0,0,14
2024-03-03 04:20:00,2,2,2,1,0,0,0,0,7
2024-03-03 04:30:00,0,0,1,0,0,0,0,0,1
2024-03-03 04:40:00,2,2,4,0,0,0,0,0,8
2024-03-03 04:50:00,4,5,3,1,0,0,0,0,13
2024-03-03 05:00:00,2,2,1,0,0,0,0,0,5
2024-03-03 05:10:00,4,4,5,2,0,0,0,0,15
2024-03-03 05:20:00,1,1,3,1,0,0,0,0,6
2024-03-03 05:30:00,4,4,1,1,0,0,0,0,10
2024-03-03 05:40:00,2,2,1,0,0,0,0,0,5
2024-03-03 05:50:00,3,3,3,0,0,0,0,0,9
2024-03-03 06:00:00,2,2,1,0,0,0,0,0,5
2024-03-03 06:10:00,0,0,4,0,0,0,0,0,4
2024-03-03 06:20:00,3,3,1,0,0,0,0,0,7
2024-03-03 06:30:00,2,2,2,1,0,0,0,0,7
2024-03-03 06:40:00,8,7,3,0,0,0,0,0,18
2024-03-03 06:50:00,3,4,4,1,0,0,0,0,12
2024-03-03 07:00:00,4,4,0,0,0,0,0,0,8
2024-03-03 07:10:00,3,3,4,0,0,0,0,0,10
2024-03-03 07:20:00,6,6,5,2,0,0,1,0,20
2024-03-03 07:30:00,8,8,3,0,0,0,1,0,20
2024-03-03 07:40:00,3,3,4,1,0,0,1,0,12
2024-03-03 07:50:00,6,5,4,0,0,0,0,0,15
2024-03-03 08:00:00,3,3,0,0,0,0,0,0,6
2024-03-03 08:10:00,11,10,3,1,0,0,0,0,25
2024-03-03 08:20:00,16,12,8,0,0,0,0,0,36
2024-03-03 08:30:00,9,9,2,0,0,0,0,0,20
2024-03-03 08:40:00,9,8,10,1,0,0,0,0,28
2024-03-03 08:50:00,8,7,9,4,0,0,0,0,28
2024-03-03 09:00:00,11,11,12,6,0,0,1,0,41
2024-03-03 09:10:00,20,18,22,15,0,0,1,0,76
2024-03-03 09:20:00,25,20,31,13,0,0,1,0,90
2024-03-03 09:30:00,14,11,17,10,0,0,3,0,55
2024-03-03 09:40:00,25,19,13,1,0,0,3,0,61
2024-03-03 09:50:00,28,22,12,1,0,0,2,0,65
2024-03-03 10:00:00,31,28,15,2,0,0,4,0,80
2024-03-03 10:10:00,23,17,9,0,0,0,4,0,53
2024-03-03 10:20:00,19,15,9,2,0,0,2,1,48
2024-03-03 10:30:00,26,23,10,2,0,0,3,0,64
2024-03-03 10:40:00,30,27,13,3,0,0,2,0,75
2024-03-03 10:50:00,31,19,15,2,0,0,3,0,70
2024-03-03 11:00:00,35,23,10,1,0,0,1,0,70
2024-03-03 11:10:00,28,26,11,1,0,0,3,1,70
2024-03-03 11:20:00,28,23,18,5,0,0,1,0,75
2024-03-03 11:30:00,33,28,15,1,0,0,1,0,78
2024-03-03 11:40:00,41,29,22,2,0,0,3,0,97
2024-03-03 11:50:00,40,25,11,2,0,0,4,2,84
2024-03-03 12:00:00,36,23,16,4,0,0,2,0,81
2024-03-03 12:10:00,36,25,16,6,0,0,2,0,85
2024-03-03 12:20:00,43,37,18,12,0,0,4,1,115
2024-03-03 12:30:00,52,34,17,7,0,0,2,0,112
2024-03-03 12:40:00,42,31,16,2,0,0,2,0,93
2024-03-03 12:50:00,48,36,6,5,0,0,0,0,95
2024-03-03 13:00:00,44,32,2,0,0,0,1,0,79
2024-03-03 13:10:00,50,21,10,4,0,0,1,0,86
2024-03-03 13:20:00,43,28,19,2,0,0,5,0,97
2024-03-03 13:30:00,49,25,9,4,0,0,4,0,91
2024-03-03 13:40:00,48,25,16,5,0,0,2,0,96
2024-03-03 13:50:00,59,26,11,3,0,0,4,0,103
2024-03-03 14:00:00,53,27,18,6,0,0,3,1,108
2024-03-03 14:10:00,46,24,19,7,0,0,0,1,97
2024-03-03 14:20:00,49,32,10,2,0,0,4,0,97
2024-03-03 14:30:00,38,26,11,9,0,0,3,0,87
2024-03-03 14:40:00,62,34,17,2,0,0,3,0,118
2024-03-03 14:50:00,61,21,18,6,0,0,3,0,109
2024-03-03 15:00:00,50,34,20,4,0,0,2,1,111
2024-03-03 15:10:00,43,35,18,6,0,0,2,0,104
2024-03-03 15:20:00,55,28,11,14,0,0,2,2,112
2024-03-03 15:30:00,39,21,15,18,0,0,0,1,94
2024-03-03 15:40:00,53,29,15,3,0,0,3,0,103
2024-03-03 15:50:00,47,27,18,5,0,0,4,0,101
2024-03-03 16:00:00,49,23,15,14,0,0,3,0,104
2024-03-03 16:10:00,51,27,18,29,0,0,2,0,127
2024-03-03 16:20:00,43,31,21,14,0,0,1,0,110
2024-03-03 16:30:00,39,24,18,8,0,0,3,0,92
2024-03-03 16:40:00,41,28,23,4,0,0,6,1,103
2024-03-03 16:50:00,41,28,16,3,0,0,3,0,91
2024-03-03 17:00:00,44,25,14,2,0,0,1,0,86
2024-03-03 17:10:00,49,31,12,3,0,0,1,0,96
2024-03-03 17:20:00,47,19,13,2,0,0,2,2,85
2024-03-03 17:30:00,42,28,20,0,0,0,1,0,91
2024-03-03 17:40:00,52,32,21,2,0,0,4,1,112
2024-03-03 17:50:00,30,24,15,3,0,0,5,1,78
2024-03-03 18:00:00,44,23,7,1,0,0,2,0,77
2024-03-03 18:10:00,48,21,12,2,0,0,1,2,86
2024-03-03 18:20:00,33,26,12,12,0,0,3,0,86
2024-03-03 18:30:00,29,27,16,0,0,0,1,0,73
2024-03-03 18:40:00,31,23,13,2,0,0,1,0,70
2024-03-03 18:50:00,37,28,12,0,0,0,1,0,78
2024-03-03 19:00:00,32,31,9,1,0,0,3,0,76
2024-03-03 19:10:00,32,19,20,2,0,0,2,0,75
2024-03-03 19:20:00,27,17,11,2,0,0,0,0,57
2024-03-03 19:30:00,32,19,12,0,0,0,2,1,66
2024-03-03 19:40:00,41,32,19,1,0,0,1,0,94
2024-03-03 19:50:00,19,16,7,0,0,0,1,0,43
2024-03-03 20:00:00,39,31,15,3,0,0,0,1,89
2024-03-03 20:10:00,30,23,9,0,0,0,1,0,63
2024-03-03 20:20:00,23,22,8,4,0,0,2,0,59
2024-03-03 20:30:00,19,17,10,1,0,0,0,0,47
2024-03-03 20:40:00,23,16,12,0,0,0,1,0,52
2024-03-03 20:50:00,19,20,6,2,0,0,3,0,50
2024-03-03 21:00:00,29,23,12,2,0,0,3,0,69
2024-03-03 21:10:00,20,19,5,3,0,0,1,0,48
2024-03-03 21:20:00,27,20,5,1,0,0,1,0,54
2024-03-03 21:30:00,20,16,4,3,0,0,0,0,43
2024-03-03 21:40:00,8,9,8,2,0,0,0,0,27
2024-03-03 21:50:00,24,21,9,0,0,0,0,0,54
2024-03-03 22:00:00,17,17,5,1,0,0,0,0,40
2024-03-03 22:10:00,29,26,6,0,0,0,1,0,62
2024-03-03 22:20:00,20,16,9,7,0,0,0,0,52
2024-03-03 22:30:00,10,13,6,0,0,0,0,0,29
2024-03-03 22:40:00,13,11,8,8,0,0,0,0,40
2024-03-03 22:50:00,3,3,6,2,0,0,0,0,14
2024-03-03 23:00:00,10,7,5,0,0,0,0,0,22
2024-03-03 23:10:00,4,4,6,2,0,0,0,0,16
2024-03-03 23:20:00,6,6,4,0,0,0,0,0,16
2024-03-03 23:30:00,4,3,4,2,0,0,0,0,13
2024-03-03 23:40:00,6,6,1,0,0,0,0,0,13
2024-03-03 23:50:00,7,5,5,2,0,0,0,0,19
2024-03-04 00:00:00,2,1,3,2,0,0,0,0,8
2024-03-04 00:10:00,6,6,1,0,0,0,0,0,13
2024-03-04 00:20:00,5,6,2,1,0,0,1,0,15
2024-03-04 00:30:00,3,3,2,2,0,0,0,0,10
2024-03-04 00:40:00,2,2,3,0,0,0,0,0,7
2024-03-04 00:50:00,1,1,3,1,0,0,0,0,6
2024-03-04 01:00:00,3,3,4,3,0,0,0,0,13
2024-03-04 01:10:00,2,2,3,2,0,0,0,0,9
2024-03-04 01:20:00,2,2,4,0,0,0,0,0,8
2024-03-04 01:30:00,2,2,2,1,0,0,0,0,7
2024-03-04 01:40:00,1,1,1,0,0,0,0,0,3
2024-03-04 01:50:00,2,2,1,0,0,0,0,0,5
2024-03-04 02:00:00,1,1,2,2,0,0,0,0,6
2024-03-04 02:10:00,2,2,0,0,0,0,0,0,4
2024-03-04 02:20:00,2,2,5,0,0,0,0,0,9
2024-03-04 02:30:00,4,5,2,1,0,0,0,0,12
2024-03-04 02:40:00,0,0,0,0,0,0,0,0,0
2024-03-04 02:50:00,3,3,1,0,0,0,0,0,7
2024-03-04 03:00:00,0,0,1,0,0,0,0,0,1
2024-03-04 03:10:00,1,1,0,0,0,0,0,0,2
2024-03-04 03:20:00,0,0,1,0,0,0,0,0,1
2024-03-04 03:30:00,0,0,1,0,0,0,0,0,1
2024-03-04 03:40:00,1,1,0,0,0,0,0,0,2
2024-03-04 03:50:00,1,1,0,0,0,0,0,0,2
2024-03-04 04:00:00,2,3,1,0,0,0,0,0,6
2024-03-04 04:10:00,2,3,2,2,0,0,0,0,9
2024-03-04 04:20:00,0,0,2,0,0,0,0,0,2
2024-03-04 04:30:00,0,0,0,0,0,0,0,0,0
2024-03-04 04:40:00,1,1,2,0,0,0,0,0,4
2024-03-04 04:50:00,3,3,3,3,0,0,0,0,12
2024-03-04 05:00:00,3,4,3,3,0,0,0,0,13
2024-03-04 05:10:00,6,6,12,2,0,0,0,0,26
2024-03-04 05:20:00,2,2,6,0,0,0,0,0,10
2024-03-04 05:30:00,2,2,5,0,0,0,0,0,9
2024-03-04 05:40:00,3,3,2,1,0,0,0,0,9
2024-03-04 05:50:00,8,10,6,1,0,0,1,0,26
2024-03-04 06:00:00,4,4,9,2,0,0,0,0,19
2024-03-04 06:10:00,12,10,10,6,0,0,1,0,39
2024-03-04 06:20:00,11,11,14,5,0,0,0,0,41
2024-03-04 06:30:00,11,11,19,3,0,0,3,0,47
2024-03-04 06:40:00,17,16,18,16,0,0,1,0,68
2024-03-04 06:50:00,10,8,20,12,0,0,3,0,53
2024-03-04 07:00:00,18,12,20,14,0,0,5,1,70
2024-03-04 07:10:00,30,26,60,1,0,0,2,1,120
2024-03-04 07:20:00,37,24,43,6,0,0,3,3,116
2024-03-04 07:30:00,40,21,32,7,0,0,4,0,104
2024-03-04 07:40:00,40,25,29,7,0,0,3,0,104
2024-03-04 07:50:00,38,24,18,8,0,0,8,1,97
2024-03-04 08:00:00,31,21,18,9,0,0,4,0,83
2024-03-04 08:10:00,42,22,31,9,0,0,5,5,114
2024-03-04 08:20:00,37,22,17,5,0,0,1,0,82
2024-03-04 08:30:00,53,29,32,4,0,0,4,0,122
2024-03-04 08:40:00,41,32,20,6,0,0,2,0,101
2024-03-04 08:50:00,60,33,17,10,0,0,8,0,128
2024-03-04 09:00:00,41,24,16,10,0,0,2,0,93
2024-03-04 09:10:00,40,30,19,1,0,0,3,0,93
2024-03-04 09:20:00,48,25,26,2,0,0,1,0,102
2024-03-04 09:30:00,38,24,18,1,0,0,2,0,83
2024-03-04 09:40:00,54,36,14,4,0,0,0,0,108
2024-03-04 09:50:00,36,28,14,1,0,0,2,0,81
2024-03-04 10:00:00,34,24,19,2,0,0,2,0,81
2024-03-04 10:10:00,45,38,24,8,0,0,0,1,116
2024-03-04 10:20:00,43,35,22,5,0,0,2,0,107
2024-03-04 10:30:00,50,36,19,2,0,0,1,0,108
2024-03-04 10:40:00,56,36,20,5,0,0,1,0,118
2024-03-04 10:50:00,58,39,25,8,0,0,1,0,131
2024-03-04 11:00:00,57,46,17,3,0,0,3,0,126
2024-03-04 11:10:00,58,41,12,2,0,0,2,0,115
2024-03-04 11:20:00,41,31,30,2,0,0,2,1,107
2024-03-04 11:30:00,57,48,21,4,0,0,6,0,136
2024-03-04 11:40:00,51,36,17,4,0,0,0,0,108
2024-03-04 11:50:00,42,31,16,2,0,0,2,0,93
2024-03-04 12:00:00,59,32,25,5,0,0,1,0,122
2024-03-04 12:10:00,59,38,22,8,0,0,3,1,131
2024-03-04 12:20:00,57,38,21,2,0,0,1,0,119
2024-03-04 12:30:00,56,38,32,5,0,0,5,0,136
2024-03-04 12:40:00,63,38,21,5,0,0,3,0,130
2024-03-04 12:50:00,59,31,20,5,0,0,4,0,119
2024-03-04 13:00:00,68,41,26,12,0,0,1,0,148
2024-03-04 13:10:00,62,28,17,6,0,0,5,2,120
2024-03-04 13:20:00,62,47,27,10,0,0,1,0,147
2024-03-04 13:30:00,56,36,26,9,0,0,5,1,133
2024-03-04 13:40:00,52,33,17,11,0,0,1,4,118
2024-03-04 13:50:00,61,35,28,9,0,0,2,2,137
2024-03-04 14:00:00,61,39,15,6,0,0,1,0,122
2024-03-04 14:10:00,67,35,16,2,0,0,10,3,133
2024-03-04 14:20:00,48,47,21,8,0,0,1,0,125
2024-03-04 14:30:00,53,30,13,2,0,0,3,0,101
2024-03-04 14:40:00,54,35,15,5,0,0,7,0,116
2024-03-04 14:50:00,65,40,15,6,0,0,2,0,128
2024-03-04 15:00:00,62,41,26,4,0,0,4,0,137
2024-03-04 15:10:00,56,38,19,3,0,0,2,0,118
2024-03-04 15:20:00,73,48,17,3,0,0,2,0,143
2024-03-04 15:30:00,61,37,15,6,0,0,4,0,123
2024-03-04 15:40:00,70,55,20,4,0,0,1,0,150
2024-03-04 15:50:00,68,42,20,9,0,0,5,0,144
2024-03-04 16:00:00,66,44,15,7,0,0,3,0,135
2024-03-04 16:10:00,67,46,28,5,0,0,3,0,149
2024-03-04 16:20:00,97,51,17,3,0,0,1,0,169
2024-03-04 16:30:00,70,42,19,5,0,0,5,1,142
2024-03-04 16:40:00,72,46,19,1,0,0,6,0,144
2024-03-04 16:50:00,77,46,36,6,0,0,1,0,166
2024-03-04 17:00:00,84,52,13,2,0,0,2,0,153
2024-03-04 17:10:00,68,47,25,4,0,0,2,0,146
2024-03-04 17:20:00,95,45,20,3,0,0,2,0,165
2024-03-04 17:30:00,79,62,13,1,0,0,2,0,157
2024-03-04 17:40:00,94,55,22,6,0,0,2,0,179
2024-03-04 17:50:00,64,50,18,5,0,0,5,0,142
2024-03-04 18:00:00,70,42,23,2,0,0,3,0,140
2024-03-04 18:10:00,67,43,12,17,0,0,3,0,142
2024-03-04 18:20:00,73,35,13,9,0,0,2,0,132
2024-03-04 18:30:00,71,57,16,6,0,0,2,0,152
2024-03-04 18:40:00,57,33,25,8,0,0,2,1,126
2024-03-04 18:50:00,62,34,14,9,0,0,0,0,119
2024-03-04 19:00:00,41,26,15,3,0,0,2,0,87
2024-03-04 19:10:00,47,31,13,0,0,0,3,0,94
2024-03-04 19:20:00,43,32,15,2,0,0,5,0,97
2024-03-04 19:30:00,43,35,22,5,0,0,1,0,106
2024-03-04 19:40:00,42,35,20,8,0,0,3,0,108
2024-03-04 19:50:00,51,40,14,3,0,0,2,0,110
2024-03-04 20:00:00,40,20,9,0,0,0,2,0,71
2024-03-04 20:10:00,47,36,13,5,0,0,2,0,103
2024-03-04 20:20:00,28,23,9,1,0,0,2,0,63
2024-03-04 20:30:00,27,21,13,8,0,0,4,0,73
2024-03-04 20:40:00,27,28,10,4,0,0,1,0,70
2024-03-04 20:50:00,35,25,9,0,0,0,2,0,71
2024-03-04 21:00:00,32,26,9,0,0,0,1,0,68
2024-03-04 21:10:00,30,25,11,3,0,0,0,0,69
2024-03-04 21:20:00,20,20,19,6,0,0,1,0,66
2024-03-04 21:30:00,24,17,8,3,0,0,0,0,52
2024-03-04 21:40:00,18,19,6,4,0,0,1,0,48
2024-03-04 21:50:00,25,22,10,0,0,0,0,0,57
2024-03-04 22:00:00,22,20,8,1,0,0,0,0,51
2024-03-04 22:10:00,35,34,9,0,0,0,0,0,78
2024-03-04 22:20:00,25,13,4,0,0,0,0,0,42
2024-03-04 22:30:00,30,26,6,2,0,0,1,0,65
2024-03-04 22:40:00,18,16,6,0,0,0,1,0,41
2024-03-04 22:50:00,18,19,5,2,0,0,0,0,44
2024-03-04 23:00:00,12,14,4,1,0,0,0,0,31
2024-03-04 23:10:00,12,10,5,1,0,0,0,0,28
2024-03-04 23:20:00,11,7,7,5,0,0,0,0,30
2024-03-04 23:30:00,9,8,5,0,0,0,0,0,22
2024-03-04 23:40:00,10,8,2,3,0,0,0,0,23
2024-03-04 23:50:00,10,10,4,6,0,0,0,0,30
2024-03-05 00:00:00,8,8,6,8,0,0,1,0,31
2024-03-05 00:10:00,5,5,1,3,0,0,0,0,14
2024-03-05 00:20:00,5,5,3,0,0,0,0,0,13
2024-03-05 00:30:00,1,1,3,2,0,0,0,0,7
2024-03-05 00:40:00,4,4,3,3,0,0,0,0,14
2024-03-05 00:50:00,7,7,4,6,0,0,0,0,24
2024-03-05 01:00:00,1,1,0,1,0,0,0,0,3
2024-03-05 01:10:00,2,2,0,1,0,0,0,0,5
2024-03-05 01:20:00,0,0,2,0,0,0,0,0,2
2024-03-05 01:30:00,0,0,1,0,0,0,0,0,1
2024-03-05 01:40:00,1,1,1,1,0,0,0,0,4
2024-03-05 01:50:00,4,7,4,4,0,0,0,0,19
2024-03-05 02:00:00,1,1,2,1,0,0,0,0,5
2024-03-05 02:10:00,2,3,3,1,0,0,0,0,9
2024-03-05 02:20:00,1,1,0,0,0,0,0,0,2
2024-03-05 02:30:00,1,1,0,0,0,0,0,0,2
2024-03-05 02:40:00,3,3,1,1,0,0,0,0,8
2024-03-05 02:50:00,1,1,1,0,0,0,0,0,3
2024-03-05 03:00:00,0,0,1,1,0,0,0,0,2
2024-03-05 03:10:00,3,4,2,0,0,0,0,0,9
2024-03-05 03:20:00,1,1,0,0,0,0,0,0,2
2024-03-05 03:30:00,1,1,1,0,0,0,0,0,3
2024-03-05 03:40:00,1,1,0,0,0,0,0,0,2
2024-03-05 03:50:00,1,2,1,0,0,0,0,0,4
2024-03-05 04:00:00,2,2,1,1,0,0,0,0,6
2024-03-05 04:10:00,0,0,0,0,0,0,0,0,0
2024-03-05 04:20:00,2,2,4,1,0,0,0,0,9
2024-03-05 04:30:00,1,1,0,0,0,0,0,0,2
2024-03-05 04:40:00,1,1,1,0,0,0,0,0,3
2024-03-05 04:50:00,3,4,2,0,0,0,0,0,9
2024-03-05 05:00:00,1,1,3,0,0,0,0,0,5
2024-03-05 05:10:00,6,7,11,3,0,0,1,0,28
2024-03-05 05:20:00,5,6,3,1,0,0,2,0,17
2024-03-05 05:30:00,3,2,7,0,0,0,0,0,12
2024-03-05 05:40:00,4,4,5,0,0,0,0,0,13
2024-03-05 05:50:00,7,6,11,2,0,0,1,0,27
2024-03-05 06:00:00,3,3,6,0,0,0,0,0,12
2024-03-05 06:10:00,10,10,12,7,0,0,1,0,40
2024-03-05 06:20:00,17,15,8,8,0,0,0,0,48
2024-03-05 06:30:00,9,7,21,6,0,0,1,0,44
2024-03-05 06:40:00,19,18,19,14,0,0,2,0,72
2024-03-05 06:50:00,10,8,23,12,0,0,3,0,56
2024-03-05 07:00:00,15,10,22,11,0,0,7,2,67
2024-03-05 07:10:00,18,15,37,5,0,0,3,2,80
2024-03-05 07:20:00,41,23,38,6,0,0,2,2,112
2024-03-05 07:30:00,25,13,35,8,0,0,9,2,92
2024-03-05 07:40:00,51,23,26,8,0,0,4,1,113
2024-03-05 07:50:00,58,33,51,11,0,0,6,1,160
2024-03-05 08:00:00,33,16,24,9,0,0,8,0,90
2024-03-05 08:10:00,45,27,23,9,0,0,2,0,106
2024-03-05 08:20:00,55,33,23,4,0,0,5,1,121
2024-03-05 08:30:00,43,48,22,2,0,0,3,0,118
2024-03-05 08:40:00,48,25,15,5,0,0,7,0,100
2024-03-05 08:50:00,49,27,23,7,0,0,2,0,108
2024-03-05 09:00:00,31,23,28,9,0,0,1,0,92
2024-03-05 09:10:00,46,22,21,3,0,0,1,0,93
2024-03-05 09:20:00,37,20,21,5,0,0,4,0,87
2024-03-05 09:30:00,44,29,22,6,0,0,2,0,103
2024-03-05 09:40:00,54,38,16,7,0,0,1,0,116
2024-03-05 09:50:00,54,46,16,6,0,0,1,0,123
2024-03-05 10:00:00,35,23,29,8,0,0,2,0,97
2024-03-05 10:10:00,41,34,22,4,0,0,3,1,105
2024-03-05 10:20:00,45,36,21,6,0,0,4,0,112
2024-03-05 10:30:00,53,39,22,7,0,0,3,0,124
2024-03-05 10:40:00,40,27,25,5,0,0,3,0,100
2024-03-05 10:50:00,60,41,27,2,0,0,0,0,130
2024-03-05 11:00:00,38,30,16,5,0,0,1,1,91
2024-03-05 11:10:00,57,50,27,3,0,0,1,0,138
2024-03-05 11:20:00,52,37,19,8,0,0,2,0,118
2024-03-05 11:30:00,42,36,20,6,0,0,3,0,107
2024-03-05 11:40:00,55,47,23,7,0,0,3,0,135
2024-03-05 11:50:00,56,32,29,9,0,0,1,0,127
2024-03-05 12:00:00,52,38,18,5,0,0,0,0,113
2024-03-05 12:10:00,56,32,26,7,0,0,5,1,127
2024-03-05 12:20:00,60,30,20,6,0,0,0,0,116
2024-03-05 12:30:00,52,34,27,5,0,0,2,0,120
2024-03-05 12:40:00,53,36,29,6,0,0,4,0,128
2024-03-05 12:50:00,52,30,25,5,0,0,4,2,118
2024-03-05 13:00:00,63,39,25,6,0,0,5,1,139
2024-03-05 13:10:00,77,48,13,2,0,0,0,0,140
2024-03-05 13:20:00,70,34,28,8,0,0,7,0,147
2024-03-05 13:30:00,56,38,25,16,0,0,2,0,137
2024-03-05 13:40:00,62,38,21,10,0,0,5,4,140
2024-03-05 13:50:00,59,31,49,6,0,0,3,2,150
2024-03-05 14:00:00,65,37,31,4,0,0,3,3,143
2024-03-05 14:10:00,70,40,22,7,0,0,2,2,143
2024-03-05 14:20:00,71,38,26,5,0,0,6,0,146
2024-03-05 14:30:00,62,32,30,5,0,0,2,0,131
2024-03-05 14:40:00,51,38,39,3,0,0,1,0,132
2024-03-05 14:50:00,57,40,24,7,0,0,1,1,130
2024-03-05 15:00:00,76,54,23,3,0,0,8,0,164
2024-03-05 15:10:00,64,35,32,7,0,0,0,0,138
2024-03-05 15:20:00,70,44,31,3,0,0,4,0,152
2024-03-05 15:30:00,66,42,31,0,0,0,4,0,143
2024-03-05 15:40:00,75,49,26,6,0,0,1,0,157
2024-03-05 15:50:00,70,55,27,5,0,0,5,3,165
2024-03-05 16:00:00,87,43,36,5,0,0,5,0,176
2024-03-05 16:10:00,75,44,40,2,0,0,4,0,165
2024-03-05 16:20:00,78,38,32,4,0,0,1,1,154
2024-03-05 16:30:00,78,56,26,2,0,0,3,0,165
2024-03-05 16:40:00,67,45,22,4,0,0,2,0,140
2024-03-05 16:50:00,74,43,21,5,0,0,3,1,147
2024-03-05 17:00:00,76,49,30,5,0,0,3,0,163
2024-03-05 17:10:00,76,55,46,2,0,0,3,1,183
2024-03-05 17:20:00,71,51,44,3,0,0,3,1,173
2024-03-05 17:30:00,79,85,18,3,0,0,1,1,187
2024-03-05 17:40:00,72,45,26,0,0,0,1,0,144
2024-03-05 17:50:00,70,42,27,3,0,0,1,0,143
2024-03-05 18:00:00,87,47,27,1,0,0,0,0,162
2024-03-05 18:10:00,90,61,18,2,0,0,0,0,171
2024-03-05 18:20:00,63,47,25,30,0,0,0,0,165
2024-03-05 18:30:00,77,40,19,15,0,0,5,0,156
2024-03-05 18:40:00,53,30,21,8,0,0,3,0,115
2024-03-05 18:50:00,76,44,23,5,0,0,2,0,150
2024-03-05 19:00:00,56,44,32,6,0,0,1,0,139
2024-03-05 19:10:00,64,38,20,9,0,0,1,0,132
2024-03-05 19:20:00,57,41,23,4,0,0,2,3,130
2024-03-05 19:30:00,55,36,16,5,0,0,2,1,115
2024-03-05 19:40:00,59,37,18,1,0,0,1,0,116
2024-03-05 19:50:00,49,38,18,3,0,0,0,0,108
2024-03-05 20:00:00,40,28,15,5,0,0,2,0,90
2024-03-05 20:10:00,43,31,17,2,0,0,1,0,94
2024-03-05 20:20:00,35,30,14,3,0,0,1,0,83
2024-03-05 20:30:00,35,32,10,1,0,0,0,0,78
2024-03-05 20:40:00,32,26,18,2,0,0,1,0,79
2024-03-05 20:50:00,25,24,16,7,0,0,1,0,73
2024-03-05 21:00:00,36,28,17,1,0,0,2,0,84
2024-03-05 21:10:00,31,28,16,3,0,0,1,0,79
2024-03-05 21:20:00,32,24,12,1,0,0,0,0,69
2024-03-05 21:30:00,25,25,6,0,0,0,1,0,57
2024-03-05 21:40:00,23,20,11,0,0,0,0,0,54
2024-03-05 21:50:00,22,18,13,8,0,0,0,0,61
2024-03-05 22:00:00,23,20,8,5,0,0,0,0,56
2024-03-05 22:10:00,28,27,8,1,0,0,1,0,65
2024-03-05 22:20:00,24,15,6,0,0,0,0,0,45
2024-03-05 22:30:00,30,24,12,1,0,0,1,0,68
2024-03-05 22:40:00,21,18,8,0,0,0,2,0,49
2024-03-05 22:50:00,18,15,7,5,0,0,0,0,45
2024-03-05 23:00:00,20,19,9,3,0,0,0,0,51
2024-03-05 23:10:00,13,12,7,0,0,0,0,1,33
2024-03-05 23:20:00,11,11,9,2,0,0,0,0,33
2024-03-05 23:30:00,9,9,5,2,0,0,0,0,25
2024-03-05 23:40:00,10,10,6,2,0,0,0,0,28
2024-03-05 23:50:00,6,6,2,0,0,0,0,0,14
2024-03-06 00:00:00,2,3,1,0,0,0,0,0,6
2024-03-06 00:10:00,5,6,3,0,0,0,0,0,14
2024-03-06 00:20:00,6,10,3,2,0,0,1,0,22
2024-03-06 00:30:00,4,4,3,0,0,0,0,0,11
2024-03-06 00:40:00,3,5,3,2,0,0,0,0,13
2024-03-06 00:50:00,5,7,3,1,0,0,0,0,16
2024-03-06 01:00:00,4,4,3,1,0,0,0,0,12
2024-03-06 01:10:00,4,5,1,0,0,0,0,0,10
2024-03-06 01:20:00,0,0,3,0,0,0,0,0,3
2024-03-06 01:30:00,4,6,4,1,0,0,0,0,15
2024-03-06 01:40:00,2,2,3,2,0,0,0,0,9
2024-03-06 01:50:00,4,4,2,0,0,0,0,0,10
2024-03-06 02:00:00,1,1,3,0,0,0,0,0,5
2024-03-06 02:10:00,1,1,1,0,0,0,0,0,3
2024-03-06 02:20:00,2,2,1,0,0,0,0,0,5
2024-03-06 02:30:00,0,0,0,0,0,0,0,0,0
2024-03-06 02:40:00,4,4,1,0,0,0,0,0,9
2024-03-06 02:50:00,2,2,3,0,0,0,0,0,7
2024-03-06 03:00:00,2,2,3,2,0,0,0,0,9
2024-03-06 03:10:00,1,1,1,0,0,0,0,0,3
2024-03-06 03:20:00,3,3,4,0,0,0,0,0,10
2024-03-06 03:30:00,3,3,2,0,0,0,0,0,8
2024-03-06 03:40:00,2,2,2,1,0,0,0,0,7
2024-03-06 03:50:00,0,0,2,0,0,0,0,0,2
2024-03-06 04:00:00,4,4,4,1,0,0,0,0,13
2024-03-06 04:10:00,0,0,1,0,0,0,0,0,1
2024-03-06 04:20:00,2,2,2,0,0,0,0,0,6
2024-03-06 04:30:00,0,0,2,0,0,0,0,0,2
2024-03-06 04:40:00,0,0,2,0,0,0,0,0,2
2024-03-06 04:50:00,2,3,4,1,0,0,0,0,10
2024-03-06 05:00:00,1,1,3,0,0,0,0,0,5
2024-03-06 05:10:00,3,4,8,1,0,0,1,0,17
2024-03-06 05:20:00,7,8,8,0,0,0,1,0,24
2024-03-06 05:30:00,5,6,5,2,0,0,0,0,18
2024-03-06 05:40:00,2,2,8,0,0,0,1,0,13
2024-03-06 05:50:00,7,8,7,0,0,0,0,0,22
2024-03-06 06:00:00,7,6,12,0,0,0,1,0,26
2024-03-06 06:10:00,7,9,9,6,0,0,1,0,32
2024-03-06 06:20:00,13,13,19,10,0,0,0,0,55
2024-03-06 06:30:00,8,8,19,11,0,0,1,0,47
2024-03-06 06:40:00,22,19,23,12,0,0,3,0,79
2024-03-06 06:50:00,14,13,21,11,0,0,2,0,61
2024-03-06 07:00:00,21,7,26,18,0,0,6,0,78
2024-03-06 07:10:00,21,12,56,2,0,0,22,0,113
2024-03-06 07:20:00,29,18,48,2,0,0,3,0,100
2024-03-06 07:30:00,41,24,36,9,0,0,6,1,117
2024-03-06 07:40:00,51,24,28,10,0,0,5,1,119
2024-03-06 07:50:00,50,27,30,13,0,0,6,0,126
2024-03-06 08:00:00,41,24,28,8,0,0,1,0,102
2024-03-06 08:10:00,41,22,29,11,0,0,2,2,107
2024-03-06 08:20:00,40,21,28,3,0,0,2,0,94
2024-03-06 08:30:00,39,27,34,4,0,0,2,1,107
2024-03-06 08:40:00,40,23,25,8,0,0,3,0,99
2024-03-06 08:50:00,46,17,26,7,0,0,3,1,100
2024-03-06 09:00:00,41,27,30,5,0,0,2,0,105
2024-03-06 09:10:00,38,25,30,3,0,0,1,0,97
2024-03-06 09:20:00,43,33,31,3,0,0,0,0,110
2024-03-06 09:30:00,29,21,26,7,0,0,2,0,85
2024-03-06 09:40:00,31,26,27,2,0,0,3,0,89
2024-03-06 09:50:00,51,28,23,5,0,0,2,0,109
2024-03-06 10:00:00,39,29,21,3,0,0,2,0,94
2024-03-06 10:10:00,28,22,24,3,0,0,3,0,80
2024-03-06 10:20:00,35,24,17,6,0,0,1,0,83
2024-03-06 10:30:00,51,42,19,3,0,0,1,0,116
2024-03-06 10:40:00,56,44,22,5,0,0,1,0,128
2024-03-06 10:50:00,47,38,29,5,0,0,3,3,125
2024-03-06 11:00:00,46,28,24,5,0,0,1,0,104
2024-03-06 11:10:00,48,32,15,5,0,0,2,1,103
2024-03-06 11:20:00,45,37,27,3,0,0,1,0,113
2024-03-06 11:30:00,55,44,27,4,0,0,5,0,135
2024-03-06 11:40:00,65,44,23,3,0,0,1,0,136
2024-03-06 11:50:00,65,29,31,3,0,0,1,0,129
2024-03-06 12:00:00,52,36,30,4,0,0,0,1,123
2024-03-06 12:10:00,61,40,24,5,0,0,0,0,130
2024-03-06 12:20:00,58,48,31,6,0,0,1,1,145
2024-03-06 12:30:00,76,40,25,6,0,0,6,0,153
2024-03-06 12:40:00,67,43,33,7,0,0,4,0,154
2024-03-06 12:50:00,62,34,23,5,0,0,14,0,138
2024-03-06 13:00:00,52,41,24,7,0,0,5,0,129
2024-03-06 13:10:00,61,48,24,5,0,0,4,0,142
2024-03-06 13:20:00,60,46,21,9,0,0,5,0,141
2024-03-06 13:30:00,70,45,34,15,0,0,2,0,166
2024-03-06 13:40:00,46,32,42,9,0,0,6,3,138
2024-03-06 13:50:00,60,29,27,7,0,0,4,2,129
2024-03-06 14:00:00,59,41,23,11,0,0,2,2,138
2024-03-06 14:10:00,68,40,20,8,0,0,11,1,148
2024-03-06 14:20:00,60,30,14,7,0,0,10,0,121
2024-03-06 14:30:00,51,29,22,3,0,0,4,0,109
2024-03-06 14:40:00,64,40,26,4,0,0,3,0,137
2024-03-06 14:50:00,57,46,23,6,0,0,7,0,139
2024-03-06 15:00:00,84,40,22,2,0,0,2,0,150
2024-03-06 15:10:00,71,55,28,0,0,0,4,0,158
2024-03-06 15:20:00,68,53,17,3,0,0,3,1,145
2024-03-06 15:30:00,73,59,17,3,0,0,6,0,158
2024-03-06 15:40:00,62,47,36,6,0,0,10,0,161
2024-03-06 15:50:00,71,55,22,9,0,0,3,1,161
2024-03-06 16:00:00,60,41,23,5,0,0,6,1,136
2024-03-06 16:10:00,72,57,25,2,0,0,4,0,160
2024-03-06 16:20:00,84,59,36,6,0,0,5,0,190
2024-03-06 16:30:00,65,43,27,2,0,0,2,0,139
2024-03-06 16:40:00,71,41,21,4,0,0,2,1,140
2024-03-06 16:50:00,69,49,27,4,0,0,4,1,154
2024-03-06 17:00:00,70,46,28,3,0,0,6,2,155
2024-03-06 17:10:00,71,58,36,4,0,0,5,0,174
2024-03-06 17:20:00,84,46,24,3,0,0,8,0,165
2024-03-06 17:30:00,70,54,22,2,0,0,2,0,150
2024-03-06 17:40:00,56,33,29,2,0,0,4,0,124
2024-03-06 17:50:00,69,50,18,6,0,0,7,0,150
2024-03-06 18:00:00,66,45,11,3,0,0,4,0,129
2024-03-06 18:10:00,89,66,33,5,0,0,2,0,195
2024-03-06 18:20:00,77,40,16,16,0,0,2,1,152
2024-03-06 18:30:00,77,33,21,7,0,0,9,0,147
2024-03-06 18:40:00,60,29,18,2,0,0,2,0,111
2024-03-06 18:50:00,60,41,20,2,0,0,4,0,127
2024-03-06 19:00:00,40,27,17,2,0,0,3,0,89
2024-03-06 19:10:00,62,45,13,1,0,0,1,0,122
2024-03-06 19:20:00,55,35,23,2,0,0,2,0,117
2024-03-06 19:30:00,69,35,13,4,0,0,1,0,122
2024-03-06 19:40:00,46,30,13,0,0,0,2,0,91
2024-03-06 19:50:00,55,43,15,2,0,0,1,0,116
2024-03-06 20:00:00,40,29,16,3,0,0,2,0,90
2024-03-06 20:10:00,33,34,22,2,0,0,3,0,94
2024-03-06 20:20:00,39,28,15,2,0,0,3,0,87
2024-03-06 20:30:00,46,31,11,4,0,0,2,0,94
2024-03-06 20:40:00,36,29,10,1,0,0,1,0,77
2024-03-06 20:50:00,27,24,14,4,0,0,0,0,69
2024-03-06 21:00:00,30,29,12,3,0,0,1,0,75
2024-03-06 21:10:00,26,18,11,2,0,0,0,0,57
2024-03-06 21:20:00,34,24,13,1,0,0,0,0,72
2024-03-06 21:30:00,19,19,11,4,0,0,0,0,53
2024-03-06 21:40:00,30,19,9,1,0,0,0,0,59
2024-03-06 21:50:00,28,27,15,1,0,0,1,0,72
2024-03-06 22:00:00,39,35,11,4,0,0,0,0,89
2024-03-06 22:10:00,28,26,11,3,0,0,0,0,68
2024-03-06 22:20:00,30,28,9,1,0,0,1,0,69
2024-03-06 22:30:00,26,24,7,5,0,0,1,0,63
2024-03-06 22:40:00,21,15,7,3,0,0,0,0,46
2024-03-06 22:50:00,26,22,9,2,0,0,0,0,59
2024-03-06 23:00:00,25,27,8,3,0,0,0,0,63
2024-03-06 23:10:00,12,12,6,2,0,0,0,0,32
2024-03-06 23:20:00,17,12,9,3,0,0,0,0,41
2024-03-06 23:30:00,11,11,4,0,0,0,0,0,26
2024-03-06 23:40:00,9,10,9,4,0,0,0,0,32
2024-03-06 23:50:00,12,13,4,1,0,0,1,0,31
2024-03-07 00:00:00,2,1,3,1,0,0,0,0,7
2024-03-07 00:10:00,7,7,3,2,0,0,0,0,19
2024-03-07 00:20:00,6,9,6,2,0,0,0,0,23
2024-03-07 00:30:00,4,5,1,1,0,0,1,0,12
2024-03-07 00:40:00,6,4,5,3,0,0,0,0,18
2024-03-07 00:50:00,7,7,4,0,0,0,0,0,18
2024-03-07 01:00:00,2,2,4,1,0,0,0,0,9
2024-03-07 01:10:00,7,5,4,0,0,0,0,0,16
2024-03-07 01:20:00,3,3,4,1,0,0,0,0,11
2024-03-07 01:30:00,1,1,1,1,0,0,0,0,4
2024-03-07 01:40:00,3,4,2,0,0,0,0,0,9
2024-03-07 01:50:00,2,2,1,0,0,0,0,0,5
2024-03-07 02:00:00,3,6,2,1,0,0,0,0,12
2024-03-07 02:10:00,2,1,2,0,0,0,0,0,5
2024-03-07 02:20:00,2,3,2,0,0,0,0,0,7
2024-03-07 02:30:00,1,1,3,2,0,0,0,0,7
2024-03-07 02:40:00,5,7,4,1,0,0,0,0,17
2024-03-07 02:50:00,1,1,3,0,0,0,0,0,5
2024-03-07 03:00:00,3,2,2,1,0,0,0,0,8
2024-03-07 03:10:00,2,2,4,0,0,0,0,0,8
2024-03-07 03:20:00,2,2,0,0,0,0,0,0,4
2024-03-07 03:30:00,1,1,0,0,0,0,0,0,2
2024-03-07 03:40:00,0,0,0,0,0,0,0,0,0
2024-03-07 03:50:00,0,0,2,0,0,0,0,0,2
2024-03-07 04:00:00,1,1,1,0,0,0,0,0,3
2024-03-07 04:10:00,0,0,0,0,0,0,0,0,0
2024-03-07 04:20:00,2,2,3,0,0,0,0,0,7
2024-03-07 04:30:00,0,0,0,0,0,0,0,0,0
2024-03-07 04:40:00,2,3,1,0,0,0,0,0,6
2024-03-07 04:50:00,0,0,0,0,0,0,0,0,0
2024-03-07 05:00:00,2,2,8,0,0,0,0,0,12
2024-03-07 05:10:00,5,4,7,0,0,0,2,0,18
2024-03-07 05:20:00,5,7,5,0,0,0,0,0,17
2024-03-07 05:30:00,1,1,4,0,0,0,0,0,6
2024-03-07 05:40:00,3,3,7,0,0,0,1,0,14
2024-03-07 05:50:00,3,3,12,0,0,0,0,0,18
2024-03-07 06:00:00,8,8,3,0,0,0,0,0,19
2024-03-07 06:10:00,5,5,12,3,0,0,0,0,25
2024-03-07 06:20:00,14,11,16,9,0,0,1,0,51
2024-03-07 06:30:00,9,8,15,15,0,0,0,0,47
2024-03-07 06:40:00,22,21,17,8,0,0,1,0,69
2024-03-07 06:50:00,13,12,17,11,0,0,3,2,58
2024-03-07 07:00:00,23,19,25,15,0,0,7,0,89
2024-03-07 07:10:00,29,25,37,7,0,0,1,1,100
2024-03-07 07:20:00,36,21,37,3,0,0,5,4,106
2024-03-07 07:30:00,44,30,39,8,0,0,6,3,130
2024-03-07 07:40:00,50,25,15,9,0,0,0,0,99
2024-03-07 07:50:00,44,17,27,6,0,0,3,0,97
2024-03-07 08:00:00,45,19,50,11,0,0,3,1,129
2024-03-07 08:10:00,39,19,24,7,0,0,6,0,95
2024-03-07 08:20:00,43,34,27,4,0,0,2,1,111
2024-03-07 08:30:00,45,19,39,7,0,0,1,0,111
2024-03-07 08:40:00,45,19,29,9,0,0,3,0,105
2024-03-07 08:50:00,49,22,23,10,0,0,6,1,111
2024-03-07 09:00:00,46,22,21,7,0,0,1,0,97
2024-03-07 09:10:00,50,32,25,9,0,0,1,2,119
2024-03-07 09:20:00,44,28,14,7,0,0,2,0,95
2024-03-07 09:30:00,35,28,24,3,0,0,3,1,94
2024-03-07 09:40:00,46,37,16,7,0,0,3,0,109
2024-03-07 09:50:00,55,35,26,5,0,0,1,0,122
2024-03-07 10:00:00,46,33,23,4,0,0,2,0,108
2024-03-07 10:10:00,40,33,17,5,0,0,0,0,95
2024-03-07 10:20:00,39,27,21,9,0,0,1,0,97
2024-03-07 10:30:00,42,30,38,6,0,0,2,0,118
2024-03-07 10:40:00,51,42,22,2,0,0,1,0,118
2024-03-07 10:50:00,66,40,23,3,0,0,6,0,138
2024-03-07 11:00:00,67,50,28,4,0,0,3,0,152
2024-03-07 11:10:00,53,41,35,7,0,0,1,1,138
2024-03-07 11:20:00,54,40,28,5,0,0,3,0,130
2024-03-07 11:30:00,53,34,19,2,0,0,3,1,112
2024-03-07 11:40:00,57,55,30,2,0,0,3,0,147
2024-03-07 11:50:00,76,43,28,8,0,0,6,0,161
2024-03-07 12:00:00,63,32,30,2,0,0,2,3,132
2024-03-07 12:10:00,70,44,30,5,0,0,1,0,150
2024-03-07 12:20:00,63,34,25,4,0,0,3,1,130
2024-03-07 12:30:00,53,37,29,6,0,0,3,0,128
2024-03-07 12:40:00,61,35,19,8,0,0,3,0,126
2024-03-07 12:50:00,68,29,21,8,0,0,0,1,127
2024-03-07 13:00:00,52,29,22,14,0,0,3,0,120
2024-03-07 13:10:00,62,40,25,8,0,0,3,0,138
2024-03-07 13:20:00,74,47,39,11,0,0,4,1,176
2024-03-07 13:30:00,68,48,27,9,0,0,4,1,157
2024-03-07 13:40:00,56,49,34,9,0,0,4,0,152
2024-03-07 13:50:00,57,42,45,4,0,0,1,1,150
2024-03-07 14:00:00,57,34,29,5,0,0,1,1,127
2024-03-07 14:10:00,47,32,27,7,0,0,1,3,117
2024-03-07 14:20:00,63,48,25,5,0,0,2,1,144
2024-03-07 14:30:00,206,29,28,4,0,0,6,2,275
2024-03-07 14:40:00,71,36,27,8,0,0,2,2,146
2024-03-07 14:50:00,77,49,20,5,0,0,7,1,159
2024-03-07 15:00:00,72,54,32,4,0,0,8,3,173
2024-03-07 15:10:00,68,52,31,6,0,0,1,1,159
2024-03-07 15:20:00,66,41,36,3,0,0,4,1,151
2024-03-07 15:30:00,65,47,33,4,0,0,3,3,155
2024-03-07 15:40:00,85,55,37,5,0,0,6,0,188
2024-03-07 15:50:00,75,48,38,13,0,0,0,2,176
2024-03-07 16:00:00,95,58,31,3,0,0,2,0,189
2024-03-07 16:10:00,71,47,26,4,0,0,2,0,150
2024-03-07 16:20:00,76,50,23,1,0,0,3,0,153
2024-03-07 16:30:00,78,54,35,4,0,0,5,1,177
2024-03-07 16:40:00,85,38,30,4,0,0,2,0,159
2024-03-07 16:50:00,84,57,29,2,0,0,0,1,173
2024-03-07 17:00:00,69,53,32,3,0,0,1,0,158
2024-03-07 17:10:00,70,47,42,5,0,0,2,2,168
2024-03-07 17:20:00,70,48,40,2,0,0,2,1,163
2024-03-07 17:30:00,75,48,27,2,0,0,3,1,156
2024-03-07 17:40:00,79,49,23,1,0,0,2,0,154
2024-03-07 17:50:00,66,49,26,1,0,0,2,1,145
2024-03-07 18:00:00,79,49,21,1,0,0,0,1,151
2024-03-07 18:10:00,75,50,17,0,0,0,3,0,145
2024-03-07 18:20:00,80,49,16,3,0,0,0,0,148
2024-03-07 18:30:00,86,35,22,4,0,0,1,1,149
2024-03-07 18:40:00,60,36,71,3,0,0,0,0,170
2024-03-07 18:50:00,84,49,22,0,0,0,2,0,157
2024-03-07 19:00:00,65,32,14,11,0,0,1,1,124
2024-03-07 19:10:00,67,43,20,1,0,0,3,0,134
2024-03-07 19:20:00,62,39,18,8,0,0,0,0,127
2024-03-07 19:30:00,50,31,20,11,0,0,3,0,115
2024-03-07 19:40:00,54,39,18,0,0,0,2,0,113
2024-03-07 19:50:00,52,44,8,3,0,0,3,0,110
2024-03-07 20:00:00,50,35,12,3,0,0,1,0,101
2024-03-07 20:10:00,43,27,15,3,0,0,0,3,91
2024-03-07 20:20:00,31,25,16,4,0,0,1,0,77
2024-03-07 20:30:00,38,28,11,4,0,0,2,0,83
2024-03-07 20:40:00,25,20,7,1,0,0,3,0,56
2024-03-07 20:50:00,30,20,7,1,0,0,0,0,58
2024-03-07 21:00:00,40,28,11,2,0,0,3,0,84
2024-03-07 21:10:00,40,24,15,3,0,0,0,0,82
2024-03-07 21:20:00,34,23,14,2,0,0,1,0,74
2024-03-07 21:30:00,22,21,9,3,0,0,1,0,56
2024-03-07 21:40:00,29,25,7,2,0,0,1,0,64
2024-03-07 21:50:00,24,16,9,3,0,0,3,1,56
2024-03-07 22:00:00,44,28,11,6,0,0,0,0,89
2024-03-07 22:10:00,26,21,9,1,0,0,2,0,59
2024-03-07 22:20:00,19,20,9,1,0,0,0,0,49
2024-03-07 22:30:00,26,20,11,2,0,0,1,0,60
2024-03-07 22:40:00,22,19,13,2,0,0,0,0,56
2024-03-07 22:50:00,21,19,6,2,0,0,1,0,49
2024-03-07 23:00:00,18,19,9,2,0,0,0,0,48
2024-03-07 23:10:00,18,15,7,3,0,0,0,0,43
2024-03-07 23:20:00,13,13,9,0,0,0,0,0,35
2024-03-07 23:30:00,8,7,5,3,0,0,0,0,23
2024-03-07 23:40:00,18,17,5,1,0,0,0,0,41
2024-03-07 23:50:00,11,10,2,1,0,0,0,0,24
2024-03-08 00:00:00,10,10,8,5,0,0,0,0,33
2024-03-08 00:10:00,3,3,5,0,0,0,0,0,11
2024-03-08 00:20:00,10,8,5,2,0,0,0,0,25
2024-03-08 00:30:00,9,9,3,1,0,0,0,0,22
2024-03-08 00:40:00,5,6,5,0,0,0,0,0,16
2024-03-08 00:50:00,5,6,4,2,0,0,0,0,17
2024-03-08 01:00:00,0,0,2,0,0,0,0,0,2
2024-03-08 01:10:00,1,2,0,0,0,0,0,0,3
2024-03-08 01:20:00,2,2,2,0,0,0,0,0,6
2024-03-08 01:30:00,0,0,1,0,0,0,0,0,1
2024-03-08 01:40:00,3,3,3,0,0,0,0,0,9
2024-03-08 01:50:00,1,1,2,0,0,0,0,0,4
2024-03-08 02:00:00,1,2,1,0,0,0,0,0,4
2024-03-08 02:10:00,4,4,5,0,0,0,0,0,13
2024-03-08 02:20:00,2,2,4,0,0,0,0,0,8
2024-03-08 02:30:00,2,2,0,0,0,0,0,0,4
2024-03-08 02:40:00,0,0,1,0,0,0,0,0,1
2024-03-08 02:50:00,0,0,1,1,0,0,0,0,2
2024-03-08 03:00:00,2,2,0,0,0,0,0,0,4
2024-03-08 03:10:00,1,1,3,0,0,0,0,0,5
2024-03-08 03:20:00,1,1,2,0,0,0,0,0,4
2024-03-08 03:30:00,2,2,1,0,0,0,1,0,6
2024-03-08 03:40:00,1,1,0,0,0,0,0,0,2
2024-03-08 03:50:00,0,0,0,0,0,0,1,0,1
2024-03-08 04:00:00,2,2,1,0,0,0,0,0,5
2024-03-08 04:10:00,0,0,0,0,0,0,0,0,0
2024-03-08 04:20:00,0,0,1,0,0,0,0,0,1
2024-03-08 04:30:00,3,3,1,0,0,0,0,0,7
2024-03-08 04:40:00,1,1,2,1,0,0,0,0,5
2024-03-08 04:50:00,2,3,3,1,0,0,0,0,9
2024-03-08 05:00:00,4,5,2,0,0,0,0,0,11
2024-03-08 05:10:00,4,6,10,0,0,0,0,0,20
2024-03-08 05:20:00,8,8,6,1,0,0,1,0,24
2024-03-08 05:30:00,4,5,3,0,0,0,0,0,12
2024-03-08 05:40:00,2,2,6,0,0,0,0,0,10
2024-03-08 05:50:00,5,5,6,0,0,0,0,0,16
2024-03-08 06:00:00,1,1,6,2,0,0,1,0,11
2024-03-08 06:10:00,9,7,14,9,0,0,0,0,39
2024-03-08 06:20:00,16,17,16,12,0,0,1,0,62
2024-03-08 06:30:00,11,7,14,6,0,0,0,0,38
2024-03-08 06:40:00,14,12,15,11,0,0,1,0,53
2024-03-08 06:50:00,19,17,28,6,0,0,1,0,71
2024-03-08 07:00:00,20,20,25,8,0,0,1,0,74
2024-03-08 07:10:00,16,10,39,2,0,0,2,0,69
2024-03-08 07:20:00,37,20,31,6,0,0,1,0,95
2024-03-08 07:30:00,32,28,33,10,0,0,6,2,111
2024-03-08 07:40:00,47,24,26,8,0,0,0,1,106
2024-03-08 07:50:00,52,37,29,8,0,0,1,0,127
2024-03-08 08:00:00,39,24,35,12,0,0,6,1,117
2024-03-08 08:10:00,35,19,28,8,0,0,4,0,94
2024-03-08 08:20:00,51,36,36,5,0,0,4,0,132
2024-03-08 08:30:00,55,24,36,12,0,0,4,0,131
2024-03-08 08:40:00,44,25,30,6,0,0,5,1,111
2024-03-08 08:50:00,54,31,31,20,0,0,2,0,138
2024-03-08 09:00:00,58,31,23,14,0,0,3,1,130
2024-03-08 09:10:00,50,19,14,11,0,0,7,2,103
2024-03-08 09:20:00,47,26,35,2,0,0,1,3,114
2024-03-08 09:30:00,56,30,23,5,0,0,4,0,118
2024-03-08 09:40:00,54,21,26,4,0,0,0,0,105
2024-03-08 09:50:00,47,28,23,2,0,0,3,1,104
2024-03-08 10:00:00,56,27,16,3,0,0,0,0,102
2024-03-08 10:10:00,37,25,27,2,0,0,2,0,93
2024-03-08 10:20:00,68,36,27,3,0,0,6,0,140
2024-03-08 10:30:00,44,27,38,4,0,0,2,0,115
2024-03-08 10:40:00,41,34,28,5,0,0,0,0,108
2024-03-08 10:50:00,53,35,38,4,0,0,0,1,131
2024-03-08 11:00:00,48,37,32,7,0,0,1,0,125
2024-03-08 11:10:00,52,34,39,6,0,0,3,0,134
2024-03-08 11:20:00,54,42,33,7,0,0,1,0,137
2024-03-08 11:30:00,73,44,27,5,0,0,2,0,151
2024-03-08 11:40:00,46,26,21,5,0,0,3,0,101
2024-03-08 11:50:00,63,34,21,3,0,0,2,1,124
2024-03-08 12:00:00,71,39,31,4,0,0,3,0,148
2024-03-08 12:10:00,65,41,24,5,0,0,4,1,140
2024-03-08 12:20:00,76,34,19,11,0,0,3,0,143
2024-03-08 12:30:00,45,39,24,9,0,0,1,0,118
2024-03-08 12:40:00,74,36,22,13,0,0,1,1,147
2024-03-08 12:50:00,80,50,36,4,0,0,10,4,184
2024-03-08 13:00:00,55,39,35,4,0,0,9,0,142
2024-03-08 13:10:00,82,52,33,7,0,0,5,1,180
2024-03-08 13:20:00,88,40,24,8,0,0,5,0,165
2024-03-08 13:30:00,88,68,23,9,0,0,3,0,191
2024-03-08 13:40:00,83,42,49,8,0,0,1,3,186
2024-03-08 13:50:00,75,49,38,3,0,0,2,1,168
2024-03-08 14:00:00,123,38,37,7,0,0,0,3,208
2024-03-08 14:10:00,73,35,31,6,0,0,12,0,157
2024-03-08 14:20:00,79,40,26,0,0,0,6,2,153
2024-03-08 14:30:00,74,30,36,8,0,0,5,0,153
2024-03-08 14:40:00,80,40,30,7,0,0,11,0,168
2024-03-08 14:50:00,86,43,45,2,0,0,1,0,177
2024-03-08 15:00:00,74,29,31,5,0,0,1,1,141
2024-03-08 15:10:00,64,35,31,0,0,0,0,0,130
2024-03-08 15:20:00,79,48,32,16,0,0,5,0,180
2024-03-08 15:30:00,91,51,47,12,0,0,3,0,204
2024-03-08 15:40:00,72,39,36,3,0,0,8,0,158
2024-03-08 15:50:00,77,49,25,3,0,0,1,1,156
2024-03-08 16:00:00,76,39,30,5,0,0,2,0,152
2024-03-08 16:10:00,77,49,26,12,0,0,2,1,167
2024-03-08 16:20:00,68,46,39,7,0,0,5,0,165
2024-03-08 16:30:00,58,50,39,3,0,0,3,0,153
2024-03-08 16:40:00,69,46,29,4,0,0,1,0,149
2024-03-08 16:50:00,58,36,26,4,0,0,2,0,126
2024-03-08 17:00:00,76,49,23,7,0,0,1,0,156
2024-03-08 17:10:00,98,50,33,6,0,0,1,1,189
2024-03-08 17:20:00,69,43,23,1,0,0,3,0,139
2024-03-08 17:30:00,70,50,32,3,0,0,3,2,160
2024-03-08 17:40:00,71,48,23,6,0,0,1,0,149
2024-03-08 17:50:00,51,41,35,0,0,0,5,0,132
2024-03-08 18:00:00,68,43,27,4,0,0,0,0,142
2024-03-08 18:10:00,94,59,18,2,0,0,3,0,176
2024-03-08 18:20:00,63,42,25,5,0,0,3,0,138
2024-03-08 18:30:00,65,36,20,11,0,0,5,0,137
2024-03-08 18:40:00,57,43,23,9,0,0,6,0,138
2024-03-08 18:50:00,70,41,20,7,0,0,3,0,141
2024-03-08 19:00:00,54,30,17,1,0,0,2,1,105
2024-03-08 19:10:00,62,34,32,0,0,0,5,0,133
2024-03-08 19:20:00,55,34,17,3,0,0,2,0,111
2024-03-08 19:30:00,45,34,15,5,0,0,9,0,108
2024-03-08 19:40:00,57,32,16,4,0,0,0,0,109
2024-03-08 19:50:00,38,36,19,9,0,0,1,0,103
2024-03-08 20:00:00,38,28,14,4,0,0,1,0,85
2024-03-08 20:10:00,34,32,18,5,0,0,1,0,90
2024-03-08 20:20:00,29,28,20,3,0,0,1,0,81
2024-03-08 20:30:00,48,36,12,3,0,0,2,0,101
2024-03-08 20:40:00,33,30,14,4,0,0,0,0,81
2024-03-08 20:50:00,39,27,13,6,0,0,1,0,86
2024-03-08 21:00:00,28,19,10,2,0,0,2,0,61
2024-03-08 21:10:00,28,30,9,0,0,0,1,0,68
2024-03-08 21:20:00,29,24,11,2,0,0,2,0,68
2024-03-08 21:30:00,24,21,10,2,0,0,1,0,58
2024-03-08 21:40:00,26,19,12,4,0,0,0,0,61
2024-03-08 21:50:00,30,29,4,0,0,0,1,0,64
2024-03-08 22:00:00,27,17,13,1,0,0,1,0,59
2024-03-08 22:10:00,23,21,10,2,0,0,0,0,56
2024-03-08 22:20:00,23,21,12,1,0,0,1,0,58
2024-03-08 22:30:00,24,22,13,7,0,0,2,0,68
2024-03-08 22:40:00,28,26,10,2,0,0,0,0,66
2024-03-08 22:50:00,25,24,8,1,0,0,0,0,58
2024-03-08 23:00:00,18,21,9,0,0,0,0,0,48
2024-03-08 23:10:00,39,34,13,3,0,0,0,0,89
2024-03-08 23:20:00,18,17,16,5,0,0,0,0,56
2024-03-08 23:30:00,17,14,9,4,0,0,0,0,44
2024-03-08 23:40:00,16,15,1,1,0,0,0,0,33
2024-03-08 23:50:00,19,17,12,2,0,0,0,0,50
2024-03-09 00:00:00,15,15,6,2,0,0,0,0,38
2024-03-09 00:10:00,12,12,5,0,0,0,0,0,29
2024-03-09 00:20:00,19,16,9,0,0,0,0,0,44
2024-03-09 00:30:00,17,15,7,4,0,0,0,0,43
2024-03-09 00:40:00,11,10,5,2,0,0,0,0,28
2024-03-09 00:50:00,14,11,8,3,0,0,3,0,39
2024-03-09 01:00:00,16,14,6,0,0,0,0,0,36
2024-03-09 01:10:00,9,9,5,0,0,0,0,0,23
2024-03-09 01:20:00,14,11,7,3,0,0,0,0,35
2024-03-09 01:30:00,7,5,6,3,0,0,0,0,21
2024-03-09 01:40:00,11,12,5,3,0,0,0,0,31
2024-03-09 01:50:00,5,5,2,0,0,0,0,0,12
2024-03-09 02:00:00,5,6,4,0,0,0,0,0,15
2024-03-09 02:10:00,5,6,5,0,0,0,0,0,16
2024-03-09 02:20:00,3,3,2,1,0,0,0,0,9
2024-03-09 02:30:00,3,3,5,2,0,0,0,0,13
2024-03-09 02:40:00,6,5,5,1,0,0,0,0,17
2024-03-09 02:50:00,7,7,3,0,0,0,0,0,17
2024-03-09 03:00:00,4,4,3,0,0,0,0,0,11
2024-03-09 03:10:00,8,9,6,0,0,0,0,0,23
2024-03-09 03:20:00,2,2,4,1,0,0,1,0,10
2024-03-09 03:30:00,4,4,4,1,0,0,0,0,13
2024-03-09 03:40:00,5,5,3,0,0,0,0,0,13
2024-03-09 03:50:00,4,4,3,0,0,0,0,0,11
2024-03-09 04:00:00,6,5,0,0,0,0,0,0,11
2024-03-09 04:10:00,6,7,6,1,0,0,0,0,20
2024-03-09 04:20:00,3,4,4,0,0,0,0,0,11
2024-03-09 04:30:00,3,3,3,0,0,0,0,0,9
2024-03-09 04:40:00,6,7,3,3,0,0,0,0,19
2024-03-09 04:50:00,3,3,3,2,0,0,0,0,11
2024-03-09 05:00:00,1,1,3,0,0,0,0,0,5
2024-03-09 05:10:00,2,2,5,1,0,0,0,0,10
2024-03-09 05:20:00,3,3,3,0,0,0,0,0,9
2024-03-09 05:30:00,2,2,2,0,0,0,1,0,7
2024-03-09 05:40:00,3,3,4,0,0,0,0,0,10
2024-03-09 05:50:00,3,4,2,0,0,0,0,0,9
2024-03-09 06:00:00,1,1,2,0,0,0,0,0,4
2024-03-09 06:10:00,6,6,5,4,0,0,0,0,21
2024-03-09 06:20:00,7,6,8,5,0,0,0,0,26
2024-03-09 06:30:00,5,7,7,4,0,0,0,0,23
2024-03-09 06:40:00,4,4,7,5,0,0,0,0,20
2024-03-09 06:50:00,9,7,11,3,0,0,0,0,30
2024-03-09 07:00:00,11,10,4,0,0,0,0,0,25
2024-03-09 07:10:00,4,4,3,1,0,0,0,0,12
2024-03-09 07:20:00,4,4,8,0,0,0,1,0,17
2024-03-09 07:30:00,9,9,8,0,0,0,1,0,27
2024-03-09 07:40:00,14,13,7,0,0,0,1,1,36
2024-03-09 07:50:00,14,14,11,1,0,0,0,0,40
2024-03-09 08:00:00,26,21,8,0,0,0,3,0,58
2024-03-09 08:10:00,16,12,10,0,0,0,0,0,38
2024-03-09 08:20:00,17,15,12,0,0,0,1,0,45
2024-03-09 08:30:00,22,21,10,1,0,0,0,0,54
2024-03-09 08:40:00,19,18,18,2,0,0,0,0,57
2024-03-09 08:50:00,28,19,18,33,0,0,1,0,99
2024-03-09 09:00:00,31,23,18,3,0,0,0,0,75
2024-03-09 09:10:00,39,29,9,13,0,0,2,0,92
2024-03-09 09:20:00,28,17,17,3,0,0,2,0,67
2024-03-09 09:30:00,31,27,20,3,0,0,4,0,85
2024-03-09 09:40:00,42,36,23,20,0,0,2,1,124
2024-03-09 09:50:00,43,37,31,10,0,0,1,0,122
2024-03-09 10:00:00,29,27,24,10,0,0,1,0,91
2024-03-09 10:10:00,52,44,24,8,0,0,6,0,134
2024-03-09 10:20:00,29,26,19,1,0,1,1,1,78
2024-03-09 10:30:00,44,28,29,3,0,0,3,1,108
2024-03-09 10:40:00,49,28,14,3,0,0,5,1,100
2024-03-09 10:50:00,60,38,23,1,0,0,1,0,123
2024-03-09 11:00:00,38,31,31,4,0,0,0,1,105
2024-03-09 11:10:00,46,27,22,1,0,0,7,0,103
2024-03-09 11:20:00,91,26,21,6,0,0,3,0,147
2024-03-09 11:30:00,37,27,20,1,0,0,2,0,87
2024-03-09 11:40:00,46,37,34,0,0,0,3,0,120
2024-03-09 11:50:00,61,51,22,1,0,0,3,0,138
2024-03-09 12:00:00,67,43,28,3,0,0,5,0,146
2024-03-09 12:10:00,48,31,15,2,0,0,4,0,100
2024-03-09 12:20:00,64,25,13,0,0,0,8,1,111
2024-03-09 12:30:00,51,41,32,1,0,0,4,0,129
2024-03-09 12:40:00,53,41,22,2,0,0,2,0,120
2024-03-09 12:50:00,68,45,16,2,0,0,4,2,137
2024-03-09 13:00:00,56,36,23,5,0,0,4,0,124
2024-03-09 13:10:00,52,30,18,1,0,0,2,4,107
2024-03-09 13:20:00,45,27,11,4,0,0,1,0,88
2024-03-09 13:30:00,48,32,20,3,0,0,2,2,107
2024-03-09 13:40:00,96,16,21,5,0,0,4,1,143
2024-03-09 13:50:00,52,32,20,4,0,0,5,0,113
2024-03-09 14:00:00,62,44,15,3,0,0,5,0,129
2024-03-09 14:10:00,58,40,15,3,0,0,5,1,122
2024-03-09 14:20:00,55,43,15,4,0,0,6,0,123
2024-03-09 14:30:00,64,47,13,6,0,0,3,0,133
2024-03-09 14:40:00,78,55,23,8,0,0,2,2,168
2024-03-09 14:50:00,55,37,22,6,0,0,1,0,121
2024-03-09 15:00:00,73,47,24,6,0,0,5,0,155
2024-03-09 15:10:00,53,34,20,5,0,0,3,0,115
2024-03-09 15:20:00,67,39,15,5,0,0,2,0,128
2024-03-09 15:30:00,50,42,14,2,0,0,2,0,110
2024-03-09 15:40:00,53,33,19,1,0,0,5,0,111
2024-03-09 15:50:00,49,38,15,3,0,0,4,0,109
2024-03-09 16:00:00,55,27,21,3,0,0,1,1,108
2024-03-09 16:10:00,55,44,26,6,0,0,1,1,133
2024-03-09 16:20:00,41,36,16,3,0,0,1,1,98
2024-03-09 16:30:00,58,41,19,1,0,0,5,0,124
2024-03-09 16:40:00,52,39,12,0,0,0,0,0,103
2024-03-09 16:50:00,59,39,17,3,0,0,9,1,128
2024-03-09 17:00:00,55,41,15,4,0,0,4,0,119
2024-03-09 17:10:00,50,38,22,2,0,0,1,2,115
2024-03-09 17:20:00,64,34,10,1,0,0,2,0,111
2024-03-09 17:30:00,44,28,17,1,0,0,2,2,94
2024-03-09 17:40:00,59,42,17,2,0,0,1,0,121
2024-03-09 17:50:00,66,54,18,3,0,0,4,0,145
2024-03-09 18:00:00,47,38,10,3,0,0,1,0,99
2024-03-09 18:10:00,54,40,19,2,0,0,1,0,116
2024-03-09 18:20:00,55,38,15,4,0,0,5,0,117
2024-03-09 18:30:00,39,33,17,6,0,0,3,0,98
2024-03-09 18:40:00,41,31,15,7,0,0,2,0,96
2024-03-09 18:50:00,56,39,18,2,0,0,2,0,117
2024-03-09 19:00:00,38,26,9,2,0,0,4,0,79
2024-03-09 19:10:00,49,41,18,1,0,0,3,0,112
2024-03-09 19:20:00,59,31,21,2,0,0,9,3,125
2024-03-09 19:30:00,34,23,14,1,0,0,5,1,78
2024-03-09 19:40:00,43,30,13,2,0,0,2,0,90
2024-03-09 19:50:00,30,20,12,3,0,0,0,0,65
2024-03-09 20:00:00,34,27,12,8,0,0,0,0,81
2024-03-09 20:10:00,40,33,9,2,0,0,2,0,86
2024-03-09 20:20:00,38,31,16,3,0,0,4,0,92
2024-03-09 20:30:00,32,29,9,2,0,0,2,0,74
2024-03-09 20:40:00,26,20,15,3,0,0,1,0,65
2024-03-09 20:50:00,38,31,12,2,0,0,1,0,84
2024-03-09 21:00:00,25,21,10,2,0,0,2,0,60
2024-03-09 21:10:00,32,23,13,0,0,0,0,0,68
2024-03-09 21:20:00,24,26,9,1,0,0,1,0,61
2024-03-09 21:30:00,30,23,9,2,0,0,2,0,66
2024-03-09 21:40:00,25,26,11,1,0,0,0,0,63
2024-03-09 21:50:00,23,18,5,0,0,0,3,0,49
2024-03-09 22:00:00,26,20,13,3,0,0,0,0,62
2024-03-09 22:10:00,32,28,15,5,0,0,0,0,80
2024-03-09 22:20:00,23,24,10,2,0,0,3,0,62
2024-03-09 22:30:00,29,25,9,2,0,0,1,0,66
2024-03-09 22:40:00,23,23,4,0,0,0,0,0,50
2024-03-09 22:50:00,29,22,8,2,0,0,0,0,61
2024-03-09 23:00:00,24,18,11,1,0,0,1,0,55
2024-03-09 23:10:00,27,21,14,3,0,0,0,0,65
2024-03-09 23:20:00,24,18,13,4,0,0,0,0,59
2024-03-09 23:30:00,14,13,5,0,0,0,1,0,33
2024-03-09 23:40:00,10,11,5,0,0,0,0,0,26
2024-03-09 23:50:00,21,21,12,3,0,0,0,0,57
2024-03-10 00:00:00,16,16,4,1,0,0,0,0,37
2024-03-10 00:10:00,18,13,11,1,0,0,0,0,43
2024-03-10 00:20:00,18,19,5,3,0,0,2,0,47
2024-03-10 00:30:00,8,6,10,3,0,0,0,0,27
2024-03-10 00:40:00,14,14,3,0,0,0,0,0,31
2024-03-10 00:50:00,16,20,6,2,0,0,0,0,44
2024-03-10 01:00:00,9,9,9,2,0,0,0,0,29
2024-03-10 01:10:00,10,8,5,3,0,0,0,0,26
2024-03-10 01:20:00,8,7,7,1,0,0,0,0,23
2024-03-10 01:30:00,9,11,5,1,0,0,0,0,26
2024-03-10 01:40:00,10,10,7,2,0,0,0,0,29
2024-03-10 01:50:00,7,5,4,1,0,0,0,0,17
2024-03-10 02:00:00,7,7,5,3,0,0,0,0,22
2024-03-10 02:10:00,7,7,7,3,0,0,0,0,24
2024-03-10 02:20:00,8,9,5,2,0,0,0,0,24
2024-03-10 02:30:00,5,6,5,3,0,0,0,0,19
2024-03-10 02:40:00,14,16,5,3,0,0,0,0,38
2024-03-10 02:50:00,5,4,3,0,0,0,0,0,12
2024-03-10 03:00:00,3,3,4,0,0,0,0,0,10
2024-03-10 03:10:00,3,4,3,0,0,0,0,0,10
2024-03-10 03:20:00,4,3,3,0,0,0,0,0,10
2024-03-10 03:30:00,4,4,2,3,0,0,0,0,13
2024-03-10 03:40:00,3,2,5,1,0,0,0,0,11
2024-03-10 03:50:00,7,6,3,4,0,0,0,0,20
2024-03-10 04:00:00,0,0,3,0,0,0,0,0,3
2024-03-10 04:10:00,4,4,0,0,0,0,0,0,8
2024-03-10 04:20:00,4,4,6,0,0,0,0,0,14
2024-03-10 04:30:00,1,1,3,0,0,0,0,0,5
2024-03-10 04:40:00,2,2,5,3,0,0,0,0,12
2024-03-10 04:50:00,0,0,0,0,0,0,0,0,0
2024-03-10 05:00:00,2,2,4,0,0,0,0,0,8
2024-03-10 05:10:00,2,2,3,1,0,0,0,0,8
2024-03-10 05:20:00,3,3,3,0,0,0,0,0,9
2024-03-10 05:30:00,1,1,3,0,0,0,0,0,5
2024-03-10 05:40:00,2,2,3,1,0,0,0,0,8
2024-03-10 05:50:00,1,1,2,0,0,0,0,0,4
2024-03-10 06:00:00,2,2,2,0,0,0,1,0,7
2024-03-10 06:10:00,5,5,2,1,0,0,0,0,13
2024-03-10 06:20:00,3,3,3,1,0,0,0,0,10
2024-03-10 06:30:00,5,7,5,2,0,0,0,0,19
2024-03-10 06:40:00,4,4,1,0,0,0,0,0,9
2024-03-10 06:50:00,6,5,5,0,0,0,0,0,16
2024-03-10 07:00:00,6,6,4,0,0,0,0,0,16
2024-03-10 07:10:00,2,2,1,0,0,0,0,0,5
2024-03-10 07:20:00,7,6,3,1,0,0,0,0,17
2024-03-10 07:30:00,7,7,4,2,0,0,1,0,21
2024-03-10 07:40:00,2,2,4,0,0,0,0,0,8
2024-03-10 07:50:00,5,5,3,1,0,0,1,0,15
2024-03-10 08:00:00,8,8,3,1,0,0,0,0,20
2024-03-10 08:10:00,4,4,2,0,0,0,0,0,10
2024-03-10 08:20:00,7,7,5,1,0,0,0,0,20
2024-03-10 08:30:00,6,5,6,0,0,0,0,0,17
2024-03-10 08:40:00,10,10,5,0,0,0,0,0,25
2024-03-10 08:50:00,10,10,11,1,0,0,1,0,33
2024-03-10 09:00:00,12,11,7,1,0,0,3,0,34
2024-03-10 09:10:00,19,19,7,1,0,0,2,0,48
2024-03-10 09:20:00,20,18,8,2,0,0,0,0,48
2024-03-10 09:30:00,14,13,13,4,0,0,2,0,46
2024-03-10 09:40:00,24,20,15,5,0,0,0,0,64
2024-03-10 09:50:00,25,19,13,2,0,0,3,1,63
2024-03-10 10:00:00,13,11,7,4,0,0,3,0,38
2024-03-10 10:10:00,22,21,14,7,0,0,0,0,64
2024-03-10 10:20:00,19,16,14,4,0,0,1,0,54
2024-03-10 10:30:00,32,25,10,0,0,0,2,0,69
2024-03-10 10:40:00,34,33,17,5,0,0,1,0,90
2024-03-10 10:50:00,20,14,10,4,0,0,2,0,50
2024-03-10 11:00:00,28,25,12,5,0,0,1,0,71
2024-03-10 11:10:00,29,22,10,3,0,0,1,0,65
2024-03-10 11:20:00,35,32,10,2,0,0,4,0,83
2024-03-10 11:30:00,26,21,9,1,0,0,1,0,58
2024-03-10 11:40:00,41,32,8,2,0,0,4,0,87
2024-03-10 11:50:00,34,21,13,0,0,0,0,0,68
2024-03-10 12:00:00,30,19,11,1,0,0,2,0,63
2024-03-10 12:10:00,43,38,10,2,0,0,0,0,93
2024-03-10 12:20:00,46,29,8,1,0,0,1,0,85
2024-03-10 12:30:00,39,27,14,2,0,0,2,1,85
2024-03-10 12:40:00,45,31,17,3,0,0,2,0,98
2024-03-10 12:50:00,34,23,13,3,0,0,3,0,76
2024-03-10 13:00:00,46,35,12,4,0,0,1,0,98
2024-03-10 13:10:00,55,34,9,2,0,0,3,0,103
2024-03-10 13:20:00,41,23,14,3,0,0,1,0,82
2024-03-10 13:30:00,37,30,10,2,0,0,1,1,81
2024-03-10 13:40:00,36,26,13,5,0,0,2,0,82
2024-03-10 13:50:00,39,22,11,1,0,0,0,0,73
2024-03-10 14:00:00,41,27,9,3,0,0,3,0,83
2024-03-10 14:10:00,45,28,16,3,0,0,2,0,94
2024-03-10 14:20:00,35,24,9,4,0,0,2,0,74
2024-03-10 14:30:00,35,23,15,3,0,0,0,0,76
2024-03-10 14:40:00,41,29,9,3,0,0,4,1,87
2024-03-10 14:50:00,44,23,14,3,0,0,2,0,86
2024-03-10 15:00:00,37,21,17,1,0,0,2,0,78
2024-03-10 15:10:00,40,25,23,2,0,0,2,1,93
2024-03-10 15:20:00,34,32,19,4,0,0,2,0,91
2024-03-10 15:30:00,58,35,16,5,0,0,1,0,115
2024-03-10 15:40:00,39,25,8,3,0,0,2,0,77
2024-03-10 15:50:00,42,28,17,2,0,0,3,0,92
2024-03-10 16:00:00,44,30,10,6,0,0,0,1,91
2024-03-10 16:10:00,37,23,11,3,0,0,2,0,76
2024-03-10 16:20:00,43,32,16,3,0,0,2,3,99
2024-03-10 16:30:00,38,20,16,4,0,0,2,0,80
2024-03-10 16:40:00,41,28,13,4,0,0,5,0,91
2024-03-10 16:50:00,43,24,11,4,0,0,3,0,85
2024-03-10 17:00:00,30,21,21,2,0,0,0,0,74
2024-03-10 17:10:00,40,25,17,2,0,0,8,2,94
2024-03-10 17:20:00,42,31,14,1,0,0,0,0,88
2024-03-10 17:30:00,40,31,14,4,0,0,3,0,92
2024-03-10 17:40:00,36,25,18,0,0,0,1,0,80
2024-03-10 17:50:00,44,34,12,3,0,0,2,0,95
2024-03-10 18:00:00,32,25,13,2,0,0,5,0,77
2024-03-10 18:10:00,50,31,9,1,0,0,2,0,93
2024-03-10 18:20:00,36,24,8,0,0,0,1,0,69
2024-03-10 18:30:00,33,26,21,2,0,0,0,0,82
2024-03-10 18:40:00,32,31,11,0,0,0,1,0,75
2024-03-10 18:50:00,42,34,17,3,0,0,1,0,97
2024-03-10 19:00:00,39,34,16,4,0,0,3,0,96
2024-03-10 19:10:00,48,41,14,0,0,0,1,0,104
2024-03-10 19:20:00,31,28,19,3,0,0,0,0,81
2024-03-10 19:30:00,26,26,9,1,0,0,1,0,63
2024-03-10 19:40:00,28,24,10,2,0,0,1,0,65
2024-03-10 19:50:00,24,21,8,1,0,0,1,0,55
2024-03-10 20:00:00,35,29,10,4,0,0,3,0,81
2024-03-10 20:10:00,26,25,10,1,0,0,0,0,62
2024-03-10 20:20:00,27,24,10,1,0,0,0,0,62
2024-03-10 20:30:00,19,21,14,4,0,0,3,1,62
2024-03-10 20:40:00,21,18,4,0,0,0,0,0,43
2024-03-10 20:50:00,29,24,12,3,0,0,0,0,68
2024-03-10 21:00:00,27,20,39,0,0,0,0,0,86
2024-03-10 21:10:00,35,34,5,3,0,0,0,0,77
2024-03-10 21:20:00,30,27,11,6,0,0,0,0,74
2024-03-10 21:30:00,44,29,8,2,0,0,0,0,83
2024-03-10 21:40:00,25,18,7,1,0,0,0,0,51
2024-03-10 21:50:00,18,18,9,2,0,0,0,0,47
2024-03-10 22:00:00,9,12,4,1,0,0,0,0,26
2024-03-10 22:10:00,17,14,8,1,0,0,2,0,42
2024-03-10 22:20:00,15,12,6,1,0,0,0,0,34
2024-03-10 22:30:00,8,6,9,5,0,0,0,0,28
2024-03-10 22:40:00,8,6,5,4,0,0,0,0,23
2024-03-10 22:50:00,10,10,5,10,0,0,0,0,35
2024-03-10 23:00:00,4,4,4,4,0,0,0,0,16
2024-03-10 23:10:00,8,5,6,7,0,0,0,0,26
2024-03-10 23:20:00,5,5,7,5,0,0,0,0,22
2024-03-10 23:30:00,3,3,5,3,0,0,0,0,14
2024-03-10 23:40:00,9,7,9,7,0,0,0,0,32
2024-03-10 23:50:00,4,3,2,3,0,0,0,0,12
2024-03-11 00:00:00,2,2,1,3,0,0,0,0,8
2024-03-11 00:10:00,7,5,7,5,0,0,0,0,24
2024-03-11 00:20:00,6,6,6,5,0,0,0,0,23
2024-03-11 00:30:00,4,4,6,4,0,0,0,0,18
2024-03-11 00:40:00,3,3,6,2,0,0,0,0,14
2024-03-11 00:50:00,1,1,3,1,0,0,0,0,6
2024-03-11 01:00:00,4,4,1,5,0,0,0,0,14
2024-03-11 01:10:00,3,2,4,3,0,0,0,0,12
2024-03-11 01:20:00,2,2,1,1,0,0,0,0,6
2024-03-11 01:30:00,1,1,0,1,0,0,0,0,3
2024-03-11 01:40:00,3,3,2,3,0,0,0,0,11
2024-03-11 01:50:00,2,2,1,2,0,0,0,0,7
2024-03-11 02:00:00,0,0,3,0,0,0,0,0,3
2024-03-11 02:10:00,7,6,4,6,0,0,0,0,23
2024-03-11 02:20:00,2,2,0,2,0,0,0,0,6
2024-03-11 02:30:00,3,3,2,3,0,0,0,0,11
2024-03-11 02:40:00,1,1,0,1,0,0,0,0,3
2024-03-11 02:50:00,0,0,0,0,0,0,0,0,0
2024-03-11 03:00:00,0,0,0,0,0,0,0,0,0
2024-03-11 03:10:00,5,5,3,5,0,0,0,0,18
2024-03-11 03:20:00,0,0,1,0,0,0,0,0,1
2024-03-11 03:30:00,0,0,1,0,0,0,1,0,2
2024-03-11 03:40:00,0,0,0,0,0,0,0,0,0
2024-03-11 03:50:00,1,1,2,1,0,0,0,0,5
2024-03-11 04:00:00,1,1,2,1,0,0,0,0,5
2024-03-11 04:10:00,3,3,2,2,0,0,0,0,10
2024-03-11 04:20:00,1,1,3,1,0,0,0,0,6
2024-03-11 04:30:00,0,0,3,0,0,0,0,0,3
2024-03-11 04:40:00,2,2,1,2,0,0,0,0,7
2024-03-11 04:50:00,1,1,1,1,0,0,0,0,4
2024-03-11 05:00:00,2,2,4,3,0,0,0,0,11
2024-03-11 05:10:00,4,4,12,4,0,0,1,0,25
2024-03-11 05:20:00,3,3,5,3,0,0,0,0,14
2024-03-11 05:30:00,4,4,11,4,0,0,1,0,24
2024-03-11 05:40:00,3,3,8,4,0,0,0,0,18
2024-03-11 05:50:00,8,8,8,8,0,0,0,0,32
2024-03-11 06:00:00,3,4,9,7,0,0,1,0,24
2024-03-11 06:10:00,7,7,12,8,0,0,1,0,35
2024-03-11 06:20:00,13,13,18,11,0,0,0,0,55
2024-03-11 06:30:00,13,10,21,14,0,0,1,0,59
2024-03-11 06:40:00,15,11,22,8,0,0,0,0,56
2024-03-11 06:50:00,15,11,26,6,0,0,0,0,58
2024-03-11 07:00:00,16,10,25,13,0,0,3,1,68
2024-03-11 07:10:00,23,15,42,4,0,0,1,0,85
2024-03-11 07:20:00,48,28,34,0,0,0,3,3,116
2024-03-11 07:30:00,38,18,19,5,0,0,2,1,83
2024-03-11 07:40:00,53,26,19,8,0,0,6,1,113
2024-03-11 07:50:00,32,19,29,10,0,0,4,0,94
2024-03-11 08:00:00,43,27,64,12,0,0,4,0,150
2024-03-11 08:10:00,31,16,34,4,0,0,0,0,85
2024-03-11 08:20:00,50,34,23,5,0,0,1,0,113
2024-03-11 08:30:00,45,30,21,3,0,0,2,1,102
2024-03-11 08:40:00,55,24,21,4,0,0,1,0,105
2024-03-11 08:50:00,48,21,27,9,0,0,1,0,106
2024-03-11 09:00:00,48,33,23,11,0,0,3,0,118
2024-03-11 09:10:00,51,29,22,4,0,0,2,0,108
2024-03-11 09:20:00,38,19,26,6,0,0,2,1,92
2024-03-11 09:30:00,39,26,19,3,0,0,0,0,87
2024-03-11 09:40:00,56,42,32,7,0,0,1,0,138
2024-03-11 09:50:00,36,23,29,13,0,0,1,0,102
2024-03-11 10:00:00,40,30,34,3,0,0,1,1,109
2024-03-11 10:10:00,49,33,29,3,0,0,1,0,115
2024-03-11 10:20:00,47,34,15,6,0,0,2,0,104
2024-03-11 10:30:00,41,34,13,2,0,0,7,0,97
2024-03-11 10:40:00,46,37,19,8,0,0,4,0,114
2024-03-11 10:50:00,44,31,16,8,0,0,0,0,99
2024-03-11 11:00:00,53,32,17,3,0,0,2,0,107
2024-03-11 11:10:00,44,34,19,2,0,0,2,1,102
2024-03-11 11:20:00,42,34,26,3,0,0,1,0,106
2024-03-11 11:30:00,61,35,23,2,0,0,0,0,121
2024-03-11 11:40:00,68,39,25,7,0,0,0,0,139
2024-03-11 11:50:00,65,36,22,7,0,0,4,0,134
2024-03-11 12:00:00,51,37,23,3,0,0,5,0,119
2024-03-11 12:10:00,56,32,23,7,0,0,2,0,120
2024-03-11 12:20:00,65,24,18,5,0,0,1,0,113
2024-03-11 12:30:00,62,25,17,8,0,0,1,0,113
2024-03-11 12:40:00,55,26,23,8,0,0,0,0,112
2024-03-11 12:50:00,54,26,14,7,0,0,6,3,110
2024-03-11 13:00:00,46,25,20,9,0,0,3,2,105
2024-03-11 13:10:00,79,38,17,4,0,0,4,0,142
2024-03-11 13:20:00,76,28,16,14,0,0,4,0,138
2024-03-11 13:30:00,61,33,23,7,0,0,8,1,133
2024-03-11 13:40:00,64,25,24,8,0,0,6,1,128
2024-03-11 13:50:00,60,34,12,4,0,0,4,1,115
2024-03-11 14:00:00,63,45,24,3,0,0,2,1,138
2024-03-11 14:10:00,66,48,25,8,0,0,4,1,152
2024-03-11 14:20:00,67,42,24,6,0,0,4,0,143
2024-03-11 14:30:00,66,38,19,2,0,0,5,0,130
2024-03-11 14:40:00,70,50,26,6,0,0,0,0,152
2024-03-11 14:50:00,79,53,24,8,0,0,4,0,168
2024-03-11 15:00:00,68,54,25,3,0,0,3,0,153
2024-03-11 15:10:00,64,48,14,2,0,0,4,2,134
2024-03-11 15:20:00,62,43,14,1,0,0,4,0,124
2024-03-11 15:30:00,72,57,25,3,0,0,3,0,160
2024-03-11 15:40:00,74,51,21,6,0,0,4,0,156
2024-03-11 15:50:00,101,61,24,11,0,0,4,0,201
2024-03-11 16:00:00,78,50,23,11,0,0,0,0,162
2024-03-11 16:10:00,79,49,23,2,0,0,3,0,156
2024-03-11 16:20:00,78,38,16,2,0,0,1,0,135
2024-03-11 16:30:00,85,56,20,1,0,0,2,0,164
2024-03-11 16:40:00,64,44,21,3,0,0,6,0,138
2024-03-11 16:50:00,77,59,17,0,0,0,5,0,158
2024-03-11 17:00:00,87,57,26,13,0,0,5,0,188
2024-03-11 17:10:00,90,49,24,5,0,0,4,0,172
2024-03-11 17:20:00,68,44,25,6,0,0,6,0,149
2024-03-11 17:30:00,86,65,19,4,0,0,2,0,176
2024-03-11 17:40:00,73,47,28,5,0,0,0,1,154
2024-03-11 17:50:00,66,54,25,3,0,0,2,1,151
2024-03-11 18:00:00,68,47,16,2,0,0,3,0,136
2024-03-11 18:10:00,87,68,22,2,0,0,4,0,183
2024-03-11 18:20:00,66,37,17,0,0,0,2,0,122
2024-03-11 18:30:00,73,51,16,13,0,0,4,0,157
2024-03-11 18:40:00,61,44,16,2,0,0,4,0,127
2024-03-11 18:50:00,56,40,14,4,0,0,0,0,114
2024-03-11 19:00:00,38,31,16,1,0,0,0,0,86
2024-03-11 19:10:00,62,41,13,2,0,0,0,0,118
2024-03-11 19:20:00,52,28,17,3,0,0,3,1,104
2024-03-11 19:30:00,44,34,17,0,0,0,4,0,99
2024-03-11 19:40:00,41,25,21,2,0,0,2,0,91
2024-03-11 19:50:00,53,35,16,0,0,0,0,0,104
2024-03-11 20:00:00,43,33,14,6,0,0,2,0,98
2024-03-11 20:10:00,43,36,39,1,0,0,1,0,120
2024-03-11 20:20:00,38,34,18,6,0,0,1,0,97
2024-03-11 20:30:00,37,27,9,0,0,0,2,0,75
2024-03-11 20:40:00,30,25,4,0,0,0,1,0,60
2024-03-11 20:50:00,30,22,10,3,0,0,1,0,66
2024-03-11 21:00:00,26,23,12,1,0,0,0,1,63
2024-03-11 21:10:00,34,25,5,2,0,0,0,0,66
2024-03-11 21:20:00,36,29,9,1,0,0,1,0,76
2024-03-11 21:30:00,34,27,10,4,0,0,0,0,75
2024-03-11 21:40:00,22,21,5,0,0,0,0,0,48
2024-03-11 21:50:00,29,30,11,1,0,0,1,0,72
2024-03-11 22:00:00,32,32,12,9,0,0,2,0,87
2024-03-11 22:10:00,25,22,10,3,0,0,1,0,61
2024-03-11 22:20:00,17,16,10,1,0,0,0,0,44
2024-03-11 22:30:00,20,17,3,0,0,0,0,0,40
2024-03-11 22:40:00,13,15,5,0,0,0,0,0,33
2024-03-11 22:50:00,16,14,3,3,0,0,0,0,36
2024-03-11 23:00:00,10,11,9,2,0,0,0,0,32
2024-03-11 23:10:00,8,7,3,0,0,0,0,0,18
2024-03-11 23:20:00,12,13,5,3,0,0,1,0,34
2024-03-11 23:30:00,6,8,3,2,0,0,0,0,19
2024-03-11 23:40:00,9,8,2,0,0,0,0,0,19
2024-03-11 23:50:00,3,4,2,0,0,0,0,0,9
2024-03-12 00:00:00,2,2,0,0,0,0,0,0,4
2024-03-12 00:10:00,1,1,2,1,0,0,0,0,5
2024-03-12 00:20:00,6,7,2,0,0,0,0,0,15
2024-03-12 00:30:00,6,6,1,0,0,0,0,0,13
2024-03-12 00:40:00,4,5,1,1,0,0,0,0,11
2024-03-12 00:50:00,2,3,0,0,0,0,0,0,5
2024-03-12 01:00:00,2,2,2,1,0,0,0,0,7
2024-03-12 01:10:00,0,0,1,2,0,0,0,0,3
2024-03-12 01:20:00,0,0,1,0,0,0,0,0,1
2024-03-12 01:30:00,3,3,2,1,0,0,0,0,9
2024-03-12 01:40:00,0,0,1,0,0,0,0,0,1
2024-03-12 01:50:00,2,2,1,1,0,0,0,0,6
2024-03-12 02:00:00,3,3,5,1,0,0,0,0,12
2024-03-12 02:10:00,1,1,1,0,0,0,0,0,3
2024-03-12 02:20:00,2,2,1,1,0,0,0,0,6
2024-03-12 02:30:00,1,1,1,0,0,0,0,0,3
2024-03-12 02:40:00,0,0,0,0,0,0,0,0,0
2024-03-12 02:50:00,1,1,0,0,0,0,0,0,2
2024-03-12 03:00:00,0,0,0,0,0,0,0,0,0
2024-03-12 03:10:00,2,2,2,0,0,0,0,0,6
2024-03-12 03:20:00,3,3,2,0,0,0,0,0,8
2024-03-12 03:30:00,1,1,2,2,0,0,0,0,6
2024-03-12 03:40:00,0,0,0,0,0,0,0,0,0
2024-03-12 03:50:00,1,1,0,0,0,0,1,0,3
2024-03-12 04:00:00,1,1,0,0,0,0,0,0,2
2024-03-12 04:10:00,1,1,1,0,0,0,0,0,3
2024-03-12 04:20:00,1,1,1,0,0,0,0,0,3
2024-03-12 04:30:00,1,2,1,0,0,0,0,0,4
2024-03-12 04:40:00,1,1,1,0,0,0,0,0,3
2024-03-12 04:50:00,0,0,2,0,0,0,0,0,2
2024-03-12 05:00:00,3,2,1,0,0,0,0,0,6
2024-03-12 05:10:00,2,2,4,0,0,0,0,0,8
2024-03-12 05:20:00,3,4,3,1,0,0,3,3,17
2024-03-12 05:30:00,6,5,7,0,0,0,0,0,18
2024-03-12 05:40:00,7,7,7,0,0,0,2,0,23
2024-03-12 05:50:00,4,5,5,2,0,0,0,0,16
2024-03-12 06:00:00,6,6,6,2,0,0,0,0,20
2024-03-12 06:10:00,10,8,12,8,0,0,1,0,39
2024-03-12 06:20:00,13,14,17,10,0,0,0,0,54
2024-03-12 06:30:00,9,10,12,10,0,0,0,0,41
2024-03-12 06:40:00,16,16,20,11,0,0,0,0,63
2024-03-12 06:50:00,20,16,20,10,0,0,1,0,67
2024-03-12 07:00:00,13,13,24,13,0,0,1,1,65
2024-03-12 07:10:00,30,22,44,6,0,0,9,0,111
2024-03-12 07:20:00,25,13,37,7,0,0,8,0,90
2024-03-12 07:30:00,26,16,17,7,0,0,4,2,72
2024-03-12 07:40:00,48,23,22,11,0,0,4,0,108
2024-03-12 07:50:00,58,27,23,9,0,0,1,0,118
2024-03-12 08:00:00,41,29,25,6,0,0,6,0,107
2024-03-12 08:10:00,41,23,22,9,0,0,3,1,99
2024-03-12 08:20:00,32,17,26,1,0,0,3,0,79
2024-03-12 08:30:00,34,25,29,5,0,0,0,0,93
2024-03-12 08:40:00,50,33,26,4,0,0,3,0,116
2024-03-12 08:50:00,48,20,28,8,0,0,3,0,107
2024-03-12 09:00:00,46,29,31,4,0,0,3,0,113
2024-03-12 09:10:00,44,23,20,5,0,0,3,0,95
2024-03-12 09:20:00,34,20,11,5,0,0,2,0,72
2024-03-12 09:30:00,38,23,30,10,0,0,3,0,104
2024-03-12 09:40:00,40,30,23,3,0,0,1,1,98
2024-03-12 09:50:00,48,30,16,4,0,0,2,0,100
2024-03-12 10:00:00,39,28,18,5,0,0,0,0,90
2024-03-12 10:10:00,44,31,30,2,0,0,5,0,112
2024-03-12 10:20:00,38,32,15,3,0,0,3,0,91
2024-03-12 10:30:00,54,40,21,4,0,0,0,0,119
2024-03-12 10:40:00,51,44,23,3,0,0,3,0,124
2024-03-12 10:50:00,46,43,24,5,0,0,0,0,118
2024-03-12 11:00:00,56,39,20,3,0,0,4,0,122
2024-03-12 11:10:00,52,32,23,2,0,0,3,0,112
2024-03-12 11:20:00,37,30,18,4,0,0,1,0,90
2024-03-12 11:30:00,76,54,18,6,0,0,2,0,156
2024-03-12 11:40:00,57,46,19,6,0,0,5,0,133
2024-03-12 11:50:00,55,37,23,10,0,0,2,0,127
2024-03-12 12:00:00,55,44,24,6,0,0,2,0,131
2024-03-12 12:10:00,50,31,19,4,0,0,2,0,106
2024-03-12 12:20:00,60,42,14,4,0,0,2,1,123
2024-03-12 12:30:00,54,37,23,2,0,0,4,1,121
2024-03-12 12:40:00,59,32,25,4,0,0,3,0,123
2024-03-12 12:50:00,55,37,16,0,0,0,0,1,109
2024-03-12 13:00:00,64,38,25,4,0,0,2,0,133
2024-03-12 13:10:00,71,46,21,9,0,0,4,0,151
2024-03-12 13:20:00,61,40,26,14,0,0,10,0,151
2024-03-12 13:30:00,47,31,28,8,0,0,2,2,118
2024-03-12 13:40:00,46,26,22,7,0,0,8,1,110
2024-03-12 13:50:00,63,33,32,4,0,0,1,1,134
2024-03-12 14:00:00,52,44,27,5,0,0,1,1,130
2024-03-12 14:10:00,85,51,24,7,0,0,0,0,167
2024-03-12 14:20:00,65,49,16,3,0,0,4,0,137
2024-03-12 14:30:00,76,45,19,7,0,0,1,0,148
2024-03-12 14:40:00,70,43,17,1,0,0,6,2,139
2024-03-12 14:50:00,86,35,19,6,0,0,2,0,148
2024-03-12 15:00:00,78,54,20,5,0,0,2,0,159
2024-03-12 15:10:00,74,56,22,4,0,0,5,0,161
2024-03-12 15:20:00,86,45,23,3,0,0,2,1,160
2024-03-12 15:30:00,74,52,22,1,0,0,0,2,151
2024-03-12 15:40:00,60,32,18,6,0,0,3,0,119
2024-03-12 15:50:00,85,53,29,9,0,0,3,1,180
2024-03-12 16:00:00,69,47,23,3,0,0,0,0,142
2024-03-12 16:10:00,76,45,28,3,0,0,3,0,155
2024-03-12 16:20:00,89,43,21,3,0,0,2,0,158
2024-03-12 16:30:00,74,57,19,3,0,0,3,0,156
2024-03-12 16:40:00,69,50,24,6,0,0,1,0,150
2024-03-12 16:50:00,97,51,24,5,0,0,5,0,182
2024-03-12 17:00:00,66,38,22,2,0,0,3,0,131
2024-03-12 17:10:00,102,49,21,2,0,0,3,1,178
2024-03-12 17:20:00,91,50,24,4,0,0,1,1,171
2024-03-12 17:30:00,85,59,22,5,0,0,2,0,173
2024-03-12 17:40:00,70,56,18,5,0,0,8,0,157
2024-03-12 17:50:00,87,57,29,3,0,0,2,0,178
2024-03-12 18:00:00,84,39,22,4,0,0,2,0,151
2024-03-12 18:10:00,88,52,11,3,0,0,3,0,157
2024-03-12 18:20:00,86,52,12,20,0,0,3,0,173
2024-03-12 18:30:00,78,43,18,10,0,0,3,0,152
2024-03-12 18:40:00,68,42,18,2,0,0,1,0,131
2024-03-12 18:50:00,69,38,27,3,0,0,3,0,140
2024-03-12 19:00:00,50,29,17,1,0,0,3,1,101
2024-03-12 19:10:00,76,40,20,5,0,0,2,0,143
2024-03-12 19:20:00,48,32,17,1,0,0,1,0,99
2024-03-12 19:30:00,54,45,20,4,0,0,4,0,127
2024-03-12 19:40:00,36,28,10,2,0,0,6,0,82
2024-03-12 19:50:00,36,26,13,3,0,0,0,0,78
2024-03-12 20:00:00,32,23,7,2,0,0,1,0,65
2024-03-12 20:10:00,37,25,13,3,0,0,1,0,79
2024-03-12 20:20:00,41,33,14,2,0,0,1,0,91
2024-03-12 20:30:00,34,26,6,12,0,0,0,0,78
2024-03-12 20:40:00,62,29,16,26,0,0,0,0,133
2024-03-12 20:50:00,79,22,18,29,0,0,1,0,149
2024-03-12 21:00:00,47,25,22,31,0,0,0,0,125
2024-03-12 21:10:00,41,21,15,26,0,0,0,0,103
2024-03-12 21:20:00,22,17,10,18,0,0,0,0,67
2024-03-12 21:30:00,41,23,15,24,0,0,0,0,103
2024-03-12 21:40:00,41,20,15,25,0,0,0,0,101
2024-03-12 21:50:00,35,21,8,19,0,0,1,0,84
2024-03-12 22:00:00,24,20,12,20,0,0,0,0,76
2024-03-12 22:10:00,28,16,15,16,0,0,0,0,75
2024-03-12 22:20:00,27,16,12,17,0,0,1,0,73
2024-03-12 22:30:00,19,14,9,16,0,0,0,0,58
2024-03-12 22:40:00,31,21,12,22,0,0,1,0,87
2024-03-12 22:50:00,49,22,11,23,0,0,0,0,105
2024-03-12 23:00:00,25,18,10,18,0,0,0,0,71
2024-03-12 23:10:00,35,22,16,21,0,0,0,0,94
2024-03-12 23:20:00,28,19,10,16,0,0,0,0,73
2024-03-12 23:30:00,13,13,6,12,0,0,0,0,44
2024-03-12 23:40:00,12,9,9,9,0,0,0,0,39
2024-03-12 23:50:00,9,7,5,6,0,0,0,0,27
2024-03-13 00:00:00,5,5,5,6,0,0,0,0,21
2024-03-13 00:10:00,4,4,5,4,0,0,0,0,17
2024-03-13 00:20:00,8,5,10,7,0,0,0,0,30
2024-03-13 00:30:00,12,9,7,12,0,0,0,0,40
2024-03-13 00:40:00,9,5,8,7,0,0,0,0,29
2024-03-13 00:50:00,3,3,3,3,0,0,0,0,12
2024-03-13 01:00:00,3,3,4,4,0,0,0,0,14
2024-03-13 01:10:00,1,1,0,1,0,0,0,0,3
2024-03-13 01:20:00,3,3,2,2,0,0,0,0,10
2024-03-13 01:30:00,2,2,3,2,0,0,0,0,9
2024-03-13 01:40:00,2,2,0,2,0,0,0,0,6
2024-03-13 01:50:00,4,4,1,5,0,0,0,0,14
2024-03-13 02:00:00,0,0,1,0,0,0,0,0,1
2024-03-13 02:10:00,2,2,1,2,0,0,0,0,7
2024-03-13 02:20:00,2,2,3,2,0,0,0,0,9
2024-03-13 02:30:00,1,1,2,2,0,0,0,0,6
2024-03-13 02:40:00,1,1,1,1,0,0,0,0,4
2024-03-13 02:50:00,1,1,0,1,0,0,0,0,3
2024-03-13 03:00:00,0,0,1,0,0,0,0,0,1
2024-03-13 03:10:00,2,2,1,2,0,0,0,0,7
2024-03-13 03:20:00,1,1,3,1,0,0,0,0,6
2024-03-13 03:30:00,3,3,3,4,0,0,0,0,13
2024-03-13 03:40:00,1,1,3,1,0,0,0,0,6
2024-03-13 03:50:00,0,0,1,0,0,0,1,0,2
2024-03-13 04:00:00,3,3,1,3,0,0,0,0,10
2024-03-13 04:10:00,1,1,0,1,0,0,0,0,3
2024-03-13 04:20:00,1,1,1,1,0,0,0,0,4
2024-03-13 04:30:00,0,0,3,0,0,0,0,0,3
2024-03-13 04:40:00,1,1,1,1,0,0,0,0,4
2024-03-13 04:50:00,1,1,2,0,0,0,0,0,4
2024-03-13 05:00:00,4,5,5,3,0,0,0,0,17
2024-03-13 05:10:00,3,3,5,3,0,0,0,0,14
2024-03-13 05:20:00,4,4,5,4,0,0,1,0,18
2024-03-13 05:30:00,4,3,3,3,0,0,0,0,13
2024-03-13 05:40:00,7,7,9,7,0,0,0,0,30
2024-03-13 05:50:00,4,4,6,4,0,0,0,0,18
2024-03-13 06:00:00,6,5,9,6,0,0,1,0,27
2024-03-13 06:10:00,9,11,13,10,0,0,1,0,44
2024-03-13 06:20:00,17,12,16,15,0,0,0,0,60
2024-03-13 06:30:00,6,7,15,9,0,0,0,0,37
2024-03-13 06:40:00,23,17,19,9,0,0,3,0,71
2024-03-13 06:50:00,8,12,18,4,0,0,1,0,43
2024-03-13 07:00:00,13,10,29,7,0,0,3,0,62
2024-03-13 07:10:00,42,19,40,9,0,0,0,0,110
2024-03-13 07:20:00,45,20,32,5,0,0,5,1,108
2024-03-13 07:30:00,37,21,29,13,0,0,4,1,105
2024-03-13 07:40:00,45,22,29,5,0,0,4,3,108
2024-03-13 07:50:00,56,37,24,12,0,0,5,1,135
2024-03-13 08:00:00,32,24,24,12,0,0,0,0,92
2024-03-13 08:10:00,49,27,22,6,0,0,1,0,105
2024-03-13 08:20:00,39,19,25,4,0,0,0,0,87
2024-03-13 08:30:00,54,30,29,5,0,0,1,0,119
2024-03-13 08:40:00,37,27,21,5,0,0,6,0,96
2024-03-13 08:50:00,46,24,36,8,0,0,0,0,114
2024-03-13 09:00:00,45,31,17,7,0,0,1,0,101
2024-03-13 09:10:00,41,23,24,1,0,0,3,0,92
2024-03-13 09:20:00,37,25,32,3,0,0,2,0,99
2024-03-13 09:30:00,43,33,16,6,0,0,1,0,99
2024-03-13 09:40:00,44,26,21,8,0,0,0,0,99
2024-03-13 09:50:00,43,31,24,6,0,0,0,0,104
2024-03-13 10:00:00,45,39,27,3,0,0,2,0,116
2024-03-13 10:10:00,48,33,22,4,0,0,0,0,107
2024-03-13 10:20:00,44,31,16,2,0,0,1,0,94
2024-03-13 10:30:00,43,36,15,4,0,0,3,0,101
2024-03-13 10:40:00,56,37,13,2,0,0,1,0,109
2024-03-13 10:50:00,44,38,27,4,0,0,1,0,114
2024-03-13 11:00:00,51,25,28,2,0,0,1,0,107
2024-03-13 11:10:00,51,33,21,3,0,0,3,0,111
2024-03-13 11:20:00,53,33,19,0,0,0,3,3,111
2024-03-13 11:30:00,57,47,14,4,0,0,2,0,124
2024-03-13 11:40:00,49,31,21,4,0,0,3,0,108
2024-03-13 11:50:00,51,30,19,4,0,0,5,0,109
2024-03-13 12:00:00,60,39,20,11,0,0,0,0,130
2024-03-13 12:10:00,60,33,22,6,0,0,1,1,123
2024-03-13 12:20:00,55,38,20,5,0,0,3,0,121
2024-03-13 12:30:00,47,33,12,2,0,0,3,0,97
2024-03-13 12:40:00,52,29,13,6,0,0,4,0,104
2024-03-13 12:50:00,52,32,19,6,0,0,1,0,110
2024-03-13 13:00:00,63,48,22,5,0,0,1,0,139
2024-03-13 13:10:00,61,35,15,7,0,0,4,0,122
2024-03-13 13:20:00,58,33,43,10,0,0,2,1,147
2024-03-13 13:30:00,54,41,31,11,0,0,3,1,141
2024-03-13 13:40:00,54,31,24,9,0,0,4,0,122
2024-03-13 13:50:00,57,32,33,5,0,0,1,1,129
2024-03-13 14:00:00,62,35,28,8,0,0,3,1,137
2024-03-13 14:10:00,52,30,23,7,0,0,1,0,113
2024-03-13 14:20:00,52,43,15,5,0,0,7,0,122
2024-03-13 14:30:00,64,50,22,2,0,0,0,1,139
2024-03-13 14:40:00,69,40,23,8,0,0,0,0,140
2024-03-13 14:50:00,76,36,24,6,0,0,4,1,147
2024-03-13 15:00:00,66,35,19,6,0,0,3,0,129
2024-03-13 15:10:00,70,40,22,4,0,0,8,0,144
2024-03-13 15:20:00,56,49,30,1,0,0,0,0,136
2024-03-13 15:30:00,61,41,27,3,0,0,4,0,136
2024-03-13 15:40:00,72,40,26,8,0,0,2,0,148
2024-03-13 15:50:00,76,65,15,6,0,0,3,0,165
2024-03-13 16:00:00,63,54,29,3,0,0,1,0,150
2024-03-13 16:10:00,61,47,29,4,0,0,5,0,146
2024-03-13 16:20:00,71,57,24,1,0,0,1,0,154
2024-03-13 16:30:00,76,45,26,2,0,0,3,0,152
2024-03-13 16:40:00,77,48,26,5,0,0,3,1,160
2024-03-13 16:50:00,75,60,26,4,0,0,3,0,168
2024-03-13 17:00:00,70,42,22,3,0,0,4,0,141
2024-03-13 17:10:00,72,55,24,1,0,0,1,0,153
2024-03-13 17:20:00,73,51,18,2,0,0,1,0,145
2024-03-13 17:30:00,72,47,24,5,0,0,4,1,153
2024-03-13 17:40:00,97,65,23,5,0,0,6,0,196
2024-03-13 17:50:00,68,28,19,7,0,0,2,0,124
2024-03-13 18:00:00,72,44,28,5,0,0,0,0,149
2024-03-13 18:10:00,91,43,23,1,0,0,5,0,163
2024-03-13 18:20:00,64,36,19,22,0,0,2,0,143
2024-03-13 18:30:00,92,23,18,44,0,0,3,0,180
2024-03-13 18:40:00,69,31,19,31,0,0,0,0,150
2024-03-13 18:50:00,60,28,21,29,0,0,3,0,141
2024-03-13 19:00:00,60,23,20,20,0,0,0,0,123
2024-03-13 19:10:00,66,35,23,36,0,0,1,0,161
2024-03-13 19:20:00,47,21,20,22,0,0,1,1,112
2024-03-13 19:30:00,56,22,25,29,0,0,8,0,140
2024-03-13 19:40:00,44,23,17,24,0,0,1,0,109
2024-03-13 19:50:00,35,26,12,22,0,0,0,0,95
2024-03-13 20:00:00,36,23,12,21,0,0,2,0,94
2024-03-13 20:10:00,52,26,14,20,0,0,5,0,117
2024-03-13 20:20:00,43,32,14,28,0,0,2,0,119
2024-03-13 20:30:00,26,24,10,17,0,0,1,0,78
2024-03-13 20:40:00,39,32,10,25,0,0,1,0,107
2024-03-13 20:50:00,35,20,11,21,0,0,2,0,89
2024-03-13 21:00:00,39,30,7,18,0,0,0,0,94
2024-03-13 21:10:00,31,23,12,16,0,0,0,0,82
2024-03-13 21:20:00,53,38,12,27,0,0,1,0,131
2024-03-13 21:30:00,38,27,2,24,0,0,0,0,91
2024-03-13 21:40:00,27,24,11,12,0,0,1,0,75
2024-03-13 21:50:00,25,16,7,11,0,0,0,0,59
2024-03-13 22:00:00,28,25,6,20,0,0,0,0,79
2024-03-13 22:10:00,32,22,7,13,0,0,0,0,74
2024-03-13 22:20:00,25,22,6,12,0,0,0,0,65
2024-03-13 22:30:00,37,31,9,18,0,0,0,0,95
2024-03-13 22:40:00,26,23,8,17,0,0,0,0,74
2024-03-13 22:50:00,21,22,10,9,0,0,0,0,62
2024-03-13 23:00:00,14,13,8,12,0,0,0,0,47
2024-03-13 23:10:00,16,17,5,13,0,0,0,0,51
2024-03-13 23:20:00,19,18,7,12,0,0,0,0,56
2024-03-13 23:30:00,7,5,5,5,0,0,0,0,22
2024-03-13 23:40:00,12,10,4,10,0,0,0,0,36
2024-03-13 23:50:00,7,8,6,7,0,0,0,0,28
2024-03-14 00:00:00,10,12,6,9,0,0,0,0,37
2024-03-14 00:10:00,7,7,5,7,0,0,0,0,26
2024-03-14 00:20:00,3,5,1,1,0,0,1,0,11
2024-03-14 00:30:00,9,9,5,4,0,0,0,0,27
2024-03-14 00:40:00,4,5,0,1,0,0,0,0,10
2024-03-14 00:50:00,4,5,3,0,0,0,0,0,12
2024-03-14 01:00:00,2,2,2,1,0,0,0,0,7
2024-03-14 01:10:00,2,3,2,2,0,0,0,0,9
2024-03-14 01:20:00,3,4,3,1,0,0,2,0,13
2024-03-14 01:30:00,2,2,1,2,0,0,0,0,7
2024-03-14 01:40:00,0,0,0,0,0,0,0,0,0
2024-03-14 01:50:00,3,3,4,2,0,0,0,0,12
2024-03-14 02:00:00,4,4,5,4,0,0,0,0,17
2024-03-14 02:10:00,2,2,0,2,0,0,0,0,6
2024-03-14 02:20:00,2,2,2,1,0,0,0,0,7
2024-03-14 02:30:00,0,0,0,0,0,0,0,0,0
2024-03-14 02:40:00,0,0,0,0,0,0,0,0,0
2024-03-14 02:50:00,0,0,0,0,0,0,0,0,0
2024-03-14 03:00:00,1,1,1,0,0,0,0,0,3
2024-03-14 03:10:00,2,2,2,2,0,0,0,0,8
2024-03-14 03:20:00,3,3,3,2,0,0,0,0,11
2024-03-14 03:30:00,2,3,2,1,0,0,0,0,8
2024-03-14 03:40:00,0,0,2,0,0,0,0,0,2
2024-03-14 03:50:00,1,1,2,1,0,0,0,0,5
2024-03-14 04:00:00,2,3,1,0,0,0,0,0,6
2024-03-14 04:10:00,2,2,4,1,0,0,0,0,9
2024-03-14 04:20:00,1,1,0,0,0,0,0,0,2
2024-03-14 04:30:00,1,1,1,0,0,0,0,0,3
2024-03-14 04:40:00,1,1,1,0,0,0,0,0,3
2024-03-14 04:50:00,0,0,1,0,0,0,0,0,1
2024-03-14 05:00:00,2,2,3,1,0,0,0,0,8
2024-03-14 05:10:00,7,8,11,3,0,0,1,0,30
2024-03-14 05:20:00,1,2,3,0,0,0,0,0,6
2024-03-14 05:30:00,6,9,3,1,0,0,3,0,22
2024-03-14 05:40:00,4,4,3,1,0,0,0,0,12
2024-03-14 05:50:00,11,11,9,6,0,0,0,0,37
2024-03-14 06:00:00,7,7,11,6,0,0,0,0,31
2024-03-14 06:10:00,13,12,11,5,0,0,0,0,41
2024-03-14 06:20:00,22,15,13,7,0,0,2,0,59
2024-03-14 06:30:00,11,13,12,6,0,0,3,0,45
2024-03-14 06:40:00,20,17,19,9,0,0,3,0,68
2024-03-14 06:50:00,18,13,15,7,0,0,2,0,55
2024-03-14 07:00:00,16,12,15,13,0,0,4,0,60
2024-03-14 07:10:00,26,21,36,5,0,0,4,0,92
2024-03-14 07:20:00,38,24,39,10,0,0,6,3,120
2024-03-14 07:30:00,32,19,26,6,0,0,3,0,86
2024-03-14 07:40:00,54,19,24,10,0,0,3,1,111
2024-03-14 07:50:00,50,24,42,4,0,0,3,1,124
2024-03-14 08:00:00,35,18,28,9,0,0,2,0,92
2024-03-14 08:10:00,46,28,15,7,0,0,2,0,98
2024-03-14 08:20:00,40,15,31,1,0,0,1,2,90
2024-03-14 08:30:00,50,39,41,6,0,0,7,0,143
2024-03-14 08:40:00,53,28,19,6,0,0,3,0,109
2024-03-14 08:50:00,47,23,13,5,0,0,3,1,92
2024-03-14 09:00:00,50,26,21,10,0,0,3,1,111
2024-03-14 09:10:00,57,24,27,3,0,0,4,1,116
2024-03-14 09:20:00,31,19,16,6,0,0,4,0,76
2024-03-14 09:30:00,34,31,32,4,0,0,1,1,103
2024-03-14 09:40:00,47,32,16,4,0,0,3,0,102
2024-03-14 09:50:00,53,40,19,6,0,0,6,0,124
2024-03-14 10:00:00,53,39,18,9,0,0,3,0,122
2024-03-14 10:10:00,48,33,29,6,0,0,1,0,117
2024-03-14 10:20:00,58,44,25,4,0,0,2,0,133
2024-03-14 10:30:00,47,32,20,4,0,0,1,1,105
2024-03-14 10:40:00,54,34,36,5,0,0,0,0,129
2024-03-14 10:50:00,52,34,12,3,0,0,2,0,103
2024-03-14 11:00:00,58,44,21,6,0,0,3,0,132
2024-03-14 11:10:00,53,29,11,2,0,0,5,0,100
2024-03-14 11:20:00,50,28,21,4,0,0,0,0,103
2024-03-14 11:30:00,51,35,16,3,0,0,1,0,106
2024-03-14 11:40:00,72,52,23,6,0,0,1,1,155
2024-03-14 11:50:00,55,48,26,7,0,0,3,2,141
2024-03-14 12:00:00,72,34,16,5,0,0,2,0,129
2024-03-14 12:10:00,66,25,19,5,0,0,1,0,116
2024-03-14 12:20:00,49,30,16,8,0,0,3,0,106
2024-03-14 12:30:00,59,36,26,6,0,0,2,0,129
2024-03-14 12:40:00,57,45,18,7,0,0,5,0,132
2024-03-14 12:50:00,52,31,30,10,0,0,1,0,124
2024-03-14 13:00:00,76,47,16,5,0,0,4,3,151
2024-03-14 13:10:00,61,43,26,3,0,0,1,0,134
2024-03-14 13:20:00,61,39,19,13,0,0,3,1,136
2024-03-14 13:30:00,62,39,28,8,0,0,10,0,147
2024-03-14 13:40:00,60,36,28,12,0,0,2,1,139
2024-03-14 13:50:00,67,32,30,4,0,0,2,3,138
2024-03-14 14:00:00,46,33,25,6,0,0,3,2,115
2024-03-14 14:10:00,64,35,28,4,0,0,11,0,142
2024-03-14 14:20:00,71,34,28,4,0,0,4,0,141
2024-03-14 14:30:00,85,29,22,5,0,0,2,1,144
2024-03-14 14:40:00,64,30,24,6,0,0,2,2,128
2024-03-14 14:50:00,74,45,31,4,0,0,6,0,160
2024-03-14 15:00:00,57,41,19,6,0,0,10,1,134
2024-03-14 15:10:00,70,40,21,6,0,0,6,0,143
2024-03-14 15:20:00,59,35,23,3,0,0,3,4,127
2024-03-14 15:30:00,70,51,28,6,0,0,5,0,160
2024-03-14 15:40:00,115,56,16,5,0,0,5,0,197
2024-03-14 15:50:00,84,53,34,11,0,0,4,0,186
2024-03-14 16:00:00,74,45,18,4,0,0,4,0,145
2024-03-14 16:10:00,72,47,23,2,0,0,3,0,147
2024-03-14 16:20:00,85,47,24,4,0,0,2,1,163
2024-03-14 16:30:00,82,42,25,6,0,0,4,1,160
2024-03-14 16:40:00,179,36,16,14,0,0,2,1,248
2024-03-14 16:50:00,89,55,31,7,0,0,3,1,186
2024-03-14 17:00:00,64,43,16,2,0,0,2,1,128
2024-03-14 17:10:00,88,45,30,3,0,0,4,1,171
2024-03-14 17:20:00,87,42,20,5,0,0,2,1,157
2024-03-14 17:30:00,89,64,21,1,0,0,15,0,190
2024-03-14 17:40:00,70,49,19,2,0,0,4,0,144
2024-03-14 17:50:00,71,57,16,3,0,0,0,0,147
2024-03-14 18:00:00,77,48,12,0,0,0,0,0,137
2024-03-14 18:10:00,24,23,4,1,0,0,1,0,53
2024-03-14 18:20:00,26,20,10,2,0,0,1,1,60
2024-03-14 18:30:00,90,46,15,5,0,0,0,1,157
2024-03-14 18:40:00,61,40,19,11,0,0,1,0,132
2024-03-14 18:50:00,69,28,19,7,0,0,2,0,125
2024-03-14 19:00:00,59,37,13,3,0,0,3,0,115
2024-03-14 19:10:00,74,43,18,1,0,0,2,0,138
2024-03-14 19:20:00,49,31,24,8,0,0,0,1,113
2024-03-14 19:30:00,48,26,11,0,0,0,2,0,87
2024-03-14 19:40:00,50,35,22,3,0,0,3,0,113
2024-03-14 19:50:00,50,42,16,7,0,0,1,0,116
2024-03-14 20:00:00,32,27,14,6,0,0,8,0,87
2024-03-14 20:10:00,48,33,13,7,0,0,1,0,102
2024-03-14 20:20:00,45,24,22,5,0,0,1,0,97
2024-03-14 20:30:00,40,26,12,2,0,0,1,0,81
2024-03-14 20:40:00,32,24,11,6,0,0,1,0,74
2024-03-14 20:50:00,38,25,11,2,0,0,1,0,77
2024-03-14 21:00:00,34,27,4,3,0,0,2,0,70
2024-03-14 21:10:00,31,23,12,2,0,0,1,0,69
2024-03-14 21:20:00,38,34,14,0,0,0,3,0,89
2024-03-14 21:30:00,30,18,10,2,0,0,0,0,60
2024-03-14 21:40:00,33,26,10,1,0,0,1,0,71
2024-03-14 21:50:00,25,24,5,1,0,0,0,0,55
2024-03-14 22:00:00,30,21,6,2,0,0,0,0,59
2024-03-14 22:10:00,40,37,11,0,0,0,0,0,88
2024-03-14 22:20:00,21,14,5,0,0,0,0,0,40
2024-03-14 22:30:00,29,18,9,2,0,0,0,0,58
2024-03-14 22:40:00,16,14,4,0,0,0,0,0,34
2024-03-14 22:50:00,15,18,4,1,0,0,1,0,39
2024-03-14 23:00:00,18,13,2,0,0,0,0,0,33
2024-03-14 23:10:00,12,12,8,0,0,0,1,0,33
2024-03-14 23:20:00,18,17,8,4,0,0,0,0,47
2024-03-14 23:30:00,7,8,3,1,0,0,0,0,19
2024-03-14 23:40:00,9,10,4,0,0,0,0,0,23
2024-03-14 23:50:00,8,7,3,0,0,0,0,0,18
2024-03-15 00:00:00,10,12,5,2,0,0,0,0,29
2024-03-15 00:10:00,9,9,5,2,0,0,0,0,25
2024-03-15 00:20:00,3,3,4,0,0,0,0,0,10
2024-03-15 00:30:00,9,10,3,1,0,0,0,0,23
2024-03-15 00:40:00,5,5,6,2,0,0,0,0,18
2024-03-15 00:50:00,5,6,4,2,0,0,0,0,17
2024-03-15 01:00:00,4,4,2,0,0,0,0,0,10
2024-03-15 01:10:00,1,1,2,1,0,0,0,0,5
2024-03-15 01:20:00,0,0,1,0,0,0,0,0,1
2024-03-15 01:30:00,2,2,1,1,0,0,0,0,6
2024-03-15 01:40:00,1,1,0,0,0,0,0,0,2
2024-03-15 01:50:00,3,4,4,3,0,0,0,0,14
2024-03-15 02:00:00,4,5,2,0,0,0,0,0,11
2024-03-15 02:10:00,3,3,2,2,0,0,0,0,10
2024-03-15 02:20:00,1,1,3,1,0,0,0,0,6
2024-03-15 02:30:00,3,4,4,0,0,0,0,0,11
2024-03-15 02:40:00,2,2,3,1,0,0,0,0,8
2024-03-15 02:50:00,3,4,1,0,0,0,0,0,8
2024-03-15 03:00:00,0,0,0,0,0,0,0,0,0
2024-03-15 03:10:00,1,1,0,0,0,0,0,0,2
2024-03-15 03:20:00,3,5,5,2,0,0,0,0,15
2024-03-15 03:30:00,2,3,1,1,0,0,0,0,7
2024-03-15 03:40:00,1,1,3,0,0,0,1,0,6
2024-03-15 03:50:00,1,1,2,0,0,0,0,0,4
2024-03-15 04:00:00,2,2,2,1,0,0,0,0,7
2024-03-15 04:10:00,1,1,1,1,0,0,0,0,4
2024-03-15 04:20:00,0,0,1,0,0,0,0,0,1
2024-03-15 04:30:00,0,0,1,0,0,0,0,0,1
2024-03-15 04:40:00,2,2,3,0,0,0,0,0,7
2024-03-15 04:50:00,0,0,5,1,0,0,0,0,6
2024-03-15 05:00:00,2,2,2,0,0,0,0,0,6
2024-03-15 05:10:00,3,4,9,2,0,0,0,0,18
2024-03-15 05:20:00,3,3,2,0,0,0,1,0,9
2024-03-15 05:30:00,5,6,3,0,0,0,2,0,16
2024-03-15 05:40:00,5,4,4,4,0,0,1,0,18
2024-03-15 05:50:00,6,5,6,1,0,0,0,0,18
2024-03-15 06:00:00,6,7,6,3,0,0,1,0,23
2024-03-15 06:10:00,5,5,12,7,0,0,0,0,29
2024-03-15 06:20:00,11,8,12,8,0,0,1,0,40
2024-03-15 06:30:00,12,9,17,8,0,0,1,0,47
2024-03-15 06:40:00,18,12,10,9,0,0,2,0,51
2024-03-15 06:50:00,12,9,14,4,0,0,3,0,42
2024-03-15 07:00:00,22,13,28,18,0,0,5,0,86
2024-03-15 07:10:00,25,16,48,8,0,0,7,0,104
2024-03-15 07:20:00,34,23,30,6,0,0,6,1,100
2024-03-15 07:30:00,35,21,48,18,0,0,8,0,130
2024-03-15 07:40:00,57,22,19,8,0,0,6,0,112
2024-03-15 07:50:00,40,21,29,10,0,0,1,0,101
2024-03-15 08:00:00,35,26,24,8,0,0,2,0,95
2024-03-15 08:10:00,34,20,36,5,0,0,6,0,101
2024-03-15 08:20:00,48,30,14,3,0,0,5,1,101
2024-03-15 08:30:00,41,24,29,2,0,0,5,0,101
2024-03-15 08:40:00,59,20,26,7,0,0,4,0,116
2024-03-15 08:50:00,56,30,27,14,0,0,6,0,133
2024-03-15 09:00:00,42,22,17,10,0,0,2,0,93
2024-03-15 09:10:00,39,21,17,3,0,0,4,1,85
2024-03-15 09:20:00,49,28,18,2,0,0,1,0,98
2024-03-15 09:30:00,43,25,41,4,0,0,0,0,113
2024-03-15 09:40:00,55,41,20,1,0,0,1,0,118
2024-03-15 09:50:00,51,38,32,7,0,0,0,0,128
2024-03-15 10:00:00,52,41,22,2,0,0,2,0,119
2024-03-15 10:10:00,37,29,23,1,0,0,4,0,94
2024-03-15 10:20:00,47,37,16,0,0,0,2,0,102
2024-03-15 10:30:00,47,36,23,4,0,0,2,0,112
2024-03-15 10:40:00,63,49,25,4,0,0,3,0,144
2024-03-15 10:50:00,49,34,26,4,0,0,0,0,113
2024-03-15 11:00:00,43,33,23,6,0,0,1,1,107
2024-03-15 11:10:00,58,36,19,4,0,0,3,0,120
2024-03-15 11:20:00,65,38,27,3,0,0,1,0,134
2024-03-15 11:30:00,62,36,27,9,0,0,1,0,135
2024-03-15 11:40:00,62,37,29,8,0,0,0,0,136
2024-03-15 11:50:00,59,31,22,7,0,0,1,0,120
2024-03-15 12:00:00,61,34,25,2,0,0,0,6,128
2024-03-15 12:10:00,69,35,23,5,0,0,2,0,134
2024-03-15 12:20:00,70,35,21,10,0,0,3,0,139
2024-03-15 12:30:00,77,42,30,10,0,0,9,0,168
2024-03-15 12:40:00,51,30,26,8,0,0,4,0,119
2024-03-15 12:50:00,66,36,32,6,0,0,1,1,142
2024-03-15 13:00:00,77,67,28,4,0,0,1,0,177
2024-03-15 13:10:00,224,42,25,2,0,0,4,0,297
2024-03-15 13:20:00,83,50,38,9,0,0,0,0,180
2024-03-15 13:30:00,72,55,31,12,0,0,0,1,171
2024-03-15 13:40:00,58,29,23,5,0,0,5,1,121
2024-03-15 13:50:00,84,52,20,4,0,0,4,2,166
2024-03-15 14:00:00,60,41,33,3,0,0,5,0,142
2024-03-15 14:10:00,77,42,16,2,0,0,1,0,138
2024-03-15 14:20:00,66,36,15,4,0,0,0,1,122
2024-03-15 14:30:00,69,44,22,3,0,0,4,0,142
2024-03-15 14:40:00,70,42,21,2,0,0,1,0,136
2024-03-15 14:50:00,63,49,18,2,0,0,2,0,134
2024-03-15 15:00:00,80,47,20,6,0,0,12,0,165
2024-03-15 15:10:00,61,39,14,3,0,0,3,1,121
2024-03-15 15:20:00,62,43,21,4,0,0,5,0,135
2024-03-15 15:30:00,66,54,21,3,0,0,9,0,153
2024-03-15 15:40:00,77,56,14,2,0,0,6,0,155
2024-03-15 15:50:00,75,48,16,1,0,0,4,0,144
2024-03-15 16:00:00,71,46,23,4,0,0,3,0,147
2024-03-15 16:10:00,63,48,23,0,0,0,4,0,138
2024-03-15 16:20:00,58,36,19,2,0,0,0,0,115
2024-03-15 16:30:00,71,53,16,1,0,0,5,0,146
2024-03-15 16:40:00,60,33,18,3,0,0,5,0,119
2024-03-15 16:50:00,64,48,32,3,0,0,2,0,149
2024-03-15 17:00:00,78,50,21,6,0,0,0,0,155
2024-03-15 17:10:00,74,51,26,5,0,0,7,2,165
2024-03-15 17:20:00,62,47,20,2,0,0,3,0,134
2024-03-15 17:30:00,49,34,18,3,0,0,2,1,107
2024-03-15 17:40:00,70,51,14,1,0,0,6,0,142
2024-03-15 17:50:00,66,41,23,2,0,0,4,0,136
2024-03-15 18:00:00,71,54,20,3,0,0,1,1,150
2024-03-15 18:10:00,68,40,31,1,0,0,2,0,142
2024-03-15 18:20:00,61,42,20,3,0,0,2,0,128
2024-03-15 18:30:00,88,55,21,15,0,0,3,0,182
2024-03-15 18:40:00,55,37,18,17,0,0,2,1,130
2024-03-15 18:50:00,75,44,22,6,0,0,3,0,150
2024-03-15 19:00:00,55,39,22,4,0,0,3,0,123
2024-03-15 19:10:00,53,38,16,4,0,0,3,0,114
2024-03-15 19:20:00,37,27,16,2,0,0,1,0,83
2024-03-15 19:30:00,51,30,30,25,0,0,2,0,138
2024-03-15 19:40:00,48,28,20,25,0,0,3,0,124
2024-03-15 19:50:00,38,25,20,25,0,0,8,0,116
2024-03-15 20:00:00,65,29,15,33,0,0,0,0,142
2024-03-15 20:10:00,36,25,18,22,0,0,3,0,104
2024-03-15 20:20:00,31,17,12,21,0,0,0,0,81
2024-03-15 20:30:00,44,24,7,25,0,0,2,0,102
2024-03-15 20:40:00,42,24,21,18,0,0,0,0,105
2024-03-15 20:50:00,30,25,13,22,0,0,1,0,91
2024-03-15 21:00:00,35,18,13,22,0,0,1,0,89
2024-03-15 21:10:00,36,25,22,22,0,0,0,0,105
2024-03-15 21:20:00,43,28,9,23,0,0,1,0,104
2024-03-15 21:30:00,24,23,7,19,0,0,0,0,73
2024-03-15 21:40:00,34,31,10,24,0,0,0,0,99
2024-03-15 21:50:00,23,16,9,13,0,0,1,0,62
2024-03-15 22:00:00,31,27,12,17,0,0,0,0,87
2024-03-15 22:10:00,30,32,16,10,0,0,1,0,89
2024-03-15 22:20:00,20,20,18,8,0,0,3,0,69
2024-03-15 22:30:00,32,28,9,4,0,0,0,0,73
2024-03-15 22:40:00,24,21,12,6,0,0,3,0,66
2024-03-15 22:50:00,21,17,10,2,0,0,1,1,52
2024-03-15 23:00:00,22,21,7,4,0,0,1,0,55
2024-03-15 23:10:00,31,24,8,8,0,0,0,0,71
2024-03-15 23:20:00,31,33,7,5,0,0,0,0,76
2024-03-15 23:30:00,18,14,5,0,0,0,1,0,38
2024-03-15 23:40:00,13,15,8,2,0,0,0,0,38
2024-03-15 23:50:00,18,18,7,1,0,0,0,0,44
2024-03-16 00:00:00,15,16,10,1,0,0,0,0,42
2024-03-16 00:10:00,10,9,5,0,0,0,0,0,24
2024-03-16 00:20:00,15,15,7,3,0,0,0,0,40
2024-03-16 00:30:00,11,12,4,2,0,0,0,0,29
2024-03-16 00:40:00,13,15,3,2,0,0,0,0,33
2024-03-16 00:50:00,9,12,6,3,0,0,0,0,30
2024-03-16 01:00:00,5,5,2,0,0,0,0,0,12
2024-03-16 01:10:00,12,11,6,3,0,0,0,0,32
2024-03-16 01:20:00,8,10,4,1,0,0,0,0,23
2024-03-16 01:30:00,10,9,8,3,0,0,0,0,30
2024-03-16 01:40:00,13,12,8,6,0,0,0,0,39
2024-03-16 01:50:00,12,9,4,10,0,0,0,0,35
2024-03-16 02:00:00,8,6,8,4,0,0,0,0,26
2024-03-16 02:10:00,4,5,4,4,0,0,0,0,17
2024-03-16 02:20:00,5,5,2,1,0,0,0,0,13
2024-03-16 02:30:00,3,3,3,1,0,0,0,0,10
2024-03-16 02:40:00,4,5,6,0,0,0,0,0,15
2024-03-16 02:50:00,3,4,0,0,0,0,0,0,7
2024-03-16 03:00:00,2,2,0,0,0,0,0,0,4
2024-03-16 03:10:00,8,9,5,2,0,0,0,0,24
2024-03-16 03:20:00,5,5,3,3,0,0,0,0,16
2024-03-16 03:30:00,2,2,2,3,0,0,0,0,9
2024-03-16 03:40:00,4,3,7,4,0,0,0,0,18
2024-03-16 03:50:00,6,5,2,5,0,0,1,0,19
2024-03-16 04:00:00,3,3,4,2,0,0,0,0,12
2024-03-16 04:10:00,1,1,1,1,0,0,0,0,4
2024-03-16 04:20:00,3,3,1,2,0,0,0,0,9
2024-03-16 04:30:00,0,0,1,0,0,0,0,0,1
2024-03-16 04:40:00,1,1,4,1,0,0,0,0,7
2024-03-16 04:50:00,1,1,2,1,0,0,0,0,5
2024-03-16 05:00:00,1,0,1,1,0,0,0,0,3
2024-03-16 05:10:00,1,1,4,1,0,0,0,0,7
2024-03-16 05:20:00,1,1,4,1,0,0,0,0,7
2024-03-16 05:30:00,0,0,5,0,0,0,0,0,5
2024-03-16 05:40:00,3,2,3,2,0,0,0,0,10
2024-03-16 05:50:00,3,3,5,3,0,0,0,0,14
2024-03-16 06:00:00,2,2,3,2,0,0,1,0,10
2024-03-16 06:10:00,5,5,4,4,0,0,0,0,18
2024-03-16 06:20:00,6,4,12,9,0,0,1,0,32
2024-03-16 06:30:00,10,8,7,1,0,0,0,0,26
2024-03-16 06:40:00,4,4,5,0,0,0,0,0,13
2024-03-16 06:50:00,5,5,7,3,0,0,1,0,21
2024-03-16 07:00:00,9,6,8,2,0,0,0,0,25
2024-03-16 07:10:00,5,5,9,1,0,0,1,0,21
2024-03-16 07:20:00,11,11,7,0,0,0,0,0,29
2024-03-16 07:30:00,13,13,5,0,0,0,0,1,32
2024-03-16 07:40:00,12,11,11,0,0,0,0,0,34
2024-03-16 07:50:00,13,12,10,3,0,0,2,0,40
2024-03-16 08:00:00,11,11,13,5,0,0,0,0,40
2024-03-16 08:10:00,14,14,13,1,0,0,1,0,43
2024-03-16 08:20:00,17,14,8,1,0,0,1,0,41
2024-03-16 08:30:00,22,20,10,0,0,0,2,0,54
2024-03-16 08:40:00,15,13,16,2,0,0,1,0,47
2024-03-16 08:50:00,24,20,17,3,0,0,1,0,65
2024-03-16 09:00:00,29,24,15,4,0,0,0,0,72
2024-03-16 09:10:00,30,29,10,1,0,0,2,0,72
2024-03-16 09:20:00,27,24,11,2,0,0,2,0,66
2024-03-16 09:30:00,38,28,13,3,0,0,2,0,84
2024-03-16 09:40:00,41,32,18,7,0,0,4,0,102
2024-03-16 09:50:00,47,35,17,9,0,0,1,0,109
2024-03-16 10:00:00,30,27,24,9,0,0,3,0,93
2024-03-16 10:10:00,54,44,19,5,0,0,1,0,123
2024-03-16 10:20:00,46,36,17,7,0,0,2,0,108
2024-03-16 10:30:00,53,38,22,3,0,0,5,1,122
2024-03-16 10:40:00,48,39,12,4,0,0,3,0,106
2024-03-16 10:50:00,60,32,18,1,0,0,2,0,113
2024-03-16 11:00:00,60,43,23,4,0,0,2,0,132
2024-03-16 11:10:00,41,28,29,3,0,0,4,0,105
2024-03-16 11:20:00,49,35,22,3,0,0,1,0,110
2024-03-16 11:30:00,41,27,18,1,0,0,5,0,92
2024-03-16 11:40:00,42,32,6,1,0,0,3,1,85
2024-03-16 11:50:00,55,37,13,3,0,0,1,0,109
2024-03-16 12:00:00,42,36,25,4,0,0,2,1,110
2024-03-16 12:10:00,51,41,15,1,0,0,2,0,110
2024-03-16 12:20:00,55,35,18,3,0,0,2,0,113
2024-03-16 12:30:00,70,34,12,2,0,0,4,1,123
2024-03-16 12:40:00,54,38,20,1,0,0,1,0,114
2024-03-16 12:50:00,57,43,18,1,0,0,3,0,122
2024-03-16 13:00:00,62,47,24,6,0,0,2,0,141
2024-03-16 13:10:00,63,45,15,4,0,0,2,0,129
2024-03-16 13:20:00,51,42,15,3,0,0,3,1,115
2024-03-16 13:30:00,58,42,28,0,0,0,3,0,131
2024-03-16 13:40:00,49,39,20,1,0,0,0,0,109
2024-03-16 13:50:00,68,41,38,5,0,0,13,0,165
2024-03-16 14:00:00,48,41,25,3,0,0,3,2,122
2024-03-16 14:10:00,52,44,26,1,0,0,6,0,129
2024-03-16 14:20:00,46,27,22,1,0,0,1,0,97
2024-03-16 14:30:00,56,40,22,2,0,0,2,0,122
2024-03-16 14:40:00,61,41,19,1,0,0,6,0,128
2024-03-16 14:50:00,49,44,26,5,0,0,9,0,133
2024-03-16 15:00:00,74,44,17,4,0,0,1,0,140
2024-03-16 15:10:00,69,40,17,3,0,0,1,0,130
2024-03-16 15:20:00,52,41,14,2,0,0,4,0,113
2024-03-16 15:30:00,55,45,15,2,0,0,7,0,124
2024-03-16 15:40:00,59,34,22,5,0,0,2,0,122
2024-03-16 15:50:00,62,40,23,1,0,0,4,0,130
2024-03-16 16:00:00,44,30,14,4,0,0,3,2,97
2024-03-16 16:10:00,57,46,27,2,0,0,1,0,133
2024-03-16 16:20:00,34,31,11,2,0,0,0,0,78
2024-03-16 16:30:00,56,43,22,5,0,0,5,1,132
2024-03-16 16:40:00,47,38,16,3,0,0,1,0,105
2024-03-16 16:50:00,43,32,20,6,0,0,3,0,104
2024-03-16 17:00:00,64,50,13,7,0,0,1,0,135
2024-03-16 17:10:00,54,41,15,6,0,0,5,0,121
2024-03-16 17:20:00,57,46,21,2,0,0,2,0,128
2024-03-16 17:30:00,50,34,14,0,0,0,5,0,103
2024-03-16 17:40:00,63,51,22,3,0,0,4,0,143
2024-03-16 17:50:00,73,44,11,1,0,0,3,0,132
2024-03-16 18:00:00,90,49,18,2,0,0,1,1,161
2024-03-16 18:10:00,103,60,10,0,0,0,1,1,175
2024-03-16 18:20:00,107,49,10,2,0,0,2,0,170
2024-03-16 18:30:00,74,34,19,5,0,0,3,0,135
2024-03-16 18:40:00,50,40,23,11,0,0,2,0,126
2024-03-16 18:50:00,73,43,21,3,0,0,8,0,148
2024-03-16 19:00:00,54,26,8,4,0,0,0,0,92
2024-03-16 19:10:00,56,39,20,2,0,0,2,0,119
2024-03-16 19:20:00,45,32,20,3,0,0,4,0,104
2024-03-16 19:30:00,50,40,20,2,0,0,1,0,113
2024-03-16 19:40:00,39,35,15,2,0,0,3,0,94
2024-03-16 19:50:00,33,28,17,0,0,0,3,0,81
2024-03-16 20:00:00,38,21,17,3,0,0,2,1,82
2024-03-16 20:10:00,46,33,12,3,0,0,2,0,96
2024-03-16 20:20:00,35,17,14,1,0,0,0,0,67
2024-03-16 20:30:00,32,28,12,8,0,0,1,0,81
2024-03-16 20:40:00,43,30,12,5,0,0,1,0,91
2024-03-16 20:50:00,22,22,13,2,0,0,0,0,59
2024-03-16 21:00:00,22,17,8,3,0,0,0,0,50
2024-03-16 21:10:00,22,24,10,2,0,0,1,0,59
2024-03-16 21:20:00,22,20,17,1,0,0,0,0,60
2024-03-16 21:30:00,52,25,11,1,0,0,1,0,90
2024-03-16 21:40:00,25,20,19,4,0,0,0,0,68
2024-03-16 21:50:00,24,19,8,3,0,0,1,0,55
2024-03-16 22:00:00,28,27,18,2,0,0,1,0,76
2024-03-16 22:10:00,34,31,11,1,0,0,2,0,79
2024-03-16 22:20:00,28,20,11,3,0,0,0,0,62
2024-03-16 22:30:00,24,17,16,4,0,0,0,0,61
2024-03-16 22:40:00,21,20,13,7,0,0,0,0,61
2024-03-16 22:50:00,21,17,15,2,0,0,0,0,55
2024-03-16 23:00:00,18,15,5,3,0,0,2,0,43
2024-03-16 23:10:00,30,24,15,5,0,0,0,0,74
2024-03-16 23:20:00,23,17,5,3,0,0,0,0,48
2024-03-16 23:30:00,13,12,10,2,0,0,0,0,37
2024-03-16 23:40:00,14,13,11,3,0,0,0,0,41
2024-03-16 23:50:00,15,12,8,1,0,0,0,0,36
2024-03-17 00:00:00,22,22,11,3,0,0,1,0,59
2024-03-17 00:10:00,10,9,6,2,0,0,0,0,27
2024-03-17 00:20:00,11,10,10,2,0,0,0,0,33
2024-03-17 00:30:00,15,10,10,1,0,0,0,0,36
2024-03-17 00:40:00,13,9,9,2,0,0,0,0,33
2024-03-17 00:50:00,15,11,9,1,0,0,0,0,36
2024-03-17 01:00:00,25,23,9,4,0,0,1,0,62
2024-03-17 01:10:00,8,9,7,3,0,0,0,0,27
2024-03-17 01:20:00,8,10,6,1,0,0,1,0,26
2024-03-17 01:30:00,12,12,3,3,0,0,0,0,30
2024-03-17 01:40:00,7,8,6,0,0,0,0,0,21
2024-03-17 01:50:00,6,7,6,1,0,0,0,0,20
2024-03-17 02:00:00,8,10,11,0,0,0,0,0,29
2024-03-17 02:10:00,3,3,3,0,0,0,0,0,9
2024-03-17 02:20:00,11,10,4,2,0,0,0,0,27
2024-03-17 02:30:00,15,13,5,3,0,0,0,0,36
2024-03-17 02:40:00,2,2,1,0,0,0,0,0,5
2024-03-17 02:50:00,5,5,3,0,0,0,0,0,13
2024-03-17 03:00:00,9,11,6,2,0,0,0,0,28
2024-03-17 03:10:00,5,5,5,3,0,0,0,0,18
2024-03-17 03:20:00,6,8,6,1,0,0,0,0,21
2024-03-17 03:30:00,1,1,1,0,0,0,0,0,3
2024-03-17 03:40:00,4,4,5,2,0,0,0,0,15
2024-03-17 03:50:00,6,6,4,0,0,0,1,0,17
2024-03-17 04:00:00,5,6,3,1,0,0,0,0,15
2024-03-17 04:10:00,4,5,5,1,0,0,0,0,15
2024-03-17 04:20:00,2,2,2,0,0,0,0,0,6
2024-03-17 04:30:00,3,4,2,0,0,0,0,0,9
2024-03-17 04:40:00,1,1,2,0,0,0,0,0,4
2024-03-17 04:50:00,3,4,4,0,0,0,0,0,11
2024-03-17 05:00:00,1,1,0,1,0,0,0,0,3
2024-03-17 05:10:00,0,0,2,0,0,0,0,0,2
2024-03-17 05:20:00,1,1,5,0,0,0,0,0,7
2024-03-17 05:30:00,2,3,2,2,0,0,0,0,9
2024-03-17 05:40:00,4,5,4,2,0,0,0,0,15
2024-03-17 05:50:00,3,3,1,1,0,0,0,0,8
2024-03-17 06:00:00,1,1,0,0,0,0,0,0,2
2024-03-17 06:10:00,2,3,2,0,0,0,0,0,7
2024-03-17 06:20:00,1,1,1,0,0,0,0,0,3
2024-03-17 06:30:00,3,3,1,1,0,0,0,0,8
2024-03-17 06:40:00,4,4,3,0,0,0,0,0,11
2024-03-17 06:50:00,5,5,4,0,0,0,0,0,14
2024-03-17 07:00:00,2,2,1,0,0,0,0,0,5
2024-03-17 07:10:00,4,4,4,2,0,0,0,0,14
2024-03-17 07:20:00,1,1,4,0,0,0,0,0,6
2024-03-17 07:30:00,6,5,3,1,0,0,0,0,15
2024-03-17 07:40:00,3,3,2,0,0,0,0,0,8
2024-03-17 07:50:00,7,7,3,1,0,0,1,0,19
2024-03-17 08:00:00,10,9,2,2,0,0,2,0,25
2024-03-17 08:10:00,7,7,5,2,0,0,0,0,21
2024-03-17 08:20:00,11,11,2,2,0,0,1,0,27
2024-03-17 08:30:00,17,16,8,0,0,0,0,0,41
2024-03-17 08:40:00,10,10,8,2,0,0,0,0,30
2024-03-17 08:50:00,13,13,10,3,0,0,0,0,39
2024-03-17 09:00:00,9,9,7,4,0,0,2,0,31
2024-03-17 09:10:00,17,17,22,20,0,0,0,0,76
2024-03-17 09:20:00,26,23,19,15,0,1,3,0,87
2024-03-17 09:30:00,22,20,20,10,0,0,0,1,73
2024-03-17 09:40:00,20,17,18,2,0,0,2,1,60
2024-03-17 09:50:00,29,24,9,2,0,0,2,0,66
2024-03-17 10:00:00,25,22,17,3,0,0,1,0,68
2024-03-17 10:10:00,31,27,13,4,0,0,1,0,76
2024-03-17 10:20:00,25,19,17,5,0,0,1,0,67
2024-03-17 10:30:00,19,17,13,1,0,0,3,0,53
2024-03-17 10:40:00,19,15,11,0,0,0,1,0,46
2024-03-17 10:50:00,22,21,12,0,0,0,2,0,57
2024-03-17 11:00:00,30,26,17,3,0,0,2,0,78
2024-03-17 11:10:00,31,29,9,1,0,0,1,0,71
2024-03-17 11:20:00,28,16,14,1,0,0,0,3,62
2024-03-17 11:30:00,31,25,18,1,0,0,4,0,79
2024-03-17 11:40:00,33,23,20,5,0,0,3,1,85
2024-03-17 11:50:00,35,29,16,3,0,0,2,0,85
2024-03-17 12:00:00,29,25,10,4,0,0,0,0,68
2024-03-17 12:10:00,30,22,13,5,0,0,1,1,72
2024-03-17 12:20:00,44,29,15,14,0,0,4,2,108
2024-03-17 12:30:00,42,23,16,7,0,0,2,0,90
2024-03-17 12:40:00,34,28,23,1,0,0,1,0,87
2024-03-17 12:50:00,37,28,19,3,0,0,2,1,90
2024-03-17 13:00:00,51,33,13,3,0,0,3,3,106
2024-03-17 13:10:00,33,22,10,0,0,0,3,0,68
2024-03-17 13:20:00,53,36,18,2,0,0,3,0,112
2024-03-17 13:30:00,50,27,9,1,0,0,0,0,87
2024-03-17 13:40:00,38,28,12,2,0,0,2,0,82
2024-03-17 13:50:00,34,25,11,1,0,0,2,1,74
2024-03-17 14:00:00,44,33,10,2,0,0,6,1,96
2024-03-17 14:10:00,45,36,10,3,0,0,2,1,97
2024-03-17 14:20:00,58,39,15,2,0,0,1,0,115
2024-03-17 14:30:00,38,20,14,1,0,0,8,0,81
2024-03-17 14:40:00,50,29,10,6,0,0,4,0,99
2024-03-17 14:50:00,61,32,37,4,0,0,1,0,135
2024-03-17 15:00:00,61,32,13,6,0,0,13,0,125
2024-03-17 15:10:00,45,28,11,2,0,0,3,0,89
2024-03-17 15:20:00,39,26,10,3,0,0,4,0,82
2024-03-17 15:30:00,45,38,18,3,0,0,5,0,109
2024-03-17 15:40:00,53,34,12,1,0,0,2,0,102
2024-03-17 15:50:00,48,31,14,2,0,0,1,0,96
2024-03-17 16:00:00,36,27,12,4,0,0,3,1,83
2024-03-17 16:10:00,29,17,18,1,0,0,2,0,67
2024-03-17 16:20:00,34,26,8,2,0,0,0,1,71
2024-03-17 16:30:00,42,31,16,3,0,0,6,0,98
2024-03-17 16:40:00,31,24,17,1,0,0,2,0,75
2024-03-17 16:50:00,30,15,8,6,0,0,1,1,61
2024-03-17 17:00:00,31,21,13,4,0,0,1,0,70
2024-03-17 17:10:00,52,39,17,3,0,0,2,0,113
2024-03-17 17:20:00,35,22,16,0,0,0,0,0,73
2024-03-17 17:30:00,36,22,5,0,0,0,2,0,65
2024-03-17 17:40:00,46,26,11,1,0,0,2,0,86
2024-03-17 17:50:00,51,32,11,0,0,0,2,0,96
2024-03-17 18:00:00,46,31,14,1,0,0,4,2,98
2024-03-17 18:10:00,41,30,10,0,0,0,2,0,83
2024-03-17 18:20:00,35,19,12,0,0,0,3,0,69
2024-03-17 18:30:00,38,31,13,7,0,0,0,0,89
2024-03-17 18:40:00,34,25,7,1,0,0,0,0,67
2024-03-17 18:50:00,35,38,9,0,0,0,1,0,83
2024-03-17 19:00:00,38,32,19,1,0,0,1,0,91
2024-03-17 19:10:00,34,27,9,4,0,0,1,1,76
2024-03-17 19:20:00,32,29,10,1,0,0,3,0,75
2024-03-17 19:30:00,21,20,7,2,0,0,0,0,50
2024-03-17 19:40:00,31,31,14,2,0,0,0,0,78
2024-03-17 19:50:00,21,18,10,3,0,0,3,0,55
2024-03-17 20:00:00,39,30,10,2,0,0,0,0,81
2024-03-17 20:10:00,32,28,9,3,0,0,1,0,73
2024-03-17 20:20:00,35,26,9,3,0,0,0,0,73
2024-03-17 20:30:00,26,24,8,2,0,0,1,0,61
2024-03-17 20:40:00,28,21,11,5,0,0,0,0,65
2024-03-17 20:50:00,25,20,10,1,0,0,0,0,56
2024-03-17 21:00:00,19,18,10,3,0,0,0,0,50
2024-03-17 21:10:00,19,18,10,2,0,0,0,1,50
2024-03-17 21:20:00,25,24,12,1,0,0,0,0,62
2024-03-17 21:30:00,14,14,9,1,0,0,0,0,38
2024-03-17 21:40:00,26,25,8,2,0,0,0,0,61
2024-03-17 21:50:00,25,22,9,2,0,0,0,0,58
2024-03-17 22:00:00,23,19,10,7,0,0,0,0,59
2024-03-17 22:10:00,18,20,4,1,0,0,1,0,44
2024-03-17 22:20:00,15,17,7,1,0,0,0,0,40
2024-03-17 22:30:00,14,15,7,1,0,0,0,0,37
2024-03-17 22:40:00,17,14,4,2,0,0,1,0,38
2024-03-17 22:50:00,7,8,4,1,0,0,1,0,21
2024-03-17 23:00:00,11,11,6,3,0,0,3,0,34
2024-03-17 23:10:00,8,8,6,2,0,0,0,0,24
2024-03-17 23:20:00,7,8,1,0,0,0,0,0,16
2024-03-17 23:30:00,10,14,3,4,0,0,0,0,31
2024-03-17 23:40:00,5,5,2,1,0,0,0,0,13
2024-03-17 23:50:00,7,9,3,0,0,0,0,0,19
2024-03-18 00:00:00,1,2,2,0,0,0,0,0,5
2024-03-18 00:10:00,8,9,4,1,0,0,0,0,22
2024-03-18 00:20:00,3,2,2,0,0,0,0,0,7
2024-03-18 00:30:00,3,4,2,0,0,0,0,0,9
2024-03-18 00:40:00,5,6,2,3,0,0,0,0,16
2024-03-18 00:50:00,4,4,3,1,0,0,0,0,12
2024-03-18 01:00:00,4,4,5,2,0,0,0,0,15
2024-03-18 01:10:00,3,3,2,0,0,0,0,0,8
2024-03-18 01:20:00,1,2,1,0,0,0,0,0,4
2024-03-18 01:30:00,3,2,0,0,0,0,0,0,5
2024-03-18 01:40:00,2,2,1,0,0,0,0,0,5
2024-03-18 01:50:00,2,3,3,1,0,0,0,0,9
2024-03-18 02:00:00,3,3,2,1,0,0,0,0,9
2024-03-18 02:10:00,1,1,3,1,0,0,0,0,6
2024-03-18 02:20:00,1,2,1,0,0,0,0,0,4
2024-03-18 02:30:00,1,1,2,0,0,0,0,0,4
2024-03-18 02:40:00,1,1,0,1,0,0,0,0,3
2024-03-18 02:50:00,2,2,1,1,0,0,0,0,6
2024-03-18 03:00:00,0,0,0,0,0,0,0,0,0
2024-03-18 03:10:00,3,2,3,1,0,0,0,0,9
2024-03-18 03:20:00,5,5,4,2,0,0,0,0,16
2024-03-18 03:30:00,2,1,2,2,0,0,0,0,7
2024-03-18 03:40:00,3,3,6,3,0,0,0,0,15
2024-03-18 03:50:00,1,1,1,0,0,0,0,0,3
2024-03-18 04:00:00,2,2,3,1,0,0,0,0,8
2024-03-18 04:10:00,4,4,7,3,0,0,0,0,18
2024-03-18 04:20:00,1,3,2,0,0,0,0,0,6
2024-03-18 04:30:00,2,2,3,3,0,0,0,0,10
2024-03-18 04:40:00,0,0,3,0,0,0,0,0,3
2024-03-18 04:50:00,0,0,1,0,0,0,0,0,1
2024-03-18 05:00:00,6,10,7,3,0,0,1,0,27
2024-03-18 05:10:00,7,8,10,6,0,0,0,0,31
2024-03-18 05:20:00,7,5,12,6,0,0,0,0,30
2024-03-18 05:30:00,7,7,6,7,0,0,0,0,27
2024-03-18 05:40:00,9,7,13,5,0,0,1,0,35
2024-03-18 05:50:00,8,8,13,9,0,0,1,0,39
2024-03-18 06:00:00,6,8,18,6,0,0,2,0,40
2024-03-18 06:10:00,14,12,12,5,0,0,0,0,43
2024-03-18 06:20:00,14,10,14,6,0,0,0,0,44
2024-03-18 06:30:00,12,10,56,3,0,0,0,0,81
2024-03-18 06:40:00,21,16,17,9,0,0,0,0,63
2024-03-18 06:50:00,17,15,23,7,0,0,1,0,63
2024-03-18 07:00:00,19,17,29,13,0,0,2,3,83
2024-03-18 07:10:00,25,11,42,12,0,0,5,0,95
2024-03-18 07:20:00,39,22,56,7,0,0,5,2,131
2024-03-18 07:30:00,37,15,33,9,0,0,2,0,96
2024-03-18 07:40:00,30,13,20,6,0,0,2,4,75
2024-03-18 07:50:00,69,24,21,6,0,0,5,1,126
2024-03-18 08:00:00,42,23,33,12,0,0,0,0,110
2024-03-18 08:10:00,33,16,28,6,0,0,1,2,86
2024-03-18 08:20:00,50,17,23,4,0,0,4,1,99
2024-03-18 08:30:00,58,25,39,3,0,0,6,0,131
2024-03-18 08:40:00,63,37,18,4,0,0,3,0,125
2024-03-18 08:50:00,51,18,33,11,0,0,4,0,117
2024-03-18 09:00:00,44,31,36,11,0,0,0,1,123
2024-03-18 09:10:00,50,33,20,4,0,0,2,0,109
2024-03-18 09:20:00,42,20,30,3,0,0,1,0,96
2024-03-18 09:30:00,55,30,42,9,0,0,1,2,139
2024-03-18 09:40:00,48,15,53,7,0,0,3,0,126
2024-03-18 09:50:00,66,40,37,5,0,0,0,1,149
2024-03-18 10:00:00,41,36,36,2,0,0,1,0,116
2024-03-18 10:10:00,44,31,25,1,0,0,1,0,102
2024-03-18 10:20:00,34,29,39,1,0,0,1,0,104
2024-03-18 10:30:00,47,22,13,3,0,0,0,0,85
2024-03-18 10:40:00,53,17,19,2,0,0,0,0,91
2024-03-18 10:50:00,57,23,20,7,0,0,1,0,108
2024-03-18 11:00:00,59,29,21,3,0,0,3,0,115
2024-03-18 11:10:00,41,27,25,3,0,0,2,0,98
2024-03-18 11:20:00,60,19,25,5,0,0,3,0,112
2024-03-18 11:30:00,55,31,21,4,0,0,1,0,112
2024-03-18 11:40:00,74,45,25,4,0,0,2,0,150
2024-03-18 11:50:00,51,40,29,6,0,0,0,0,126
2024-03-18 12:00:00,64,26,26,6,0,0,3,0,125
2024-03-18 12:10:00,69,32,24,2,0,0,0,0,127
2024-03-18 12:20:00,66,44,30,4,0,0,1,0,145
2024-03-18 12:30:00,59,29,18,5,0,0,4,0,115
2024-03-18 12:40:00,53,29,35,13,0,0,1,0,131
2024-03-18 12:50:00,67,32,25,9,0,0,5,2,140
2024-03-18 13:00:00,55,34,25,6,0,0,2,2,124
2024-03-18 13:10:00,57,22,26,8,0,0,6,1,120
2024-03-18 13:20:00,77,26,32,10,0,0,6,1,152
2024-03-18 13:30:00,64,31,28,10,0,0,2,0,135
2024-03-18 13:40:00,55,19,26,6,0,0,2,4,112
2024-03-18 13:50:00,69,16,22,8,0,0,4,1,120
2024-03-18 14:00:00,64,32,29,6,0,0,3,0,134
2024-03-18 14:10:00,56,40,18,5,0,0,7,0,126
2024-03-18 14:20:00,58,23,24,6,0,0,5,0,116
2024-03-18 14:30:00,61,30,20,4,0,0,5,0,120
2024-03-18 14:40:00,71,25,30,6,0,0,5,0,137
2024-03-18 14:50:00,80,38,29,10,0,0,3,0,160
2024-03-18 15:00:00,69,40,28,9,0,0,4,0,150
2024-03-18 15:10:00,76,37,22,4,0,0,3,0,142
2024-03-18 15:20:00,72,38,26,4,0,0,3,1,144
2024-03-18 15:30:00,64,36,22,6,0,0,3,0,131
2024-03-18 15:40:00,58,21,27,2,0,0,3,1,112
2024-03-18 15:50:00,88,27,38,12,0,0,7,0,172
2024-03-18 16:00:00,66,34,35,11,0,0,5,0,151
2024-03-18 16:10:00,64,27,22,4,0,0,1,0,118
2024-03-18 16:20:00,72,39,26,3,0,0,4,1,145
2024-03-18 16:30:00,72,40,28,4,0,0,2,0,146
2024-03-18 16:40:00,65,32,22,6,0,0,2,1,128
2024-03-18 16:50:00,76,32,31,37,0,0,2,0,178
2024-03-18 17:00:00,68,41,28,3,0,0,1,0,141
2024-03-18 17:10:00,76,45,44,9,0,0,2,0,176
2024-03-18 17:20:00,60,45,22,7,0,0,4,1,139
2024-03-18 17:30:00,81,47,26,7,0,0,5,0,166
2024-03-18 17:40:00,63,41,33,7,0,0,4,1,149
2024-03-18 17:50:00,67,50,18,4,0,0,4,0,143
2024-03-18 18:00:00,88,42,34,9,0,0,4,1,178
2024-03-18 18:10:00,80,44,17,6,0,0,3,0,150
2024-03-18 18:20:00,63,39,24,11,0,0,4,0,141
2024-03-18 18:30:00,90,41,17,8,0,0,2,0,158
2024-03-18 18:40:00,70,33,19,7,0,0,3,0,132
2024-03-18 18:50:00,53,41,19,6,0,0,4,0,123
2024-03-18 19:00:00,50,34,32,11,0,0,0,0,127
2024-03-18 19:10:00,55,33,21,5,0,0,2,0,116
2024-03-18 19:20:00,58,34,17,7,0,0,1,0,117
2024-03-18 19:30:00,44,24,26,6,0,0,2,0,102
2024-03-18 19:40:00,52,28,30,8,0,0,2,0,120
2024-03-18 19:50:00,51,37,8,0,0,0,1,0,97
2024-03-18 20:00:00,39,25,14,1,0,0,3,0,82
2024-03-18 20:10:00,37,23,15,1,0,0,2,0,78
2024-03-18 20:20:00,36,33,14,8,0,0,0,0,91
2024-03-18 20:30:00,29,21,12,1,0,0,3,0,66
2024-03-18 20:40:00,30,22,9,1,0,0,3,0,65
2024-03-18 20:50:00,30,22,12,3,0,0,0,0,67
2024-03-18 21:00:00,35,22,18,2,0,0,0,0,77
2024-03-18 21:10:00,35,22,14,4,0,0,0,0,75
2024-03-18 21:20:00,31,22,7,4,0,0,2,0,66
2024-03-18 21:30:00,26,14,10,9,0,0,0,0,59
2024-03-18 21:40:00,39,21,17,16,0,0,0,0,93
2024-03-18 21:50:00,20,15,9,15,0,0,0,0,59
2024-03-18 22:00:00,21,17,15,12,0,0,2,0,67
2024-03-18 22:10:00,28,24,16,15,0,0,1,0,84
2024-03-18 22:20:00,21,18,11,10,0,0,0,0,60
2024-03-18 22:30:00,30,24,14,20,0,0,4,0,92
2024-03-18 22:40:00,17,14,10,13,0,0,0,0,54
2024-03-18 22:50:00,12,11,6,11,0,0,0,0,40
2024-03-18 23:00:00,11,8,9,9,0,0,0,0,37
2024-03-18 23:10:00,17,12,7,13,0,0,0,0,49
2024-03-18 23:20:00,11,9,6,10,0,0,0,0,36
2024-03-18 23:30:00,8,7,9,9,0,0,1,0,34
2024-03-18 23:40:00,8,6,5,4,0,0,0,0,23
2024-03-18 23:50:00,3,3,6,3,0,0,0,0,15
2024-03-19 00:00:00,5,5,9,4,0,0,0,0,23
2024-03-19 00:10:00,9,9,7,9,0,0,0,0,34
2024-03-19 00:20:00,5,4,5,4,0,0,0,0,18
2024-03-19 00:30:00,4,4,3,3,0,0,0,0,14
2024-03-19 00:40:00,7,6,7,5,0,0,0,0,25
2024-03-19 00:50:00,5,5,7,9,0,0,0,0,26
2024-03-19 01:00:00,3,3,6,3,0,0,0,0,15
2024-03-19 01:10:00,4,4,3,5,0,0,0,0,16
2024-03-19 01:20:00,5,6,3,3,0,0,0,0,17
2024-03-19 01:30:00,1,1,1,1,0,0,0,0,4
2024-03-19 01:40:00,4,3,2,3,0,0,0,0,12
2024-03-19 01:50:00,1,1,1,1,0,0,0,0,4
2024-03-19 02:00:00,0,0,4,0,0,0,0,0,4
2024-03-19 02:10:00,1,1,2,0,0,0,0,0,4
2024-03-19 02:20:00,3,3,1,3,0,0,0,0,10
2024-03-19 02:30:00,3,3,4,4,0,0,0,0,14
2024-03-19 02:40:00,3,3,3,3,0,0,0,0,12
2024-03-19 02:50:00,1,1,2,1,0,0,0,0,5
2024-03-19 03:00:00,0,0,0,0,0,0,0,0,0
2024-03-19 03:10:00,4,4,3,3,0,0,0,0,14
2024-03-19 03:20:00,1,1,3,1,0,0,0,0,6
2024-03-19 03:30:00,1,2,1,1,0,0,0,0,5
2024-03-19 03:40:00,1,1,3,2,0,0,0,0,7
2024-03-19 03:50:00,1,1,0,1,0,0,1,0,4
2024-03-19 04:00:00,3,5,1,1,0,0,0,0,10
2024-03-19 04:10:00,2,2,3,1,0,0,0,0,8
2024-03-19 04:20:00,3,3,8,3,0,0,0,0,17
2024-03-19 04:30:00,0,0,3,0,0,0,0,0,3
2024-03-19 04:40:00,0,0,2,0,0,0,0,0,2
2024-03-19 04:50:00,3,3,6,2,0,0,0,0,14
2024-03-19 05:00:00,3,3,9,1,0,0,0,0,16
2024-03-19 05:10:00,7,6,11,5,0,0,0,0,29
2024-03-19 05:20:00,6,6,6,1,0,0,1,0,20
2024-03-19 05:30:00,8,11,10,1,0,0,1,0,31
2024-03-19 05:40:00,6,7,5,1,0,0,0,0,19
2024-03-19 05:50:00,9,10,8,2,0,0,1,0,30
2024-03-19 06:00:00,3,3,12,6,0,0,1,0,25
2024-03-19 06:10:00,9,10,12,4,0,0,0,0,35
2024-03-19 06:20:00,14,13,18,7,0,0,0,0,52
2024-03-19 06:30:00,10,9,13,5,0,0,2,0,39
2024-03-19 06:40:00,22,20,21,10,0,0,2,0,75
2024-03-19 06:50:00,26,18,26,11,0,0,3,0,84
2024-03-19 07:00:00,17,10,27,16,0,0,8,1,79
2024-03-19 07:10:00,26,16,43,7,0,0,6,1,99
2024-03-19 07:20:00,23,14,49,13,0,0,6,2,107
2024-03-19 07:30:00,37,22,46,12,0,0,4,0,121
2024-03-19 07:40:00,26,16,27,8,0,0,1,0,78
2024-03-19 07:50:00,67,19,34,18,0,0,8,1,147
2024-03-19 08:00:00,43,13,33,8,0,0,6,0,103
2024-03-19 08:10:00,41,17,39,9,0,0,2,0,108
2024-03-19 08:20:00,53,23,24,10,0,0,3,0,113
2024-03-19 08:30:00,42,25,38,9,0,0,4,1,119
2024-03-19 08:40:00,56,25,31,2,0,0,4,1,119
2024-03-19 08:50:00,46,21,36,9,0,0,3,0,115
2024-03-19 09:00:00,42,15,22,4,0,0,0,0,83
2024-03-19 09:10:00,35,21,32,7,0,0,8,1,104
2024-03-19 09:20:00,45,24,33,3,0,0,3,0,108
2024-03-19 09:30:00,46,29,32,4,0,0,2,0,113
2024-03-19 09:40:00,47,28,24,4,0,0,2,0,105
2024-03-19 09:50:00,57,26,32,9,0,0,3,2,129
2024-03-19 10:00:00,47,32,24,8,0,0,2,0,113
2024-03-19 10:10:00,39,26,31,5,0,0,4,0,105
2024-03-19 10:20:00,50,29,24,0,0,0,1,0,104
2024-03-19 10:30:00,46,34,21,7,0,0,1,0,109
2024-03-19 10:40:00,38,30,18,2,0,0,3,0,91
2024-03-19 10:50:00,51,28,34,9,0,0,0,0,122
2024-03-19 11:00:00,54,37,14,7,0,0,3,0,115
2024-03-19 11:10:00,63,35,33,6,0,0,2,0,139
2024-03-19 11:20:00,54,37,19,4,0,0,3,0,117
2024-03-19 11:30:00,48,24,24,10,0,0,3,1,110
2024-03-19 11:40:00,61,41,25,7,0,0,2,1,137
2024-03-19 11:50:00,62,42,15,6,0,0,3,1,129
2024-03-19 12:00:00,52,19,18,10,0,0,7,4,110
2024-03-19 12:10:00,59,38,22,5,0,0,5,0,129
2024-03-19 12:20:00,52,34,23,5,0,0,3,0,117
2024-03-19 12:30:00,58,36,24,9,0,0,2,0,129
2024-03-19 12:40:00,55,31,23,7,0,0,7,2,125
2024-03-19 12:50:00,63,19,30,11,0,0,0,0,123
2024-03-19 13:00:00,67,27,20,7,0,0,8,1,130
2024-03-19 13:10:00,64,31,19,6,0,0,4,1,125
2024-03-19 13:20:00,51,17,25,5,0,0,3,0,101
2024-03-19 13:30:00,74,28,27,17,0,0,12,2,160
2024-03-19 13:40:00,60,26,31,9,0,0,4,0,130
2024-03-19 13:50:00,66,40,17,4,0,0,4,0,131
2024-03-19 14:00:00,56,25,32,14,0,0,6,0,133
2024-03-19 14:10:00,72,27,34,6,0,0,6,2,147
2024-03-19 14:20:00,63,24,49,5,0,0,2,2,145
2024-03-19 14:30:00,73,32,34,3,0,0,4,2,148
2024-03-19 14:40:00,45,18,22,8,0,0,2,2,97
2024-03-19 14:50:00,74,33,32,8,0,0,8,0,155
2024-03-19 15:00:00,71,43,20,9,0,0,4,0,147
2024-03-19 15:10:00,78,32,31,8,0,0,11,1,161
2024-03-19 15:20:00,84,59,31,6,0,0,9,1,190
2024-03-19 15:30:00,75,50,22,4,0,0,4,0,155
2024-03-19 15:40:00,76,33,32,10,0,0,3,0,154
2024-03-19 15:50:00,64,28,20,5,0,0,4,0,121
2024-03-19 16:00:00,93,40,31,3,0,0,1,2,170
2024-03-19 16:10:00,64,26,19,9,0,0,2,2,122
2024-03-19 16:20:00,63,31,29,9,0,0,4,0,136
2024-03-19 16:30:00,71,30,33,2,0,0,4,0,140
2024-03-19 16:40:00,65,33,27,6,0,0,2,1,134
2024-03-19 16:50:00,78,55,27,3,0,0,3,0,166
2024-03-19 17:00:00,82,25,27,6,0,0,5,0,145
2024-03-19 17:10:00,75,44,42,10,0,0,2,0,173
2024-03-19 17:20:00,66,37,26,3,0,0,1,0,133
2024-03-19 17:30:00,101,51,25,3,0,0,0,2,182
2024-03-19 17:40:00,72,39,24,3,0,0,2,0,140
2024-03-19 17:50:00,85,32,26,7,0,0,3,0,153
2024-03-19 18:00:00,82,31,24,2,0,0,2,1,142
2024-03-19 18:10:00,60,29,31,8,0,0,2,0,130
2024-03-19 18:20:00,91,45,27,5,0,0,2,0,170
2024-03-19 18:30:00,74,48,25,2,0,0,2,0,151
2024-03-19 18:40:00,73,45,23,2,0,0,2,0,145
2024-03-19 18:50:00,69,25,28,26,0,0,2,0,150
2024-03-19 19:00:00,55,27,24,7,0,0,0,0,113
2024-03-19 19:10:00,62,38,39,3,0,0,9,0,151
2024-03-19 19:20:00,45,17,14,0,0,0,2,0,78
2024-03-19 19:30:00,48,22,24,2,0,0,4,1,101
2024-03-19 19:40:00,47,33,14,1,0,0,1,0,96
2024-03-19 19:50:00,55,42,22,3,0,0,1,0,123
2024-03-19 20:00:00,41,29,21,8,0,0,4,0,103
2024-03-19 20:10:00,39,27,11,2,0,0,1,0,80
2024-03-19 20:20:00,48,27,13,3,0,0,1,0,92
2024-03-19 20:30:00,51,30,25,2,0,0,0,0,108
2024-03-19 20:40:00,37,27,13,6,0,0,1,1,85
2024-03-19 20:50:00,31,21,32,5,0,0,0,0,89
2024-03-19 21:00:00,33,27,15,6,0,0,3,0,84
2024-03-19 21:10:00,38,22,16,1,0,0,0,0,77
2024-03-19 21:20:00,32,23,23,5,0,0,0,0,83
2024-03-19 21:30:00,42,30,11,2,0,0,4,0,89
2024-03-19 21:40:00,32,29,11,1,0,0,0,0,73
2024-03-19 21:50:00,35,23,15,1,0,0,0,0,74
2024-03-19 22:00:00,33,26,9,0,0,0,1,0,69
2024-03-19 22:10:00,33,23,83,2,0,0,1,0,142
2024-03-19 22:20:00,26,24,12,2,0,0,0,0,64
2024-03-19 22:30:00,29,21,9,5,0,0,0,0,64
2024-03-19 22:40:00,20,18,7,1,0,0,0,0,46
2024-03-19 22:50:00,15,15,7,1,0,0,0,0,38
2024-03-19 23:00:00,14,16,9,3,0,0,0,0,42
2024-03-19 23:10:00,7,7,12,5,0,0,0,0,31
2024-03-19 23:20:00,10,9,5,2,0,0,0,0,26
2024-03-19 23:30:00,10,11,5,1,0,0,0,0,27
2024-03-19 23:40:00,5,3,6,0,0,0,0,0,14
2024-03-19 23:50:00,12,11,3,0,0,0,0,0,26
2024-03-20 00:00:00,5,5,7,2,0,0,0,0,19
2024-03-20 00:10:00,3,4,6,4,0,0,0,0,17
2024-03-20 00:20:00,3,4,7,4,0,0,0,0,18
2024-03-20 00:30:00,6,7,5,0,0,0,0,0,18
2024-03-20 00:40:00,7,8,4,1,0,0,0,0,20
2024-03-20 00:50:00,5,4,6,3,0,0,0,0,18
2024-03-20 01:00:00,4,4,1,0,0,0,0,0,9
2024-03-20 01:10:00,6,5,3,1,0,0,0,0,15
2024-03-20 01:20:00,3,3,6,1,0,0,0,0,13
2024-03-20 01:30:00,2,2,2,0,0,0,0,0,6
2024-03-20 01:40:00,1,1,2,0,0,0,0,0,4
2024-03-20 01:50:00,3,3,3,1,0,0,0,0,10
2024-03-20 02:00:00,0,0,2,0,0,0,0,0,2
2024-03-20 02:10:00,2,2,2,1,0,0,0,0,7
2024-03-20 02:20:00,2,3,3,1,0,0,0,0,9
2024-03-20 02:30:00,1,1,0,0,0,0,0,0,2
2024-03-20 02:40:00,1,1,2,0,0,0,0,0,4
2024-03-20 02:50:00,1,2,2,1,0,0,0,0,6
2024-03-20 03:00:00,1,1,2,0,0,0,0,0,4
2024-03-20 03:10:00,2,2,2,1,0,0,0,0,7
2024-03-20 03:20:00,7,6,13,1,0,0,0,0,27
2024-03-20 03:30:00,0,0,3,0,0,0,0,0,3
2024-03-20 03:40:00,3,2,3,0,0,0,0,0,8
2024-03-20 03:50:00,0,0,0,0,0,0,1,0,1
2024-03-20 04:00:00,2,2,1,0,0,0,0,0,5
2024-03-20 04:10:00,2,3,4,0,0,0,0,0,9
2024-03-20 04:20:00,1,1,2,0,0,0,0,0,4
2024-03-20 04:30:00,2,2,4,1,0,0,0,0,9
2024-03-20 04:40:00,1,1,4,0,0,0,0,0,6
2024-03-20 04:50:00,1,1,3,0,0,0,0,0,5
2024-03-20 05:00:00,4,6,3,0,0,0,0,0,13
2024-03-20 05:10:00,6,6,13,3,0,0,0,0,28
2024-03-20 05:20:00,7,12,5,0,0,0,0,0,24
2024-03-20 05:30:00,4,5,11,0,0,0,2,0,22
2024-03-20 05:40:00,6,7,7,2,0,0,0,0,22
2024-03-20 05:50:00,8,8,13,2,0,0,0,0,31
2024-03-20 06:00:00,6,6,13,3,0,0,0,0,28
2024-03-20 06:10:00,15,17,19,3,0,0,0,0,54
2024-03-20 06:20:00,19,14,16,35,0,0,1,0,85
2024-03-20 06:30:00,10,9,20,5,0,0,1,0,45
2024-03-20 06:40:00,21,15,22,18,0,0,2,0,78
2024-03-20 06:50:00,11,10,20,7,0,0,2,0,50
2024-03-20 07:00:00,11,8,29,13,0,0,5,3,69
2024-03-20 07:10:00,26,17,53,11,0,0,2,1,110
2024-03-20 07:20:00,30,19,50,12,0,0,5,3,119
2024-03-20 07:30:00,44,14,16,10,0,0,0,2,86
2024-03-20 07:40:00,43,15,20,8,0,0,8,2,96
2024-03-20 07:50:00,43,17,38,11,0,0,3,2,114
2024-03-20 08:00:00,46,22,36,26,0,0,3,0,133
2024-03-20 08:10:00,59,19,33,11,0,0,7,0,129
2024-03-20 08:20:00,35,14,33,7,0,0,3,0,92
2024-03-20 08:30:00,45,31,20,2,0,0,3,0,101
2024-03-20 08:40:00,44,23,35,9,0,0,7,0,118
2024-03-20 08:50:00,44,14,19,8,0,0,3,1,89
2024-03-20 09:00:00,36,17,32,8,0,0,3,0,96
2024-03-20 09:10:00,30,20,32,8,0,0,4,0,94
2024-03-20 09:20:00,45,20,25,10,0,0,1,1,102
2024-03-20 09:30:00,46,11,25,9,0,0,2,0,93
2024-03-20 09:40:00,59,23,34,6,0,0,6,2,130
2024-03-20 09:50:00,52,33,26,8,0,0,5,0,124
2024-03-20 10:00:00,39,29,30,5,0,0,2,0,105
2024-03-20 10:10:00,38,33,23,6,0,0,2,0,102
2024-03-20 10:20:00,47,27,23,8,0,0,1,0,106
2024-03-20 10:30:00,45,30,24,4,0,0,3,0,106
2024-03-20 10:40:00,47,28,24,8,0,0,4,0,111
2024-03-20 10:50:00,60,32,21,2,0,0,7,0,122
2024-03-20 11:00:00,59,37,14,3,0,0,2,0,115
2024-03-20 11:10:00,57,36,36,8,0,0,3,0,140
2024-03-20 11:20:00,51,36,30,10,0,0,2,0,129
2024-03-20 11:30:00,54,30,29,7,0,0,1,0,121
2024-03-20 11:40:00,82,48,21,4,0,0,3,0,158
2024-03-20 11:50:00,51,27,20,7,0,0,7,0,112
2024-03-20 12:00:00,50,32,22,7,0,0,1,0,112
2024-03-20 12:10:00,61,39,30,5,0,0,3,0,138
2024-03-20 12:20:00,54,43,19,6,0,0,8,1,131
2024-03-20 12:30:00,49,42,23,7,0,0,5,0,126
2024-03-20 12:40:00,50,24,31,11,0,0,4,0,120
2024-03-20 12:50:00,59,35,22,5,0,0,1,2,124
2024-03-20 13:00:00,63,25,21,6,0,0,2,0,117
2024-03-20 13:10:00,68,44,38,7,0,0,0,0,157
2024-03-20 13:20:00,41,24,45,19,0,0,4,0,133
2024-03-20 13:30:00,70,35,32,16,0,0,2,0,155
2024-03-20 13:40:00,62,15,28,10,0,0,2,0,117
2024-03-20 13:50:00,64,21,27,12,0,0,13,2,139
2024-03-20 14:00:00,55,31,33,10,0,0,3,3,135
2024-03-20 14:10:00,71,20,55,15,0,0,5,0,166
2024-03-20 14:20:00,59,22,52,7,0,0,1,1,142
2024-03-20 14:30:00,64,23,30,7,0,0,4,1,129
2024-03-20 14:40:00,70,41,25,6,0,0,7,2,151
2024-03-20 14:50:00,70,22,29,8,0,0,8,1,138
2024-03-20 15:00:00,73,38,24,3,0,0,4,0,142
2024-03-20 15:10:00,67,45,27,7,0,0,5,1,152
2024-03-20 15:20:00,67,31,31,3,0,0,1,0,133
2024-03-20 15:30:00,53,28,32,12,0,0,4,0,129
2024-03-20 15:40:00,62,29,33,7,0,0,13,0,144
2024-03-20 15:50:00,76,43,40,9,0,0,1,1,170
2024-03-20 16:00:00,80,53,47,3,0,0,3,2,188
2024-03-20 16:10:00,69,25,36,10,0,0,3,0,143
2024-03-20 16:20:00,57,12,42,45,0,0,3,5,164
2024-03-20 16:30:00,82,48,29,6,0,0,7,0,172
2024-03-20 16:40:00,69,38,29,5,0,0,2,0,143
2024-03-20 16:50:00,64,29,27,3,0,0,5,1,129
2024-03-20 17:00:00,79,57,28,8,0,0,4,1,177
2024-03-20 17:10:00,89,29,38,7,0,0,2,0,165
2024-03-20 17:20:00,55,34,32,4,0,0,2,0,127
2024-03-20 17:30:00,86,48,20,4,0,0,2,1,161
2024-03-20 17:40:00,80,41,20,3,0,0,5,0,149
2024-03-20 17:50:00,73,47,22,3,0,0,2,0,147
2024-03-20 18:00:00,79,30,32,7,0,0,2,0,150
2024-03-20 18:10:00,77,49,27,4,0,0,0,0,157
2024-03-20 18:20:00,68,50,17,0,0,0,0,0,135
2024-03-20 18:30:00,67,32,16,1,0,0,2,0,118
2024-03-20 18:40:00,73,39,18,3,0,0,4,0,137
2024-03-20 18:50:00,76,38,26,25,0,0,0,1,166
2024-03-20 19:00:00,56,31,28,9,0,0,2,1,127
2024-03-20 19:10:00,62,39,65,3,0,0,1,0,170
2024-03-20 19:20:00,46,34,28,8,0,0,0,0,116
2024-03-20 19:30:00,54,33,29,1,0,0,1,0,118
2024-03-20 19:40:00,34,23,21,5,0,0,1,1,85
2024-03-20 19:50:00,58,25,13,5,0,0,3,0,104
2024-03-20 20:00:00,34,19,17,8,0,0,0,0,78
2024-03-20 20:10:00,47,28,36,0,0,0,1,0,112
2024-03-20 20:20:00,44,27,21,4,0,0,0,0,96
2024-03-20 20:30:00,29,25,20,5,0,0,1,0,80
2024-03-20 20:40:00,36,24,16,1,0,0,0,0,77
2024-03-20 20:50:00,31,19,40,2,0,0,1,1,94
2024-03-20 21:00:00,30,19,15,7,0,0,0,0,71
2024-03-20 21:10:00,47,28,12,5,0,0,0,0,92
2024-03-20 21:20:00,33,25,11,4,0,0,1,1,75
2024-03-20 21:30:00,35,23,18,2,0,0,1,0,79
2024-03-20 21:40:00,39,31,18,9,0,0,0,0,97
2024-03-20 21:50:00,28,23,7,3,0,0,1,0,62
2024-03-20 22:00:00,32,17,27,2,0,0,3,0,81
2024-03-20 22:10:00,29,25,45,1,0,0,2,0,102
2024-03-20 22:20:00,19,17,7,2,0,0,1,0,46
2024-03-20 22:30:00,30,28,9,2,0,0,1,0,70
2024-03-20 22:40:00,24,19,9,2,0,0,0,0,54
2024-03-20 22:50:00,14,13,11,1,0,0,0,0,39
2024-03-20 23:00:00,13,13,10,5,0,0,0,0,41
2024-03-20 23:10:00,18,17,8,1,0,0,0,0,44
2024-03-20 23:20:00,18,12,8,1,0,0,1,0,40
2024-03-20 23:30:00,13,10,4,1,0,0,0,0,28
2024-03-20 23:40:00,5,5,5,0,0,0,0,0,15
2024-03-20 23:50:00,10,8,4,1,0,0,0,0,23
2024-03-21 00:00:00,7,5,7,1,0,0,0,0,20
2024-03-21 00:10:00,9,7,3,1,0,0,0,0,20
2024-03-21 00:20:00,7,9,5,1,0,0,0,0,22
2024-03-21 00:30:00,4,5,8,0,0,0,0,0,17
2024-03-21 00:40:00,6,6,5,2,0,0,0,0,19
2024-03-21 00:50:00,3,4,4,2,0,0,0,0,13
2024-03-21 01:00:00,4,4,5,1,0,0,0,0,14
2024-03-21 01:10:00,5,6,2,2,0,0,0,0,15
2024-03-21 01:20:00,2,2,4,1,0,0,0,0,9
2024-03-21 01:30:00,6,8,5,2,0,0,0,0,21
2024-03-21 01:40:00,4,5,0,0,0,0,0,0,9
2024-03-21 01:50:00,2,2,1,0,0,0,0,0,5
2024-03-21 02:00:00,1,1,2,0,0,0,0,0,4
2024-03-21 02:10:00,2,3,1,0,0,0,0,0,6
2024-03-21 02:20:00,1,1,2,0,0,0,0,0,4
2024-03-21 02:30:00,1,1,0,0,0,0,0,0,2
2024-03-21 02:40:00,4,3,3,0,0,0,0,0,10
2024-03-21 02:50:00,2,2,1,0,0,0,0,0,5
2024-03-21 03:00:00,1,1,1,1,0,0,0,0,4
2024-03-21 03:10:00,2,2,3,1,0,0,0,0,8
2024-03-21 03:20:00,3,3,3,1,0,0,0,0,10
2024-03-21 03:30:00,2,2,3,3,0,0,0,0,10
2024-03-21 03:40:00,2,3,3,1,0,0,0,0,9
2024-03-21 03:50:00,0,0,0,0,0,0,0,0,0
2024-03-21 04:00:00,1,1,1,0,0,0,0,0,3
2024-03-21 04:10:00,4,4,7,1,0,0,0,0,16
2024-03-21 04:20:00,2,2,4,0,0,0,0,0,8
2024-03-21 04:30:00,3,4,5,1,0,0,0,0,13
2024-03-21 04:40:00,1,1,6,0,0,0,0,0,8
2024-03-21 04:50:00,1,2,1,0,0,0,0,0,4
2024-03-21 05:00:00,5,5,7,1,0,0,0,0,18
2024-03-21 05:10:00,5,5,12,3,0,0,0,0,25
2024-03-21 05:20:00,8,9,7,2,0,0,1,0,27
2024-03-21 05:30:00,3,6,1,0,0,0,1,0,11
2024-03-21 05:40:00,7,7,6,2,0,0,2,0,24
2024-03-21 05:50:00,10,10,11,2,0,0,0,0,33
2024-03-21 06:00:00,5,5,10,2,0,0,0,0,22
2024-03-21 06:10:00,12,11,7,5,0,0,0,0,35
2024-03-21 06:20:00,15,11,12,7,0,0,0,0,45
2024-03-21 06:30:00,9,9,14,5,0,0,1,0,38
2024-03-21 06:40:00,21,18,17,8,0,0,0,0,64
2024-03-21 06:50:00,15,15,21,11,0,0,3,0,65
2024-03-21 07:00:00,20,8,28,11,0,0,2,1,70
2024-03-21 07:10:00,23,16,54,13,0,0,7,1,114
2024-03-21 07:20:00,31,15,45,7,0,0,7,2,107
2024-03-21 07:30:00,41,21,20,11,0,0,4,0,97
2024-03-21 07:40:00,29,16,34,5,0,0,1,1,86
2024-03-21 07:50:00,66,21,38,14,0,0,6,0,145
2024-03-21 08:00:00,42,18,27,5,0,0,2,0,94
2024-03-21 08:10:00,46,19,29,11,0,0,4,1,110
2024-03-21 08:20:00,38,13,38,3,0,0,2,0,94
2024-03-21 08:30:00,45,22,26,5,0,0,6,0,104
2024-03-21 08:40:00,38,25,30,10,0,0,2,0,105
2024-03-21 08:50:00,50,18,36,8,0,0,4,0,116
2024-03-21 09:00:00,43,16,31,20,0,0,2,0,112
2024-03-21 09:10:00,40,18,63,4,0,0,7,2,134
2024-03-21 09:20:00,36,13,31,8,0,0,2,0,90
2024-03-21 09:30:00,40,26,31,13,0,0,3,1,114
2024-03-21 09:40:00,60,29,28,6,0,0,1,0,124
2024-03-21 09:50:00,40,30,25,8,0,0,0,0,103
2024-03-21 10:00:00,50,34,28,11,0,0,4,0,127
2024-03-21 10:10:00,42,29,22,7,0,0,0,0,100
2024-03-21 10:20:00,47,35,24,8,0,0,0,0,114
2024-03-21 10:30:00,41,27,27,11,0,0,4,0,110
2024-03-21 10:40:00,44,31,25,1,0,0,3,1,105
2024-03-21 10:50:00,48,30,22,4,0,0,2,0,106
2024-03-21 11:00:00,52,37,20,4,0,0,4,0,117
2024-03-21 11:10:00,62,26,20,4,0,0,0,0,112
2024-03-21 11:20:00,58,38,25,10,0,0,3,0,134
2024-03-21 11:30:00,68,35,25,4,0,0,1,0,133
2024-03-21 11:40:00,65,40,30,6,0,0,3,1,145
2024-03-21 11:50:00,55,41,31,8,0,0,4,0,139
2024-03-21 12:00:00,42,29,25,8,0,0,3,0,107
2024-03-21 12:10:00,70,33,27,7,0,0,3,1,141
2024-03-21 12:20:00,68,34,26,12,0,0,0,0,140
2024-03-21 12:30:00,68,38,25,11,0,0,1,0,143
2024-03-21 12:40:00,50,27,29,6,0,0,0,1,113
2024-03-21 12:50:00,57,32,24,8,0,0,0,0,121
2024-03-21 13:00:00,50,21,27,8,0,0,8,1,115
2024-03-21 13:10:00,54,29,22,4,0,0,2,0,111
2024-03-21 13:20:00,54,24,48,32,0,0,4,3,165
2024-03-21 13:30:00,88,32,38,16,0,0,5,1,180
2024-03-21 13:40:00,59,23,25,7,0,0,3,2,119
2024-03-21 13:50:00,75,16,25,3,0,0,3,1,123
2024-03-21 14:00:00,57,10,20,3,0,0,3,0,93
2024-03-21 14:10:00,55,19,29,12,0,0,1,0,116
2024-03-21 14:20:00,67,25,30,35,0,0,3,1,161
2024-03-21 14:30:00,69,29,30,5,0,0,1,0,134
2024-03-21 14:40:00,82,37,30,6,0,0,1,1,157
2024-03-21 14:50:00,68,27,36,14,0,0,3,0,148
2024-03-21 15:00:00,74,44,54,8,0,0,9,0,189
2024-03-21 15:10:00,71,52,58,7,0,0,3,3,194
2024-03-21 15:20:00,73,40,44,7,0,0,4,1,169
2024-03-21 15:30:00,83,34,28,3,0,0,6,1,155
2024-03-21 15:40:00,84,37,31,5,0,0,4,0,161
2024-03-21 15:50:00,91,54,28,9,0,0,1,0,183
2024-03-21 16:00:00,73,23,27,4,0,0,1,2,130
2024-03-21 16:10:00,83,37,28,4,0,0,3,1,156
2024-03-21 16:20:00,79,46,22,5,0,0,1,0,153
2024-03-21 16:30:00,80,28,37,6,0,0,7,1,159
2024-03-21 16:40:00,72,33,20,10,0,0,3,0,138
2024-03-21 16:50:00,72,40,20,5,0,1,1,0,139
2024-03-21 17:00:00,79,30,20,2,0,0,5,1,137
2024-03-21 17:10:00,81,42,28,5,0,0,2,0,158
2024-03-21 17:20:00,84,46,28,1,0,0,2,0,161
2024-03-21 17:30:00,134,55,28,8,0,0,1,0,226
2024-03-21 17:40:00,84,31,28,2,0,0,2,3,150
2024-03-21 17:50:00,76,42,26,3,0,0,3,2,152
2024-03-21 18:00:00,65,37,31,0,0,0,5,0,138
2024-03-21 18:10:00,93,48,24,4,0,0,2,0,171
2024-03-21 18:20:00,84,46,19,3,0,0,1,0,153
2024-03-21 18:30:00,95,50,17,0,0,0,2,0,164
2024-03-21 18:40:00,58,29,29,8,0,0,2,0,126
2024-03-21 18:50:00,102,25,29,35,0,0,4,0,195
2024-03-21 19:00:00,51,43,28,6,0,0,0,0,128
2024-03-21 19:10:00,74,42,18,3,0,0,1,0,138
2024-03-21 19:20:00,45,28,25,4,0,0,2,0,104
2024-03-21 19:30:00,47,29,29,17,0,0,7,0,129
2024-03-21 19:40:00,60,30,69,5,0,0,1,0,165
2024-03-21 19:50:00,51,35,26,6,0,0,1,0,119
2024-03-21 20:00:00,52,32,20,5,0,0,1,0,110
2024-03-21 20:10:00,33,22,18,10,0,0,5,0,88
2024-03-21 20:20:00,42,24,24,5,0,0,1,0,96
2024-03-21 20:30:00,36,25,12,1,0,0,0,0,74
2024-03-21 20:40:00,34,27,12,3,0,0,1,0,77
2024-03-21 20:50:00,28,17,18,2,0,0,0,0,65
2024-03-21 21:00:00,37,22,14,7,0,0,2,0,82
2024-03-21 21:10:00,26,15,13,10,0,0,0,0,64
2024-03-21 21:20:00,23,18,12,4,0,0,1,0,58
2024-03-21 21:30:00,28,23,12,3,0,0,1,0,67
2024-03-21 21:40:00,29,16,51,0,0,0,0,1,97
2024-03-21 21:50:00,32,26,11,2,0,0,0,0,71
2024-03-21 22:00:00,27,23,17,7,0,0,1,0,75
2024-03-21 22:10:00,31,24,20,0,0,0,1,0,76
2024-03-21 22:20:00,31,24,11,0,0,0,0,0,66
2024-03-21 22:30:00,26,17,21,5,0,0,1,0,70
2024-03-21 22:40:00,34,24,13,4,0,0,2,0,77
2024-03-21 22:50:00,16,12,9,4,0,0,0,0,41
2024-03-21 23:00:00,22,17,43,1,0,0,0,0,83
2024-03-21 23:10:00,19,17,8,2,0,0,0,0,46
2024-03-21 23:20:00,26,20,10,3,0,0,0,0,59
2024-03-21 23:30:00,9,7,9,2,0,0,0,0,27
2024-03-21 23:40:00,9,10,6,2,0,1,0,0,28
2024-03-21 23:50:00,15,14,12,7,0,0,0,0,48
2024-03-22 00:00:00,8,8,5,1,0,0,0,0,22
2024-03-22 00:10:00,10,12,8,4,0,0,0,0,34
2024-03-22 00:20:00,8,8,7,4,0,0,0,0,27
2024-03-22 00:30:00,9,11,9,0,0,0,0,0,29
2024-03-22 00:40:00,4,4,6,1,0,0,0,0,15
2024-03-22 00:50:00,6,5,8,1,0,0,0,0,20
2024-03-22 01:00:00,3,3,19,0,0,0,0,0,25
2024-03-22 01:10:00,4,5,5,0,0,0,0,0,14
2024-03-22 01:20:00,2,2,6,0,0,0,0,0,10
2024-03-22 01:30:00,4,4,3,0,0,0,0,0,11
2024-03-22 01:40:00,5,6,2,2,0,0,0,0,15
2024-03-22 01:50:00,2,1,7,2,0,0,0,0,12
2024-03-22 02:00:00,4,4,4,2,0,0,0,0,14
2024-03-22 02:10:00,3,4,2,1,0,0,0,0,10
2024-03-22 02:20:00,6,6,5,3,0,0,0,0,20
2024-03-22 02:30:00,1,1,4,1,0,0,0,0,7
2024-03-22 02:40:00,2,2,4,0,0,0,0,0,8
2024-03-22 02:50:00,3,3,4,2,0,0,0,0,12
2024-03-22 03:00:00,3,3,0,0,0,0,0,0,6
2024-03-22 03:10:00,2,2,1,0,0,0,0,0,5
2024-03-22 03:20:00,1,1,0,0,0,0,0,0,2
2024-03-22 03:30:00,1,1,2,1,0,0,0,0,5
2024-03-22 03:40:00,1,1,0,1,0,0,0,0,3
2024-03-22 03:50:00,2,2,6,0,0,0,0,0,10
2024-03-22 04:00:00,2,2,2,0,0,0,0,0,6
2024-03-22 04:10:00,1,2,3,0,0,0,0,0,6
2024-03-22 04:20:00,0,0,3,2,0,0,0,0,5
2024-03-22 04:30:00,1,1,7,1,0,0,0,0,10
2024-03-22 04:40:00,1,1,3,0,0,0,0,0,5
2024-03-22 04:50:00,1,1,3,0,0,0,0,0,5
2024-03-22 05:00:00,2,3,4,0,0,0,0,0,9
2024-03-22 05:10:00,5,6,9,2,0,0,0,0,22
2024-03-22 05:20:00,3,4,2,0,0,0,0,0,9
2024-03-22 05:30:00,6,4,4,2,0,0,0,0,16
2024-03-22 05:40:00,3,3,10,0,0,0,1,0,17
2024-03-22 05:50:00,4,4,7,0,0,0,0,0,15
2024-03-22 06:00:00,5,6,11,7,0,0,0,0,29
2024-03-22 06:10:00,7,7,5,3,0,0,0,0,22
2024-03-22 06:20:00,15,13,18,8,0,0,0,0,54
2024-03-22 06:30:00,8,8,13,5,0,0,0,0,34
2024-03-22 06:40:00,15,13,16,7,0,0,2,0,53
2024-03-22 06:50:00,13,10,25,8,0,0,2,1,59
2024-03-22 07:00:00,25,18,24,13,0,0,2,1,83
2024-03-22 07:10:00,23,14,48,6,0,0,3,0,94
2024-03-22 07:20:00,27,20,41,4,0,0,8,2,102
2024-03-22 07:30:00,36,21,24,6,0,0,9,2,98
2024-03-22 07:40:00,47,27,24,10,0,0,5,0,113
2024-03-22 07:50:00,51,29,27,6,0,0,3,0,116
2024-03-22 08:00:00,49,25,32,12,0,0,4,0,122
2024-03-22 08:10:00,31,16,18,5,0,0,2,1,73
2024-03-22 08:20:00,39,25,26,4,0,0,2,0,96
2024-03-22 08:30:00,37,22,29,5,0,0,4,1,98
2024-03-22 08:40:00,49,28,29,13,0,0,2,0,121
2024-03-22 08:50:00,56,45,28,7,0,0,2,0,138
2024-03-22 09:00:00,38,22,21,4,0,0,1,0,86
2024-03-22 09:10:00,40,20,28,6,0,0,2,0,96
2024-03-22 09:20:00,47,24,24,8,0,0,3,0,106
2024-03-22 09:30:00,35,24,19,9,0,0,3,6,96
2024-03-22 09:40:00,50,34,29,13,0,0,2,1,129
2024-03-22 09:50:00,59,40,22,18,0,0,0,0,139
2024-03-22 10:00:00,43,25,27,4,0,0,3,4,106
2024-03-22 10:10:00,56,31,36,6,0,0,6,2,137
2024-03-22 10:20:00,58,42,25,6,0,0,2,0,133
2024-03-22 10:30:00,59,33,18,5,0,0,3,1,119
2024-03-22 10:40:00,49,28,30,2,0,0,7,1,117
2024-03-22 10:50:00,71,50,22,2,0,0,8,1,154
2024-03-22 11:00:00,59,33,14,1,0,0,3,1,111
2024-03-22 11:10:00,61,34,21,19,0,0,5,0,140
2024-03-22 11:20:00,72,41,25,6,0,0,2,0,146
2024-03-22 11:30:00,66,40,25,1,0,0,2,1,135
2024-03-22 11:40:00,61,47,23,2,0,0,5,0,138
2024-03-22 11:50:00,49,21,26,0,0,0,0,0,96
2024-03-22 12:00:00,73,51,24,6,0,0,3,0,157
2024-03-22 12:10:00,59,38,15,1,0,0,4,0,117
2024-03-22 12:20:00,62,41,24,2,0,0,1,0,130
2024-03-22 12:30:00,61,56,25,6,0,0,9,1,158
2024-03-22 12:40:00,74,49,23,5,0,0,8,0,159
2024-03-22 12:50:00,80,68,16,5,0,0,4,0,173
2024-03-22 13:00:00,59,37,16,4,0,0,3,0,119
2024-03-22 13:10:00,79,42,27,8,0,0,6,0,162
2024-03-22 13:20:00,75,50,20,2,0,0,5,0,152
2024-03-22 13:30:00,67,38,27,6,0,0,0,0,138
2024-03-22 13:40:00,80,55,23,3,0,0,5,0,166
2024-03-22 13:50:00,94,63,24,4,0,0,2,0,187
2024-03-22 14:00:00,72,48,12,4,0,0,7,0,143
2024-03-22 14:10:00,83,65,24,4,0,0,4,0,180
2024-03-22 14:20:00,63,47,16,1,0,0,4,0,131
2024-03-22 14:30:00,71,45,26,7,0,0,3,0,152
2024-03-22 14:40:00,80,54,14,1,0,0,3,0,152
2024-03-22 14:50:00,76,44,14,5,0,0,3,0,142
2024-03-22 15:00:00,75,58,25,2,0,0,10,0,170
2024-03-22 15:10:00,73,58,26,7,0,0,8,0,172
2024-03-22 15:20:00,74,48,24,2,0,0,3,0,151
2024-03-22 15:30:00,86,59,17,2,0,0,5,0,169
2024-03-22 15:40:00,54,37,16,1,0,0,1,0,109
2024-03-22 15:50:00,69,56,18,1,0,0,4,0,148
2024-03-22 16:00:00,81,66,18,1,0,0,1,1,168
2024-03-22 16:10:00,56,35,14,2,0,0,10,0,117
2024-03-22 16:20:00,72,54,22,2,0,0,7,0,157
2024-03-22 16:30:00,75,54,30,5,0,0,3,0,167
2024-03-22 16:40:00,74,52,18,2,0,0,2,0,148
2024-03-22 16:50:00,59,42,23,2,0,0,3,0,129
2024-03-22 17:00:00,64,51,27,3,0,0,8,1,154
2024-03-22 17:10:00,73,42,34,0,0,0,2,0,151
2024-03-22 17:20:00,61,50,25,3,0,0,6,1,146
2024-03-22 17:30:00,77,44,12,3,0,0,4,0,140
2024-03-22 17:40:00,63,52,21,7,0,0,2,0,145
2024-03-22 17:50:00,106,61,19,4,0,0,7,2,199
2024-03-22 18:00:00,65,44,24,2,0,0,9,0,144
2024-03-22 18:10:00,66,51,26,3,0,0,3,0,149
2024-03-22 18:20:00,51,49,18,3,0,0,3,0,124
2024-03-22 18:30:00,34,23,5,0,0,0,0,0,62
2024-03-22 18:40:00,37,20,16,0,0,0,0,0,73
2024-03-22 18:50:00,41,30,14,15,0,0,3,0,103
2024-03-22 19:00:00,59,32,13,2,0,0,1,0,107
2024-03-22 19:10:00,49,33,18,2,0,0,1,0,103
2024-03-22 19:20:00,68,31,20,2,0,0,0,0,121
2024-03-22 19:30:00,54,38,12,9,0,0,4,0,117
2024-03-22 19:40:00,39,24,13,2,0,0,1,0,79
2024-03-22 19:50:00,34,25,14,3,0,0,1,0,77
2024-03-22 20:00:00,32,23,17,4,0,0,2,0,78
2024-03-22 20:10:00,39,29,16,1,0,0,6,0,91
2024-03-22 20:20:00,31,27,12,3,0,0,0,0,73
2024-03-22 20:30:00,50,31,13,3,0,0,0,0,97
2024-03-22 20:40:00,36,28,17,4,0,0,0,0,85
2024-03-22 20:50:00,43,32,11,4,0,0,1,0,91
2024-03-22 21:00:00,28,23,13,4,0,0,2,0,70
2024-03-22 21:10:00,36,29,14,2,0,0,1,0,82
2024-03-22 21:20:00,21,14,18,0,0,0,0,0,53
2024-03-22 21:30:00,32,24,7,1,0,0,0,0,64
2024-03-22 21:40:00,33,27,7,0,0,0,3,0,70
2024-03-22 21:50:00,29,19,9,2,0,0,3,0,62
2024-03-22 22:00:00,25,23,7,2,0,0,1,0,58
2024-03-22 22:10:00,40,34,14,3,0,0,1,0,92
2024-03-22 22:20:00,32,25,15,1,0,0,0,0,73
2024-03-22 22:30:00,12,12,13,0,0,0,0,0,37
2024-03-22 22:40:00,24,15,19,3,0,0,0,1,62
2024-03-22 22:50:00,24,20,13,1,0,0,0,0,58
2024-03-22 23:00:00,25,22,4,1,0,0,0,0,52
2024-03-22 23:10:00,26,24,8,1,0,0,0,0,59
2024-03-22 23:20:00,17,14,14,8,0,0,0,0,53
2024-03-22 23:30:00,19,19,9,3,0,0,1,0,51
2024-03-22 23:40:00,15,16,6,4,0,0,0,0,41
2024-03-22 23:50:00,13,11,9,2,0,0,1,0,36
2024-03-23 00:00:00,19,14,4,3,0,0,0,0,40
2024-03-23 00:10:00,9,9,4,4,0,0,0,0,26
2024-03-23 00:20:00,8,10,3,1,0,0,0,0,22
2024-03-23 00:30:00,16,17,6,9,0,0,0,0,48
2024-03-23 00:40:00,12,9,3,2,0,0,0,0,26
2024-03-23 00:50:00,9,10,5,4,0,0,0,0,28
2024-03-23 01:00:00,8,6,5,0,0,0,0,0,19
2024-03-23 01:10:00,6,6,6,3,0,0,0,0,21
2024-03-23 01:20:00,8,8,6,3,0,0,0,0,25
2024-03-23 01:30:00,6,7,4,0,0,0,0,0,17
2024-03-23 01:40:00,6,7,3,1,0,0,0,0,17
2024-03-23 01:50:00,5,5,8,2,0,0,0,0,20
2024-03-23 02:00:00,6,4,6,4,0,0,1,0,21
2024-03-23 02:10:00,5,5,4,1,0,0,0,0,15
2024-03-23 02:20:00,4,4,1,0,0,0,0,0,9
2024-03-23 02:30:00,4,5,4,3,0,0,0,0,16
2024-03-23 02:40:00,4,4,1,1,0,0,0,0,10
2024-03-23 02:50:00,8,7,3,4,0,0,0,0,22
2024-03-23 03:00:00,6,8,2,2,0,0,0,0,18
2024-03-23 03:10:00,3,5,3,0,0,0,1,0,12
2024-03-23 03:20:00,2,2,3,1,0,0,0,0,8
2024-03-23 03:30:00,4,4,3,0,0,0,0,0,11
2024-03-23 03:40:00,3,3,3,2,0,0,0,0,11
2024-03-23 03:50:00,0,0,3,0,0,0,0,0,3
2024-03-23 04:00:00,4,5,4,3,0,0,0,0,16
2024-03-23 04:10:00,1,1,0,0,0,0,0,0,2
2024-03-23 04:20:00,3,3,1,0,0,0,0,0,7
2024-03-23 04:30:00,1,1,2,0,0,0,0,0,4
2024-03-23 04:40:00,4,5,4,2,0,0,0,0,15
2024-03-23 04:50:00,2,2,1,1,0,0,0,0,6
2024-03-23 05:00:00,1,1,3,1,0,0,0,0,6
2024-03-23 05:10:00,5,5,7,2,0,0,0,0,19
2024-03-23 05:20:00,4,3,2,1,0,0,0,0,10
2024-03-23 05:30:00,3,3,5,1,0,0,0,0,12
2024-03-23 05:40:00,1,1,2,1,0,0,0,0,5
2024-03-23 05:50:00,2,2,4,3,0,0,1,0,12
2024-03-23 06:00:00,5,5,4,5,0,0,0,0,19
2024-03-23 06:10:00,5,4,4,5,0,0,0,0,18
2024-03-23 06:20:00,9,9,13,11,0,0,0,0,42
2024-03-23 06:30:00,8,6,8,5,0,0,0,0,27
2024-03-23 06:40:00,5,4,7,3,0,0,0,0,19
2024-03-23 06:50:00,4,4,10,2,0,0,0,0,20
2024-03-23 07:00:00,9,8,6,1,0,0,0,0,24
2024-03-23 07:10:00,7,7,7,1,0,0,0,0,22
2024-03-23 07:20:00,9,9,11,3,0,0,0,0,32
2024-03-23 07:30:00,9,8,7,0,0,0,0,0,24
2024-03-23 07:40:00,7,7,6,0,0,0,0,0,20
2024-03-23 07:50:00,16,15,6,1,0,0,1,0,39
2024-03-23 08:00:00,11,11,11,0,0,0,0,0,33
2024-03-23 08:10:00,17,14,11,1,0,0,1,0,44
2024-03-23 08:20:00,15,12,7,0,0,0,1,0,35
2024-03-23 08:30:00,20,19,13,0,0,0,1,0,53
2024-03-23 08:40:00,28,25,17,4,0,0,2,0,76
2024-03-23 08:50:00,25,26,25,2,0,0,0,0,78
2024-03-23 09:00:00,27,26,10,1,0,0,0,0,64
2024-03-23 09:10:00,31,26,12,0,0,0,3,0,72
2024-03-23 09:20:00,33,29,15,1,0,0,1,0,79
2024-03-23 09:30:00,32,28,23,4,0,0,1,0,88
2024-03-23 09:40:00,34,32,16,9,0,0,1,1,93
2024-03-23 09:50:00,39,27,22,6,0,0,3,0,97
2024-03-23 10:00:00,22,21,22,9,0,0,0,2,76
2024-03-23 10:10:00,40,35,23,7,0,0,4,0,109
2024-03-23 10:20:00,32,26,15,2,0,0,3,0,78
2024-03-23 10:30:00,41,27,23,1,0,0,0,0,92
2024-03-23 10:40:00,34,27,18,4,0,0,4,0,87
2024-03-23 10:50:00,52,41,20,4,0,0,2,0,119
2024-03-23 11:00:00,52,41,17,1,0,0,2,0,113
2024-03-23 11:10:00,44,34,17,2,0,0,4,0,101
2024-03-23 11:20:00,38,34,14,3,0,0,7,0,96
2024-03-23 11:30:00,46,43,29,4,0,0,0,1,123
2024-03-23 11:40:00,47,36,18,1,0,0,1,0,103
2024-03-23 11:50:00,35,31,21,0,0,0,2,0,89
2024-03-23 12:00:00,68,50,20,0,0,0,6,0,144
2024-03-23 12:10:00,59,35,20,1,0,0,1,0,116
2024-03-23 12:20:00,54,40,6,1,0,0,1,0,102
2024-03-23 12:30:00,53,32,18,1,0,0,3,0,107
2024-03-23 12:40:00,75,37,20,0,0,0,0,0,132
2024-03-23 12:50:00,56,34,16,3,0,0,5,0,114
2024-03-23 13:00:00,51,34,25,2,0,0,4,0,116
2024-03-23 13:10:00,57,37,22,2,0,0,3,0,121
2024-03-23 13:20:00,55,39,11,2,0,0,2,0,109
2024-03-23 13:30:00,54,38,6,1,0,0,5,0,104
2024-03-23 13:40:00,52,33,12,0,0,0,2,0,99
2024-03-23 13:50:00,52,32,16,2,0,0,4,0,106
2024-03-23 14:00:00,58,35,21,0,0,0,4,1,119
2024-03-23 14:10:00,67,44,14,0,0,0,6,0,131
2024-03-23 14:20:00,57,37,18,0,0,0,2,0,114
2024-03-23 14:30:00,52,35,34,1,0,0,2,0,124
2024-03-23 14:40:00,60,41,14,0,0,0,1,0,116
2024-03-23 14:50:00,65,49,28,3,0,0,3,0,148
2024-03-23 15:00:00,61,42,16,3,0,0,3,0,125
2024-03-23 15:10:00,73,41,21,3,0,0,0,0,138
2024-03-23 15:20:00,37,31,21,3,0,0,3,0,95
2024-03-23 15:30:00,59,43,12,3,0,0,5,0,122
2024-03-23 15:40:00,60,45,12,1,0,0,2,0,120
2024-03-23 15:50:00,51,37,20,0,0,0,1,0,109
2024-03-23 16:00:00,67,42,15,4,0,0,3,0,131
2024-03-23 16:10:00,45,35,11,1,0,0,1,0,93
2024-03-23 16:20:00,52,40,14,1,0,0,1,0,108
2024-03-23 16:30:00,43,31,18,1,0,0,5,0,98
2024-03-23 16:40:00,48,31,25,1,0,0,5,0,110
2024-03-23 16:50:00,52,30,16,0,0,0,2,0,100
2024-03-23 17:00:00,45,38,8,0,0,0,6,0,97
2024-03-23 17:10:00,55,43,20,3,0,0,5,0,126
2024-03-23 17:20:00,52,36,21,5,0,0,1,0,115
2024-03-23 17:30:00,44,36,15,1,0,0,5,0,101
2024-03-23 17:40:00,59,40,21,3,0,0,3,0,126
2024-03-23 17:50:00,51,33,13,1,0,0,4,0,102
2024-03-23 18:00:00,55,42,15,1,0,0,3,0,116
2024-03-23 18:10:00,62,41,22,6,0,0,4,0,135
2024-03-23 18:20:00,55,44,16,1,0,0,1,0,117
2024-03-23 18:30:00,49,42,17,1,0,0,2,0,111
2024-03-23 18:40:00,48,36,21,7,0,0,3,0,115
2024-03-23 18:50:00,43,22,16,11,0,0,0,0,92
2024-03-23 19:00:00,41,27,15,14,0,0,1,1,99
2024-03-23 19:10:00,38,33,13,11,0,0,3,0,98
2024-03-23 19:20:00,38,32,21,14,0,0,1,0,106
2024-03-23 19:30:00,38,27,11,13,0,0,0,0,89
2024-03-23 19:40:00,44,31,22,8,0,0,1,0,106
2024-03-23 19:50:00,31,28,4,0,0,0,2,0,65
2024-03-23 20:00:00,47,40,11,2,0,0,1,0,101
2024-03-23 20:10:00,38,26,14,0,0,0,0,0,78
2024-03-23 20:20:00,21,19,9,3,0,0,2,0,54
2024-03-23 20:30:00,35,23,9,3,0,0,1,0,71
2024-03-23 20:40:00,36,32,7,0,0,0,2,0,77
2024-03-23 20:50:00,37,36,11,4,0,0,1,0,89
2024-03-23 21:00:00,26,22,12,3,0,0,0,0,63
2024-03-23 21:10:00,23,21,9,3,0,0,0,0,56
2024-03-23 21:20:00,25,17,9,3,0,0,0,0,54
2024-03-23 21:30:00,22,20,14,13,0,0,1,0,70
2024-03-23 21:40:00,23,18,9,17,0,0,0,0,67
2024-03-23 21:50:00,25,18,8,14,0,0,0,0,65
2024-03-23 22:00:00,25,20,10,11,0,0,0,0,66
2024-03-23 22:10:00,32,18,16,3,0,0,0,0,69
2024-03-23 22:20:00,16,12,5,0,0,0,0,0,33
2024-03-23 22:30:00,23,16,8,3,0,0,0,0,50
2024-03-23 22:40:00,27,23,14,4,0,0,0,0,68
2024-03-23 22:50:00,20,17,15,1,0,0,2,0,55
2024-03-23 23:00:00,30,28,10,2,0,0,1,0,71
2024-03-23 23:10:00,26,22,12,0,0,0,0,0,60
2024-03-23 23:20:00,20,19,9,4,0,0,0,0,52
2024-03-23 23:30:00,29,21,10,1,0,0,0,0,61
2024-03-23 23:40:00,23,21,10,4,0,0,0,0,58
2024-03-23 23:50:00,17,19,10,2,0,0,0,0,48
2024-03-24 00:00:00,17,15,2,0,0,0,0,0,34
2024-03-24 00:10:00,10,10,6,4,0,0,0,0,30
2024-03-24 00:20:00,14,12,7,9,0,0,0,0,42
2024-03-24 00:30:00,15,12,7,10,0,0,0,0,44
2024-03-24 00:40:00,13,10,8,9,0,0,0,0,40
2024-03-24 00:50:00,16,9,9,8,0,0,0,0,42
2024-03-24 01:00:00,1,1,3,1,0,0,1,0,7
2024-03-24 01:10:00,9,8,11,8,0,0,0,0,36
2024-03-24 01:20:00,5,5,4,6,0,0,0,0,20
2024-03-24 01:30:00,5,3,4,3,0,0,0,0,15
2024-03-24 01:40:00,3,3,6,4,0,0,0,0,16
2024-03-24 01:50:00,10,7,5,8,0,0,0,0,30
2024-03-24 02:00:00,8,8,2,6,0,0,0,0,24
2024-03-24 02:10:00,7,8,4,6,0,0,0,0,25
2024-03-24 02:20:00,2,3,6,2,0,0,0,0,13
2024-03-24 02:30:00,8,9,4,3,0,0,0,0,24
2024-03-24 02:40:00,4,4,4,1,0,0,0,0,13
2024-03-24 02:50:00,4,4,6,0,0,0,0,0,14
2024-03-24 03:00:00,10,9,7,2,0,0,0,0,28
2024-03-24 03:10:00,7,6,8,1,0,0,0,0,22
2024-03-24 03:20:00,4,4,2,0,0,0,0,0,10
2024-03-24 03:30:00,2,3,2,0,0,0,0,0,7
2024-03-24 03:40:00,3,2,0,0,0,0,0,0,5
2024-03-24 03:50:00,4,5,2,1,0,0,0,0,12
2024-03-24 04:00:00,2,2,3,0,0,0,0,0,7
2024-03-24 04:10:00,1,1,2,0,0,0,0,0,4
2024-03-24 04:20:00,0,0,0,0,0,0,0,0,0
2024-03-24 04:30:00,1,2,2,0,0,0,0,0,5
2024-03-24 04:40:00,1,2,0,0,0,0,0,0,3
2024-03-24 04:50:00,4,4,1,1,0,0,0,0,10
2024-03-24 05:00:00,1,1,4,1,0,0,0,0,7
2024-03-24 05:10:00,4,5,2,0,0,0,0,0,11
2024-03-24 05:20:00,4,6,3,0,0,0,0,0,13
2024-03-24 05:30:00,2,2,1,1,0,0,0,0,6
2024-03-24 05:40:00,5,5,4,0,0,0,0,0,14
2024-03-24 05:50:00,2,2,2,1,0,0,0,0,7
2024-03-24 06:00:00,4,3,4,3,0,0,0,0,14
2024-03-24 06:10:00,2,2,3,0,0,0,0,0,7
2024-03-24 06:20:00,7,7,2,0,0,0,0,0,16
2024-03-24 06:30:00,4,4,5,2,0,0,0,0,15
2024-03-24 06:40:00,4,4,6,0,0,0,0,0,14
2024-03-24 06:50:00,7,6,9,0,0,0,0,0,22
2024-03-24 07:00:00,2,2,7,1,0,0,0,0,12
2024-03-24 07:10:00,2,2,1,0,0,0,0,0,5
2024-03-24 07:20:00,5,5,2,1,0,0,1,0,14
2024-03-24 07:30:00,5,5,4,0,0,0,0,0,14
2024-03-24 07:40:00,6,6,5,2,0,0,0,0,19
2024-03-24 07:50:00,8,8,5,0,0,0,1,0,22
2024-03-24 08:00:00,14,14,1,1,0,0,0,0,30
2024-03-24 08:10:00,10,8,2,0,0,0,0,0,20
2024-03-24 08:20:00,7,7,6,1,0,0,0,0,21
2024-03-24 08:30:00,11,11,5,1,0,0,0,0,28
2024-03-24 08:40:00,15,16,5,0,0,0,0,0,36
2024-03-24 08:50:00,15,14,7,1,0,0,0,0,37
2024-03-24 09:00:00,15,13,9,0,0,0,1,0,38
2024-03-24 09:10:00,12,10,10,0,0,0,1,0,33
2024-03-24 09:20:00,23,21,10,3,0,0,0,0,57
2024-03-24 09:30:00,27,25,20,3,0,0,0,0,75
2024-03-24 09:40:00,25,25,9,3,0,0,0,0,62
2024-03-24 09:50:00,27,23,14,6,0,0,0,0,70
2024-03-24 10:00:00,24,24,8,2,0,0,1,0,59
2024-03-24 10:10:00,17,14,7,2,0,0,0,0,40
2024-03-24 10:20:00,20,17,12,1,0,0,2,0,52
2024-03-24 10:30:00,21,21,18,1,0,0,1,0,62
2024-03-24 10:40:00,17,17,10,2,0,0,0,0,46
2024-03-24 10:50:00,20,18,10,2,0,0,1,0,51
2024-03-24 11:00:00,23,22,6,0,0,0,2,0,53
2024-03-24 11:10:00,23,21,7,1,0,0,1,0,53
2024-03-24 11:20:00,24,21,16,3,0,0,0,0,64
2024-03-24 11:30:00,21,18,16,3,0,0,3,0,61
2024-03-24 11:40:00,32,28,17,2,0,0,1,0,80
2024-03-24 11:50:00,26,21,6,2,0,0,0,0,55
2024-03-24 12:00:00,39,27,13,3,0,0,2,0,84
2024-03-24 12:10:00,33,30,13,1,0,0,1,0,78
2024-03-24 12:20:00,40,30,12,2,0,0,1,0,85
2024-03-24 12:30:00,28,24,10,2,0,0,2,0,66
2024-03-24 12:40:00,32,26,9,0,0,0,2,0,69
2024-03-24 12:50:00,30,22,12,1,0,0,1,0,66
2024-03-24 13:00:00,27,24,9,1,0,0,0,0,61
2024-03-24 13:10:00,41,30,11,2,0,0,2,0,86
2024-03-24 13:20:00,40,27,9,0,0,0,1,0,77
2024-03-24 13:30:00,38,20,14,3,0,0,1,0,76
2024-03-24 13:40:00,38,32,16,1,0,0,1,0,88
2024-03-24 13:50:00,30,26,13,1,0,0,1,0,71
2024-03-24 14:00:00,29,26,3,2,0,0,3,0,63
2024-03-24 14:10:00,45,33,15,1,0,0,2,0,96
2024-03-24 14:20:00,35,20,25,2,0,0,0,0,82
2024-03-24 14:30:00,28,21,13,1,0,0,0,0,63
2024-03-24 14:40:00,35,30,16,2,0,0,2,0,85
2024-03-24 14:50:00,46,23,18,2,0,0,1,0,90
2024-03-24 15:00:00,30,21,15,0,0,0,0,1,67
2024-03-24 15:10:00,36,26,8,2,0,0,3,0,75
2024-03-24 15:20:00,45,28,13,3,0,0,5,0,94
2024-03-24 15:30:00,34,27,11,3,0,0,1,0,76
2024-03-24 15:40:00,39,28,10,2,0,0,1,0,80
2024-03-24 15:50:00,43,30,17,3,0,0,2,0,95
2024-03-24 16:00:00,49,36,19,6,0,0,2,0,112
2024-03-24 16:10:00,39,24,16,0,0,0,0,0,79
2024-03-24 16:20:00,40,29,17,1,0,0,2,0,89
2024-03-24 16:30:00,41,29,15,2,0,0,0,0,87
2024-03-24 16:40:00,28,21,17,1,0,0,1,0,68
2024-03-24 16:50:00,34,24,15,1,0,0,0,1,75
2024-03-24 17:00:00,32,22,17,0,0,0,1,0,72
2024-03-24 17:10:00,39,26,13,3,0,0,1,0,82
2024-03-24 17:20:00,45,24,13,1,0,0,1,0,84
2024-03-24 17:30:00,32,19,20,0,0,0,1,0,72
2024-03-24 17:40:00,34,19,12,1,0,0,1,0,67
2024-03-24 17:50:00,47,36,15,0,0,0,0,1,99
2024-03-24 18:00:00,34,25,9,2,0,0,0,0,70
2024-03-24 18:10:00,38,31,6,0,0,0,1,0,76
2024-03-24 18:20:00,38,32,18,1,0,0,5,0,94
2024-03-24 18:30:00,35,26,17,4,0,0,1,0,83
2024-03-24 18:40:00,39,27,18,16,0,0,1,0,101
2024-03-24 18:50:00,36,20,16,21,0,0,1,0,94
2024-03-24 19:00:00,31,21,12,20,0,0,0,1,85
2024-03-24 19:10:00,31,18,11,19,0,0,1,0,80
2024-03-24 19:20:00,20,20,12,19,0,0,0,0,71
2024-03-24 19:30:00,26,21,9,21,0,0,0,0,77
2024-03-24 19:40:00,22,14,7,14,0,0,0,0,57
2024-03-24 19:50:00,24,19,12,17,0,0,1,0,73
2024-03-24 20:00:00,17,12,9,12,0,0,7,0,57
2024-03-24 20:10:00,34,21,8,20,0,0,1,0,84
2024-03-24 20:20:00,36,21,10,22,0,0,3,0,92
2024-03-24 20:30:00,23,17,10,13,0,0,1,0,64
2024-03-24 20:40:00,27,21,6,22,0,0,2,1,79
2024-03-24 20:50:00,21,16,9,13,0,0,1,0,60
2024-03-24 21:00:00,24,20,6,17,0,0,0,0,67
2024-03-24 21:10:00,20,16,9,15,0,0,0,0,60
2024-03-24 21:20:00,26,27,11,15,0,0,1,0,80
2024-03-24 21:30:00,32,27,8,15,0,0,0,0,82
2024-03-24 21:40:00,18,15,11,9,0,0,0,0,53
2024-03-24 21:50:00,24,19,11,9,0,0,0,0,63
2024-03-24 22:00:00,26,26,11,16,0,0,0,0,79
2024-03-24 22:10:00,17,18,9,9,0,0,1,0,54
2024-03-24 22:20:00,15,14,10,13,0,0,1,0,53
2024-03-24 22:30:00,9,7,9,4,0,0,0,0,29
2024-03-24 22:40:00,14,10,8,6,0,0,0,0,38
2024-03-24 22:50:00,11,11,5,2,0,0,0,0,29
2024-03-24 23:00:00,11,9,6,2,0,0,0,0,28
2024-03-24 23:10:00,10,10,8,2,0,0,0,0,30
2024-03-24 23:20:00,8,10,5,0,0,0,0,0,23
2024-03-24 23:30:00,8,10,4,3,0,0,0,0,25
2024-03-24 23:40:00,11,10,5,1,0,0,0,0,27
2024-03-24 23:50:00,9,8,4,4,0,0,0,0,25
2024-03-25 00:00:00,2,3,1,0,0,0,0,0,6
2024-03-25 00:10:00,4,4,3,1,0,0,0,0,12
2024-03-25 00:20:00,5,5,2,1,0,0,0,0,13
2024-03-25 00:30:00,5,6,4,4,0,0,0,0,19
2024-03-25 00:40:00,5,3,6,1,0,0,0,0,15
2024-03-25 00:50:00,6,6,1,1,0,0,0,0,14
2024-03-25 01:00:00,5,5,1,1,0,0,0,0,12
2024-03-25 01:10:00,3,5,1,0,0,0,0,0,9
2024-03-25 01:20:00,2,2,1,1,0,0,0,0,6
2024-03-25 01:30:00,6,6,4,2,0,0,0,0,18
2024-03-25 01:40:00,2,2,5,0,0,0,0,0,9
2024-03-25 01:50:00,3,3,1,0,0,0,0,0,7
2024-03-25 02:00:00,2,2,3,0,0,0,0,0,7
2024-03-25 02:10:00,3,3,2,2,0,0,0,0,10
2024-03-25 02:20:00,1,1,1,0,0,0,0,0,3
2024-03-25 02:30:00,0,0,0,0,0,0,0,0,0
2024-03-25 02:40:00,1,1,1,0,0,0,0,0,3
2024-03-25 02:50:00,2,2,1,1,0,0,0,0,6
2024-03-25 03:00:00,1,2,5,1,0,0,0,0,9
2024-03-25 03:10:00,4,4,1,1,0,0,0,0,10
2024-03-25 03:20:00,3,3,2,0,0,0,0,0,8
2024-03-25 03:30:00,0,0,3,0,0,0,0,0,3
2024-03-25 03:40:00,3,3,0,0,0,0,0,0,6
2024-03-25 03:50:00,3,4,0,0,0,0,0,0,7
2024-03-25 04:00:00,3,4,1,1,0,0,0,0,9
2024-03-25 04:10:00,0,0,1,0,0,0,0,0,1
2024-03-25 04:20:00,0,0,0,0,0,0,0,0,0
2024-03-25 04:30:00,1,1,1,1,0,0,0,0,4
2024-03-25 04:40:00,2,2,2,0,0,0,0,0,6
2024-03-25 04:50:00,1,1,1,0,0,0,0,0,3
2024-03-25 05:00:00,3,3,2,0,0,0,0,0,8
2024-03-25 05:10:00,2,2,4,1,0,0,0,0,9
2024-03-25 05:20:00,4,6,4,0,0,0,1,0,15
2024-03-25 05:30:00,1,1,4,0,0,0,0,0,6
2024-03-25 05:40:00,7,9,10,0,0,0,0,0,26
2024-03-25 05:50:00,9,11,5,2,0,0,0,0,27
2024-03-25 06:00:00,5,5,9,2,0,0,0,0,21
2024-03-25 06:10:00,2,2,8,7,0,0,0,0,19
2024-03-25 06:20:00,11,12,15,4,0,0,0,0,42
2024-03-25 06:30:00,13,9,15,3,0,0,0,0,40
2024-03-25 06:40:00,15,15,13,5,0,0,1,0,49
2024-03-25 06:50:00,11,10,14,5,0,0,3,0,43
2024-03-25 07:00:00,14,9,14,4,0,0,0,0,41
2024-03-25 07:10:00,18,13,20,6,0,0,1,0,58
2024-03-25 07:20:00,17,16,19,4,0,0,0,0,56
2024-03-25 07:30:00,27,14,16,11,0,0,2,0,70
2024-03-25 07:40:00,26,24,11,16,0,0,1,0,78
2024-03-25 07:50:00,25,22,26,33,0,0,3,0,109
2024-03-25 08:00:00,37,14,17,18,0,0,1,0,87
2024-03-25 08:10:00,34,12,19,13,0,0,3,0,81
2024-03-25 08:20:00,42,18,17,19,0,0,2,1,99
2024-03-25 08:30:00,44,27,26,16,0,0,2,0,115
2024-03-25 08:40:00,46,32,20,9,0,0,1,0,108
2024-03-25 08:50:00,49,20,19,10,0,0,0,1,99
2024-03-25 09:00:00,42,17,15,3,0,0,0,0,77
2024-03-25 09:10:00,30,25,17,4,0,0,2,0,78
2024-03-25 09:20:00,60,36,29,4,0,0,5,0,134
2024-03-25 09:30:00,44,31,20,2,0,0,5,0,102
2024-03-25 09:40:00,42,26,24,7,0,0,0,0,99
2024-03-25 09:50:00,38,31,18,3,0,0,1,0,91
2024-03-25 10:00:00,46,33,19,2,0,0,0,0,100
2024-03-25 10:10:00,48,41,22,4,0,0,1,0,116
2024-03-25 10:20:00,43,29,14,2,0,0,2,0,90
2024-03-25 10:30:00,47,30,16,0,0,0,4,0,97
2024-03-25 10:40:00,57,34,25,2,0,0,2,0,120
2024-03-25 10:50:00,42,38,11,2,0,0,3,0,96
2024-03-25 11:00:00,64,36,20,0,0,0,6,0,126
2024-03-25 11:10:00,53,36,15,6,0,0,3,0,113
2024-03-25 11:20:00,60,38,15,9,0,0,1,5,128
2024-03-25 11:30:00,54,37,18,6,0,0,7,1,123
2024-03-25 11:40:00,51,43,30,2,0,0,4,0,130
2024-03-25 11:50:00,51,44,20,3,0,0,2,0,120
2024-03-25 12:00:00,65,39,18,1,0,0,3,2,128
2024-03-25 12:10:00,67,35,16,1,0,0,5,1,125
2024-03-25 12:20:00,62,33,22,0,0,0,7,1,125
2024-03-25 12:30:00,60,33,14,1,0,0,5,0,113
2024-03-25 12:40:00,56,46,13,0,0,0,5,0,120
2024-03-25 12:50:00,58,44,11,1,0,0,6,1,121
2024-03-25 13:00:00,55,39,22,5,0,0,1,0,122
2024-03-25 13:10:00,56,55,15,3,0,0,0,1,130
2024-03-25 13:20:00,52,33,14,2,0,0,1,0,102
2024-03-25 13:30:00,59,49,10,2,0,0,2,0,122
2024-03-25 13:40:00,56,36,22,1,0,0,2,0,117
2024-03-25 13:50:00,51,25,15,4,0,0,1,0,96
2024-03-25 14:00:00,78,34,11,1,0,0,5,0,129
2024-03-25 14:10:00,64,19,24,1,0,0,1,1,110
2024-03-25 14:20:00,66,32,21,6,0,0,2,0,127
2024-03-25 14:30:00,63,39,19,7,0,0,6,1,135
2024-03-25 14:40:00,62,46,20,5,0,1,4,0,138
2024-03-25 14:50:00,65,27,17,11,0,0,2,3,125
2024-03-25 15:00:00,65,34,12,4,0,0,7,0,122
2024-03-25 15:10:00,67,35,18,0,0,0,2,0,122
2024-03-25 15:20:00,61,46,18,0,0,0,3,0,128
2024-03-25 15:30:00,72,53,35,0,0,0,7,0,167
2024-03-25 15:40:00,73,37,19,84,0,0,7,0,220
2024-03-25 15:50:00,60,28,23,17,0,0,2,1,131
2024-03-25 16:00:00,63,42,20,38,0,0,4,1,168
2024-03-25 16:10:00,71,53,20,35,0,0,0,0,179
2024-03-25 16:20:00,71,51,20,3,0,0,4,0,149
2024-03-25 16:30:00,61,46,28,6,0,0,4,1,146
2024-03-25 16:40:00,76,52,17,14,0,0,6,0,165
2024-03-25 16:50:00,87,33,29,53,0,0,3,0,205
2024-03-25 17:00:00,82,53,25,29,0,0,0,1,190
2024-03-25 17:10:00,78,59,30,6,0,0,5,1,179
2024-03-25 17:20:00,62,47,19,2,0,0,2,0,132
2024-03-25 17:30:00,85,44,19,2,0,0,6,0,156
2024-03-25 17:40:00,73,55,25,1,0,0,3,0,157
2024-03-25 17:50:00,79,50,15,3,0,0,5,0,152
2024-03-25 18:00:00,71,50,19,1,0,0,1,0,142
2024-03-25 18:10:00,67,52,14,5,0,0,6,0,144
2024-03-25 18:20:00,75,52,17,2,0,0,1,0,147
2024-03-25 18:30:00,64,51,28,3,0,0,2,0,148
2024-03-25 18:40:00,66,51,10,4,0,0,0,3,134
2024-03-25 18:50:00,63,41,15,1,0,0,3,0,123
2024-03-25 19:00:00,48,37,12,2,0,0,4,0,103
2024-03-25 19:10:00,35,28,15,2,0,0,1,0,81
2024-03-25 19:20:00,40,31,8,0,0,0,2,0,81
2024-03-25 19:30:00,44,31,6,4,0,0,2,0,87
2024-03-25 19:40:00,39,27,15,0,0,0,4,0,85
2024-03-25 19:50:00,43,39,10,1,0,0,2,0,95
2024-03-25 20:00:00,31,19,21,2,0,0,1,0,74
2024-03-25 20:10:00,41,31,10,2,0,0,1,0,85
2024-03-25 20:20:00,43,31,13,1,0,0,0,0,88
2024-03-25 20:30:00,23,19,11,1,0,0,1,0,55
2024-03-25 20:40:00,28,27,10,2,0,0,1,0,68
2024-03-25 20:50:00,24,16,16,0,0,0,0,0,56
2024-03-25 21:00:00,17,20,16,1,0,0,1,0,55
2024-03-25 21:10:00,17,17,11,2,0,0,0,0,47
2024-03-25 21:20:00,24,25,9,2,0,0,0,0,60
2024-03-25 21:30:00,27,25,11,2,0,0,0,0,65
2024-03-25 21:40:00,16,17,11,2,0,0,0,0,46
2024-03-25 21:50:00,27,23,7,5,0,0,1,0,63
2024-03-25 22:00:00,20,18,12,2,0,0,0,0,52
2024-03-25 22:10:00,28,21,13,3,0,0,0,0,65
2024-03-25 22:20:00,14,15,6,1,0,0,0,0,36
2024-03-25 22:30:00,15,16,5,0,0,0,0,0,36
2024-03-25 22:40:00,23,18,12,6,0,0,0,0,59
2024-03-25 22:50:00,19,22,8,4,0,0,0,0,53
2024-03-25 23:00:00,6,6,6,2,0,0,0,0,20
2024-03-25 23:10:00,16,16,7,1,0,0,0,0,40
2024-03-25 23:20:00,20,16,5,2,0,0,0,0,43
2024-03-25 23:30:00,11,10,3,0,0,0,0,0,24
2024-03-25 23:40:00,13,11,7,1,0,0,0,0,32
2024-03-25 23:50:00,3,3,3,0,0,0,0,0,9
2024-03-26 00:00:00,7,6,2,0,0,0,0,0,15
2024-03-26 00:10:00,2,4,6,1,0,0,1,0,14
2024-03-26 00:20:00,8,9,4,1,0,0,0,0,22
2024-03-26 00:30:00,5,7,5,0,0,0,0,0,17
2024-03-26 00:40:00,4,4,3,1,0,0,0,0,12
2024-03-26 00:50:00,2,2,4,0,0,0,0,0,8
2024-03-26 01:00:00,2,2,6,0,0,0,0,0,10
2024-03-26 01:10:00,6,6,1,0,0,0,0,0,13
2024-03-26 01:20:00,3,3,4,2,0,0,0,0,12
2024-03-26 01:30:00,2,3,2,0,0,0,0,0,7
2024-03-26 01:40:00,4,4,2,1,0,0,0,0,11
2024-03-26 01:50:00,3,3,1,0,0,0,0,0,7
2024-03-26 02:00:00,0,0,2,0,0,0,0,0,2
2024-03-26 02:10:00,4,4,2,2,0,0,0,0,12
2024-03-26 02:20:00,1,1,1,0,0,0,0,0,3
2024-03-26 02:30:00,0,0,1,0,0,0,0,0,1
2024-03-26 02:40:00,0,0,0,0,0,0,0,0,0
2024-03-26 02:50:00,2,1,0,0,0,0,0,0,3
2024-03-26 03:00:00,2,3,2,0,0,0,0,0,7
2024-03-26 03:10:00,3,3,2,0,0,0,0,0,8
2024-03-26 03:20:00,2,2,1,0,0,0,0,0,5
2024-03-26 03:30:00,1,1,2,0,0,0,0,0,4
2024-03-26 03:40:00,1,2,3,0,0,0,0,0,6
2024-03-26 03:50:00,3,3,2,1,0,0,0,0,9
2024-03-26 04:00:00,1,1,3,0,0,0,0,0,5
2024-03-26 04:10:00,2,2,2,0,0,0,0,0,6
2024-03-26 04:20:00,2,1,3,0,0,0,0,0,6
2024-03-26 04:30:00,0,0,2,0,0,0,0,0,2
2024-03-26 04:40:00,0,0,2,0,0,0,0,0,2
2024-03-26 04:50:00,0,0,2,0,0,0,0,0,2
2024-03-26 05:00:00,4,4,6,2,0,0,0,0,16
2024-03-26 05:10:00,2,3,3,2,0,0,0,0,10
2024-03-26 05:20:00,2,3,4,0,0,0,0,0,9
2024-03-26 05:30:00,3,5,6,2,0,0,0,0,16
2024-03-26 05:40:00,7,6,6,0,0,0,1,0,20
2024-03-26 05:50:00,6,6,6,0,0,0,0,0,18
2024-03-26 06:00:00,8,7,7,3,0,0,0,0,25
2024-03-26 06:10:00,8,8,14,3,0,0,0,0,33
2024-03-26 06:20:00,12,12,9,6,0,0,1,0,40
2024-03-26 06:30:00,8,7,5,2,0,0,0,0,22
2024-03-26 06:40:00,22,20,13,4,0,0,1,0,60
2024-03-26 06:50:00,10,9,16,6,0,0,1,0,42
2024-03-26 07:00:00,15,9,13,2,0,0,2,0,41
2024-03-26 07:10:00,24,21,17,6,0,0,2,0,70
2024-03-26 07:20:00,26,19,13,0,0,0,2,0,60
2024-03-26 07:30:00,15,10,16,1,0,0,8,0,50
2024-03-26 07:40:00,25,17,13,4,0,0,4,0,63
2024-03-26 07:50:00,34,26,22,1,0,0,4,0,87
2024-03-26 08:00:00,21,17,18,3,0,0,3,0,62
2024-03-26 08:10:00,34,23,26,1,0,0,2,0,86
2024-03-26 08:20:00,46,20,19,2,0,0,2,1,90
2024-03-26 08:30:00,36,20,20,3,0,0,3,2,84
2024-03-26 08:40:00,41,24,18,3,0,0,7,1,94
2024-03-26 08:50:00,46,27,19,2,0,0,0,0,94
2024-03-26 09:00:00,40,31,22,6,0,0,0,0,99
2024-03-26 09:10:00,43,22,22,2,0,0,2,0,91
2024-03-26 09:20:00,41,33,17,3,0,0,5,0,99
2024-03-26 09:30:00,34,26,19,6,0,0,2,1,88
2024-03-26 09:40:00,42,32,16,2,0,0,3,0,95
2024-03-26 09:50:00,43,36,19,3,0,0,3,0,104
2024-03-26 10:00:00,40,33,25,1,0,0,2,1,102
2024-03-26 10:10:00,49,42,17,4,0,0,2,0,114
2024-03-26 10:20:00,53,38,17,1,0,0,7,0,116
2024-03-26 10:30:00,47,40,17,3,0,0,3,1,111
2024-03-26 10:40:00,62,32,16,6,0,0,1,0,117
2024-03-26 10:50:00,40,28,24,4,0,0,2,1,99
2024-03-26 11:00:00,48,40,24,4,0,0,2,0,118
2024-03-26 11:10:00,49,41,20,4,0,0,3,0,117
2024-03-26 11:20:00,59,40,18,0,0,0,0,0,117
2024-03-26 11:30:00,51,43,17,0,0,0,1,0,112
2024-03-26 11:40:00,61,42,11,5,0,0,2,1,122
2024-03-26 11:50:00,55,41,6,2,0,0,1,0,105
2024-03-26 12:00:00,50,42,17,1,0,0,3,0,113
2024-03-26 12:10:00,66,42,21,0,0,0,2,0,131
2024-03-26 12:20:00,42,30,24,3,0,0,5,1,105
2024-03-26 12:30:00,50,41,18,0,0,0,2,0,111
2024-03-26 12:40:00,66,55,16,1,0,0,2,0,140
2024-03-26 12:50:00,75,39,15,2,0,0,2,1,134
2024-03-26 13:00:00,60,40,18,0,0,0,2,0,120
2024-03-26 13:10:00,79,51,18,4,0,0,1,0,153
2024-03-26 13:20:00,125,31,17,2,0,0,5,1,181
2024-03-26 13:30:00,110,35,19,2,0,0,3,0,169
2024-03-26 13:40:00,189,33,15,1,0,0,6,0,244
2024-03-26 13:50:00,64,40,18,2,0,0,2,0,126
2024-03-26 14:00:00,58,38,25,6,0,0,3,0,130
2024-03-26 14:10:00,65,48,11,4,0,0,1,0,129
2024-03-26 14:20:00,60,28,18,1,0,0,4,2,113
2024-03-26 14:30:00,59,25,12,2,0,0,2,0,100
2024-03-26 14:40:00,77,31,12,0,0,0,8,1,129
2024-03-26 14:50:00,89,44,19,3,0,0,3,0,158
2024-03-26 15:00:00,52,35,21,2,0,0,1,0,111
2024-03-26 15:10:00,81,48,19,4,0,0,2,1,155
2024-03-26 15:20:00,56,46,25,0,0,0,15,0,142
2024-03-26 15:30:00,66,51,24,3,0,0,9,0,153
2024-03-26 15:40:00,91,44,27,0,0,0,1,1,164
2024-03-26 15:50:00,92,54,18,2,0,0,3,0,169
2024-03-26 16:00:00,64,45,18,0,0,0,4,0,131
2024-03-26 16:10:00,144,48,15,2,0,0,1,0,210
2024-03-26 16:20:00,60,39,28,3,0,0,5,0,135
2024-03-26 16:30:00,71,52,26,1,0,0,3,1,154
2024-03-26 16:40:00,77,54,17,2,0,0,0,0,150
2024-03-26 16:50:00,65,44,20,3,0,0,0,1,133
2024-03-26 17:00:00,65,48,11,1,0,0,3,0,128
2024-03-26 17:10:00,87,46,55,0,1,0,5,0,194
2024-03-26 17:20:00,70,49,22,2,0,0,5,0,148
2024-03-26 17:30:00,78,41,17,2,0,0,4,1,143
2024-03-26 17:40:00,72,51,21,4,0,0,7,0,155
2024-03-26 17:50:00,57,44,14,0,0,0,2,0,117
2024-03-26 18:00:00,66,41,27,2,0,0,1,0,137
2024-03-26 18:10:00,72,56,15,0,0,0,8,0,151
2024-03-26 18:20:00,65,50,15,2,0,0,4,0,136
2024-03-26 18:30:00,63,47,25,0,0,0,2,0,137
2024-03-26 18:40:00,67,54,10,2,0,0,3,0,136
2024-03-26 18:50:00,62,40,12,1,0,0,1,0,116
2024-03-26 19:00:00,56,34,26,29,0,0,4,1,150
2024-03-26 19:10:00,46,36,15,2,0,0,1,0,100
2024-03-26 19:20:00,56,39,12,0,0,0,2,0,109
2024-03-26 19:30:00,47,28,8,3,0,0,2,0,88
2024-03-26 19:40:00,27,18,12,1,0,0,0,0,58
2024-03-26 19:50:00,35,32,10,5,0,0,5,0,87
2024-03-26 20:00:00,36,28,14,1,0,0,1,0,80
2024-03-26 20:10:00,33,25,11,0,0,0,0,0,69
2024-03-26 20:20:00,38,31,15,3,0,0,2,0,89
2024-03-26 20:30:00,33,28,13,0,0,0,1,0,75
2024-03-26 20:40:00,35,29,5,0,0,0,1,0,70
2024-03-26 20:50:00,29,27,12,2,0,0,1,0,71
2024-03-26 21:00:00,27,24,10,1,0,0,0,0,62
2024-03-26 21:10:00,25,21,9,1,0,0,1,0,57
2024-03-26 21:20:00,36,25,10,1,0,0,2,0,74
2024-03-26 21:30:00,30,27,7,0,0,0,1,0,65
2024-03-26 21:40:00,20,17,11,1,0,0,0,0,49
2024-03-26 21:50:00,34,30,5,1,0,0,0,0,70
2024-03-26 22:00:00,26,22,6,0,0,0,0,0,54
2024-03-26 22:10:00,21,20,8,2,0,0,1,0,52
2024-03-26 22:20:00,24,25,5,1,0,0,2,0,57
2024-03-26 22:30:00,9,10,4,2,0,0,0,0,25
2024-03-26 22:40:00,27,21,13,3,0,0,0,0,64
2024-03-26 22:50:00,14,16,8,2,0,0,0,0,40
2024-03-26 23:00:00,20,17,7,2,0,0,0,0,46
2024-03-26 23:10:00,19,19,1,0,0,0,0,0,39
2024-03-26 23:20:00,8,9,4,0,0,0,0,0,21
2024-03-26 23:30:00,14,15,1,0,0,0,0,0,30
2024-03-26 23:40:00,6,5,3,1,0,0,0,0,15
2024-03-26 23:50:00,16,13,5,1,0,0,0,0,35
2024-03-27 00:00:00,5,5,5,3,0,0,0,0,18
2024-03-27 00:10:00,10,9,4,1,0,0,0,0,24
2024-03-27 00:20:00,10,10,7,2,0,0,0,0,29
2024-03-27 00:30:00,6,8,8,2,0,0,0,0,24
2024-03-27 00:40:00,7,6,2,1,0,0,2,0,18
2024-03-27 00:50:00,3,3,4,2,0,0,0,0,12
2024-03-27 01:00:00,1,1,1,1,0,0,0,0,4
2024-03-27 01:10:00,1,1,3,0,0,0,0,0,5
2024-03-27 01:20:00,3,4,1,1,0,0,0,0,9
2024-03-27 01:30:00,3,4,3,0,0,0,0,0,10
2024-03-27 01:40:00,4,4,3,1,0,0,0,0,12
2024-03-27 01:50:00,2,3,1,0,0,0,0,0,6
2024-03-27 02:00:00,2,2,1,1,0,0,0,0,6
2024-03-27 02:10:00,3,3,3,1,0,0,0,0,10
2024-03-27 02:20:00,0,0,1,0,0,0,0,0,1
2024-03-27 02:30:00,3,3,0,0,0,0,0,0,6
2024-03-27 02:40:00,1,1,1,0,0,0,0,0,3
2024-03-27 02:50:00,1,1,2,0,0,0,0,0,4
2024-03-27 03:00:00,3,4,2,2,0,0,1,0,12
2024-03-27 03:10:00,3,3,1,0,0,0,0,0,7
2024-03-27 03:20:00,3,3,4,0,0,0,0,0,10
2024-03-27 03:30:00,2,2,1,0,0,0,0,0,5
2024-03-27 03:40:00,0,0,0,0,0,0,0,0,0
2024-03-27 03:50:00,4,5,3,1,0,0,1,0,14
2024-03-27 04:00:00,0,0,1,0,0,0,0,0,1
2024-03-27 04:10:00,0,0,1,0,0,0,0,0,1
2024-03-27 04:20:00,1,1,1,0,0,0,0,0,3
2024-03-27 04:30:00,2,2,3,1,0,0,0,0,8
2024-03-27 04:40:00,0,0,0,0,0,0,0,0,0
2024-03-27 04:50:00,2,2,2,1,0,0,0,0,7
2024-03-27 05:00:00,8,8,4,0,0,0,0,0,20
2024-03-27 05:10:00,2,3,8,0,0,0,1,0,14
2024-03-27 05:20:00,0,0,3,0,0,0,1,0,4
2024-03-27 05:30:00,3,3,2,0,0,0,0,0,8
2024-03-27 05:40:00,6,7,4,1,0,0,1,0,19
2024-03-27 05:50:00,3,3,7,3,0,0,0,0,16
2024-03-27 06:00:00,6,6,7,2,0,0,0,0,21
2024-03-27 06:10:00,12,11,11,8,0,0,0,0,42
2024-03-27 06:20:00,18,16,11,4,0,0,0,0,49
2024-03-27 06:30:00,7,7,8,3,0,0,0,0,25
2024-03-27 06:40:00,17,13,7,5,0,0,3,0,45
2024-03-27 06:50:00,13,9,14,9,0,0,0,0,45
2024-03-27 07:00:00,20,16,20,3,0,0,0,0,59
2024-03-27 07:10:00,23,17,21,5,0,0,4,0,70
2024-03-27 07:20:00,19,24,17,4,0,0,1,0,65
2024-03-27 07:30:00,28,21,19,1,0,0,2,0,71
2024-03-27 07:40:00,23,18,15,3,0,0,1,0,60
2024-03-27 07:50:00,38,20,20,6,0,0,0,0,84
2024-03-27 08:00:00,23,13,20,4,0,0,3,0,63
2024-03-27 08:10:00,39,21,24,3,0,0,7,0,94
2024-03-27 08:20:00,41,19,18,2,0,0,1,0,81
2024-03-27 08:30:00,45,26,21,4,0,1,4,0,101
2024-03-27 08:40:00,45,28,14,4,0,0,5,0,96
2024-03-27 08:50:00,44,28,15,3,0,0,2,1,93
2024-03-27 09:00:00,55,25,11,4,0,0,1,0,96
2024-03-27 09:10:00,33,23,13,3,0,0,3,1,76
2024-03-27 09:20:00,50,34,20,1,0,0,2,1,108
2024-03-27 09:30:00,36,25,15,0,0,0,6,0,82
2024-03-27 09:40:00,51,39,12,1,0,0,4,0,107
2024-03-27 09:50:00,62,51,15,3,0,0,2,0,133
2024-03-27 10:00:00,44,38,16,2,0,0,2,0,102
2024-03-27 10:10:00,42,38,14,3,0,0,2,0,99
2024-03-27 10:20:00,49,39,14,4,0,0,1,0,107
2024-03-27 10:30:00,38,30,25,1,0,0,1,2,97
2024-03-27 10:40:00,50,36,16,1,0,0,4,1,108
2024-03-27 10:50:00,52,41,8,2,0,0,6,2,111
2024-03-27 11:00:00,54,40,26,2,0,0,2,0,124
2024-03-27 11:10:00,55,46,16,1,0,0,2,0,120
2024-03-27 11:20:00,67,44,9,1,0,0,2,0,123
2024-03-27 11:30:00,47,33,17,2,0,0,2,2,103
2024-03-27 11:40:00,61,46,24,0,1,0,1,0,133
2024-03-27 11:50:00,51,45,14,2,0,0,2,0,114
2024-03-27 12:00:00,60,34,17,2,0,0,2,0,115
2024-03-27 12:10:00,54,39,23,2,0,0,3,0,121
2024-03-27 12:20:00,82,34,16,2,0,0,1,0,135
2024-03-27 12:30:00,51,42,16,3,0,0,9,0,121
2024-03-27 12:40:00,108,42,26,6,0,0,4,0,186
2024-03-27 12:50:00,64,34,21,6,0,0,4,0,129
2024-03-27 13:00:00,54,38,13,2,0,0,1,0,108
2024-03-27 13:10:00,70,46,11,1,0,0,7,2,137
2024-03-27 13:20:00,69,51,22,3,0,0,2,0,147
2024-03-27 13:30:00,55,40,14,2,0,0,6,0,117
2024-03-27 13:40:00,64,50,18,1,0,0,2,0,135
2024-03-27 13:50:00,55,35,13,5,0,0,4,0,112
2024-03-27 14:00:00,56,34,11,4,0,0,0,0,105
2024-03-27 14:10:00,54,37,28,0,0,0,5,0,124
2024-03-27 14:20:00,69,44,25,1,0,0,3,0,142
2024-03-27 14:30:00,55,28,17,5,0,0,3,1,109
2024-03-27 14:40:00,95,44,13,1,0,0,4,0,157
2024-03-27 14:50:00,90,49,18,2,0,0,9,0,168
2024-03-27 15:00:00,53,43,15,3,0,0,1,0,115
2024-03-27 15:10:00,78,59,17,1,0,0,5,0,160
2024-03-27 15:20:00,62,43,22,1,0,0,0,0,128
2024-03-27 15:30:00,67,48,18,0,0,0,2,0,135
2024-03-27 15:40:00,61,42,24,1,0,0,5,0,133
2024-03-27 15:50:00,75,50,19,5,0,0,1,1,151
2024-03-27 16:00:00,54,44,19,2,0,0,2,0,121
2024-03-27 16:10:00,66,44,23,4,0,0,3,0,140
2024-03-27 16:20:00,67,51,21,0,0,0,0,0,139
2024-03-27 16:30:00,91,69,29,1,0,0,3,2,195
2024-03-27 16:40:00,67,51,13,0,0,0,5,0,136
2024-03-27 16:50:00,86,60,22,1,0,0,1,0,170
2024-03-27 17:00:00,54,42,18,0,0,0,1,0,115
2024-03-27 17:10:00,83,42,24,2,0,0,2,0,153
2024-03-27 17:20:00,68,36,30,0,0,0,3,0,137
2024-03-27 17:30:00,81,51,34,2,0,0,4,0,172
2024-03-27 17:40:00,63,30,27,1,0,0,0,0,121
2024-03-27 17:50:00,64,28,32,2,0,0,2,0,128
2024-03-27 18:00:00,78,38,19,2,0,0,0,0,137
2024-03-27 18:10:00,73,35,23,0,0,0,1,0,132
2024-03-27 18:20:00,70,38,21,7,0,0,3,0,139
2024-03-27 18:30:00,66,37,21,30,0,0,0,0,154
2024-03-27 18:40:00,62,33,20,37,0,0,0,0,152
2024-03-27 18:50:00,57,25,13,33,0,0,0,0,128
2024-03-27 19:00:00,55,26,18,33,0,0,0,0,132
2024-03-27 19:10:00,64,33,17,40,0,0,1,0,155
2024-03-27 19:20:00,53,33,14,35,0,0,3,0,138
2024-03-27 19:30:00,50,29,10,27,0,0,1,0,117
2024-03-27 19:40:00,39,21,11,20,0,0,1,0,92
2024-03-27 19:50:00,46,30,17,25,0,0,4,0,122
2024-03-27 20:00:00,37,25,16,20,0,0,0,0,98
2024-03-27 20:10:00,39,19,16,21,0,0,1,0,96
2024-03-27 20:20:00,31,22,8,21,0,0,1,0,83
2024-03-27 20:30:00,40,24,13,26,0,0,1,0,104
2024-03-27 20:40:00,39,25,12,29,0,0,0,0,105
2024-03-27 20:50:00,32,21,13,24,0,0,0,0,90
2024-03-27 21:00:00,41,19,5,22,0,0,0,0,87
2024-03-27 21:10:00,31,20,12,21,0,0,1,0,85
2024-03-27 21:20:00,28,22,14,16,0,0,1,0,81
2024-03-27 21:30:00,33,19,31,22,0,0,1,0,106
2024-03-27 21:40:00,24,19,10,18,0,0,0,0,71
2024-03-27 21:50:00,36,23,15,24,0,0,3,0,101
2024-03-27 22:00:00,35,25,13,22,0,0,0,0,95
2024-03-27 22:10:00,18,15,6,12,0,0,0,0,51
2024-03-27 22:20:00,24,17,14,15,0,0,0,1,71
2024-03-27 22:30:00,16,14,5,9,0,0,0,0,44
2024-03-27 22:40:00,26,23,7,15,0,0,0,0,71
2024-03-27 22:50:00,20,22,9,16,0,0,0,0,67
2024-03-27 23:00:00,23,21,8,17,0,0,3,0,72
2024-03-27 23:10:00,16,16,4,6,0,0,1,0,43
2024-03-27 23:20:00,9,9,3,7,0,0,0,0,28
2024-03-27 23:30:00,15,13,3,8,0,0,0,0,39
2024-03-27 23:40:00,12,13,7,12,0,0,0,0,44
2024-03-27 23:50:00,5,6,2,2,0,0,0,0,15
2024-03-28 00:00:00,9,10,7,5,0,0,0,0,31
2024-03-28 00:10:00,6,6,8,4,0,0,0,0,24
2024-03-28 00:20:00,9,9,3,3,0,0,0,0,24
2024-03-28 00:30:00,2,2,5,2,0,0,0,0,11
2024-03-28 00:40:00,6,5,2,4,0,0,0,0,17
2024-03-28 00:50:00,4,4,3,3,0,0,0,0,14
2024-03-28 01:00:00,5,7,2,3,0,0,0,0,17
2024-03-28 01:10:00,3,4,3,0,0,0,0,0,10
2024-03-28 01:20:00,1,1,1,0,0,0,0,0,3
2024-03-28 01:30:00,6,6,2,2,0,0,0,0,16
2024-03-28 01:40:00,5,5,2,3,0,0,0,0,15
2024-03-28 01:50:00,1,1,0,1,0,0,1,0,4
2024-03-28 02:00:00,2,2,1,0,0,0,0,0,5
2024-03-28 02:10:00,2,2,5,1,0,0,0,0,10
2024-03-28 02:20:00,2,2,2,1,0,0,0,0,7
2024-03-28 02:30:00,1,1,1,0,0,0,0,0,3
2024-03-28 02:40:00,1,1,2,0,0,0,0,0,4
2024-03-28 02:50:00,1,1,1,2,0,0,0,0,5
2024-03-28 03:00:00,1,2,2,0,0,0,0,0,5
2024-03-28 03:10:00,3,2,0,0,0,0,0,0,5
2024-03-28 03:20:00,2,3,2,0,0,0,0,0,7
2024-03-28 03:30:00,2,2,1,1,0,0,0,0,6
2024-03-28 03:40:00,0,0,2,0,0,0,0,0,2
2024-03-28 03:50:00,1,1,1,1,0,0,1,0,5
2024-03-28 04:00:00,2,2,3,0,0,0,0,0,7
2024-03-28 04:10:00,0,0,1,0,0,0,0,0,1
2024-03-28 04:20:00,0,0,0,0,0,0,0,0,0
2024-03-28 04:30:00,1,1,3,2,0,0,0,0,7
2024-03-28 04:40:00,1,1,0,0,0,0,0,0,2
2024-03-28 04:50:00,1,1,1,0,0,0,0,0,3
2024-03-28 05:00:00,5,6,5,1,0,0,0,0,17
2024-03-28 05:10:00,4,5,4,1,0,0,0,0,14
2024-03-28 05:20:00,1,2,6,2,0,0,0,0,11
2024-03-28 05:30:00,1,1,2,0,0,0,1,0,5
2024-03-28 05:40:00,6,5,10,0,0,0,0,0,21
2024-03-28 05:50:00,7,7,7,3,0,0,0,0,24
2024-03-28 06:00:00,7,7,6,2,0,0,0,0,22
2024-03-28 06:10:00,8,8,10,4,0,0,0,0,30
2024-03-28 06:20:00,8,8,12,5,0,0,0,0,33
2024-03-28 06:30:00,12,12,10,6,0,0,0,0,40
2024-03-28 06:40:00,18,12,8,3,0,0,1,0,42
2024-03-28 06:50:00,11,10,16,7,0,0,0,0,44
2024-03-28 07:00:00,16,12,11,9,0,0,1,1,50
2024-03-28 07:10:00,15,13,10,4,0,0,2,0,44
2024-03-28 07:20:00,21,18,18,4,0,0,1,0,62
2024-03-28 07:30:00,35,21,18,3,0,0,1,0,78
2024-03-28 07:40:00,32,23,10,2,0,0,2,0,69
2024-03-28 07:50:00,34,30,13,5,0,0,1,0,83
2024-03-28 08:00:00,24,17,20,1,0,0,2,0,64
2024-03-28 08:10:00,40,23,22,5,0,0,1,0,91
2024-03-28 08:20:00,42,28,25,3,0,0,0,0,98
2024-03-28 08:30:00,35,24,27,2,0,0,2,1,91
2024-03-28 08:40:00,43,24,31,3,0,0,2,0,103
2024-03-28 08:50:00,57,31,24,1,0,0,2,0,115
2024-03-28 09:00:00,44,24,16,1,0,0,2,1,88
2024-03-28 09:10:00,50,22,30,3,0,0,1,0,106
2024-03-28 09:20:00,46,26,26,3,0,0,3,0,104
2024-03-28 09:30:00,46,35,26,2,0,0,1,0,110
2024-03-28 09:40:00,51,40,29,3,0,0,3,0,126
2024-03-28 09:50:00,56,39,24,3,0,0,2,0,124
2024-03-28 10:00:00,48,42,26,2,0,0,0,0,118
2024-03-28 10:10:00,52,36,21,2,0,0,1,0,112
2024-03-28 10:20:00,47,34,30,2,0,0,3,0,116
2024-03-28 10:30:00,47,37,22,3,0,0,6,1,116
2024-03-28 10:40:00,67,32,11,3,0,0,1,0,114
2024-03-28 10:50:00,65,36,17,7,0,0,3,0,128
2024-03-28 11:00:00,51,29,20,5,0,0,2,1,108
2024-03-28 11:10:00,67,37,18,2,0,0,2,0,126
2024-03-28 11:20:00,75,49,14,4,0,0,0,0,142
2024-03-28 11:30:00,58,47,18,1,0,0,2,0,126
2024-03-28 11:40:00,72,42,25,1,0,0,0,0,140
2024-03-28 11:50:00,74,39,21,0,0,0,3,0,137
2024-03-28 12:00:00,61,49,23,1,0,0,2,0,136
2024-03-28 12:10:00,61,39,24,1,0,0,3,0,128
2024-03-28 12:20:00,72,46,14,5,0,0,6,0,143
2024-03-28 12:30:00,53,29,18,2,0,0,2,1,105
2024-03-28 12:40:00,63,36,12,0,0,0,0,0,111
2024-03-28 12:50:00,67,39,12,3,0,0,10,0,131
2024-03-28 13:00:00,56,40,22,5,0,0,7,0,130
2024-03-28 13:10:00,74,28,19,0,0,0,0,0,121
2024-03-28 13:20:00,59,42,19,0,0,0,2,0,122
2024-03-28 13:30:00,61,32,17,2,0,0,1,0,113
2024-03-28 13:40:00,48,33,15,2,0,0,4,0,102
2024-03-28 13:50:00,63,25,21,1,0,0,1,1,112
2024-03-28 14:00:00,54,32,17,2,0,0,2,2,109
2024-03-28 14:10:00,63,16,19,1,0,0,3,3,105
2024-03-28 14:20:00,86,15,14,5,0,0,4,1,125
2024-03-28 14:30:00,62,31,9,0,0,0,5,0,107
2024-03-28 14:40:00,76,36,7,2,0,0,6,0,127
2024-03-28 14:50:00,59,44,20,2,0,0,2,0,127
2024-03-28 15:00:00,77,52,25,0,0,0,1,0,155
2024-03-28 15:10:00,77,43,14,2,0,0,3,0,139
2024-03-28 15:20:00,74,28,30,6,0,0,4,0,142
2024-03-28 15:30:00,65,33,24,0,0,0,14,0,136
2024-03-28 15:40:00,71,41,18,0,0,0,6,1,137
2024-03-28 15:50:00,79,57,14,3,0,0,3,0,156
2024-03-28 16:00:00,65,51,15,6,0,0,4,0,141
2024-03-28 16:10:00,85,43,23,0,0,0,7,0,158
2024-03-28 16:20:00,69,52,21,0,0,0,2,0,144
2024-03-28 16:30:00,74,47,20,0,0,0,5,0,146
2024-03-28 16:40:00,69,44,22,1,0,0,2,0,138
2024-03-28 16:50:00,86,68,21,1,0,0,3,0,179
2024-03-28 17:00:00,121,52,22,2,0,0,4,0,201
2024-03-28 17:10:00,79,60,24,12,0,0,5,1,181
2024-03-28 17:20:00,80,55,26,0,0,0,4,0,165
2024-03-28 17:30:00,85,61,21,1,0,0,2,0,170
2024-03-28 17:40:00,84,52,12,3,0,0,6,2,159
2024-03-28 17:50:00,75,53,23,1,0,0,4,0,156
2024-03-28 18:00:00,79,53,20,0,0,0,3,0,155
2024-03-28 18:10:00,80,46,26,1,0,0,3,0,156
2024-03-28 18:20:00,59,45,21,1,0,0,3,0,129
2024-03-28 18:30:00,69,51,18,1,0,0,2,0,141
2024-03-28 18:40:00,55,37,19,4,0,0,1,0,116
2024-03-28 18:50:00,84,55,9,2,0,0,4,0,154
2024-03-28 19:00:00,49,35,14,12,0,0,2,0,112
2024-03-28 19:10:00,66,37,14,2,0,0,0,0,119
2024-03-28 19:20:00,55,38,11,0,0,0,8,0,112
2024-03-28 19:30:00,57,41,14,0,0,0,4,0,116
2024-03-28 19:40:00,59,42,15,1,0,0,2,0,119
2024-03-28 19:50:00,60,42,14,6,0,0,1,0,123
2024-03-28 20:00:00,43,34,16,2,0,0,1,0,96
2024-03-28 20:10:00,55,30,15,1,0,0,2,0,103
2024-03-28 20:20:00,53,26,11,1,0,0,1,0,92
2024-03-28 20:30:00,37,29,13,1,0,0,0,0,80
2024-03-28 20:40:00,34,29,9,0,0,0,0,0,72
2024-03-28 20:50:00,41,37,15,1,0,0,1,0,95
2024-03-28 21:00:00,27,18,6,0,0,0,1,0,52
2024-03-28 21:10:00,32,23,8,1,0,0,0,0,64
2024-03-28 21:20:00,35,23,17,2,0,0,1,0,78
2024-03-28 21:30:00,25,22,7,1,0,0,0,0,55
2024-03-28 21:40:00,28,22,14,3,0,0,2,0,69
2024-03-28 21:50:00,34,28,12,1,0,0,1,0,76
2024-03-28 22:00:00,26,29,10,3,0,0,1,0,69
2024-03-28 22:10:00,36,24,5,1,0,0,0,0,66
2024-03-28 22:20:00,35,27,5,2,0,0,3,0,72
2024-03-28 22:30:00,23,21,10,0,0,0,0,0,54
2024-03-28 22:40:00,23,18,7,3,0,0,0,0,51
2024-03-28 22:50:00,15,14,9,2,0,0,0,0,40
2024-03-28 23:00:00,22,14,9,1,0,0,1,0,47
2024-03-28 23:10:00,24,19,10,3,0,0,0,0,56
2024-03-28 23:20:00,26,23,9,3,0,0,1,0,62
2024-03-28 23:30:00,10,6,11,3,0,0,0,0,30
2024-03-28 23:40:00,15,16,8,2,0,0,0,0,41
2024-03-28 23:50:00,13,11,6,2,0,0,0,0,32
2024-03-29 00:00:00,16,17,7,3,0,0,0,0,43
2024-03-29 00:10:00,9,9,4,0,0,0,0,0,22
2024-03-29 00:20:00,17,15,5,6,0,0,0,0,43
2024-03-29 00:30:00,10,9,2,2,0,0,0,0,23
2024-03-29 00:40:00,8,8,3,2,0,0,0,0,21
2024-03-29 00:50:00,12,12,6,4,0,0,0,0,34
2024-03-29 01:00:00,10,7,1,1,0,0,0,0,19
2024-03-29 01:10:00,6,6,3,4,0,0,0,0,19
2024-03-29 01:20:00,2,2,2,0,0,0,0,0,6
2024-03-29 01:30:00,6,7,0,0,0,0,1,0,14
2024-03-29 01:40:00,5,5,4,3,0,0,0,0,17
2024-03-29 01:50:00,0,0,5,1,0,0,0,0,6
2024-03-29 02:00:00,3,2,3,0,0,0,0,0,8
2024-03-29 02:10:00,5,4,4,1,0,0,0,0,14
2024-03-29 02:20:00,4,3,2,0,0,0,0,0,9
2024-03-29 02:30:00,4,3,3,3,0,0,0,0,13
2024-03-29 02:40:00,5,6,5,1,0,0,0,0,17
2024-03-29 02:50:00,5,5,3,1,0,0,0,0,14
2024-03-29 03:00:00,5,5,3,2,0,0,0,0,15
2024-03-29 03:10:00,4,5,3,0,0,0,0,0,12
2024-03-29 03:20:00,3,2,2,0,0,0,0,0,7
2024-03-29 03:30:00,6,7,4,4,0,0,0,0,21
2024-03-29 03:40:00,4,4,3,1,0,0,0,0,12
2024-03-29 03:50:00,1,1,1,1,0,0,0,0,4
2024-03-29 04:00:00,4,6,1,1,0,0,0,0,12
2024-03-29 04:10:00,1,1,1,1,0,0,0,0,4
2024-03-29 04:20:00,2,2,2,1,0,0,0,0,7
2024-03-29 04:30:00,1,1,4,1,0,0,0,0,7
2024-03-29 04:40:00,2,2,1,1,0,0,0,0,6
2024-03-29 04:50:00,0,0,1,0,0,0,0,0,1
2024-03-29 05:00:00,4,4,1,4,0,0,0,0,13
2024-03-29 05:10:00,2,2,8,2,0,0,0,0,14
2024-03-29 05:20:00,4,4,2,4,0,0,0,0,14
2024-03-29 05:30:00,3,3,5,1,0,0,0,0,12
2024-03-29 05:40:00,2,2,5,2,0,0,0,0,11
2024-03-29 05:50:00,2,2,3,2,0,0,0,0,9
2024-03-29 06:00:00,2,2,2,2,0,0,0,0,8
2024-03-29 06:10:00,3,3,4,3,0,0,0,0,13
2024-03-29 06:20:00,1,1,0,0,0,0,0,0,2
2024-03-29 06:30:00,2,2,0,1,0,0,0,0,5
2024-03-29 06:40:00,0,0,4,0,0,0,0,0,4
2024-03-29 06:50:00,2,2,5,1,0,0,0,0,10
2024-03-29 07:00:00,3,3,2,1,0,0,0,0,9
2024-03-29 07:10:00,6,6,1,1,0,0,0,0,14
2024-03-29 07:20:00,5,5,5,0,0,0,2,0,17
2024-03-29 07:30:00,1,1,3,0,0,0,0,0,5
2024-03-29 07:40:00,6,5,4,0,0,0,0,0,15
2024-03-29 07:50:00,5,4,3,0,0,0,0,0,12
2024-03-29 08:00:00,4,4,2,0,0,0,1,0,11
2024-03-29 08:10:00,5,5,1,0,0,0,0,0,11
2024-03-29 08:20:00,5,5,6,0,0,0,1,0,17
2024-03-29 08:30:00,6,6,4,0,0,0,0,0,16
2024-03-29 08:40:00,10,10,12,0,0,0,0,0,32
2024-03-29 08:50:00,12,11,7,0,0,0,0,0,30
2024-03-29 09:00:00,8,8,6,0,0,0,0,0,22
2024-03-29 09:10:00,16,16,5,0,0,0,0,0,37
2024-03-29 09:20:00,16,15,10,0,0,0,0,0,41
2024-03-29 09:30:00,10,10,5,0,0,0,1,0,26
2024-03-29 09:40:00,21,19,8,1,0,0,0,0,49
2024-03-29 09:50:00,17,14,10,0,0,0,0,0,41
2024-03-29 10:00:00,11,10,9,1,0,0,1,0,32
2024-03-29 10:10:00,16,13,18,0,0,0,0,0,47
2024-03-29 10:20:00,18,17,14,1,0,0,3,1,54
2024-03-29 10:30:00,16,15,10,0,0,0,1,0,42
2024-03-29 10:40:00,18,14,14,1,0,0,0,0,47
2024-03-29 10:50:00,14,11,9,0,0,0,1,0,35
2024-03-29 11:00:00,18,17,10,2,0,0,1,0,48
2024-03-29 11:10:00,13,9,11,0,0,0,0,0,33
2024-03-29 11:20:00,19,17,12,2,0,0,1,0,51
2024-03-29 11:30:00,25,19,12,0,0,0,1,0,57
2024-03-29 11:40:00,32,19,7,1,0,0,0,0,59
2024-03-29 11:50:00,35,28,12,1,0,0,0,0,76
2024-03-29 12:00:00,27,23,14,1,0,0,0,0,65
2024-03-29 12:10:00,27,20,5,0,0,0,0,0,52
2024-03-29 12:20:00,33,26,20,1,0,0,2,0,82
2024-03-29 12:30:00,37,27,10,0,0,0,0,0,74
2024-03-29 12:40:00,36,30,22,1,0,0,1,0,90
2024-03-29 12:50:00,36,30,12,1,0,0,0,0,79
2024-03-29 13:00:00,26,23,14,1,0,0,1,0,65
2024-03-29 13:10:00,32,24,15,1,0,0,0,0,72
2024-03-29 13:20:00,25,23,15,0,0,0,1,0,64
2024-03-29 13:30:00,24,20,17,0,0,0,0,0,61
2024-03-29 13:40:00,28,18,17,0,0,0,1,0,64
2024-03-29 13:50:00,33,21,16,2,0,0,1,0,73
2024-03-29 14:00:00,27,21,18,1,0,0,2,0,69
2024-03-29 14:10:00,30,25,18,0,0,0,0,0,73
2024-03-29 14:20:00,32,26,16,3,0,0,4,0,81
2024-03-29 14:30:00,35,27,14,1,0,0,1,0,78
2024-03-29 14:40:00,33,22,16,1,0,0,1,1,74
2024-03-29 14:50:00,36,29,18,1,0,0,0,0,84
2024-03-29 15:00:00,38,26,12,0,0,0,1,0,77
2024-03-29 15:10:00,36,29,19,1,0,0,0,0,85
2024-03-29 15:20:00,37,28,15,1,0,0,1,1,83
2024-03-29 15:30:00,18,16,18,1,0,0,0,0,53
2024-03-29 15:40:00,33,30,10,1,0,0,0,0,74
2024-03-29 15:50:00,37,34,24,0,0,0,0,0,95
2024-03-29 16:00:00,29,19,14,2,0,0,1,0,65
2024-03-29 16:10:00,25,23,16,1,0,0,1,0,66
2024-03-29 16:20:00,27,23,21,0,0,0,0,0,71
2024-03-29 16:30:00,34,24,13,2,0,0,1,0,74
2024-03-29 16:40:00,17,16,16,1,0,0,2,0,52
2024-03-29 16:50:00,33,27,20,0,0,0,0,0,80
2024-03-29 17:00:00,35,27,16,0,0,0,1,0,79
2024-03-29 17:10:00,22,11,15,0,0,0,3,0,51
2024-03-29 17:20:00,42,32,22,2,0,0,0,0,98
2024-03-29 17:30:00,36,24,12,0,0,0,3,1,76
2024-03-29 17:40:00,38,29,16,0,0,0,1,0,84
2024-03-29 17:50:00,40,25,16,1,0,0,1,1,84
2024-03-29 18:00:00,44,26,19,1,0,0,2,0,92
2024-03-29 18:10:00,44,29,15,2,0,0,0,0,90
2024-03-29 18:20:00,36,27,20,0,0,0,2,0,85
2024-03-29 18:30:00,28,19,16,1,0,0,0,0,64
2024-03-29 18:40:00,35,25,10,1,0,0,3,0,74
2024-03-29 18:50:00,32,26,15,2,0,0,2,0,77
2024-03-29 19:00:00,34,24,13,13,0,0,0,0,84
2024-03-29 19:10:00,45,27,10,28,0,0,5,0,115
2024-03-29 19:20:00,25,18,16,18,0,0,1,0,78
2024-03-29 19:30:00,35,24,9,22,0,0,0,0,90
2024-03-29 19:40:00,20,20,7,16,0,0,0,0,63
2024-03-29 19:50:00,23,15,14,13,0,0,3,0,68
2024-03-29 20:00:00,19,14,11,13,0,0,1,0,58
2024-03-29 20:10:00,30,21,14,17,0,0,0,0,82
2024-03-29 20:20:00,17,16,10,14,0,0,0,0,57
2024-03-29 20:30:00,24,14,9,16,0,0,2,0,65
2024-03-29 20:40:00,19,17,14,15,0,0,0,0,65
2024-03-29 20:50:00,30,20,13,22,0,0,0,0,85
2024-03-29 21:00:00,27,15,8,19,0,0,1,0,70
2024-03-29 21:10:00,21,13,13,17,0,0,2,0,66
2024-03-29 21:20:00,19,15,11,14,0,0,0,0,59
2024-03-29 21:30:00,21,16,9,16,0,0,0,0,62
2024-03-29 21:40:00,26,19,13,18,0,0,0,0,76
2024-03-29 21:50:00,29,19,12,16,0,0,0,0,76
2024-03-29 22:00:00,18,14,5,17,0,0,0,0,54
2024-03-29 22:10:00,36,23,12,23,0,0,0,0,94
2024-03-29 22:20:00,12,8,6,12,0,0,1,1,40
2024-03-29 22:30:00,19,12,6,15,0,0,0,0,52
2024-03-29 22:40:00,19,14,4,13,0,0,0,0,50
2024-03-29 22:50:00,14,12,5,14,0,0,0,0,45
2024-03-29 23:00:00,15,13,3,11,0,0,0,0,42
2024-03-29 23:10:00,16,15,8,13,0,0,0,0,52
2024-03-29 23:20:00,17,12,8,14,0,0,0,0,51
2024-03-29 23:30:00,10,7,6,6,0,0,0,0,29
2024-03-29 23:40:00,13,13,6,12,0,0,0,0,44
2024-03-29 23:50:00,11,10,10,10,0,0,0,0,41
2024-03-30 00:00:00,10,10,6,9,0,0,0,0,35
2024-03-30 00:10:00,15,11,4,10,0,0,0,0,40
2024-03-30 00:20:00,9,8,2,7,0,0,0,0,26
2024-03-30 00:30:00,6,6,3,5,0,0,0,0,20
2024-03-30 00:40:00,8,7,5,6,0,0,0,0,26
2024-03-30 00:50:00,9,10,4,9,0,0,0,0,32
2024-03-30 01:00:00,10,9,5,8,0,0,1,0,33
2024-03-30 01:10:00,9,7,7,7,0,0,0,0,30
2024-03-30 01:20:00,3,3,3,2,0,0,0,0,11
2024-03-30 01:30:00,4,4,2,2,0,0,0,0,12
2024-03-30 01:40:00,5,4,2,4,0,0,0,0,15
2024-03-30 01:50:00,7,6,3,6,0,0,0,0,22
2024-03-30 02:00:00,7,6,4,7,0,0,1,0,25
2024-03-30 02:10:00,3,3,1,2,0,0,0,0,9
2024-03-30 02:20:00,4,4,3,4,0,0,0,0,15
2024-03-30 02:30:00,8,8,3,10,0,0,0,0,29
2024-03-30 02:40:00,0,0,2,0,0,0,0,0,2
2024-03-30 02:50:00,3,3,4,2,0,0,0,0,12
2024-03-30 03:00:00,4,4,2,4,0,0,0,0,14
2024-03-30 03:10:00,2,2,2,2,0,0,0,0,8
2024-03-30 03:20:00,2,2,4,2,0,0,0,0,10
2024-03-30 03:30:00,1,1,0,1,0,0,1,0,4
2024-03-30 03:40:00,4,4,2,4,0,0,0,0,14
2024-03-30 03:50:00,4,4,0,3,0,0,1,0,12
2024-03-30 04:00:00,3,3,3,3,0,0,0,0,12
2024-03-30 04:10:00,1,1,0,1,0,0,0,0,3
2024-03-30 04:20:00,4,4,4,4,0,0,0,0,16
2024-03-30 04:30:00,3,3,3,4,0,0,0,0,13
2024-03-30 04:40:00,2,2,3,2,0,0,0,0,9
2024-03-30 04:50:00,2,2,2,2,0,0,0,0,8
2024-03-30 05:00:00,2,2,4,1,0,0,0,0,9
2024-03-30 05:10:00,2,2,4,2,0,0,0,0,10
2024-03-30 05:20:00,0,0,0,0,0,0,0,0,0
2024-03-30 05:30:00,5,5,2,4,0,0,1,0,17
2024-03-30 05:40:00,4,4,3,4,0,0,0,0,15
2024-03-30 05:50:00,2,2,2,2,0,0,0,0,8
2024-03-30 06:00:00,3,3,1,1,0,0,0,0,8
2024-03-30 06:10:00,5,4,3,1,0,0,0,0,13
2024-03-30 06:20:00,7,7,7,1,0,0,0,0,22
2024-03-30 06:30:00,2,2,6,1,0,0,0,0,11
2024-03-30 06:40:00,7,7,3,0,0,0,0,0,17
2024-03-30 06:50:00,4,4,5,0,0,0,0,0,13
2024-03-30 07:00:00,4,4,2,0,0,0,0,0,10
2024-03-30 07:10:00,6,5,6,2,0,0,0,0,19
2024-03-30 07:20:00,7,6,6,2,0,0,0,0,21
2024-03-30 07:30:00,13,13,5,0,0,0,1,0,32
2024-03-30 07:40:00,10,10,7,0,0,0,1,0,28
2024-03-30 07:50:00,11,10,11,0,0,0,0,0,32
2024-03-30 08:00:00,16,16,4,0,0,0,2,0,38
2024-03-30 08:10:00,17,16,13,0,0,0,1,0,47
2024-03-30 08:20:00,14,13,9,2,0,0,0,0,38
2024-03-30 08:30:00,23,20,10,0,0,0,0,0,53
2024-03-30 08:40:00,25,19,10,0,0,0,3,0,57
2024-03-30 08:50:00,27,22,11,0,0,0,2,0,62
2024-03-30 09:00:00,36,28,11,1,0,0,0,0,76
2024-03-30 09:10:00,32,31,11,0,0,0,2,0,76
2024-03-30 09:20:00,39,35,16,0,0,0,2,0,92
2024-03-30 09:30:00,39,33,8,1,0,0,3,0,84
2024-03-30 09:40:00,42,27,20,4,0,0,1,0,94
2024-03-30 09:50:00,44,29,19,3,1,0,9,0,105
2024-03-30 10:00:00,50,33,19,7,0,0,1,0,110
2024-03-30 10:10:00,41,32,12,0,0,0,1,0,86
2024-03-30 10:20:00,50,40,11,2,0,0,5,0,108
2024-03-30 10:30:00,47,40,24,4,0,0,4,1,120
2024-03-30 10:40:00,52,41,16,1,0,0,2,0,112
2024-03-30 10:50:00,66,48,18,1,0,0,4,0,137
2024-03-30 11:00:00,53,45,24,2,0,0,3,2,129
2024-03-30 11:10:00,47,38,18,3,0,0,7,0,113
2024-03-30 11:20:00,38,30,9,1,0,0,1,0,79
2024-03-30 11:30:00,44,31,19,2,0,0,3,0,99
2024-03-30 11:40:00,63,45,18,3,0,0,1,0,130
2024-03-30 11:50:00,61,53,19,2,0,0,4,0,139
2024-03-30 12:00:00,61,45,21,0,0,0,3,0,130
2024-03-30 12:10:00,61,46,18,1,0,0,0,0,126
2024-03-30 12:20:00,56,46,14,1,0,0,1,0,118
2024-03-30 12:30:00,90,36,20,0,0,0,5,0,151
2024-03-30 12:40:00,53,38,28,0,0,0,5,0,124
2024-03-30 12:50:00,57,36,15,0,0,0,3,0,111
2024-03-30 13:00:00,56,36,18,1,0,0,3,0,114
2024-03-30 13:10:00,54,29,16,2,0,0,4,1,106
2024-03-30 13:20:00,56,48,22,1,0,0,1,0,128
2024-03-30 13:30:00,65,46,22,1,0,0,1,0,135
2024-03-30 13:40:00,55,41,17,0,0,0,2,0,115
2024-03-30 13:50:00,41,31,22,0,0,0,2,0,96
2024-03-30 14:00:00,47,39,9,0,0,0,5,1,101
2024-03-30 14:10:00,52,46,11,3,0,0,1,1,114
2024-03-30 14:20:00,68,42,20,0,0,0,2,0,132
2024-03-30 14:30:00,66,49,16,0,0,0,10,1,142
2024-03-30 14:40:00,53,37,11,2,0,0,2,1,106
2024-03-30 14:50:00,48,36,8,1,0,0,3,0,96
2024-03-30 15:00:00,55,42,16,1,0,0,0,0,114
2024-03-30 15:10:00,63,54,14,1,0,0,2,1,135
2024-03-30 15:20:00,69,56,15,1,0,0,4,0,145
2024-03-30 15:30:00,62,45,18,1,0,0,3,0,129
2024-03-30 15:40:00,57,32,14,2,0,0,11,0,116
2024-03-30 15:50:00,42,36,12,0,0,0,4,1,95
2024-03-30 16:00:00,51,32,23,4,0,0,1,0,111
2024-03-30 16:10:00,47,34,13,2,0,0,4,0,100
2024-03-30 16:20:00,52,38,13,3,0,0,5,0,111
2024-03-30 16:30:00,48,38,12,2,0,0,8,0,108
2024-03-30 16:40:00,56,40,14,1,0,0,0,0,111
2024-03-30 16:50:00,47,27,19,3,0,0,7,0,103
2024-03-30 17:00:00,53,37,14,1,0,0,2,0,107
2024-03-30 17:10:00,42,29,22,2,1,0,5,0,101
2024-03-30 17:20:00,54,45,11,0,0,0,0,0,110
2024-03-30 17:30:00,56,43,15,1,0,0,1,0,116
2024-03-30 17:40:00,37,31,15,0,0,0,1,0,84
2024-03-30 17:50:00,49,34,14,0,0,0,3,0,100
2024-03-30 18:00:00,61,43,21,2,0,0,5,0,132
2024-03-30 18:10:00,54,39,18,2,0,0,2,0,115
2024-03-30 18:20:00,48,41,12,1,0,0,2,0,104
2024-03-30 18:30:00,39,34,10,4,0,0,0,0,87
2024-03-30 18:40:00,44,25,10,0,0,0,2,0,81
2024-03-30 18:50:00,41,35,13,1,0,0,1,0,91
2024-03-30 19:00:00,32,30,12,11,0,0,4,0,89
2024-03-30 19:10:00,31,27,9,7,0,0,2,0,76
2024-03-30 19:20:00,33,31,16,0,0,0,0,0,80
2024-03-30 19:30:00,30,27,13,1,0,0,2,0,73
2024-03-30 19:40:00,30,29,13,1,0,0,5,0,78
2024-03-30 19:50:00,44,31,9,2,0,0,1,0,87
2024-03-30 20:00:00,25,23,7,5,0,0,0,0,60
2024-03-30 20:10:00,43,32,12,0,0,0,3,0,90
2024-03-30 20:20:00,36,30,11,1,0,0,1,0,79
2024-03-30 20:30:00,35,30,10,1,0,0,2,0,78
2024-03-30 20:40:00,20,21,8,0,0,0,0,1,50
2024-03-30 20:50:00,21,20,10,1,0,0,2,0,54
2024-03-30 21:00:00,17,17,11,1,0,0,1,0,47
2024-03-30 21:10:00,24,25,8,0,0,0,1,0,58
2024-03-30 21:20:00,23,22,9,1,0,0,0,0,55
2024-03-30 21:30:00,23,20,5,1,0,0,0,0,49
2024-03-30 21:40:00,15,12,8,2,0,0,0,0,37
2024-03-30 21:50:00,23,19,12,3,0,0,0,1,58
2024-03-30 22:00:00,19,19,6,2,0,0,0,0,46
2024-03-30 22:10:00,27,20,8,0,0,0,0,0,55
2024-03-30 22:20:00,23,21,7,2,0,0,2,0,55
2024-03-30 22:30:00,14,12,5,3,0,0,1,0,35
2024-03-30 22:40:00,22,18,4,1,0,0,0,0,45
2024-03-30 22:50:00,19,16,8,5,0,0,2,0,50
2024-03-30 23:00:00,19,17,5,1,0,0,0,0,42
2024-03-30 23:10:00,22,17,9,1,0,0,0,0,49
2024-03-30 23:20:00,17,20,7,1,0,0,0,0,45
2024-03-30 23:30:00,12,15,5,0,0,0,0,0,32
2024-03-30 23:40:00,11,10,8,0,0,0,0,0,29
2024-03-30 23:50:00,11,11,6,2,0,0,1,0,31
2024-03-31 00:00:00,7,7,1,0,0,0,0,0,15
2024-03-31 00:10:00,8,7,8,2,0,0,0,0,25
2024-03-31 00:20:00,14,15,5,2,0,0,1,0,37
2024-03-31 00:30:00,10,9,6,0,0,0,0,0,25
2024-03-31 00:40:00,3,2,6,4,0,0,0,0,15
2024-03-31 00:50:00,12,9,4,0,0,0,2,0,27
2024-03-31 01:00:00,9,9,4,6,0,0,0,0,28
2024-03-31 01:10:00,9,9,5,4,0,0,0,0,27
2024-03-31 01:20:00,10,10,8,9,0,0,0,0,37
2024-03-31 01:30:00,5,5,2,5,0,0,0,0,17
2024-03-31 01:40:00,8,8,4,7,0,0,0,0,27
2024-03-31 01:50:00,5,4,6,4,0,0,0,0,19
2024-03-31 02:00:00,0,0,0,0,0,0,0,0,0
2024-03-31 02:10:00,0,0,0,0,0,0,0,0,0
2024-03-31 02:20:00,0,0,0,0,0,0,0,0,0
2024-03-31 02:30:00,0,0,0,0,0,0,0,0,0
2024-03-31 02:40:00,0,0,0,0,0,0,0,0,0
2024-03-31 02:50:00,0,0,0,0,0,0,0,0,0
2024-03-31 03:00:00,0,0,0,0,0,0,0,0,0
2024-03-31 03:10:00,0,0,0,0,0,0,0,0,0
2024-03-31 03:20:00,0,0,0,0,0,0,0,0,0
2024-03-31 03:30:00,0,0,0,0,0,0,0,0,0
2024-03-31 03:40:00,0,0,0,0,0,0,0,0,0
2024-03-31 03:50:00,0,0,0,0,0,0,0,0,0
2024-03-31 04:00:00,7,7,6,6,0,0,0,0,26
2024-03-31 04:10:00,7,7,3,9,0,0,0,0,26
2024-03-31 04:20:00,6,5,7,5,0,0,0,0,23
2024-03-31 04:30:00,4,4,4,3,0,0,0,0,15
2024-03-31 04:40:00,2,2,5,2,0,0,0,0,11
2024-03-31 04:50:00,6,5,6,6,0,0,0,0,23
2024-03-31 05:00:00,2,2,5,2,0,0,0,0,11
2024-03-31 05:10:00,5,4,3,4,0,0,0,0,16
2024-03-31 05:20:00,2,2,7,4,0,0,0,0,15
2024-03-31 05:30:00,1,1,5,1,0,0,0,0,8
2024-03-31 05:40:00,4,3,6,3,0,0,0,0,16
2024-03-31 05:50:00,0,0,2,0,0,0,0,0,2
2024-03-31 06:00:00,4,4,2,4,0,0,0,0,14
2024-03-31 06:10:00,3,2,1,2,0,0,0,0,8
2024-03-31 06:20:00,5,5,5,5,0,0,0,0,20
2024-03-31 06:30:00,4,4,4,4,0,0,0,0,16
2024-03-31 06:40:00,6,4,3,6,0,0,0,0,19
2024-03-31 06:50:00,3,3,6,3,0,0,0,0,15
2024-03-31 07:00:00,3,3,1,2,0,0,0,0,9
2024-03-31 07:10:00,3,3,3,2,0,0,0,0,11
2024-03-31 07:20:00,0,0,4,1,0,0,1,0,6
2024-03-31 07:30:00,2,2,2,0,0,0,1,0,7
2024-03-31 07:40:00,7,6,7,1,0,0,0,0,21
2024-03-31 07:50:00,6,6,6,2,0,0,1,0,21
2024-03-31 08:00:00,7,7,4,2,0,0,0,0,20
2024-03-31 08:10:00,5,5,4,0,0,0,0,0,14
2024-03-31 08:20:00,11,10,4,1,0,0,0,0,26
2024-03-31 08:30:00,10,10,2,0,0,0,0,0,22
2024-03-31 08:40:00,5,4,6,0,0,0,0,0,15
2024-03-31 08:50:00,8,8,10,2,0,0,2,0,30
2024-03-31 09:00:00,8,8,5,0,0,0,1,0,22
2024-03-31 09:10:00,15,15,6,0,0,0,0,0,36
2024-03-31 09:20:00,11,10,9,0,0,0,0,0,30
2024-03-31 09:30:00,9,9,12,0,0,0,0,0,30
2024-03-31 09:40:00,18,14,16,1,0,0,0,0,49
2024-03-31 09:50:00,23,21,9,0,0,0,1,0,54
2024-03-31 10:00:00,18,13,11,0,0,0,0,0,42
2024-03-31 10:10:00,21,18,8,0,0,0,1,1,49
2024-03-31 10:20:00,14,11,10,0,0,0,1,0,36
2024-03-31 10:30:00,32,25,11,1,0,0,3,2,74
2024-03-31 10:40:00,27,18,10,0,0,0,2,1,58
2024-03-31 10:50:00,25,17,9,0,0,0,3,0,54
2024-03-31 11:00:00,30,23,9,3,0,0,0,0,65
2024-03-31 11:10:00,25,24,12,0,0,0,2,0,63
2024-03-31 11:20:00,40,28,12,2,0,0,0,0,82
2024-03-31 11:30:00,19,16,18,2,0,0,3,0,58
2024-03-31 11:40:00,34,23,9,0,0,0,3,0,69
2024-03-31 11:50:00,37,29,9,0,0,0,1,0,76
2024-03-31 12:00:00,27,20,5,0,0,0,0,0,52
2024-03-31 12:10:00,44,27,11,1,0,0,0,0,83
2024-03-31 12:20:00,49,33,11,2,0,0,2,0,97
2024-03-31 12:30:00,31,25,15,0,0,0,0,0,71
2024-03-31 12:40:00,40,34,12,1,0,0,0,0,87
2024-03-31 12:50:00,46,33,15,3,0,0,2,0,99
2024-03-31 13:00:00,45,31,6,0,0,0,2,0,84
2024-03-31 13:10:00,30,23,15,0,0,0,3,0,71
2024-03-31 13:20:00,36,22,9,1,0,0,2,0,70
2024-03-31 13:30:00,34,30,13,1,0,0,0,0,78
2024-03-31 13:40:00,37,30,11,6,0,0,0,0,84
2024-03-31 13:50:00,36,23,6,3,0,0,1,0,69
2024-03-31 14:00:00,36,22,4,1,0,0,3,2,68
2024-03-31 14:10:00,38,20,7,0,0,0,1,0,66
2024-03-31 14:20:00,38,26,10,2,0,0,3,0,79
2024-03-31 14:30:00,33,29,13,0,0,0,1,0,76
2024-03-31 14:40:00,41,35,15,1,0,0,3,0,95
2024-03-31 14:50:00,38,23,12,2,0,0,1,1,77
2024-03-31 15:00:00,46,42,17,0,0,0,3,0,108
2024-03-31 15:10:00,26,26,8,7,0,0,2,0,69
2024-03-31 15:20:00,40,36,14,1,0,0,10,0,101
2024-03-31 15:30:00,31,28,13,1,0,0,1,0,74
2024-03-31 15:40:00,28,23,12,11,0,0,0,0,74
2024-03-31 15:50:00,44,34,5,1,0,0,2,2,88
2024-03-31 16:00:00,37,30,13,0,0,0,2,0,82
2024-03-31 16:10:00,39,23,11,1,0,0,1,1,76
2024-03-31 16:20:00,38,21,13,2,0,0,4,0,78
2024-03-31 16:30:00,37,28,10,2,0,0,1,0,78
2024-03-31 16:40:00,30,22,10,0,0,0,3,0,65
2024-03-31 16:50:00,33,30,8,1,0,0,6,0,78
2024-03-31 17:00:00,39,28,9,3,0,0,2,0,81
2024-03-31 17:10:00,26,22,13,1,0,0,2,0,64
2024-03-31 17:20:00,27,21,14,3,0,0,2,0,67
2024-03-31 17:30:00,31,21,8,0,0,0,0,0,60
2024-03-31 17:40:00,45,23,8,0,0,0,4,0,80
2024-03-31 17:50:00,46,32,15,3,0,0,0,0,96
2024-03-31 18:00:00,34,26,13,2,0,0,2,0,77
2024-03-31 18:10:00,29,26,15,1,0,0,1,0,72
2024-03-31 18:20:00,31,29,8,0,0,0,4,0,72
2024-03-31 18:30:00,38,33,11,0,0,0,2,0,84
2024-03-31 18:40:00,35,32,10,2,0,0,0,1,80
2024-03-31 18:50:00,34,25,5,1,0,0,0,0,65
2024-03-31 19:00:00,38,27,15,2,0,0,1,0,83
2024-03-31 19:10:00,39,27,7,0,0,0,3,0,76
2024-03-31 19:20:00,32,26,9,3,0,0,0,0,70
2024-03-31 19:30:00,43,25,17,2,0,0,2,1,90
2024-03-31 19:40:00,27,25,16,2,0,0,0,0,70
2024-03-31 19:50:00,35,28,11,0,0,0,0,0,74
2024-03-31 20:00:00,23,19,11,0,0,0,0,0,53
2024-03-31 20:10:00,26,27,10,1,0,0,1,0,65
2024-03-31 20:20:00,18,15,22,1,0,0,0,0,56
2024-03-31 20:30:00,25,21,5,2,0,0,0,0,53
2024-03-31 20:40:00,24,20,6,0,0,0,2,0,52
2024-03-31 20:50:00,25,18,8,1,0,0,0,0,52
2024-03-31 21:00:00,18,15,7,0,0,0,4,0,44
2024-03-31 21:10:00,17,11,8,1,0,0,2,0,39
2024-03-31 21:20:00,22,23,11,0,0,0,9,0,65
2024-03-31 21:30:00,38,26,10,1,0,0,0,0,75
2024-03-31 21:40:00,20,19,7,1,0,0,1,0,48
2024-03-31 21:50:00,30,32,11,2,0,0,0,0,75
2024-03-31 22:00:00,14,13,3,1,0,0,0,0,31
2024-03-31 22:10:00,12,12,9,1,0,0,0,0,34
2024-03-31 22:20:00,18,22,8,1,0,0,0,0,49
2024-03-31 22:30:00,17,15,6,2,0,0,1,0,41
2024-03-31 22:40:00,22,17,10,4,0,0,1,0,54
2024-03-31 22:50:00,10,8,4,5,0,0,1,0,28
2024-03-31 23:00:00,16,11,6,10,0,0,0,0,43
2024-03-31 23:10:00,18,17,10,16,0,0,0,0,61
2024-03-31 23:20:00,16,12,6,11,0,0,0,0,45
2024-03-31 23:30:00,8,8,10,10,0,0,0,0,36
2024-03-31 23:40:00,11,7,9,8,0,0,0,0,35
2024-03-31 23:50:00,7,7,8,4,0,0,0,0,26
2024-04-01 00:00:00,15,13,14,12,0,0,0,0,54
2024-04-01 00:10:00,10,9,9,9,0,0,0,0,37
2024-04-01 00:20:00,14,12,10,12,0,0,0,0,48
2024-04-01 00:30:00,8,8,6,8,0,0,0,0,30
2024-04-01 00:40:00,8,7,8,7,0,0,0,0,30
2024-04-01 00:50:00,7,7,5,6,0,0,0,0,25
2024-04-01 01:00:00,13,10,7,10,0,0,0,0,40
2024-04-01 01:10:00,8,7,9,8,0,0,0,0,32
2024-04-01 01:20:00,6,6,7,6,0,0,0,0,25
2024-04-01 01:30:00,7,7,8,7,0,0,0,0,29
2024-04-01 01:40:00,6,6,7,6,0,0,0,0,25
2024-04-01 01:50:00,8,6,4,6,0,0,0,0,24
2024-04-01 02:00:00,9,9,4,9,0,0,0,0,31
2024-04-01 02:10:00,10,10,8,10,0,0,0,0,38
2024-04-01 02:20:00,5,5,0,4,0,0,0,0,14
2024-04-01 02:30:00,5,4,2,4,0,0,0,0,15
2024-04-01 02:40:00,4,4,4,4,0,0,0,0,16
2024-04-01 02:50:00,5,5,4,5,0,0,0,0,19
2024-04-01 03:00:00,5,6,6,6,0,0,0,0,23
2024-04-01 03:10:00,1,1,3,2,0,0,0,0,7
2024-04-01 03:20:00,2,2,5,2,0,0,0,0,11
2024-04-01 03:30:00,4,4,3,4,0,0,0,0,15
2024-04-01 03:40:00,3,3,7,3,0,0,0,0,16
2024-04-01 03:50:00,1,1,2,1,0,0,0,0,5
2024-04-01 04:00:00,2,2,0,2,0,0,0,0,6
2024-04-01 04:10:00,2,2,1,2,0,0,0,0,7
2024-04-01 04:20:00,2,2,4,2,0,0,0,0,10
2024-04-01 04:30:00,2,2,6,3,0,0,0,0,13
2024-04-01 04:40:00,1,1,1,1,0,0,0,0,4
2024-04-01 04:50:00,2,2,6,2,0,0,0,0,12
2024-04-01 05:00:00,2,2,2,2,0,0,0,0,8
2024-04-01 05:10:00,4,3,5,4,0,0,0,0,16
2024-04-01 05:20:00,2,2,4,2,0,0,0,0,10
2024-04-01 05:30:00,2,2,5,3,0,0,0,0,12
2024-04-01 05:40:00,1,1,5,1,0,0,0,0,8
2024-04-01 05:50:00,3,3,1,3,0,0,0,0,10
2024-04-01 06:00:00,0,0,2,0,0,0,0,0,2
2024-04-01 06:10:00,7,6,4,6,0,0,0,0,23
2024-04-01 06:20:00,4,4,3,3,0,0,0,0,14
2024-04-01 06:30:00,6,6,3,5,0,0,0,0,20
2024-04-01 06:40:00,3,3,6,4,0,0,0,0,16
2024-04-01 06:50:00,4,4,4,4,0,0,1,0,17
2024-04-01 07:00:00,0,0,2,0,0,0,0,0,2
2024-04-01 07:10:00,2,2,3,0,0,0,1,0,8
2024-04-01 07:20:00,3,3,3,3,0,0,0,0,12
2024-04-01 07:30:00,6,6,4,3,0,0,0,0,19
2024-04-01 07:40:00,4,4,5,2,0,0,0,0,15
2024-04-01 07:50:00,2,2,6,0,0,0,1,0,11
2024-04-01 08:00:00,4,4,1,0,0,0,0,0,9
2024-04-01 08:10:00,2,3,4,0,0,0,0,0,9
2024-04-01 08:20:00,8,7,6,2,0,0,0,0,23
2024-04-01 08:30:00,7,7,2,0,0,0,0,0,16
2024-04-01 08:40:00,4,4,3,0,0,0,0,0,11
2024-04-01 08:50:00,6,6,4,0,0,0,0,0,16
2024-04-01 09:00:00,8,7,11,2,0,0,0,0,28
2024-04-01 09:10:00,7,7,10,2,0,0,0,0,26
2024-04-01 09:20:00,9,7,6,0,0,0,0,0,22
2024-04-01 09:30:00,9,7,9,0,0,0,1,0,26
2024-04-01 09:40:00,12,10,11,1,0,0,1,0,35
2024-04-01 09:50:00,21,16,13,1,0,0,0,0,51
2024-04-01 10:00:00,14,14,12,0,0,0,0,0,40
2024-04-01 10:10:00,10,8,5,0,0,0,0,0,23
2024-04-01 10:20:00,16,15,7,0,0,0,1,0,39
2024-04-01 10:30:00,19,14,9,1,0,0,0,0,43
2024-04-01 10:40:00,19,16,4,0,0,0,0,0,39
2024-04-01 10:50:00,21,15,12,3,0,0,1,0,52
2024-04-01 11:00:00,29,28,9,1,0,0,0,0,67
2024-04-01 11:10:00,27,15,15,0,0,0,1,0,58
2024-04-01 11:20:00,30,19,13,1,0,0,0,0,63
2024-04-01 11:30:00,18,16,12,0,0,0,1,0,47
2024-04-01 11:40:00,18,16,9,1,0,0,0,0,44
2024-04-01 11:50:00,29,24,21,2,0,0,1,0,77
2024-04-01 12:00:00,35,25,10,2,0,0,1,0,73
2024-04-01 12:10:00,27,24,8,0,0,0,0,0,59
2024-04-01 12:20:00,28,26,16,0,0,0,2,0,72
2024-04-01 12:30:00,26,23,11,0,0,0,1,0,61
2024-04-01 12:40:00,26,25,14,3,0,0,3,0,71
2024-04-01 12:50:00,30,28,10,0,0,0,0,0,68
2024-04-01 13:00:00,35,33,10,1,0,0,1,0,80
2024-04-01 13:10:00,27,26,9,0,0,0,2,0,64
2024-04-01 13:20:00,27,19,14,1,0,0,0,0,61
2024-04-01 13:30:00,28,24,8,0,0,0,0,0,60
2024-04-01 13:40:00,38,26,13,0,0,0,0,1,78
2024-04-01 13:50:00,45,28,20,0,0,0,0,0,93
2024-04-01 14:00:00,31,24,26,0,0,0,0,0,81
2024-04-01 14:10:00,33,22,11,0,0,0,1,0,67
2024-04-01 14:20:00,38,30,10,3,0,0,0,0,81
2024-04-01 14:30:00,37,28,15,2,0,0,1,0,83
2024-04-01 14:40:00,31,26,9,0,0,0,1,0,67
2024-04-01 14:50:00,51,35,16,0,0,0,1,0,103
2024-04-01 15:00:00,37,33,15,1,0,0,0,0,86
2024-04-01 15:10:00,34,20,19,1,0,0,3,0,77
2024-04-01 15:20:00,51,32,13,0,0,0,2,0,98
2024-04-01 15:30:00,39,31,14,0,0,0,1,0,85
2024-04-01 15:40:00,44,35,14,2,0,0,0,0,95
2024-04-01 15:50:00,48,38,16,2,0,0,2,0,106
2024-04-01 16:00:00,35,22,16,2,0,0,1,0,76
2024-04-01 16:10:00,45,29,13,3,0,0,1,0,91
2024-04-01 16:20:00,36,27,11,0,0,0,1,0,75
2024-04-01 16:30:00,32,30,10,0,0,0,1,0,73
2024-04-01 16:40:00,42,31,16,0,0,0,4,0,93
2024-04-01 16:50:00,32,35,14,0,0,0,3,0,84
2024-04-01 17:00:00,31,18,12,3,0,0,1,0,65
2024-04-01 17:10:00,36,28,12,1,0,0,2,0,79
2024-04-01 17:20:00,34,28,8,1,0,0,1,0,72
2024-04-01 17:30:00,39,26,18,1,0,0,1,0,85
2024-04-01 17:40:00,34,30,17,0,0,0,1,0,82
2024-04-01 17:50:00,32,27,15,0,0,0,1,0,75
2024-04-01 18:00:00,38,25,14,0,0,0,1,0,78
2024-04-01 18:10:00,31,25,18,3,0,0,0,0,77
2024-04-01 18:20:00,37,28,10,1,0,0,0,0,76
2024-04-01 18:30:00,34,27,10,0,0,0,0,0,71
2024-04-01 18:40:00,30,22,14,0,0,0,0,0,66
2024-04-01 18:50:00,23,21,14,1,0,0,0,0,59
2024-04-01 19:00:00,27,21,7,3,0,0,1,0,59
2024-04-01 19:10:00,48,33,10,3,0,0,1,0,95
2024-04-01 19:20:00,35,24,9,0,0,0,1,0,69
2024-04-01 19:30:00,35,25,5,0,0,0,1,0,66
2024-04-01 19:40:00,37,30,16,1,0,0,1,1,86
2024-04-01 19:50:00,29,22,11,1,0,0,0,1,64
2024-04-01 20:00:00,24,22,10,8,0,1,1,0,66
2024-04-01 20:10:00,34,22,13,18,0,0,2,0,89
2024-04-01 20:20:00,24,16,9,18,0,0,0,0,67
2024-04-01 20:30:00,43,23,7,17,1,0,0,0,91
2024-04-01 20:40:00,26,17,14,17,0,0,2,0,76
2024-04-01 20:50:00,23,17,8,16,0,0,3,0,67
2024-04-01 21:00:00,29,22,8,23,0,0,0,0,82
2024-04-01 21:10:00,19,17,9,14,0,0,0,0,59
2024-04-01 21:20:00,14,10,5,9,0,0,1,0,39
2024-04-01 21:30:00,26,23,7,15,0,0,1,0,72
2024-04-01 21:40:00,19,18,8,11,0,0,0,0,56
2024-04-01 21:50:00,17,15,10,12,0,0,0,0,54
2024-04-01 22:00:00,24,22,9,15,0,0,0,0,70
2024-04-01 22:10:00,16,13,6,7,0,0,0,0,42
2024-04-01 22:20:00,13,10,7,5,0,0,0,0,35
2024-04-01 22:30:00,13,10,6,3,0,0,0,0,32
2024-04-01 22:40:00,15,14,9,7,0,0,0,0,45
2024-04-01 22:50:00,14,15,10,8,0,0,2,0,49
2024-04-01 23:00:00,18,17,10,8,0,0,1,0,54
2024-04-01 23:10:00,19,16,8,6,0,0,0,0,49
2024-04-01 23:20:00,16,14,11,4,0,0,1,0,46
2024-04-01 23:30:00,15,15,5,7,0,0,0,0,42
2024-04-01 23:40:00,8,8,8,4,0,0,0,0,28
2024-04-01 23:50:00,18,15,6,3,0,0,1,0,43
2024-04-02 00:00:00,9,12,9,6,0,0,0,0,36
2024-04-02 00:10:00,5,5,3,2,0,0,0,0,15
2024-04-02 00:20:00,4,4,4,2,0,0,0,0,14
2024-04-02 00:30:00,10,10,6,3,0,0,0,0,29
2024-04-02 00:40:00,10,10,4,2,0,0,0,0,26
2024-04-02 00:50:00,2,2,5,0,0,0,0,0,9
2024-04-02 01:00:00,6,6,3,1,0,0,0,0,16
2024-04-02 01:10:00,5,5,2,4,0,0,0,0,16
2024-04-02 01:20:00,4,5,6,1,0,0,0,0,16
2024-04-02 01:30:00,2,2,3,2,0,0,0,0,9
2024-04-02 01:40:00,3,3,2,1,0,0,0,0,9
2024-04-02 01:50:00,2,3,3,1,0,0,0,0,9
2024-04-02 02:00:00,1,1,0,0,0,0,0,0,2
2024-04-02 02:10:00,0,0,1,0,0,0,0,0,1
2024-04-02 02:20:00,3,3,3,2,0,0,0,0,11
2024-04-02 02:30:00,3,3,2,1,0,0,0,0,9
2024-04-02 02:40:00,2,1,3,0,0,0,0,0,6
2024-04-02 02:50:00,0,0,0,0,0,0,0,0,0
2024-04-02 03:00:00,1,1,3,0,0,0,0,0,5
2024-04-02 03:10:00,3,4,1,0,0,0,0,0,8
2024-04-02 03:20:00,1,1,1,0,0,0,0,0,3
2024-04-02 03:30:00,0,0,2,0,0,0,0,0,2
2024-04-02 03:40:00,1,2,1,0,0,0,0,0,4
2024-04-02 03:50:00,5,6,5,5,0,0,0,0,21
2024-04-02 04:00:00,1,1,0,0,0,0,0,0,2
2024-04-02 04:10:00,0,0,1,0,0,0,0,0,1
2024-04-02 04:20:00,1,1,1,0,0,0,0,0,3
2024-04-02 04:30:00,0,0,2,0,0,0,0,0,2
2024-04-02 04:40:00,4,4,3,1,0,0,0,0,12
2024-04-02 04:50:00,2,2,1,0,0,0,1,0,6
2024-04-02 05:00:00,4,6,4,0,0,0,0,0,14
2024-04-02 05:10:00,5,6,3,1,0,0,0,0,15
2024-04-02 05:20:00,4,5,2,0,0,0,0,0,11
2024-04-02 05:30:00,7,7,7,1,0,0,0,0,22
2024-04-02 05:40:00,8,9,3,1,0,0,0,0,21
2024-04-02 05:50:00,4,5,6,0,0,0,0,0,15
2024-04-02 06:00:00,11,9,5,4,0,0,0,0,29
2024-04-02 06:10:00,8,7,8,2,0,0,0,0,25
2024-04-02 06:20:00,14,10,10,7,0,0,0,0,41
2024-04-02 06:30:00,10,8,14,10,0,0,1,0,43
2024-04-02 06:40:00,20,17,8,7,0,0,2,2,56
2024-04-02 06:50:00,15,12,15,11,0,0,0,0,53
2024-04-02 07:00:00,10,7,12,8,0,0,0,0,37
2024-04-02 07:10:00,17,14,14,3,0,0,1,0,49
2024-04-02 07:20:00,16,13,14,3,0,0,2,0,48
2024-04-02 07:30:00,14,10,9,1,0,0,3,0,37
2024-04-02 07:40:00,31,23,14,4,0,0,1,0,73
2024-04-02 07:50:00,34,29,13,1,0,0,1,0,78
2024-04-02 08:00:00,28,21,18,2,0,0,1,0,70
2024-04-02 08:10:00,31,27,10,0,0,0,2,0,70
2024-04-02 08:20:00,31,25,18,6,0,0,4,1,85
2024-04-02 08:30:00,35,23,22,0,0,0,4,0,84
2024-04-02 08:40:00,41,25,17,2,0,0,1,0,86
2024-04-02 08:50:00,42,25,17,2,0,0,1,0,87
2024-04-02 09:00:00,43,28,17,1,0,0,1,0,90
2024-04-02 09:10:00,39,19,18,2,0,0,2,0,80
2024-04-02 09:20:00,38,20,15,3,0,0,0,0,76
2024-04-02 09:30:00,31,21,17,0,0,0,3,0,72
2024-04-02 09:40:00,39,29,15,2,0,0,4,0,89
2024-04-02 09:50:00,47,31,7,1,0,0,6,0,92
2024-04-02 10:00:00,50,46,14,1,0,0,1,0,112
2024-04-02 10:10:00,47,34,18,2,0,0,4,0,105
2024-04-02 10:20:00,46,35,11,2,0,0,6,0,100
2024-04-02 10:30:00,32,27,15,2,0,0,4,0,80
2024-04-02 10:40:00,64,35,14,1,0,0,5,0,119
2024-04-02 10:50:00,48,38,11,1,0,0,0,0,98
2024-04-02 11:00:00,35,29,17,1,0,0,8,0,90
2024-04-02 11:10:00,61,35,16,2,0,0,1,3,118
2024-04-02 11:20:00,66,45,29,3,0,0,0,0,143
2024-04-02 11:30:00,47,29,25,2,0,0,3,0,106
2024-04-02 11:40:00,48,34,18,3,0,0,0,0,103
2024-04-02 11:50:00,58,42,9,1,0,0,2,0,112
2024-04-02 12:00:00,51,43,16,2,0,0,4,0,116
2024-04-02 12:10:00,65,54,7,0,0,0,1,0,127
2024-04-02 12:20:00,65,36,13,1,0,0,1,0,116
2024-04-02 12:30:00,52,31,16,2,0,0,0,1,102
2024-04-02 12:40:00,56,49,18,2,0,0,6,0,131
2024-04-02 12:50:00,51,45,19,4,0,0,1,0,120
2024-04-02 13:00:00,67,55,19,3,0,0,1,0,145
2024-04-02 13:10:00,53,39,10,3,0,0,3,0,108
2024-04-02 13:20:00,48,35,14,0,0,0,5,0,102
2024-04-02 13:30:00,57,35,10,0,0,0,1,0,103
2024-04-02 13:40:00,51,35,14,4,0,0,0,2,106
2024-04-02 13:50:00,57,56,16,1,0,0,0,0,130
2024-04-02 14:00:00,48,40,16,1,0,0,1,0,106
2024-04-02 14:10:00,58,39,19,1,0,0,2,0,119
2024-04-02 14:20:00,62,42,12,1,0,0,3,0,120
2024-04-02 14:30:00,77,48,13,2,0,0,2,0,142
2024-04-02 14:40:00,63,40,9,1,0,0,3,0,116
2024-04-02 14:50:00,65,38,13,3,0,0,3,0,122
2024-04-02 15:00:00,69,44,23,3,0,0,8,0,147
2024-04-02 15:10:00,65,33,27,3,0,0,4,0,132
2024-04-02 15:20:00,59,46,15,2,0,0,1,0,123
2024-04-02 15:30:00,66,47,27,2,0,0,1,1,144
2024-04-02 15:40:00,78,44,32,1,0,0,1,1,157
2024-04-02 15:50:00,105,54,21,1,0,0,2,0,183
2024-04-02 16:00:00,71,43,15,0,0,0,5,0,134
2024-04-02 16:10:00,67,45,23,0,0,0,1,0,136
2024-04-02 16:20:00,78,39,13,2,0,0,5,0,137
2024-04-02 16:30:00,71,56,18,0,0,0,1,0,146
2024-04-02 16:40:00,60,48,18,1,0,0,2,0,129
2024-04-02 16:50:00,65,53,18,3,0,0,6,0,145
2024-04-02 17:00:00,62,39,17,0,0,0,3,0,121
2024-04-02 17:10:00,82,63,25,0,0,0,3,0,173
2024-04-02 17:20:00,85,54,11,1,0,0,3,0,154
2024-04-02 17:30:00,66,45,24,4,0,0,6,1,146
2024-04-02 17:40:00,60,35,10,1,0,0,6,0,112
2024-04-02 17:50:00,71,62,27,13,0,0,1,0,174
2024-04-02 18:00:00,73,50,27,0,0,0,6,0,156
2024-04-02 18:10:00,72,56,24,3,0,0,2,1,158
2024-04-02 18:20:00,66,52,23,3,0,0,3,0,147
2024-04-02 18:30:00,57,46,12,1,0,0,7,1,124
2024-04-02 18:40:00,58,47,7,0,0,0,2,0,114
2024-04-02 18:50:00,60,45,19,1,0,0,4,0,129
2024-04-02 19:00:00,47,31,13,1,0,0,2,0,94
2024-04-02 19:10:00,70,43,9,1,0,0,5,1,129
2024-04-02 19:20:00,37,35,15,0,0,0,2,0,89
2024-04-02 19:30:00,45,34,14,2,0,0,2,0,97
2024-04-02 19:40:00,42,35,23,5,0,0,0,0,105
2024-04-02 19:50:00,52,42,12,0,0,0,0,0,106
2024-04-02 20:00:00,32,25,14,3,0,0,6,0,80
2024-04-02 20:10:00,30,21,13,1,0,0,6,0,71
2024-04-02 20:20:00,27,22,8,2,0,0,1,0,60
2024-04-02 20:30:00,28,19,11,0,0,0,4,0,62
2024-04-02 20:40:00,20,22,8,2,0,0,0,0,52
2024-04-02 20:50:00,32,28,9,1,0,0,1,0,71
2024-04-02 21:00:00,24,24,8,2,0,0,0,0,58
2024-04-02 21:10:00,33,27,11,3,0,0,1,0,75
2024-04-02 21:20:00,30,19,10,1,0,0,3,0,63
2024-04-02 21:30:00,26,23,5,3,0,0,2,0,59
2024-04-02 21:40:00,15,15,8,2,0,0,0,0,40
2024-04-02 21:50:00,21,19,10,2,0,0,1,0,53
2024-04-02 22:00:00,22,22,8,1,0,0,0,0,53
2024-04-02 22:10:00,22,24,9,0,0,0,2,0,57
2024-04-02 22:20:00,25,25,4,1,0,0,0,0,55
2024-04-02 22:30:00,17,17,6,3,0,0,1,0,44
2024-04-02 22:40:00,10,9,2,2,0,0,1,0,24
2024-04-02 22:50:00,18,15,8,9,0,0,1,0,51
2024-04-02 23:00:00,16,15,6,8,0,0,1,0,46
2024-04-02 23:10:00,12,13,3,0,0,0,1,0,29
2024-04-02 23:20:00,10,12,4,0,0,0,1,0,27
2024-04-02 23:30:00,13,13,6,1,0,0,0,0,33
2024-04-02 23:40:00,4,4,2,0,0,0,0,0,10
2024-04-02 23:50:00,17,20,7,4,0,0,0,0,48
2024-04-03 00:00:00,8,10,7,3,0,0,0,0,28
2024-04-03 00:10:00,7,8,1,1,0,0,0,0,17
2024-04-03 00:20:00,3,3,1,0,0,0,0,0,7
2024-04-03 00:30:00,5,5,2,0,0,0,0,0,12
2024-04-03 00:40:00,5,6,5,0,0,0,0,0,16
2024-04-03 00:50:00,3,3,1,0,0,0,0,0,7
2024-04-03 01:00:00,7,9,7,8,0,0,0,0,31
2024-04-03 01:10:00,1,1,4,2,0,0,0,0,8
2024-04-03 01:20:00,0,0,2,0,0,0,0,0,2
2024-04-03 01:30:00,4,4,1,2,0,0,0,0,11
2024-04-03 01:40:00,1,1,2,1,0,0,0,0,5
2024-04-03 01:50:00,6,5,4,4,0,0,0,0,19
2024-04-03 02:00:00,4,4,2,4,0,0,0,0,14
2024-04-03 02:10:00,2,2,0,0,0,0,0,0,4
2024-04-03 02:20:00,1,1,0,1,0,0,0,0,3
2024-04-03 02:30:00,2,2,2,1,0,0,0,0,7
2024-04-03 02:40:00,2,2,2,1,0,0,0,0,7
2024-04-03 02:50:00,0,0,2,0,0,0,0,0,2
2024-04-03 03:00:00,3,1,3,4,0,0,0,0,11
2024-04-03 03:10:00,2,2,1,0,0,0,0,0,5
2024-04-03 03:20:00,2,2,1,1,0,0,0,0,6
2024-04-03 03:30:00,3,2,3,0,0,0,0,0,8
2024-04-03 03:40:00,2,2,1,1,0,0,1,0,7
2024-04-03 03:50:00,1,1,1,0,0,0,0,0,3
2024-04-03 04:00:00,1,2,1,0,0,0,0,0,4
2024-04-03 04:10:00,6,5,1,0,0,0,0,0,12
2024-04-03 04:20:00,1,1,2,0,0,0,0,0,4
2024-04-03 04:30:00,4,5,4,0,0,0,0,0,13
2024-04-03 04:40:00,0,0,1,0,0,0,0,0,1
2024-04-03 04:50:00,0,0,1,0,0,0,0,0,1
2024-04-03 05:00:00,2,3,3,0,0,0,0,0,8
2024-04-03 05:10:00,5,5,4,0,0,0,0,0,14
2024-04-03 05:20:00,6,7,5,1,0,0,1,0,20
2024-04-03 05:30:00,2,2,2,0,0,0,0,0,6
2024-04-03 05:40:00,4,3,4,1,0,0,0,0,12
2024-04-03 05:50:00,8,9,9,5,0,0,0,0,31
2024-04-03 06:00:00,5,5,3,5,0,0,0,0,18
2024-04-03 06:10:00,13,11,7,9,0,0,0,0,40
2024-04-03 06:20:00,15,12,16,15,0,0,1,0,59
2024-04-03 06:30:00,8,8,11,9,0,0,1,0,37
2024-04-03 06:40:00,20,15,11,10,0,0,1,1,58
2024-04-03 06:50:00,11,12,9,5,0,0,1,0,38
2024-04-03 07:00:00,14,16,18,12,0,0,0,0,60
2024-04-03 07:10:00,16,16,14,4,0,0,1,0,51
2024-04-03 07:20:00,16,11,15,0,0,0,0,0,42
2024-04-03 07:30:00,29,21,11,1,0,0,1,0,63
2024-04-03 07:40:00,28,21,16,1,0,0,1,0,67
2024-04-03 07:50:00,40,18,13,0,0,0,3,0,74
2024-04-03 08:00:00,26,18,18,4,0,0,2,0,68
2024-04-03 08:10:00,29,20,19,5,0,0,3,0,76
2024-04-03 08:20:00,27,21,17,0,0,0,1,0,66
2024-04-03 08:30:00,37,18,25,3,0,0,4,0,87
2024-04-03 08:40:00,39,26,30,1,0,0,2,0,98
2024-04-03 08:50:00,37,20,21,2,0,0,0,0,80
2024-04-03 09:00:00,31,24,16,2,0,0,0,0,73
2024-04-03 09:10:00,42,27,23,2,0,0,1,0,95
2024-04-03 09:20:00,41,24,22,4,0,0,1,0,92
2024-04-03 09:30:00,33,20,19,8,0,0,0,1,81
2024-04-03 09:40:00,45,26,22,2,0,0,3,0,98
2024-04-03 09:50:00,41,32,18,3,0,0,0,0,94
2024-04-03 10:00:00,53,35,29,3,0,0,2,0,122
2024-04-03 10:10:00,40,27,18,5,0,0,3,0,93
2024-04-03 10:20:00,44,33,20,4,0,0,3,0,104
2024-04-03 10:30:00,34,27,20,2,0,0,2,0,85
2024-04-03 10:40:00,44,30,24,5,0,0,0,0,103
2024-04-03 10:50:00,54,33,24,1,0,0,1,0,113
2024-04-03 11:00:00,55,38,20,2,0,0,1,0,116
2024-04-03 11:10:00,48,37,16,6,0,0,3,0,110
2024-04-03 11:20:00,53,38,30,3,0,0,2,0,126
2024-04-03 11:30:00,48,27,21,2,0,0,0,0,98
2024-04-03 11:40:00,51,33,22,2,0,0,2,0,110
2024-04-03 11:50:00,58,42,16,4,0,0,2,1,123
2024-04-03 12:00:00,60,47,19,1,0,0,1,0,128
2024-04-03 12:10:00,62,44,19,2,0,0,2,1,130
2024-04-03 12:20:00,76,45,9,2,0,0,4,0,136
2024-04-03 12:30:00,54,35,25,1,0,0,3,0,118
2024-04-03 12:40:00,61,32,20,1,0,0,10,0,124
2024-04-03 12:50:00,72,44,18,4,0,0,1,0,139
2024-04-03 13:00:00,51,33,13,2,0,0,3,0,102
2024-04-03 13:10:00,62,35,12,5,0,0,2,0,116
2024-04-03 13:20:00,59,50,16,0,0,0,1,0,126
2024-04-03 13:30:00,56,52,27,2,0,0,0,0,137
2024-04-03 13:40:00,39,35,12,0,0,0,1,0,87
2024-04-03 13:50:00,54,49,17,3,0,0,2,2,127
2024-04-03 14:00:00,55,47,18,0,0,0,0,0,120
2024-04-03 14:10:00,63,48,21,4,0,0,3,0,139
2024-04-03 14:20:00,62,46,17,5,0,0,2,0,132
2024-04-03 14:30:00,49,34,22,3,0,0,0,0,108
2024-04-03 14:40:00,67,43,21,0,0,0,3,0,134
2024-04-03 14:50:00,56,35,21,1,0,0,2,0,115
2024-04-03 15:00:00,52,37,27,4,0,0,2,0,122
2024-04-03 15:10:00,63,32,22,2,0,0,4,1,124
2024-04-03 15:20:00,58,38,20,2,0,0,2,0,120
2024-04-03 15:30:00,50,26,22,1,0,0,1,0,100
2024-04-03 15:40:00,56,48,32,1,0,0,1,0,138
2024-04-03 15:50:00,69,48,27,0,0,0,0,0,144
2024-04-03 16:00:00,59,49,18,0,0,0,0,0,126
2024-04-03 16:10:00,79,55,17,1,0,0,2,0,154
2024-04-03 16:20:00,50,44,15,1,0,0,3,0,113
2024-04-03 16:30:00,70,56,20,3,0,0,2,0,151
2024-04-03 16:40:00,61,40,23,1,0,0,4,0,129
2024-04-03 16:50:00,76,48,25,3,0,0,4,0,156
2024-04-03 17:00:00,51,31,22,1,0,0,1,0,106
2024-04-03 17:10:00,74,44,28,1,0,0,1,0,148
2024-04-03 17:20:00,58,33,21,0,0,0,3,1,116
2024-04-03 17:30:00,64,42,26,1,0,0,5,1,139
2024-04-03 17:40:00,71,52,25,1,0,0,3,0,152
2024-04-03 17:50:00,63,49,16,0,0,0,5,0,133
2024-04-03 18:00:00,66,47,28,1,0,0,4,0,146
2024-04-03 18:10:00,69,53,22,1,0,0,0,0,145
2024-04-03 18:20:00,62,52,13,0,0,0,3,0,130
2024-04-03 18:30:00,67,48,18,1,0,0,2,0,136
2024-04-03 18:40:00,58,46,11,0,0,0,1,0,116
2024-04-03 18:50:00,57,45,26,1,0,0,3,0,132
2024-04-03 19:00:00,52,40,17,1,0,0,0,0,110
2024-04-03 19:10:00,95,48,17,0,0,0,3,0,163
2024-04-03 19:20:00,52,43,11,0,0,0,1,0,107
2024-04-03 19:30:00,37,32,15,0,0,0,2,0,86
2024-04-03 19:40:00,37,30,13,0,0,0,0,0,80
2024-04-03 19:50:00,43,39,5,0,0,0,2,0,89
2024-04-03 20:00:00,26,25,10,5,0,0,1,0,67
2024-04-03 20:10:00,39,27,9,24,0,0,3,0,102
2024-04-03 20:20:00,34,28,10,8,0,0,0,0,80
2024-04-03 20:30:00,25,22,11,11,0,0,1,0,70
2024-04-03 20:40:00,38,25,7,15,0,0,2,0,87
2024-04-03 20:50:00,35,26,8,19,0,0,2,0,90
2024-04-03 21:00:00,27,31,12,13,0,0,2,0,85
2024-04-03 21:10:00,31,27,11,12,0,0,2,0,83
2024-04-03 21:20:00,24,13,10,10,0,0,5,0,62
2024-04-03 21:30:00,29,19,14,9,0,0,3,0,74
2024-04-03 21:40:00,45,23,8,5,0,0,0,0,81
2024-04-03 21:50:00,21,23,6,2,0,0,0,0,52
2024-04-03 22:00:00,16,14,5,8,0,0,0,0,43
2024-04-03 22:10:00,29,16,15,10,0,0,0,0,70
2024-04-03 22:20:00,29,25,9,10,0,0,1,0,74
2024-04-03 22:30:00,18,16,8,16,0,0,0,0,58
2024-04-03 22:40:00,23,18,3,19,0,0,0,0,63
2024-04-03 22:50:00,28,22,12,22,0,0,3,0,87
2024-04-03 23:00:00,16,13,8,13,0,0,0,0,50
2024-04-03 23:10:00,13,10,7,12,0,0,1,0,43
2024-04-03 23:20:00,16,14,9,13,0,0,0,0,52
2024-04-03 23:30:00,16,13,2,13,0,0,0,0,44
2024-04-03 23:40:00,6,6,4,5,0,0,1,0,22
2024-04-03 23:50:00,14,13,7,12,0,0,0,0,46
2024-04-04 00:00:00,6,6,4,8,0,0,0,0,24
2024-04-04 00:10:00,6,6,4,4,0,0,0,0,20
2024-04-04 00:20:00,10,7,9,6,0,0,0,0,32
2024-04-04 00:30:00,4,4,7,3,0,0,0,0,18
2024-04-04 00:40:00,7,7,0,6,0,0,0,0,20
2024-04-04 00:50:00,5,4,2,5,0,0,0,0,16
2024-04-04 01:00:00,3,2,4,2,0,0,0,0,11
2024-04-04 01:10:00,3,3,3,3,0,0,0,0,12
2024-04-04 01:20:00,2,2,5,3,0,0,0,0,12
2024-04-04 01:30:00,2,2,3,1,0,0,0,0,8
2024-04-04 01:40:00,3,5,1,3,0,0,1,0,13
2024-04-04 01:50:00,1,1,0,1,0,0,0,0,3
2024-04-04 02:00:00,3,4,4,2,0,0,0,0,13
2024-04-04 02:10:00,1,1,0,0,0,0,0,0,2
2024-04-04 02:20:00,1,1,2,1,0,0,0,0,5
2024-04-04 02:30:00,1,1,2,0,0,0,0,0,4
2024-04-04 02:40:00,3,3,1,2,0,0,0,0,9
2024-04-04 02:50:00,0,0,1,0,0,0,0,0,1
2024-04-04 03:00:00,2,2,2,2,0,0,0,0,8
2024-04-04 03:10:00,3,3,3,2,0,0,0,0,11
2024-04-04 03:20:00,6,4,3,4,0,0,0,0,17
2024-04-04 03:30:00,1,1,3,1,0,0,0,0,6
2024-04-04 03:40:00,2,2,3,2,0,0,0,0,9
2024-04-04 03:50:00,1,1,0,1,0,0,0,0,3
2024-04-04 04:00:00,1,1,1,1,0,0,0,0,4
2024-04-04 04:10:00,1,1,1,1,0,0,0,0,4
2024-04-04 04:20:00,0,0,1,0,0,0,0,0,1
2024-04-04 04:30:00,2,2,3,2,0,0,0,0,9
2024-04-04 04:40:00,1,1,0,1,0,0,0,0,3
2024-04-04 04:50:00,1,1,3,1,0,0,0,0,6
2024-04-04 05:00:00,1,2,2,1,0,0,0,0,6
2024-04-04 05:10:00,3,3,4,3,0,0,0,0,13
2024-04-04 05:20:00,8,8,7,8,0,0,0,0,31
2024-04-04 05:30:00,2,2,3,3,0,0,1,0,11
2024-04-04 05:40:00,9,7,4,9,0,0,0,0,29
2024-04-04 05:50:00,6,5,9,5,0,0,0,0,25
2024-04-04 06:00:00,9,6,9,6,0,0,0,0,30
2024-04-04 06:10:00,11,9,11,13,0,0,0,0,44
2024-04-04 06:20:00,5,7,13,10,0,0,0,0,35
2024-04-04 06:30:00,8,6,11,8,0,0,0,0,33
2024-04-04 06:40:00,16,10,13,11,0,0,2,0,52
2024-04-04 06:50:00,19,15,11,7,0,0,3,0,55
2024-04-04 07:00:00,9,9,10,3,0,0,0,0,31
2024-04-04 07:10:00,15,14,20,7,0,0,0,0,56
2024-04-04 07:20:00,24,18,14,2,0,0,1,0,59
2024-04-04 07:30:00,25,14,17,1,0,0,3,0,60
2024-04-04 07:40:00,26,18,12,4,0,0,1,0,61
2024-04-04 07:50:00,38,22,13,5,0,0,1,0,79
2024-04-04 08:00:00,33,20,19,4,0,0,0,0,76
2024-04-04 08:10:00,32,18,15,4,0,0,2,0,71
2024-04-04 08:20:00,25,17,18,5,0,0,4,0,69
2024-04-04 08:30:00,46,27,13,5,0,0,0,0,91
2024-04-04 08:40:00,37,22,11,1,0,0,0,0,71
2024-04-04 08:50:00,40,21,16,4,0,0,1,0,82
2024-04-04 09:00:00,28,12,19,2,0,0,4,0,65
2024-04-04 09:10:00,68,19,15,4,0,0,5,0,111
2024-04-04 09:20:00,47,26,17,3,0,0,2,0,95
2024-04-04 09:30:00,96,26,19,5,0,0,2,1,149
2024-04-04 09:40:00,46,34,19,4,0,0,4,0,107
2024-04-04 09:50:00,59,46,9,1,0,0,1,0,116
2024-04-04 10:00:00,47,33,15,3,0,0,1,0,99
2024-04-04 10:10:00,111,37,17,2,0,0,2,0,169
2024-04-04 10:20:00,37,33,19,1,0,0,5,0,95
2024-04-04 10:30:00,111,34,20,8,0,0,1,0,174
2024-04-04 10:40:00,39,32,17,3,0,0,1,0,92
2024-04-04 10:50:00,48,32,21,2,0,0,1,0,104
2024-04-04 11:00:00,50,42,17,2,0,0,2,0,113
2024-04-04 11:10:00,73,36,20,0,0,0,1,0,130
2024-04-04 11:20:00,52,43,19,3,0,0,0,0,117
2024-04-04 11:30:00,197,47,20,3,0,0,0,0,267
2024-04-04 11:40:00,40,29,14,3,0,0,4,0,90
2024-04-04 11:50:00,52,28,16,4,0,0,2,0,102
2024-04-04 12:00:00,61,43,18,0,0,0,0,0,122
2024-04-04 12:10:00,50,38,19,2,0,0,4,0,113
2024-04-04 12:20:00,60,40,15,1,0,0,0,0,116
2024-04-04 12:30:00,80,46,20,0,0,0,1,0,147
2024-04-04 12:40:00,53,40,18,4,0,0,0,0,115
2024-04-04 12:50:00,42,31,23,5,0,0,1,0,102
2024-04-04 13:00:00,47,35,22,6,0,0,0,0,110
2024-04-04 13:10:00,55,42,9,2,0,0,4,0,112
2024-04-04 13:20:00,56,40,20,4,0,0,1,0,121
2024-04-04 13:30:00,38,26,26,4,0,0,2,0,96
2024-04-04 13:40:00,43,26,15,2,0,0,1,0,87
2024-04-04 13:50:00,53,38,19,4,0,0,4,0,118
2024-04-04 14:00:00,58,42,22,3,0,0,0,0,125
2024-04-04 14:10:00,54,37,18,2,0,0,5,1,117
2024-04-04 14:20:00,53,40,18,1,0,0,2,0,114
2024-04-04 14:30:00,51,35,25,3,0,0,1,0,115
2024-04-04 14:40:00,55,34,32,1,0,0,0,1,123
2024-04-04 14:50:00,53,34,28,2,0,0,1,0,118
2024-04-04 15:00:00,55,37,20,4,0,0,0,0,116
2024-04-04 15:10:00,62,46,27,0,0,0,5,0,140
2024-04-04 15:20:00,60,30,22,4,0,0,1,0,117
2024-04-04 15:30:00,62,36,25,5,0,0,4,0,132
2024-04-04 15:40:00,71,52,22,2,0,0,2,0,149
2024-04-04 15:50:00,68,50,21,0,0,0,2,0,141
2024-04-04 16:00:00,59,46,19,3,0,0,1,0,128
2024-04-04 16:10:00,72,51,18,3,0,0,7,0,151
2024-04-04 16:20:00,115,43,20,2,0,0,2,0,182
2024-04-04 16:30:00,64,49,20,0,0,0,2,0,135
2024-04-04 16:40:00,67,45,26,3,0,0,3,0,144
2024-04-04 16:50:00,62,41,20,0,0,0,2,1,126
2024-04-04 17:00:00,65,51,21,0,0,0,1,0,138
2024-04-04 17:10:00,59,36,13,0,0,0,3,0,111
2024-04-04 17:20:00,57,41,8,0,0,0,3,0,109
2024-04-04 17:30:00,85,50,12,1,0,0,3,0,151
2024-04-04 17:40:00,55,29,9,2,0,0,0,0,95
2024-04-04 17:50:00,71,53,20,1,0,0,4,0,149
2024-04-04 18:00:00,77,57,21,2,0,0,8,0,165
2024-04-04 18:10:00,65,50,9,2,0,0,1,0,127
2024-04-04 18:20:00,60,42,15,3,0,0,0,0,120
2024-04-04 18:30:00,52,40,15,1,0,0,1,0,109
2024-04-04 18:40:00,65,39,15,1,0,0,1,0,121
2024-04-04 18:50:00,65,44,12,0,0,0,1,0,122
2024-04-04 19:00:00,55,41,11,0,0,0,0,0,107
2024-04-04 19:10:00,57,41,10,1,0,0,7,0,116
2024-04-04 19:20:00,57,42,12,0,0,0,3,0,114
2024-04-04 19:30:00,48,42,12,0,0,0,1,0,103
2024-04-04 19:40:00,48,45,16,0,0,0,1,0,110
2024-04-04 19:50:00,40,35,14,1,0,0,2,0,92
2024-04-04 20:00:00,39,31,10,2,0,0,1,0,83
2024-04-04 20:10:00,34,25,10,11,0,0,3,0,83
2024-04-04 20:20:00,31,24,9,12,0,0,1,0,77
2024-04-04 20:30:00,33,29,9,13,0,0,1,0,85
2024-04-04 20:40:00,29,28,15,24,0,0,1,0,97
2024-04-04 20:50:00,29,23,5,15,0,0,1,0,73
2024-04-04 21:00:00,28,22,7,12,0,0,3,0,72
2024-04-04 21:10:00,35,22,7,16,0,0,2,0,82
2024-04-04 21:20:00,22,20,10,16,0,0,2,0,70
2024-04-04 21:30:00,31,19,13,17,0,0,2,0,82
2024-04-04 21:40:00,30,21,12,20,0,0,0,0,83
2024-04-04 21:50:00,30,20,13,20,0,0,1,0,84
2024-04-04 22:00:00,19,14,11,12,0,0,0,0,56
2024-04-04 22:10:00,42,12,18,14,0,0,0,0,86
2024-04-04 22:20:00,23,17,4,19,0,0,0,0,63
2024-04-04 22:30:00,26,18,11,17,0,0,0,0,72
2024-04-04 22:40:00,29,19,11,20,0,0,0,0,79
2024-04-04 22:50:00,19,11,20,11,0,0,0,0,61
2024-04-04 23:00:00,14,13,5,11,0,0,0,0,43
2024-04-04 23:10:00,12,7,6,8,0,0,3,0,36
2024-04-04 23:20:00,19,14,7,11,0,0,1,0,52
2024-04-04 23:30:00,14,13,6,14,0,0,0,0,47
2024-04-04 23:40:00,15,15,7,14,0,0,1,0,52
2024-04-04 23:50:00,18,14,7,14,0,0,2,0,55
2024-04-05 00:00:00,7,6,8,6,0,0,0,0,27
2024-04-05 00:10:00,5,5,9,6,0,0,0,0,25
2024-04-05 00:20:00,7,7,2,5,0,0,0,0,21
2024-04-05 00:30:00,7,7,6,8,0,0,0,0,28
2024-04-05 00:40:00,9,8,5,9,0,0,0,0,31
2024-04-05 00:50:00,9,9,5,8,0,0,0,0,31
2024-04-05 01:00:00,6,5,3,5,0,0,0,0,19
2024-04-05 01:10:00,7,6,4,6,0,0,1,0,24
2024-04-05 01:20:00,5,5,4,5,0,0,0,0,19
2024-04-05 01:30:00,1,1,1,0,0,0,0,0,3
2024-04-05 01:40:00,7,7,3,7,0,0,0,0,24
2024-04-05 01:50:00,2,2,4,2,0,0,0,0,10
2024-04-05 02:00:00,0,1,0,1,0,0,0,0,2
