datetime,V21Z,V22Z,V81Z,V82Z,Total
2024-03-01 01:00:00,2,0,0,0,2
2024-03-01 01:10:00,4,0,2,4,10
2024-03-01 01:20:00,5,0,0,5,10
2024-03-01 01:30:00,5,0,0,3,8
2024-03-01 01:40:00,2,0,0,2,4
2024-03-01 01:50:00,2,0,0,2,4
2024-03-01 02:00:00,0,0,0,0,0
2024-03-01 02:10:00,5,0,0,2,7
2024-03-01 02:20:00,2,0,0,1,3
2024-03-01 02:30:00,0,0,0,0,0
2024-03-01 02:40:00,0,0,0,0,0
2024-03-01 02:50:00,0,0,0,2,2
2024-03-01 03:00:00,4,0,1,2,7
2024-03-01 03:10:00,3,0,0,0,3
2024-03-01 03:20:00,3,0,0,3,6
2024-03-01 03:30:00,3,0,0,0,3
2024-03-01 03:40:00,2,0,2,1,5
2024-03-01 03:50:00,2,0,0,1,3
2024-03-01 04:00:00,2,0,0,0,2
2024-03-01 04:10:00,2,0,0,3,5
2024-03-01 04:20:00,1,0,0,3,4
2024-03-01 04:30:00,0,0,1,2,3
2024-03-01 04:40:00,1,0,0,4,5
2024-03-01 04:50:00,2,0,0,0,2
2024-03-01 05:00:00,4,2,0,4,10
2024-03-01 05:10:00,4,0,2,12,18
2024-03-01 05:20:00,4,0,1,7,12
2024-03-01 05:30:00,7,0,0,5,12
2024-03-01 05:40:00,7,0,1,9,17
2024-03-01 05:50:00,9,1,3,7,20
2024-03-01 06:00:00,5,0,3,12,20
2024-03-01 06:10:00,11,0,0,11,22
2024-03-01 06:20:00,12,1,1,18,32
2024-03-01 06:30:00,16,2,0,21,39
2024-03-01 06:40:00,26,4,0,31,61
2024-03-01 06:50:00,25,3,7,43,78
2024-03-01 07:00:00,19,2,8,46,75
2024-03-01 07:10:00,27,4,4,59,94
2024-03-01 07:20:00,27,3,12,54,96
2024-03-01 07:30:00,37,6,15,57,115
2024-03-01 07:40:00,35,4,15,43,97
2024-03-01 07:50:00,42,3,10,56,111
2024-03-01 08:00:00,52,2,7,45,106
2024-03-01 08:10:00,44,4,8,40,96
2024-03-01 08:20:00,29,2,5,40,76
2024-03-01 08:30:00,35,5,8,43,91
2024-03-01 08:40:00,39,2,3,36,80
2024-03-01 08:50:00,44,5,3,48,100
2024-03-01 09:00:00,45,3,7,45,100
2024-03-01 09:10:00,41,1,2,44,88
2024-03-01 09:20:00,43,2,3,41,89
2024-03-01 09:30:00,38,2,5,52,97
2024-03-01 09:40:00,33,3,6,59,101
2024-03-01 09:50:00,44,2,6,50,102
2024-03-01 10:00:00,33,5,7,44,89
2024-03-01 10:10:00,41,9,5,53,108
2024-03-01 10:20:00,38,8,6,51,103
2024-03-01 10:30:00,31,1,7,50,89
2024-03-01 10:40:00,41,3,8,59,111
2024-03-01 10:50:00,38,1,4,53,96
2024-03-01 11:00:00,41,3,6,49,99
2024-03-01 11:10:00,55,3,6,51,115
2024-03-01 11:20:00,37,3,3,52,95
2024-03-01 11:30:00,44,8,7,50,109
2024-03-01 11:40:00,50,3,12,57,122
2024-03-01 11:50:00,49,5,12,54,120
2024-03-01 12:00:00,52,2,8,57,119
2024-03-01 12:10:00,53,7,5,49,114
2024-03-01 12:20:00,54,3,9,66,132
2024-03-01 12:30:00,64,7,7,56,134
2024-03-01 12:40:00,46,5,10,62,123
2024-03-01 12:50:00,49,7,5,53,114
2024-03-01 13:00:00,54,7,6,49,116
2024-03-01 13:10:00,59,10,9,58,136
2024-03-01 13:20:00,74,9,4,61,148
2024-03-01 13:30:00,60,10,8,46,124
2024-03-01 13:40:00,51,7,7,63,128
2024-03-01 13:50:00,66,6,3,52,127
2024-03-01 14:00:00,51,4,11,44,110
2024-03-01 14:10:00,57,4,5,42,108
2024-03-01 14:20:00,55,10,9,63,137
2024-03-01 14:30:00,55,10,5,52,122
2024-03-01 14:40:00,55,4,6,44,109
2024-03-01 14:50:00,69,5,6,48,128
2024-03-01 15:00:00,51,10,7,53,121
2024-03-01 15:10:00,64,3,8,44,119
2024-03-01 15:20:00,57,3,7,43,110
2024-03-01 15:30:00,48,13,7,44,112
2024-03-01 15:40:00,60,3,5,51,119
2024-03-01 15:50:00,64,9,7,46,126
2024-03-01 16:00:00,56,10,6,45,117
2024-03-01 16:10:00,55,3,4,43,105
2024-03-01 16:20:00,61,6,11,38,116
2024-03-01 16:30:00,58,8,5,43,114
2024-03-01 16:40:00,64,7,11,50,132
2024-03-01 16:50:00,69,8,13,37,127
2024-03-01 17:00:00,64,9,14,39,126
2024-03-01 17:10:00,44,3,16,52,115
2024-03-01 17:20:00,48,6,8,48,110
2024-03-01 17:30:00,54,4,12,43,113
2024-03-01 17:40:00,48,7,9,52,116
2024-03-01 17:50:00,60,9,4,54,127
2024-03-01 18:00:00,56,7,11,47,121
2024-03-01 18:10:00,52,6,7,49,114
2024-03-01 18:20:00,42,8,7,45,102
2024-03-01 18:30:00,47,9,4,46,106
2024-03-01 18:40:00,39,5,5,53,102
2024-03-01 18:50:00,48,7,5,31,91
2024-03-01 19:00:00,44,9,5,41,99
2024-03-01 19:10:00,44,4,8,52,108
2024-03-01 19:20:00,40,10,6,37,93
2024-03-01 19:30:00,40,4,6,44,94
2024-03-01 19:40:00,45,4,3,35,87
2024-03-01 19:50:00,29,3,5,36,73
2024-03-01 20:00:00,35,6,2,23,66
2024-03-01 20:10:00,31,4,5,30,70
2024-03-01 20:20:00,30,5,5,29,69
2024-03-01 20:30:00,18,7,1,19,45
2024-03-01 20:40:00,25,2,0,19,46
2024-03-01 20:50:00,21,2,2,18,43
2024-03-01 21:00:00,27,3,2,14,46
2024-03-01 21:10:00,33,0,5,13,51
2024-03-01 21:20:00,24,3,4,17,48
2024-03-01 21:30:00,15,3,2,18,38
2024-03-01 21:40:00,31,4,2,19,56
2024-03-01 21:50:00,31,12,2,13,58
2024-03-01 22:00:00,22,5,1,17,45
2024-03-01 22:10:00,19,4,3,24,50
2024-03-01 22:20:00,25,3,1,17,46
2024-03-01 22:30:00,21,4,0,8,33
2024-03-01 22:40:00,22,7,4,16,49
2024-03-01 22:50:00,19,2,3,14,38
2024-03-01 23:00:00,12,2,0,15,29
2024-03-01 23:10:00,13,2,4,13,32
2024-03-01 23:20:00,11,1,1,9,22
2024-03-01 23:30:00,14,3,0,3,20
2024-03-01 23:40:00,10,0,1,14,25
2024-03-01 23:50:00,15,1,0,12,28
2024-03-02 00:00:00,11,5,2,7,25
2024-03-02 00:10:00,15,6,1,10,32
2024-03-02 00:20:00,12,0,3,8,23
2024-03-02 00:30:00,12,2,0,7,21
2024-03-02 00:40:00,10,1,0,11,22
2024-03-02 00:50:00,11,0,0,6,17
2024-03-02 01:00:00,8,4,0,5,17
2024-03-02 01:10:00,11,2,0,3,16
2024-03-02 01:20:00,4,0,0,8,12
2024-03-02 01:30:00,3,1,0,6,10
2024-03-02 01:40:00,5,1,2,4,12
2024-03-02 01:50:00,10,2,0,1,13
2024-03-02 02:00:00,10,0,0,6,16
2024-03-02 02:10:00,6,1,0,4,11
2024-03-02 02:20:00,2,3,0,2,7
2024-03-02 02:30:00,9,1,1,1,12
2024-03-02 02:40:00,4,2,0,2,8
2024-03-02 02:50:00,3,0,0,5,8
2024-03-02 03:00:00,0,0,0,3,3
2024-03-02 03:10:00,8,0,0,5,13
2024-03-02 03:20:00,4,0,0,5,9
2024-03-02 03:30:00,4,0,0,0,4
2024-03-02 03:40:00,8,0,1,1,10
2024-03-02 03:50:00,3,0,0,0,3
2024-03-02 04:00:00,2,0,0,0,2
2024-03-02 04:10:00,3,0,0,2,5
2024-03-02 04:20:00,4,0,0,2,6
2024-03-02 04:30:00,3,0,0,2,5
2024-03-02 04:40:00,1,0,0,0,1
2024-03-02 04:50:00,2,0,0,5,7
2024-03-02 05:00:00,0,2,1,2,5
2024-03-02 05:10:00,2,0,0,2,4
2024-03-02 05:20:00,4,2,0,2,8
2024-03-02 05:30:00,0,0,0,3,3
2024-03-02 05:40:00,4,0,0,2,6
2024-03-02 05:50:00,6,0,0,0,6
2024-03-02 06:00:00,5,0,0,3,8
2024-03-02 06:10:00,2,0,0,2,4
2024-03-02 06:20:00,4,0,0,5,9
2024-03-02 06:30:00,7,1,0,13,21
2024-03-02 06:40:00,7,0,0,4,11
2024-03-02 06:50:00,8,1,2,8,19
2024-03-02 07:00:00,6,0,0,10,16
2024-03-02 07:10:00,6,0,0,6,12
2024-03-02 07:20:00,5,0,3,9,17
2024-03-02 07:30:00,6,2,1,11,20
2024-03-02 07:40:00,11,1,3,6,21
2024-03-02 07:50:00,12,0,0,21,33
2024-03-02 08:00:00,14,2,2,13,31
2024-03-02 08:10:00,20,2,0,17,39
2024-03-02 08:20:00,14,1,3,24,42
2024-03-02 08:30:00,22,5,3,28,58
2024-03-02 08:40:00,26,2,5,22,55
2024-03-02 08:50:00,29,3,5,24,61
2024-03-02 09:00:00,28,3,2,32,65
2024-03-02 09:10:00,36,2,3,24,65
2024-03-02 09:20:00,23,3,6,35,67
2024-03-02 09:30:00,33,3,1,40,77
2024-03-02 09:40:00,35,5,7,52,99
2024-03-02 09:50:00,51,3,7,41,102
2024-03-02 10:00:00,39,2,1,40,82
2024-03-02 10:10:00,53,1,5,44,103
2024-03-02 10:20:00,42,6,7,34,89
2024-03-02 10:30:00,45,3,3,37,88
2024-03-02 10:40:00,34,4,5,51,94
2024-03-02 10:50:00,39,5,7,37,88
2024-03-02 11:00:00,46,5,8,49,108
2024-03-02 11:10:00,44,3,7,37,91
2024-03-02 11:20:00,40,4,3,31,78
2024-03-02 11:30:00,41,0,6,37,84
2024-03-02 11:40:00,42,4,8,36,90
2024-03-02 11:50:00,45,7,7,34,93
2024-03-02 12:00:00,33,3,8,35,79
2024-03-02 12:10:00,48,3,7,33,91
2024-03-02 12:20:00,44,2,7,48,101
2024-03-02 12:30:00,52,5,6,53,116
2024-03-02 12:40:00,34,9,5,35,83
2024-03-02 12:50:00,72,3,4,108,187
2024-03-02 13:00:00,75,6,8,107,196
2024-03-02 13:10:00,41,5,15,97,158
2024-03-02 13:20:00,50,8,14,119,191
2024-03-02 13:30:00,54,9,10,45,118
2024-03-02 13:40:00,44,4,15,23,86
2024-03-02 13:50:00,52,7,14,20,93
2024-03-02 14:00:00,55,8,24,27,114
2024-03-02 14:10:00,45,5,21,14,85
2024-03-02 14:20:00,54,3,6,49,112
2024-03-02 14:30:00,46,4,11,52,113
2024-03-02 14:40:00,48,8,9,37,102
2024-03-02 14:50:00,47,4,8,43,102
2024-03-02 15:00:00,45,5,9,44,103
2024-03-02 15:10:00,58,4,6,36,104
2024-03-02 15:20:00,45,3,5,44,97
2024-03-02 15:30:00,54,6,7,34,101
2024-03-02 15:40:00,37,4,2,41,84
2024-03-02 15:50:00,39,4,6,30,79
2024-03-02 16:00:00,37,6,6,35,84
2024-03-02 16:10:00,39,4,5,38,86
2024-03-02 16:20:00,45,2,11,35,93
2024-03-02 16:30:00,36,5,6,29,76
2024-03-02 16:40:00,29,5,7,41,82
2024-03-02 16:50:00,31,3,5,30,69
2024-03-02 17:00:00,43,2,4,40,89
2024-03-02 17:10:00,37,7,8,43,95
2024-03-02 17:20:00,45,3,11,37,96
2024-03-02 17:30:00,45,8,11,47,111
2024-03-02 17:40:00,62,8,7,41,118
2024-03-02 17:50:00,59,10,5,30,104
2024-03-02 18:00:00,53,7,5,44,109
2024-03-02 18:10:00,36,6,4,49,95
2024-03-02 18:20:00,45,5,17,37,104
2024-03-02 18:30:00,55,7,5,40,107
2024-03-02 18:40:00,49,10,7,48,114
2024-03-02 18:50:00,51,9,4,46,110
2024-03-02 19:00:00,44,2,6,57,109
2024-03-02 19:10:00,38,10,7,27,82
2024-03-02 19:20:00,42,7,4,30,83
2024-03-02 19:30:00,34,4,3,27,68
2024-03-02 19:40:00,25,2,3,19,49
2024-03-02 19:50:00,21,4,1,25,51
2024-03-02 20:00:00,28,5,1,29,63
2024-03-02 20:10:00,28,5,0,27,60
2024-03-02 20:20:00,36,1,5,24,66
2024-03-02 20:30:00,29,5,0,27,61
2024-03-02 20:40:00,29,0,1,29,59
2024-03-02 20:50:00,27,2,2,27,58
2024-03-02 21:00:00,28,2,0,15,45
2024-03-02 21:10:00,27,5,3,9,44
2024-03-02 21:20:00,24,5,2,17,48
2024-03-02 21:30:00,21,3,3,16,43
2024-03-02 21:40:00,22,5,6,22,55
2024-03-02 21:50:00,18,2,0,16,36
2024-03-02 22:00:00,16,2,6,24,48
2024-03-02 22:10:00,22,3,3,18,46
2024-03-02 22:20:00,18,9,9,23,59
2024-03-02 22:30:00,24,2,2,10,38
2024-03-02 22:40:00,21,2,2,11,36
2024-03-02 22:50:00,17,4,1,17,39
2024-03-02 23:00:00,22,3,0,6,31
2024-03-02 23:10:00,13,10,2,12,37
2024-03-02 23:20:00,15,5,0,16,36
2024-03-02 23:30:00,8,4,3,8,23
2024-03-02 23:40:00,10,4,2,9,25
2024-03-02 23:50:00,12,0,1,9,22
2024-03-03 00:00:00,20,0,0,7,27
2024-03-03 00:10:00,9,0,1,10,20
2024-03-03 00:20:00,17,1,0,9,27
2024-03-03 00:30:00,12,1,0,1,14
2024-03-03 00:40:00,15,0,4,10,29
2024-03-03 00:50:00,15,1,0,17,33
2024-03-03 01:00:00,9,2,2,2,15
2024-03-03 01:10:00,8,1,1,5,15
2024-03-03 01:20:00,13,4,2,4,23
2024-03-03 01:30:00,8,0,0,6,14
2024-03-03 01:40:00,6,0,1,12,19
2024-03-03 01:50:00,11,0,0,4,15
2024-03-03 02:00:00,7,3,0,3,13
2024-03-03 02:10:00,10,2,2,5,19
2024-03-03 02:20:00,6,2,0,8,16
2024-03-03 02:30:00,2,0,0,2,4
2024-03-03 02:40:00,4,0,0,2,6
2024-03-03 02:50:00,8,0,0,3,11
2024-03-03 03:00:00,5,4,0,2,11
2024-03-03 03:10:00,4,0,1,5,10
2024-03-03 03:20:00,11,0,0,1,12
2024-03-03 03:30:00,8,0,0,7,15
2024-03-03 03:40:00,2,0,0,4,6
2024-03-03 03:50:00,4,0,3,3,10
2024-03-03 04:00:00,6,0,0,4,10
2024-03-03 04:10:00,3,0,0,1,4
2024-03-03 04:20:00,3,0,0,0,3
2024-03-03 04:30:00,1,0,0,2,3
2024-03-03 04:40:00,2,0,0,3,5
2024-03-03 04:50:00,1,0,0,1,2
2024-03-03 05:00:00,5,0,0,0,5
2024-03-03 05:10:00,3,1,0,5,9
2024-03-03 05:20:00,2,0,0,2,4
2024-03-03 05:30:00,2,0,0,1,3
2024-03-03 05:40:00,8,0,0,2,10
2024-03-03 05:50:00,2,0,0,1,3
2024-03-03 06:00:00,3,0,0,4,7
2024-03-03 06:10:00,0,0,0,3,3
2024-03-03 06:20:00,4,0,0,2,6
2024-03-03 06:30:00,2,0,0,5,7
2024-03-03 06:40:00,5,0,0,1,6
2024-03-03 06:50:00,5,0,0,6,11
2024-03-03 07:00:00,3,0,0,3,6
2024-03-03 07:10:00,3,1,1,5,10
2024-03-03 07:20:00,4,0,2,5,11
2024-03-03 07:30:00,5,0,0,4,9
2024-03-03 07:40:00,4,1,1,3,9
2024-03-03 07:50:00,3,1,0,4,8
2024-03-03 08:00:00,6,1,2,2,11
2024-03-03 08:10:00,10,3,1,8,22
2024-03-03 08:20:00,13,1,2,13,29
2024-03-03 08:30:00,17,0,2,10,29
2024-03-03 08:40:00,10,0,1,14,25
2024-03-03 08:50:00,10,0,4,14,28
2024-03-03 09:00:00,9,2,1,9,21
2024-03-03 09:10:00,22,0,0,20,42
2024-03-03 09:20:00,26,2,4,27,59
2024-03-03 09:30:00,32,0,2,33,67
2024-03-03 09:40:00,26,2,2,40,70
2024-03-03 09:50:00,19,1,6,22,48
2024-03-03 10:00:00,26,0,6,31,63
2024-03-03 10:10:00,26,0,3,28,57
2024-03-03 10:20:00,23,0,2,18,43
2024-03-03 10:30:00,25,2,2,29,58
2024-03-03 10:40:00,30,3,4,23,60
2024-03-03 10:50:00,31,4,1,28,64
2024-03-03 11:00:00,32,5,5,33,75
2024-03-03 11:10:00,30,0,3,17,50
2024-03-03 11:20:00,29,2,9,32,72
2024-03-03 11:30:00,24,2,6,24,56
2024-03-03 11:40:00,31,2,8,34,75
2024-03-03 11:50:00,29,3,3,26,61
2024-03-03 12:00:00,41,2,5,26,74
2024-03-03 12:10:00,27,3,6,31,67
2024-03-03 12:20:00,38,3,7,32,80
2024-03-03 12:30:00,38,4,7,32,81
2024-03-03 12:40:00,39,4,4,32,79
2024-03-03 12:50:00,48,4,6,30,88
2024-03-03 13:00:00,32,4,9,21,66
2024-03-03 13:10:00,44,8,10,40,102
2024-03-03 13:20:00,33,2,6,26,67
2024-03-03 13:30:00,52,6,7,29,94
2024-03-03 13:40:00,38,7,6,21,72
2024-03-03 13:50:00,49,7,5,32,93
2024-03-03 14:00:00,44,4,8,28,84
2024-03-03 14:10:00,44,7,5,30,86
2024-03-03 14:20:00,45,4,8,28,85
2024-03-03 14:30:00,32,0,9,39,80
2024-03-03 14:40:00,42,3,4,27,76
2024-03-03 14:50:00,31,10,6,41,88
2024-03-03 15:00:00,32,1,7,38,78
2024-03-03 15:10:00,40,7,6,26,79
2024-03-03 15:20:00,46,2,6,40,94
2024-03-03 15:30:00,37,5,7,32,81
2024-03-03 15:40:00,37,7,4,26,74
2024-03-03 15:50:00,34,2,4,35,75
2024-03-03 16:00:00,32,3,9,29,73
2024-03-03 16:10:00,45,2,10,48,105
2024-03-03 16:20:00,28,3,7,34,72
2024-03-03 16:30:00,26,2,7,37,72
2024-03-03 16:40:00,28,2,6,26,62
2024-03-03 16:50:00,44,5,3,23,75
2024-03-03 17:00:00,33,5,6,27,71
2024-03-03 17:10:00,36,9,13,39,97
2024-03-03 17:20:00,30,3,5,42,80
2024-03-03 17:30:00,35,6,13,40,94
2024-03-03 17:40:00,40,4,10,32,86
2024-03-03 17:50:00,29,6,7,48,90
2024-03-03 18:00:00,20,1,3,32,56
2024-03-03 18:10:00,37,2,6,35,80
2024-03-03 18:20:00,23,4,4,33,64
2024-03-03 18:30:00,28,5,6,45,84
2024-03-03 18:40:00,33,5,3,48,89
2024-03-03 18:50:00,37,1,8,27,73
2024-03-03 19:00:00,23,3,6,32,64
2024-03-03 19:10:00,36,1,1,36,74
2024-03-03 19:20:00,14,3,6,28,51
2024-03-03 19:30:00,27,2,7,22,58
2024-03-03 19:40:00,39,1,2,20,62
2024-03-03 19:50:00,26,0,2,25,53
2024-03-03 20:00:00,33,5,6,20,64
2024-03-03 20:10:00,24,2,1,18,45
2024-03-03 20:20:00,25,1,3,20,49
2024-03-03 20:30:00,17,3,1,25,46
2024-03-03 20:40:00,9,2,1,23,35
2024-03-03 20:50:00,20,1,2,17,40
2024-03-03 21:00:00,18,3,0,16,37
2024-03-03 21:10:00,17,4,1,19,41
2024-03-03 21:20:00,30,3,5,8,46
2024-03-03 21:30:00,14,1,2,10,27
2024-03-03 21:40:00,12,0,4,9,25
2024-03-03 21:50:00,16,4,1,16,37
2024-03-03 22:00:00,11,2,1,11,25
2024-03-03 22:10:00,13,12,0,8,33
2024-03-03 22:20:00,13,4,0,5,22
2024-03-03 22:30:00,9,0,0,6,15
2024-03-03 22:40:00,8,1,0,10,19
2024-03-03 22:50:00,4,1,0,9,14
2024-03-03 23:00:00,9,2,4,5,20
2024-03-03 23:10:00,3,0,0,5,8
2024-03-03 23:20:00,5,1,0,3,9
2024-03-03 23:30:00,1,0,0,2,3
2024-03-03 23:40:00,6,0,1,1,8
2024-03-03 23:50:00,4,0,0,7,11
2024-03-04 00:00:00,1,1,0,3,5
2024-03-04 00:10:00,4,0,0,1,5
2024-03-04 00:20:00,6,0,0,4,10
2024-03-04 00:30:00,5,0,0,1,6
2024-03-04 00:40:00,0,0,0,3,3
2024-03-04 00:50:00,0,1,0,1,2
2024-03-04 01:00:00,4,0,0,4,8
2024-03-04 01:10:00,4,2,0,2,8
2024-03-04 01:20:00,1,0,0,2,3
2024-03-04 01:30:00,2,0,0,2,4
2024-03-04 01:40:00,3,0,0,0,3
2024-03-04 01:50:00,5,0,0,1,6
2024-03-04 02:00:00,1,0,0,0,1
2024-03-04 02:10:00,0,1,0,0,1
2024-03-04 02:20:00,0,0,2,1,3
2024-03-04 02:30:00,3,2,1,0,6
2024-03-04 02:40:00,3,0,0,0,3
2024-03-04 02:50:00,1,0,1,1,3
2024-03-04 03:00:00,1,0,0,0,1
2024-03-04 03:10:00,1,0,0,0,1
2024-03-04 03:20:00,2,0,0,0,2
2024-03-04 03:30:00,0,0,0,1,1
2024-03-04 03:40:00,1,0,0,0,1
2024-03-04 03:50:00,0,0,2,0,2
2024-03-04 04:00:00,4,0,0,1,5
2024-03-04 04:10:00,1,0,0,0,1
2024-03-04 04:20:00,0,0,0,1,1
2024-03-04 04:30:00,0,0,0,0,0
2024-03-04 04:40:00,0,0,0,1,1
2024-03-04 04:50:00,3,1,0,3,7
2024-03-04 05:00:00,3,0,0,1,4
2024-03-04 05:10:00,7,0,4,12,23
2024-03-04 05:20:00,2,0,0,4,6
2024-03-04 05:30:00,9,0,0,10,19
2024-03-04 05:40:00,6,0,5,9,20
2024-03-04 05:50:00,13,2,1,9,25
2024-03-04 06:00:00,10,0,5,14,29
2024-03-04 06:10:00,13,1,0,20,34
2024-03-04 06:20:00,16,2,1,18,37
2024-03-04 06:30:00,13,1,4,20,38
2024-03-04 06:40:00,21,1,1,25,48
2024-03-04 06:50:00,17,0,5,38,60
2024-03-04 07:00:00,19,4,9,47,79
2024-03-04 07:10:00,28,2,8,46,84
2024-03-04 07:20:00,43,3,13,60,119
2024-03-04 07:30:00,55,6,13,57,131
2024-03-04 07:40:00,38,3,8,66,115
2024-03-04 07:50:00,48,3,9,56,116
2024-03-04 08:00:00,34,3,12,52,101
2024-03-04 08:10:00,45,6,10,58,119
2024-03-04 08:20:00,45,2,6,41,94
2024-03-04 08:30:00,47,4,4,52,107
2024-03-04 08:40:00,38,3,8,47,96
2024-03-04 08:50:00,46,3,4,49,102
2024-03-04 09:00:00,36,2,8,34,80
2024-03-04 09:10:00,39,1,6,38,84
2024-03-04 09:20:00,33,4,12,46,95
2024-03-04 09:30:00,31,4,3,43,81
2024-03-04 09:40:00,55,8,8,47,118
2024-03-04 09:50:00,32,5,4,47,88
2024-03-04 10:00:00,26,3,5,46,80
2024-03-04 10:10:00,36,3,3,47,89
2024-03-04 10:20:00,41,5,8,44,98
2024-03-04 10:30:00,40,3,2,43,88
2024-03-04 10:40:00,47,7,9,47,110
2024-03-04 10:50:00,42,5,2,37,86
2024-03-04 11:00:00,40,4,3,37,84
2024-03-04 11:10:00,46,2,3,48,99
2024-03-04 11:20:00,41,5,4,50,100
2024-03-04 11:30:00,42,3,1,50,96
2024-03-04 11:40:00,37,8,6,39,90
2024-03-04 11:50:00,33,4,2,36,75
2024-03-04 12:00:00,52,5,5,54,116
2024-03-04 12:10:00,45,3,7,36,91
2024-03-04 12:20:00,46,3,6,49,104
2024-03-04 12:30:00,48,3,7,59,117
2024-03-04 12:40:00,50,5,6,36,97
2024-03-04 12:50:00,39,6,3,35,83
2024-03-04 13:00:00,49,7,8,46,110
2024-03-04 13:10:00,46,10,11,43,110
2024-03-04 13:20:00,51,8,6,49,114
2024-03-04 13:30:00,39,7,2,36,84
2024-03-04 13:40:00,49,7,8,57,121
2024-03-04 13:50:00,53,9,5,34,101
2024-03-04 14:00:00,42,2,12,40,96
2024-03-04 14:10:00,39,3,4,35,81
2024-03-04 14:20:00,42,6,4,49,101
2024-03-04 14:30:00,40,5,6,41,92
2024-03-04 14:40:00,54,2,6,45,107
2024-03-04 14:50:00,56,5,7,40,108
2024-03-04 15:00:00,54,5,4,49,112
2024-03-04 15:10:00,38,7,9,55,109
2024-03-04 15:20:00,55,6,4,40,105
2024-03-04 15:30:00,38,8,6,38,90
2024-03-04 15:40:00,62,10,13,51,136
2024-03-04 15:50:00,55,8,2,43,108
2024-03-04 16:00:00,49,7,7,45,108
2024-03-04 16:10:00,62,5,3,42,112
2024-03-04 16:20:00,49,6,6,38,99
2024-03-04 16:30:00,62,4,6,40,112
2024-03-04 16:40:00,54,10,10,45,119
2024-03-04 16:50:00,54,8,13,47,122
2024-03-04 17:00:00,69,12,5,46,132
2024-03-04 17:10:00,49,6,18,43,116
2024-03-04 17:20:00,55,7,5,43,110
2024-03-04 17:30:00,48,5,6,44,103
2024-03-04 17:40:00,63,9,5,48,125
2024-03-04 17:50:00,51,3,11,36,101
2024-03-04 18:00:00,41,2,9,45,97
2024-03-04 18:10:00,52,7,15,34,108
2024-03-04 18:20:00,41,8,4,35,88
2024-03-04 18:30:00,54,13,9,48,124
2024-03-04 18:40:00,36,8,8,61,113
2024-03-04 18:50:00,49,4,8,45,106
2024-03-04 19:00:00,31,6,5,41,83
2024-03-04 19:10:00,29,4,4,34,71
2024-03-04 19:20:00,46,5,12,39,102
2024-03-04 19:30:00,29,3,5,39,76
2024-03-04 19:40:00,33,5,4,33,75
2024-03-04 19:50:00,28,3,2,21,54
2024-03-04 20:00:00,23,4,2,26,55
2024-03-04 20:10:00,29,10,8,21,68
2024-03-04 20:20:00,16,1,4,21,42
2024-03-04 20:30:00,23,1,5,27,56
2024-03-04 20:40:00,16,4,0,19,39
2024-03-04 20:50:00,20,1,1,15,37
2024-03-04 21:00:00,26,2,3,22,53
2024-03-04 21:10:00,25,3,7,21,56
2024-03-04 21:20:00,19,2,1,24,46
2024-03-04 21:30:00,27,1,2,15,45
2024-03-04 21:40:00,12,3,1,15,31
2024-03-04 21:50:00,15,1,4,15,35
2024-03-04 22:00:00,18,3,4,12,37
2024-03-04 22:10:00,21,5,1,16,43
2024-03-04 22:20:00,23,5,0,20,48
2024-03-04 22:30:00,26,2,2,8,38
2024-03-04 22:40:00,19,2,0,3,24
2024-03-04 22:50:00,9,2,0,7,18
2024-03-04 23:00:00,18,0,1,6,25
2024-03-04 23:10:00,7,1,1,9,18
2024-03-04 23:20:00,7,0,2,5,14
2024-03-04 23:30:00,6,0,0,4,10
2024-03-04 23:40:00,9,0,0,3,12
2024-03-04 23:50:00,5,1,0,2,8
2024-03-05 00:00:00,5,0,1,3,9
2024-03-05 00:10:00,4,0,1,1,6
2024-03-05 00:20:00,7,0,0,2,9
2024-03-05 00:30:00,0,0,0,0,0
2024-03-05 00:40:00,1,0,0,0,1
2024-03-05 00:50:00,5,0,0,2,7
2024-03-05 01:00:00,3,0,0,1,4
2024-03-05 01:10:00,2,0,0,0,2
2024-03-05 01:20:00,0,0,0,5,5
2024-03-05 01:30:00,1,0,0,0,1
2024-03-05 01:40:00,1,0,0,2,3
2024-03-05 01:50:00,5,0,0,2,7
2024-03-05 02:00:00,0,0,0,0,0
2024-03-05 02:10:00,0,2,0,0,2
2024-03-05 02:20:00,0,0,0,0,0
2024-03-05 02:30:00,0,0,0,0,0
2024-03-05 02:40:00,5,0,0,2,7
2024-03-05 02:50:00,0,0,0,0,0
2024-03-05 03:00:00,2,0,0,0,2
2024-03-05 03:10:00,3,0,0,0,3
2024-03-05 03:20:00,2,0,1,0,3
2024-03-05 03:30:00,2,0,0,1,3
2024-03-05 03:40:00,1,0,1,0,2
2024-03-05 03:50:00,0,0,0,1,1
2024-03-05 04:00:00,4,0,0,0,4
2024-03-05 04:10:00,2,0,1,2,5
2024-03-05 04:20:00,2,0,0,1,3
2024-03-05 04:30:00,1,0,0,1,2
2024-03-05 04:40:00,1,0,0,1,2
2024-03-05 04:50:00,2,0,1,1,4
2024-03-05 05:00:00,3,0,1,7,11
2024-03-05 05:10:00,4,0,2,8,14
2024-03-05 05:20:00,9,0,4,2,15
2024-03-05 05:30:00,6,0,1,12,19
2024-03-05 05:40:00,5,1,5,8,19
2024-03-05 05:50:00,10,0,3,11,24
2024-03-05 06:00:00,9,0,4,9,22
2024-03-05 06:10:00,15,0,1,21,37
2024-03-05 06:20:00,12,1,0,21,34
2024-03-05 06:30:00,13,3,3,17,36
2024-03-05 06:40:00,27,1,1,26,55
2024-03-05 06:50:00,16,0,2,34,52
2024-03-05 07:00:00,19,1,6,43,69
2024-03-05 07:10:00,29,3,8,53,93
2024-03-05 07:20:00,39,4,4,67,114
2024-03-05 07:30:00,38,3,5,72,118
2024-03-05 07:40:00,56,3,13,60,132
2024-03-05 07:50:00,51,6,11,49,117
2024-03-05 08:00:00,44,3,12,61,120
2024-03-05 08:10:00,47,7,10,59,123
2024-03-05 08:20:00,51,4,13,48,116
2024-03-05 08:30:00,48,4,9,49,110
2024-03-05 08:40:00,41,4,3,57,105
2024-03-05 08:50:00,55,4,5,40,104
2024-03-05 09:00:00,30,2,14,52,98
2024-03-05 09:10:00,40,6,6,48,100
2024-03-05 09:20:00,47,6,8,46,107
2024-03-05 09:30:00,44,3,4,43,94
2024-03-05 09:40:00,41,2,5,41,89
2024-03-05 09:50:00,38,4,7,53,102
2024-03-05 10:00:00,37,3,4,41,85
2024-03-05 10:10:00,36,3,7,43,89
2024-03-05 10:20:00,32,12,12,41,97
2024-03-05 10:30:00,42,4,3,42,91
2024-03-05 10:40:00,42,12,3,39,96
2024-03-05 10:50:00,38,6,5,41,90
2024-03-05 11:00:00,34,6,6,32,78
2024-03-05 11:10:00,52,7,7,39,105
2024-03-05 11:20:00,40,2,4,39,85
2024-03-05 11:30:00,35,1,5,46,87
2024-03-05 11:40:00,47,4,4,40,95
2024-03-05 11:50:00,40,2,8,49,99
2024-03-05 12:00:00,48,7,4,35,94
2024-03-05 12:10:00,36,4,3,38,81
2024-03-05 12:20:00,49,10,4,45,108
2024-03-05 12:30:00,35,3,7,43,88
2024-03-05 12:40:00,32,8,6,47,93
2024-03-05 12:50:00,40,2,5,28,75
2024-03-05 13:00:00,44,7,4,38,93
2024-03-05 13:10:00,54,5,10,35,104
2024-03-05 13:20:00,46,2,9,44,101
2024-03-05 13:30:00,44,5,5,43,97
2024-03-05 13:40:00,59,6,7,49,121
2024-03-05 13:50:00,53,6,6,39,104
2024-03-05 14:00:00,49,5,4,45,103
2024-03-05 14:10:00,52,5,4,43,104
2024-03-05 14:20:00,33,5,8,40,86
2024-03-05 14:30:00,57,6,3,39,105
2024-03-05 14:40:00,51,6,5,43,105
2024-03-05 14:50:00,52,6,5,37,100
2024-03-05 15:00:00,49,4,2,48,103
2024-03-05 15:10:00,50,4,6,48,108
2024-03-05 15:20:00,46,6,8,43,103
2024-03-05 15:30:00,58,5,5,41,109
2024-03-05 15:40:00,60,5,6,44,115
2024-03-05 15:50:00,54,9,2,46,111
2024-03-05 16:00:00,67,6,4,41,118
2024-03-05 16:10:00,63,5,3,43,114
2024-03-05 16:20:00,59,6,5,48,118
2024-03-05 16:30:00,62,8,12,47,129
2024-03-05 16:40:00,47,4,5,46,102
2024-03-05 16:50:00,48,8,12,42,110
2024-03-05 17:00:00,66,8,6,54,134
2024-03-05 17:10:00,52,8,9,44,113
2024-03-05 17:20:00,49,7,9,56,121
2024-03-05 17:30:00,57,6,11,42,116
2024-03-05 17:40:00,55,8,7,46,116
2024-03-05 17:50:00,52,7,2,53,114
2024-03-05 18:00:00,52,6,8,40,106
2024-03-05 18:10:00,52,6,5,37,100
2024-03-05 18:20:00,45,11,7,40,103
2024-03-05 18:30:00,55,16,15,54,140
2024-03-05 18:40:00,50,12,11,62,135
2024-03-05 18:50:00,48,11,8,51,118
2024-03-05 19:00:00,43,11,10,50,114
2024-03-05 19:10:00,42,3,1,35,81
2024-03-05 19:20:00,53,6,6,30,95
2024-03-05 19:30:00,28,3,5,27,63
2024-03-05 19:40:00,48,6,9,42,105
2024-03-05 19:50:00,36,8,5,28,77
2024-03-05 20:00:00,33,6,5,32,76
2024-03-05 20:10:00,28,3,1,21,53
2024-03-05 20:20:00,27,5,1,27,60
2024-03-05 20:30:00,31,2,3,20,56
2024-03-05 20:40:00,25,8,8,27,68
2024-03-05 20:50:00,20,2,5,11,38
2024-03-05 21:00:00,27,2,2,21,52
2024-03-05 21:10:00,20,6,3,22,51
2024-03-05 21:20:00,18,1,3,11,33
2024-03-05 21:30:00,18,1,3,20,42
2024-03-05 21:40:00,11,3,2,26,42
2024-03-05 21:50:00,20,2,1,11,34
2024-03-05 22:00:00,14,2,0,7,23
2024-03-05 22:10:00,19,3,5,17,44
2024-03-05 22:20:00,18,3,1,10,32
2024-03-05 22:30:00,20,6,0,16,42
2024-03-05 22:40:00,18,8,0,12,38
2024-03-05 22:50:00,14,0,0,3,17
2024-03-05 23:00:00,13,1,8,3,25
2024-03-05 23:10:00,12,3,1,10,26
2024-03-05 23:20:00,4,2,0,8,14
2024-03-05 23:30:00,5,7,1,3,16
2024-03-05 23:40:00,3,2,2,0,7
2024-03-05 23:50:00,8,0,0,2,10
2024-03-06 00:00:00,3,0,0,3,6
2024-03-06 00:10:00,7,0,1,2,10
2024-03-06 00:20:00,6,0,1,1,8
2024-03-06 00:30:00,3,0,0,5,8
2024-03-06 00:40:00,4,0,0,2,6
2024-03-06 00:50:00,5,0,0,2,7
2024-03-06 01:00:00,2,0,0,1,3
2024-03-06 01:10:00,3,0,0,1,4
2024-03-06 01:20:00,2,0,0,2,4
2024-03-06 01:30:00,4,0,0,2,6
2024-03-06 01:40:00,3,0,0,3,6
2024-03-06 01:50:00,3,0,1,2,6
2024-03-06 02:00:00,3,0,0,3,6
2024-03-06 02:10:00,2,0,0,2,4
2024-03-06 02:20:00,1,4,0,0,5
2024-03-06 02:30:00,1,0,1,0,2
2024-03-06 02:40:00,3,0,0,0,3
2024-03-06 02:50:00,3,0,0,2,5
2024-03-06 03:00:00,1,0,0,2,3
2024-03-06 03:10:00,1,0,1,1,3
2024-03-06 03:20:00,7,0,0,0,7
2024-03-06 03:30:00,2,0,0,1,3
2024-03-06 03:40:00,0,0,3,1,4
2024-03-06 03:50:00,0,0,0,2,2
2024-03-06 04:00:00,3,0,0,0,3
2024-03-06 04:10:00,1,0,0,2,3
2024-03-06 04:20:00,2,0,0,1,3
2024-03-06 04:30:00,2,0,0,2,4
2024-03-06 04:40:00,2,0,0,1,3
2024-03-06 04:50:00,2,0,0,1,3
2024-03-06 05:00:00,1,0,0,6,7
2024-03-06 05:10:00,3,0,4,4,11
2024-03-06 05:20:00,10,0,0,4,14
2024-03-06 05:30:00,6,0,4,8,18
2024-03-06 05:40:00,2,0,7,12,21
2024-03-06 05:50:00,16,0,4,6,26
2024-03-06 06:00:00,7,0,5,21,33
2024-03-06 06:10:00,7,0,2,20,29
2024-03-06 06:20:00,15,1,1,20,37
2024-03-06 06:30:00,13,2,1,17,33
2024-03-06 06:40:00,19,3,5,22,49
2024-03-06 06:50:00,24,0,2,34,60
2024-03-06 07:00:00,15,3,5,45,68
2024-03-06 07:10:00,25,1,7,64,97
2024-03-06 07:20:00,39,1,7,59,106
2024-03-06 07:30:00,45,4,9,61,119
2024-03-06 07:40:00,54,2,7,47,110
2024-03-06 07:50:00,36,5,7,53,101
2024-03-06 08:00:00,59,4,3,36,102
2024-03-06 08:10:00,53,8,9,61,131
2024-03-06 08:20:00,45,3,5,48,101
2024-03-06 08:30:00,38,5,12,53,108
2024-03-06 08:40:00,43,2,4,40,89
2024-03-06 08:50:00,37,3,2,45,87
2024-03-06 09:00:00,35,3,9,39,86
2024-03-06 09:10:00,36,9,4,40,89
2024-03-06 09:20:00,30,3,3,50,86
2024-03-06 09:30:00,29,3,4,52,88
2024-03-06 09:40:00,35,2,7,52,96
2024-03-06 09:50:00,37,6,5,43,91
2024-03-06 10:00:00,30,2,2,37,71
2024-03-06 10:10:00,26,6,2,44,78
2024-03-06 10:20:00,27,6,2,44,79
2024-03-06 10:30:00,44,6,4,53,107
2024-03-06 10:40:00,45,5,7,35,92
2024-03-06 10:50:00,39,4,5,38,86
2024-03-06 11:00:00,29,4,4,47,84
2024-03-06 11:10:00,47,2,5,35,89
2024-03-06 11:20:00,31,5,5,58,99
2024-03-06 11:30:00,42,4,6,46,98
2024-03-06 11:40:00,46,3,4,49,102
2024-03-06 11:50:00,39,8,5,42,94
2024-03-06 12:00:00,39,2,9,65,115
2024-03-06 12:10:00,37,5,7,54,103
2024-03-06 12:20:00,40,8,7,46,101
2024-03-06 12:30:00,46,9,4,47,106
2024-03-06 12:40:00,47,3,4,42,96
2024-03-06 12:50:00,44,4,4,35,87
2024-03-06 13:00:00,41,8,4,46,99
2024-03-06 13:10:00,43,7,5,48,103
2024-03-06 13:20:00,33,2,4,55,94
2024-03-06 13:30:00,52,4,5,43,104
2024-03-06 13:40:00,47,6,3,45,101
2024-03-06 13:50:00,54,5,13,60,132
2024-03-06 14:00:00,45,3,3,33,84
2024-03-06 14:10:00,53,13,6,49,121
2024-03-06 14:20:00,45,7,5,39,96
2024-03-06 14:30:00,36,3,6,47,92
2024-03-06 14:40:00,52,8,10,51,121
2024-03-06 14:50:00,46,5,6,46,103
2024-03-06 15:00:00,38,3,9,54,104
2024-03-06 15:10:00,57,3,5,50,115
2024-03-06 15:20:00,46,5,5,42,98
2024-03-06 15:30:00,61,6,5,40,112
2024-03-06 15:40:00,49,4,5,44,102
2024-03-06 15:50:00,46,5,5,45,101
2024-03-06 16:00:00,58,5,6,37,106
2024-03-06 16:10:00,46,8,5,42,101
2024-03-06 16:20:00,59,2,12,58,131
2024-03-06 16:30:00,48,7,10,47,112
2024-03-06 16:40:00,37,6,7,46,96
2024-03-06 16:50:00,58,9,8,44,119
2024-03-06 17:00:00,68,12,14,44,138
2024-03-06 17:10:00,55,7,8,54,124
2024-03-06 17:20:00,52,10,7,40,109
2024-03-06 17:30:00,56,8,11,38,113
2024-03-06 17:40:00,40,10,12,43,105
2024-03-06 17:50:00,55,6,10,39,110
2024-03-06 18:00:00,49,8,6,44,107
2024-03-06 18:10:00,60,9,10,49,128
2024-03-06 18:20:00,40,8,13,36,97
2024-03-06 18:30:00,44,12,9,41,106
2024-03-06 18:40:00,37,12,17,34,100
2024-03-06 18:50:00,54,6,13,35,108
2024-03-06 19:00:00,31,10,12,47,100
2024-03-06 19:10:00,41,4,6,37,88
2024-03-06 19:20:00,29,4,6,29,68
2024-03-06 19:30:00,36,6,8,29,79
2024-03-06 19:40:00,36,3,2,33,74
2024-03-06 19:50:00,36,3,4,25,68
2024-03-06 20:00:00,33,1,3,30,67
2024-03-06 20:10:00,26,6,2,30,64
2024-03-06 20:20:00,27,3,5,22,57
2024-03-06 20:30:00,26,4,0,18,48
2024-03-06 20:40:00,37,4,2,19,62
2024-03-06 20:50:00,18,9,7,21,55
2024-03-06 21:00:00,25,8,3,17,53
2024-03-06 21:10:00,16,4,2,18,40
2024-03-06 21:20:00,19,3,0,23,45
2024-03-06 21:30:00,16,3,0,21,40
2024-03-06 21:40:00,17,4,4,24,49
2024-03-06 21:50:00,15,1,3,29,48
2024-03-06 22:00:00,20,9,3,19,51
2024-03-06 22:10:00,26,1,5,20,52
2024-03-06 22:20:00,22,5,5,14,46
2024-03-06 22:30:00,21,2,4,12,39
2024-03-06 22:40:00,20,1,1,8,30
2024-03-06 22:50:00,17,2,0,14,33
2024-03-06 23:00:00,30,2,3,14,49
2024-03-06 23:10:00,14,0,2,7,23
2024-03-06 23:20:00,8,6,0,9,23
2024-03-06 23:30:00,10,1,1,9,21
2024-03-06 23:40:00,5,0,0,3,8
2024-03-06 23:50:00,11,0,0,5,16
2024-03-07 00:00:00,2,1,0,2,5
2024-03-07 00:10:00,6,2,0,5,13
2024-03-07 00:20:00,7,0,0,3,10
2024-03-07 00:30:00,3,0,0,0,3
2024-03-07 00:40:00,5,0,0,5,10
2024-03-07 00:50:00,2,0,0,2,4
2024-03-07 01:00:00,5,0,0,3,8
2024-03-07 01:10:00,5,0,0,3,8
2024-03-07 01:20:00,3,2,0,4,9
2024-03-07 01:30:00,1,0,0,1,2
2024-03-07 01:40:00,1,0,0,1,2
2024-03-07 01:50:00,4,0,0,0,4
2024-03-07 02:00:00,3,0,0,4,7
2024-03-07 02:10:00,2,0,0,2,4
2024-03-07 02:20:00,2,0,0,1,3
2024-03-07 02:30:00,1,0,1,0,2
2024-03-07 02:40:00,3,0,0,2,5
2024-03-07 02:50:00,5,1,0,4,10
2024-03-07 03:00:00,2,0,0,0,2
2024-03-07 03:10:00,0,0,1,2,3
2024-03-07 03:20:00,7,0,0,0,7
2024-03-07 03:30:00,3,1,0,2,6
2024-03-07 03:40:00,0,0,0,2,2
2024-03-07 03:50:00,0,0,1,3,4
2024-03-07 04:00:00,2,0,0,1,3
2024-03-07 04:10:00,0,0,0,2,2
2024-03-07 04:20:00,2,0,0,1,3
2024-03-07 04:30:00,1,0,0,2,3
2024-03-07 04:40:00,1,0,0,0,1
2024-03-07 04:50:00,0,0,3,2,5
2024-03-07 05:00:00,5,1,2,4,12
2024-03-07 05:10:00,5,0,2,8,15
2024-03-07 05:20:00,8,0,3,2,13
2024-03-07 05:30:00,2,0,1,11,14
2024-03-07 05:40:00,4,0,8,10,22
2024-03-07 05:50:00,8,1,2,6,17
2024-03-07 06:00:00,8,1,1,11,21
2024-03-07 06:10:00,3,0,3,17,23
2024-03-07 06:20:00,16,1,0,21,38
2024-03-07 06:30:00,18,1,1,20,40
2024-03-07 06:40:00,16,1,5,23,45
2024-03-07 06:50:00,19,0,6,26,51
2024-03-07 07:00:00,24,4,7,43,78
2024-03-07 07:10:00,34,1,4,64,103
2024-03-07 07:20:00,32,3,7,52,94
2024-03-07 07:30:00,48,3,6,70,127
2024-03-07 07:40:00,55,10,7,54,126
2024-03-07 07:50:00,44,7,17,60,128
2024-03-07 08:00:00,45,2,13,55,115
2024-03-07 08:10:00,50,4,10,58,122
2024-03-07 08:20:00,46,1,9,62,118
2024-03-07 08:30:00,40,1,10,60,111
2024-03-07 08:40:00,40,3,10,42,95
2024-03-07 08:50:00,32,3,5,37,77
2024-03-07 09:00:00,48,1,5,48,102
2024-03-07 09:10:00,32,3,3,54,92
2024-03-07 09:20:00,38,6,9,50,103
2024-03-07 09:30:00,31,1,1,52,85
2024-03-07 09:40:00,38,6,5,53,102
2024-03-07 09:50:00,42,4,4,75,125
2024-03-07 10:00:00,43,4,4,48,99
2024-03-07 10:10:00,35,0,6,39,80
2024-03-07 10:20:00,35,4,8,52,99
2024-03-07 10:30:00,38,1,5,52,96
2024-03-07 10:40:00,47,8,3,47,105
2024-03-07 10:50:00,52,5,5,54,116
2024-03-07 11:00:00,43,7,9,54,113
2024-03-07 11:10:00,44,7,7,57,115
2024-03-07 11:20:00,43,5,7,59,114
2024-03-07 11:30:00,38,5,6,39,88
2024-03-07 11:40:00,53,4,3,56,116
2024-03-07 11:50:00,50,5,8,48,111
2024-03-07 12:00:00,39,6,5,44,94
2024-03-07 12:10:00,46,4,9,49,108
2024-03-07 12:20:00,44,5,9,62,120
2024-03-07 12:30:00,35,10,5,52,102
2024-03-07 12:40:00,36,6,7,44,93
2024-03-07 12:50:00,56,7,6,50,119
2024-03-07 13:00:00,49,0,9,47,105
2024-03-07 13:10:00,38,5,4,56,103
2024-03-07 13:20:00,54,6,8,57,125
2024-03-07 13:30:00,45,3,7,43,98
2024-03-07 13:40:00,65,4,6,54,129
2024-03-07 13:50:00,52,6,4,43,105
2024-03-07 14:00:00,36,3,10,43,92
2024-03-07 14:10:00,52,8,7,56,123
2024-03-07 14:20:00,45,3,6,56,110
2024-03-07 14:30:00,45,5,14,36,100
2024-03-07 14:40:00,52,7,7,60,126
2024-03-07 14:50:00,55,2,6,59,122
2024-03-07 15:00:00,53,12,6,51,122
2024-03-07 15:10:00,57,6,8,49,120
2024-03-07 15:20:00,48,11,4,59,122
2024-03-07 15:30:00,50,5,8,58,121
2024-03-07 15:40:00,60,4,7,77,148
2024-03-07 15:50:00,52,3,9,49,113
2024-03-07 16:00:00,58,11,2,68,139
2024-03-07 16:10:00,49,6,9,57,121
2024-03-07 16:20:00,54,6,9,48,117
2024-03-07 16:30:00,53,6,2,58,119
2024-03-07 16:40:00,61,7,5,59,132
2024-03-07 16:50:00,61,8,6,58,133
2024-03-07 17:00:00,54,11,10,47,122
2024-03-07 17:10:00,52,5,6,52,115
2024-03-07 17:20:00,54,9,6,56,125
2024-03-07 17:30:00,45,2,7,54,108
2024-03-07 17:40:00,72,8,12,52,144
2024-03-07 17:50:00,48,7,7,45,107
2024-03-07 18:00:00,57,5,7,40,109
2024-03-07 18:10:00,46,3,16,48,113
2024-03-07 18:20:00,48,8,13,43,112
2024-03-07 18:30:00,47,18,14,41,120
2024-03-07 18:40:00,56,8,9,49,122
2024-03-07 18:50:00,51,7,8,36,102
2024-03-07 19:00:00,41,0,13,53,107
2024-03-07 19:10:00,42,12,6,37,97
2024-03-07 19:20:00,53,1,5,39,98
2024-03-07 19:30:00,31,5,2,35,73
2024-03-07 19:40:00,43,4,4,31,82
2024-03-07 19:50:00,39,7,4,25,75
2024-03-07 20:00:00,33,1,4,13,51
2024-03-07 20:10:00,39,4,8,30,81
2024-03-07 20:20:00,22,6,1,30,59
2024-03-07 20:30:00,25,0,4,20,49
2024-03-07 20:40:00,28,2,2,23,55
2024-03-07 20:50:00,22,2,4,15,43
2024-03-07 21:00:00,22,2,0,12,36
2024-03-07 21:10:00,25,2,2,19,48
2024-03-07 21:20:00,23,2,2,18,45
2024-03-07 21:30:00,19,2,4,19,44
2024-03-07 21:40:00,17,5,7,19,48
2024-03-07 21:50:00,19,3,2,16,40
2024-03-07 22:00:00,20,6,1,14,41
2024-03-07 22:10:00,21,0,4,22,47
2024-03-07 22:20:00,25,3,6,17,51
2024-03-07 22:30:00,13,1,1,11,26
2024-03-07 22:40:00,10,1,0,8,19
2024-03-07 22:50:00,15,6,2,13,36
2024-03-07 23:00:00,14,0,1,5,20
2024-03-07 23:10:00,13,3,0,10,26
2024-03-07 23:20:00,16,4,0,9,29
2024-03-07 23:30:00,4,0,1,3,8
2024-03-07 23:40:00,12,4,0,3,19
2024-03-07 23:50:00,7,1,1,2,11
2024-03-08 00:00:00,6,0,0,4,10
2024-03-08 00:10:00,3,3,0,3,9
2024-03-08 00:20:00,6,0,1,0,7
2024-03-08 00:30:00,7,0,0,3,10
2024-03-08 00:40:00,7,0,0,4,11
2024-03-08 00:50:00,3,0,0,0,3
2024-03-08 01:00:00,0,0,0,2,2
2024-03-08 01:10:00,4,0,0,0,4
2024-03-08 01:20:00,0,0,0,4,4
2024-03-08 01:30:00,2,0,0,2,4
2024-03-08 01:40:00,6,0,0,1,7
2024-03-08 01:50:00,1,0,0,1,2
2024-03-08 02:00:00,1,0,0,1,2
2024-03-08 02:10:00,5,1,0,2,8
2024-03-08 02:20:00,2,0,0,3,5
2024-03-08 02:30:00,3,0,0,0,3
2024-03-08 02:40:00,0,1,0,1,2
2024-03-08 02:50:00,1,0,0,0,1
2024-03-08 03:00:00,0,0,0,2,2
2024-03-08 03:10:00,2,0,0,0,2
2024-03-08 03:20:00,4,0,0,1,5
2024-03-08 03:30:00,1,0,0,1,2
2024-03-08 03:40:00,1,0,2,0,3
2024-03-08 03:50:00,0,0,0,1,1
2024-03-08 04:00:00,4,0,0,1,5
2024-03-08 04:10:00,0,0,0,1,1
2024-03-08 04:20:00,0,0,0,1,1
2024-03-08 04:30:00,2,0,0,2,4
2024-03-08 04:40:00,2,0,0,1,3
2024-03-08 04:50:00,2,0,0,7,9
2024-03-08 05:00:00,4,0,0,4,8
2024-03-08 05:10:00,4,0,3,11,18
2024-03-08 05:20:00,8,0,0,7,15
2024-03-08 05:30:00,4,1,4,10,19
2024-03-08 05:40:00,3,0,3,9,15
2024-03-08 05:50:00,4,1,2,6,13
2024-03-08 06:00:00,3,0,3,16,22
2024-03-08 06:10:00,11,0,1,15,27
2024-03-08 06:20:00,13,3,0,16,32
2024-03-08 06:30:00,14,1,3,19,37
2024-03-08 06:40:00,21,2,4,29,56
2024-03-08 06:50:00,19,2,3,29,53
2024-03-08 07:00:00,15,2,6,40,63
2024-03-08 07:10:00,29,4,9,52,94
2024-03-08 07:20:00,36,1,10,59,106
2024-03-08 07:30:00,39,6,7,45,97
2024-03-08 07:40:00,43,4,4,53,104
2024-03-08 07:50:00,38,3,7,49,97
2024-03-08 08:00:00,43,6,13,51,113
2024-03-08 08:10:00,35,2,4,42,83
2024-03-08 08:20:00,48,0,7,58,113
2024-03-08 08:30:00,56,4,6,55,121
2024-03-08 08:40:00,44,6,7,56,113
2024-03-08 08:50:00,40,5,3,41,89
2024-03-08 09:00:00,46,8,5,44,103
2024-03-08 09:10:00,53,1,2,41,97
2024-03-08 09:20:00,36,3,7,51,97
2024-03-08 09:30:00,50,4,1,44,99
2024-03-08 09:40:00,35,7,5,54,101
2024-03-08 09:50:00,39,4,2,50,95
2024-03-08 10:00:00,42,2,4,52,100
2024-03-08 10:10:00,25,3,5,48,81
2024-03-08 10:20:00,42,8,8,60,118
2024-03-08 10:30:00,49,2,4,47,102
2024-03-08 10:40:00,32,3,4,56,95
2024-03-08 10:50:00,34,10,5,51,100
2024-03-08 11:00:00,45,5,3,44,97
2024-03-08 11:10:00,52,3,9,43,107
2024-03-08 11:20:00,34,3,11,57,105
2024-03-08 11:30:00,43,6,7,46,102
2024-03-08 11:40:00,41,3,8,34,86
2024-03-08 11:50:00,46,7,8,50,111
2024-03-08 12:00:00,55,5,8,59,127
2024-03-08 12:10:00,54,7,6,50,117
2024-03-08 12:20:00,53,11,10,48,122
2024-03-08 12:30:00,43,4,6,52,105
2024-03-08 12:40:00,41,6,8,56,111
2024-03-08 12:50:00,62,7,3,51,123
2024-03-08 13:00:00,46,7,8,58,119
2024-03-08 13:10:00,60,11,10,44,125
2024-03-08 13:20:00,50,10,5,54,119
2024-03-08 13:30:00,60,6,10,52,128
2024-03-08 13:40:00,70,10,8,34,122
2024-03-08 13:50:00,67,17,6,47,137
2024-03-08 14:00:00,39,4,8,55,106
2024-03-08 14:10:00,44,4,4,42,94
2024-03-08 14:20:00,61,6,6,62,135
2024-03-08 14:30:00,53,5,5,52,115
2024-03-08 14:40:00,56,7,4,52,119
2024-03-08 14:50:00,58,6,10,55,129
2024-03-08 15:00:00,72,4,9,55,140
2024-03-08 15:10:00,64,14,11,62,151
2024-03-08 15:20:00,57,4,7,51,119
2024-03-08 15:30:00,59,5,5,53,122
2024-03-08 15:40:00,64,11,7,59,141
2024-03-08 15:50:00,59,3,5,43,110
2024-03-08 16:00:00,48,7,9,69,133
2024-03-08 16:10:00,42,8,11,46,107
2024-03-08 16:20:00,61,3,11,61,136
2024-03-08 16:30:00,44,6,12,61,123
2024-03-08 16:40:00,59,9,7,55,130
2024-03-08 16:50:00,45,2,10,49,106
2024-03-08 17:00:00,48,11,3,62,124
2024-03-08 17:10:00,62,9,11,56,138
2024-03-08 17:20:00,70,7,13,64,154
2024-03-08 17:30:00,50,4,9,56,119
2024-03-08 17:40:00,43,9,14,55,121
2024-03-08 17:50:00,36,7,5,43,91
2024-03-08 18:00:00,45,3,16,33,97
2024-03-08 18:10:00,52,11,7,36,106
2024-03-08 18:20:00,46,4,9,31,90
2024-03-08 18:30:00,44,8,6,46,104
2024-03-08 18:40:00,51,4,6,41,102
2024-03-08 18:50:00,56,5,12,40,113
2024-03-08 19:00:00,31,5,4,44,84
2024-03-08 19:10:00,39,9,5,48,101
2024-03-08 19:20:00,42,6,5,36,89
2024-03-08 19:30:00,41,8,1,42,92
2024-03-08 19:40:00,32,9,3,42,86
2024-03-08 19:50:00,25,4,1,24,54
2024-03-08 20:00:00,34,4,2,34,74
2024-03-08 20:10:00,30,3,2,31,66
2024-03-08 20:20:00,22,0,3,35,60
2024-03-08 20:30:00,30,4,2,20,56
2024-03-08 20:40:00,33,2,3,19,57
2024-03-08 20:50:00,24,4,1,17,46
2024-03-08 21:00:00,17,2,2,24,45
2024-03-08 21:10:00,23,0,1,13,37
2024-03-08 21:20:00,27,9,7,13,56
2024-03-08 21:30:00,30,7,1,19,57
2024-03-08 21:40:00,11,2,4,16,33
2024-03-08 21:50:00,21,6,6,10,43
2024-03-08 22:00:00,21,1,2,22,46
2024-03-08 22:10:00,26,3,3,21,53
2024-03-08 22:20:00,16,4,6,24,50
2024-03-08 22:30:00,16,4,0,17,37
2024-03-08 22:40:00,22,4,2,16,44
2024-03-08 22:50:00,29,2,2,8,41
2024-03-08 23:00:00,10,0,3,5,18
2024-03-08 23:10:00,30,4,3,18,55
2024-03-08 23:20:00,18,2,2,14,36
2024-03-08 23:30:00,13,3,1,12,29
2024-03-08 23:40:00,16,2,3,8,29
2024-03-08 23:50:00,9,1,0,21,31
2024-03-09 00:00:00,14,0,0,7,21
2024-03-09 00:10:00,10,2,0,5,17
2024-03-09 00:20:00,22,0,3,9,34
2024-03-09 00:30:00,10,1,3,5,19
2024-03-09 00:40:00,10,2,0,11,23
2024-03-09 00:50:00,10,0,0,5,15
2024-03-09 01:00:00,14,2,0,8,24
2024-03-09 01:10:00,5,0,1,5,11
2024-03-09 01:20:00,9,2,0,4,15
2024-03-09 01:30:00,5,0,0,6,11
2024-03-09 01:40:00,10,5,0,2,17
2024-03-09 01:50:00,6,0,0,5,11
2024-03-09 02:00:00,3,0,0,3,6
2024-03-09 02:10:00,6,1,0,2,9
2024-03-09 02:20:00,2,0,0,2,4
2024-03-09 02:30:00,3,1,0,6,10
2024-03-09 02:40:00,3,2,0,2,7
2024-03-09 02:50:00,8,0,0,1,9
2024-03-09 03:00:00,3,0,0,5,8
2024-03-09 03:10:00,7,0,0,3,10
2024-03-09 03:20:00,5,2,0,3,10
2024-03-09 03:30:00,4,0,0,3,7
2024-03-09 03:40:00,4,0,0,4,8
2024-03-09 03:50:00,4,2,0,3,9
2024-03-09 04:00:00,4,0,0,0,4
2024-03-09 04:10:00,7,0,0,5,12
2024-03-09 04:20:00,3,2,0,2,7
2024-03-09 04:30:00,2,0,0,4,6
2024-03-09 04:40:00,5,1,1,0,7
2024-03-09 04:50:00,5,0,0,1,6
2024-03-09 05:00:00,2,0,0,4,6
2024-03-09 05:10:00,2,0,0,3,5
2024-03-09 05:20:00,5,0,0,5,10
2024-03-09 05:30:00,3,0,0,2,5
2024-03-09 05:40:00,5,0,0,4,9
2024-03-09 05:50:00,5,1,1,2,9
2024-03-09 06:00:00,3,0,0,6,9
2024-03-09 06:10:00,5,0,0,4,9
2024-03-09 06:20:00,9,0,1,8,18
2024-03-09 06:30:00,4,2,0,5,11
2024-03-09 06:40:00,11,0,0,6,17
2024-03-09 06:50:00,7,0,1,6,14
2024-03-09 07:00:00,12,0,1,9,22
2024-03-09 07:10:00,8,0,0,5,13
2024-03-09 07:20:00,8,0,1,5,14
2024-03-09 07:30:00,4,0,1,13,18
2024-03-09 07:40:00,13,2,2,6,23
2024-03-09 07:50:00,12,0,2,13,27
2024-03-09 08:00:00,25,1,0,16,42
2024-03-09 08:10:00,14,2,8,18,42
2024-03-09 08:20:00,20,1,1,16,38
2024-03-09 08:30:00,20,4,5,30,59
2024-03-09 08:40:00,23,2,4,21,50
2024-03-09 08:50:00,25,4,2,19,50
2024-03-09 09:00:00,26,5,3,29,63
2024-03-09 09:10:00,26,0,8,37,71
2024-03-09 09:20:00,36,0,5,31,72
2024-03-09 09:30:00,33,0,8,41,82
2024-03-09 09:40:00,43,8,5,39,95
2024-03-09 09:50:00,45,5,3,45,98
2024-03-09 10:00:00,25,1,0,54,80
2024-03-09 10:10:00,43,3,7,43,96
2024-03-09 10:20:00,29,6,1,40,76
2024-03-09 10:30:00,38,4,0,44,86
2024-03-09 10:40:00,44,2,3,39,88
2024-03-09 10:50:00,51,3,3,45,102
2024-03-09 11:00:00,47,8,8,37,100
2024-03-09 11:10:00,44,3,5,30,82
2024-03-09 11:20:00,47,5,5,32,89
2024-03-09 11:30:00,33,8,4,54,99
2024-03-09 11:40:00,36,1,11,58,106
2024-03-09 11:50:00,38,5,7,43,93
2024-03-09 12:00:00,47,2,9,41,99
2024-03-09 12:10:00,40,1,9,38,88
2024-03-09 12:20:00,40,4,6,45,95
2024-03-09 12:30:00,44,4,3,55,106
2024-03-09 12:40:00,34,6,9,51,100
2024-03-09 12:50:00,46,3,5,44,98
2024-03-09 13:00:00,54,5,10,40,109
2024-03-09 13:10:00,37,5,7,52,101
2024-03-09 13:20:00,38,6,6,32,82
2024-03-09 13:30:00,42,5,9,44,100
2024-03-09 13:40:00,43,2,8,42,95
2024-03-09 13:50:00,38,2,9,44,93
2024-03-09 14:00:00,51,2,7,28,88
2024-03-09 14:10:00,41,12,14,23,90
2024-03-09 14:20:00,39,5,4,31,79
2024-03-09 14:30:00,42,3,6,36,87
2024-03-09 14:40:00,61,7,7,31,106
2024-03-09 14:50:00,41,5,11,48,105
2024-03-09 15:00:00,54,7,8,40,109
2024-03-09 15:10:00,38,2,6,36,82
2024-03-09 15:20:00,46,4,8,34,92
2024-03-09 15:30:00,33,3,3,29,68
2024-03-09 15:40:00,34,5,6,48,93
2024-03-09 15:50:00,43,4,9,31,87
2024-03-09 16:00:00,35,6,6,41,88
2024-03-09 16:10:00,42,3,6,32,83
2024-03-09 16:20:00,42,1,3,35,81
2024-03-09 16:30:00,38,3,4,26,71
2024-03-09 16:40:00,41,5,6,30,82
2024-03-09 16:50:00,36,4,6,26,72
2024-03-09 17:00:00,49,2,8,34,93
2024-03-09 17:10:00,39,3,7,31,80
2024-03-09 17:20:00,45,8,1,36,90
2024-03-09 17:30:00,37,3,6,43,89
2024-03-09 17:40:00,35,7,13,35,90
2024-03-09 17:50:00,49,3,3,42,97
2024-03-09 18:00:00,41,6,10,37,94
2024-03-09 18:10:00,46,1,4,38,89
2024-03-09 18:20:00,34,4,7,27,72
2024-03-09 18:30:00,33,1,11,32,77
2024-03-09 18:40:00,34,11,4,50,99
2024-03-09 18:50:00,39,3,5,41,88
2024-03-09 19:00:00,45,6,4,30,85
2024-03-09 19:10:00,37,4,5,23,69
2024-03-09 19:20:00,43,3,0,28,74
2024-03-09 19:30:00,27,6,11,21,65
2024-03-09 19:40:00,30,10,2,25,67
2024-03-09 19:50:00,22,6,3,28,59
2024-03-09 20:00:00,25,6,2,23,56
2024-03-09 20:10:00,27,6,4,15,52
2024-03-09 20:20:00,27,1,8,43,79
2024-03-09 20:30:00,26,5,3,16,50
2024-03-09 20:40:00,22,6,2,21,51
2024-03-09 20:50:00,19,3,4,14,40
2024-03-09 21:00:00,22,1,1,22,46
2024-03-09 21:10:00,23,3,2,28,56
2024-03-09 21:20:00,20,1,4,19,44
2024-03-09 21:30:00,21,3,0,14,38
2024-03-09 21:40:00,14,2,0,15,31
2024-03-09 21:50:00,20,1,3,4,28
2024-03-09 22:00:00,21,0,2,19,42
2024-03-09 22:10:00,23,10,1,25,59
2024-03-09 22:20:00,18,1,2,22,43
2024-03-09 22:30:00,24,3,2,15,44
2024-03-09 22:40:00,15,6,2,21,44
2024-03-09 22:50:00,17,6,1,24,48
2024-03-09 23:00:00,18,3,0,10,31
2024-03-09 23:10:00,19,5,1,12,37
2024-03-09 23:20:00,14,6,0,13,33
2024-03-09 23:30:00,18,7,0,10,35
2024-03-09 23:40:00,10,0,2,7,19
2024-03-09 23:50:00,12,3,0,11,26
2024-03-10 00:00:00,10,2,0,9,21
2024-03-10 00:10:00,15,0,0,17,32
2024-03-10 00:20:00,19,1,0,7,27
2024-03-10 00:30:00,9,0,1,8,18
2024-03-10 00:40:00,9,0,0,5,14
2024-03-10 00:50:00,19,0,2,14,35
2024-03-10 01:00:00,6,0,0,7,13
2024-03-10 01:10:00,3,0,0,5,8
2024-03-10 01:20:00,8,5,0,3,16
2024-03-10 01:30:00,9,0,0,3,12
2024-03-10 01:40:00,7,3,2,6,18
2024-03-10 01:50:00,6,1,3,1,11
2024-03-10 02:00:00,9,2,0,1,12
2024-03-10 02:10:00,7,0,0,5,12
2024-03-10 02:20:00,9,0,0,5,14
2024-03-10 02:30:00,2,0,1,3,6
2024-03-10 02:40:00,13,2,0,5,20
2024-03-10 02:50:00,7,2,0,6,15
2024-03-10 03:00:00,4,0,0,1,5
2024-03-10 03:10:00,4,0,1,5,10
2024-03-10 03:20:00,2,0,1,2,5
2024-03-10 03:30:00,6,1,0,1,8
2024-03-10 03:40:00,0,0,2,0,2
2024-03-10 03:50:00,8,0,0,7,15
2024-03-10 04:00:00,4,0,0,1,5
2024-03-10 04:10:00,3,0,0,2,5
2024-03-10 04:20:00,5,0,0,5,10
2024-03-10 04:30:00,0,0,0,4,4
2024-03-10 04:40:00,3,0,0,0,3
2024-03-10 04:50:00,3,0,0,0,3
2024-03-10 05:00:00,3,0,0,3,6
2024-03-10 05:10:00,1,0,0,5,6
2024-03-10 05:20:00,4,0,1,1,6
2024-03-10 05:30:00,3,0,0,4,7
2024-03-10 05:40:00,1,1,1,0,3
2024-03-10 05:50:00,2,0,0,0,2
2024-03-10 06:00:00,1,0,0,2,3
2024-03-10 06:10:00,4,0,1,0,5
2024-03-10 06:20:00,3,0,1,3,7
2024-03-10 06:30:00,5,1,0,10,16
2024-03-10 06:40:00,3,1,0,4,8
2024-03-10 06:50:00,3,0,0,6,9
2024-03-10 07:00:00,6,0,3,2,11
2024-03-10 07:10:00,4,0,0,3,7
2024-03-10 07:20:00,6,0,0,4,10
2024-03-10 07:30:00,8,2,2,6,18
2024-03-10 07:40:00,7,1,0,7,15
2024-03-10 07:50:00,3,0,1,15,19
2024-03-10 08:00:00,8,1,1,4,14
2024-03-10 08:10:00,6,1,3,7,17
2024-03-10 08:20:00,11,1,0,14,26
2024-03-10 08:30:00,15,3,1,9,28
2024-03-10 08:40:00,9,1,3,10,23
2024-03-10 08:50:00,8,2,1,18,29
2024-03-10 09:00:00,18,0,3,14,35
2024-03-10 09:10:00,18,1,4,11,34
2024-03-10 09:20:00,24,0,2,15,41
2024-03-10 09:30:00,18,0,2,24,44
2024-03-10 09:40:00,23,2,2,26,53
2024-03-10 09:50:00,29,0,3,18,50
2024-03-10 10:00:00,15,1,3,24,43
2024-03-10 10:10:00,15,2,4,9,30
2024-03-10 10:20:00,22,2,7,18,49
2024-03-10 10:30:00,23,3,4,26,56
2024-03-10 10:40:00,24,3,2,28,57
2024-03-10 10:50:00,31,0,4,21,56
2024-03-10 11:00:00,20,4,4,25,53
2024-03-10 11:10:00,30,1,0,26,57
2024-03-10 11:20:00,27,0,4,21,52
2024-03-10 11:30:00,25,2,3,24,54
2024-03-10 11:40:00,35,2,7,22,66
2024-03-10 11:50:00,36,2,4,23,65
2024-03-10 12:00:00,25,2,4,28,59
2024-03-10 12:10:00,35,7,3,27,72
2024-03-10 12:20:00,40,1,6,27,74
2024-03-10 12:30:00,33,1,2,33,69
2024-03-10 12:40:00,34,10,1,24,69
2024-03-10 12:50:00,27,2,4,23,56
2024-03-10 13:00:00,41,5,6,18,70
2024-03-10 13:10:00,38,2,3,31,74
2024-03-10 13:20:00,32,3,2,34,71
2024-03-10 13:30:00,33,2,5,16,56
2024-03-10 13:40:00,49,1,4,31,85
2024-03-10 13:50:00,29,3,5,42,79
2024-03-10 14:00:00,31,4,4,23,62
2024-03-10 14:10:00,38,6,4,28,76
2024-03-10 14:20:00,36,3,4,25,68
2024-03-10 14:30:00,24,2,3,46,75
2024-03-10 14:40:00,36,3,2,20,61
2024-03-10 14:50:00,32,1,4,29,66
2024-03-10 15:00:00,35,2,7,44,88
2024-03-10 15:10:00,36,4,8,38,86
2024-03-10 15:20:00,31,5,3,26,65
2024-03-10 15:30:00,35,6,4,28,73
2024-03-10 15:40:00,37,2,4,32,75
2024-03-10 15:50:00,32,2,3,31,68
2024-03-10 16:00:00,36,2,5,25,68
2024-03-10 16:10:00,37,3,9,35,84
2024-03-10 16:20:00,25,2,5,22,54
2024-03-10 16:30:00,44,4,10,32,90
2024-03-10 16:40:00,27,2,3,37,69
2024-03-10 16:50:00,36,2,5,36,79
2024-03-10 17:00:00,24,3,6,36,69
2024-03-10 17:10:00,38,5,11,34,88
2024-03-10 17:20:00,28,5,7,39,79
2024-03-10 17:30:00,32,1,6,35,74
2024-03-10 17:40:00,26,3,8,22,59
2024-03-10 17:50:00,32,4,6,28,70
2024-03-10 18:00:00,32,2,4,32,70
2024-03-10 18:10:00,24,1,5,19,49
2024-03-10 18:20:00,32,3,3,28,66
2024-03-10 18:30:00,36,0,11,20,67
2024-03-10 18:40:00,31,2,5,49,87
2024-03-10 18:50:00,33,5,6,34,78
2024-03-10 19:00:00,35,3,4,29,71
2024-03-10 19:10:00,28,4,7,30,69
2024-03-10 19:20:00,29,1,3,35,68
2024-03-10 19:30:00,22,1,0,17,40
2024-03-10 19:40:00,22,1,1,23,47
2024-03-10 19:50:00,20,0,1,16,37
2024-03-10 20:00:00,23,4,2,21,50
2024-03-10 20:10:00,23,2,2,10,37
2024-03-10 20:20:00,24,0,8,21,53
2024-03-10 20:30:00,17,4,3,15,39
2024-03-10 20:40:00,22,5,0,23,50
2024-03-10 20:50:00,20,2,1,12,35
2024-03-10 21:00:00,15,4,0,22,41
2024-03-10 21:10:00,31,1,1,15,48
2024-03-10 21:20:00,35,2,0,14,51
2024-03-10 21:30:00,38,7,3,16,64
2024-03-10 21:40:00,13,1,2,9,25
2024-03-10 21:50:00,28,4,0,16,48
2024-03-10 22:00:00,16,2,2,11,31
2024-03-10 22:10:00,11,2,0,12,25
2024-03-10 22:20:00,8,0,2,8,18
2024-03-10 22:30:00,2,1,0,9,12
2024-03-10 22:40:00,5,1,0,4,10
2024-03-10 22:50:00,6,0,0,5,11
2024-03-10 23:00:00,3,0,1,4,8
2024-03-10 23:10:00,7,1,0,3,11
2024-03-10 23:20:00,1,0,0,4,5
2024-03-10 23:30:00,2,1,0,4,7
2024-03-10 23:40:00,5,0,0,2,7
2024-03-10 23:50:00,4,0,1,2,7
2024-03-11 00:00:00,3,1,0,3,7
2024-03-11 00:10:00,4,1,0,1,6
2024-03-11 00:20:00,2,1,0,4,7
2024-03-11 00:30:00,3,2,0,5,10
2024-03-11 00:40:00,2,0,3,4,9
2024-03-11 00:50:00,2,0,0,0,2
2024-03-11 01:00:00,5,2,1,0,8
2024-03-11 01:10:00,3,0,0,3,6
2024-03-11 01:20:00,0,0,0,3,3
2024-03-11 01:30:00,3,0,2,1,6
2024-03-11 01:40:00,4,0,0,1,5
2024-03-11 01:50:00,1,0,0,1,2
2024-03-11 02:00:00,2,0,1,3,6
2024-03-11 02:10:00,6,1,0,1,8
2024-03-11 02:20:00,1,0,1,1,3
2024-03-11 02:30:00,2,0,0,1,3
2024-03-11 02:40:00,0,0,1,0,1
2024-03-11 02:50:00,0,0,0,0,0
2024-03-11 03:00:00,0,0,0,0,0
2024-03-11 03:10:00,3,0,0,0,3
2024-03-11 03:20:00,2,0,0,0,2
2024-03-11 03:30:00,1,0,0,1,2
2024-03-11 03:40:00,0,0,0,0,0
2024-03-11 03:50:00,0,0,0,0,0
2024-03-11 04:00:00,2,0,0,1,3
2024-03-11 04:10:00,0,0,0,3,3
2024-03-11 04:20:00,2,0,0,0,2
2024-03-11 04:30:00,0,0,1,3,4
2024-03-11 04:40:00,3,0,0,1,4
2024-03-11 04:50:00,1,1,0,1,3
2024-03-11 05:00:00,1,0,3,7,11
2024-03-11 05:10:00,6,4,4,6,20
2024-03-11 05:20:00,5,1,1,5,12
2024-03-11 05:30:00,2,3,4,13,22
2024-03-11 05:40:00,5,3,5,19,32
2024-03-11 05:50:00,6,1,3,10,20
2024-03-11 06:00:00,8,0,8,13,29
2024-03-11 06:10:00,5,0,3,7,15
2024-03-11 06:20:00,15,3,3,19,40
2024-03-11 06:30:00,11,2,11,16,40
2024-03-11 06:40:00,7,1,5,27,40
2024-03-11 06:50:00,17,0,6,32,55
2024-03-11 07:00:00,18,2,2,37,59
2024-03-11 07:10:00,39,4,4,68,115
2024-03-11 07:20:00,37,4,3,63,107
2024-03-11 07:30:00,46,4,9,66,125
2024-03-11 07:40:00,45,3,10,54,112
2024-03-11 07:50:00,36,6,16,54,112
2024-03-11 08:00:00,39,2,11,60,112
2024-03-11 08:10:00,42,5,6,54,107
2024-03-11 08:20:00,47,6,9,64,126
2024-03-11 08:30:00,40,6,9,43,98
2024-03-11 08:40:00,44,6,9,45,104
2024-03-11 08:50:00,48,7,2,60,117
2024-03-11 09:00:00,53,4,4,41,102
2024-03-11 09:10:00,49,1,6,51,107
2024-03-11 09:20:00,37,4,2,45,88
2024-03-11 09:30:00,34,2,4,36,76
2024-03-11 09:40:00,37,7,3,56,103
2024-03-11 09:50:00,39,9,3,42,93
2024-03-11 10:00:00,32,4,3,48,87
2024-03-11 10:10:00,41,6,0,41,88
2024-03-11 10:20:00,44,5,7,40,96
2024-03-11 10:30:00,30,1,6,38,75
2024-03-11 10:40:00,42,1,2,47,92
2024-03-11 10:50:00,39,6,4,39,88
2024-03-11 11:00:00,31,5,4,38,78
2024-03-11 11:10:00,47,0,4,37,88
2024-03-11 11:20:00,41,6,7,42,96
2024-03-11 11:30:00,35,6,3,47,91
2024-03-11 11:40:00,38,6,8,51,103
2024-03-11 11:50:00,49,7,9,44,109
2024-03-11 12:00:00,40,5,3,40,88
2024-03-11 12:10:00,44,6,10,48,108
2024-03-11 12:20:00,43,8,7,38,96
2024-03-11 12:30:00,52,5,10,40,107
2024-03-11 12:40:00,44,4,7,45,100
2024-03-11 12:50:00,43,5,2,47,97
2024-03-11 13:00:00,37,5,1,32,75
2024-03-11 13:10:00,46,5,5,47,103
2024-03-11 13:20:00,45,6,5,42,98
2024-03-11 13:30:00,38,7,8,49,102
2024-03-11 13:40:00,49,3,6,36,94
2024-03-11 13:50:00,65,8,4,41,118
2024-03-11 14:00:00,50,7,7,28,92
2024-03-11 14:10:00,51,9,5,52,117
2024-03-11 14:20:00,37,6,7,45,95
2024-03-11 14:30:00,55,5,3,32,95
2024-03-11 14:40:00,57,4,6,55,122
2024-03-11 14:50:00,53,6,5,50,114
2024-03-11 15:00:00,52,6,5,44,107
2024-03-11 15:10:00,45,1,3,41,90
2024-03-11 15:20:00,51,7,8,48,114
2024-03-11 15:30:00,47,2,7,48,104
2024-03-11 15:40:00,60,7,4,37,108
2024-03-11 15:50:00,64,6,5,50,125
2024-03-11 16:00:00,53,11,10,31,105
2024-03-11 16:10:00,59,5,5,41,110
2024-03-11 16:20:00,66,16,5,42,129
2024-03-11 16:30:00,49,14,6,41,110
2024-03-11 16:40:00,52,6,6,40,104
2024-03-11 16:50:00,44,8,8,32,92
2024-03-11 17:00:00,59,7,9,40,115
2024-03-11 17:10:00,60,6,10,46,122
2024-03-11 17:20:00,53,11,8,48,120
2024-03-11 17:30:00,58,10,6,44,118
2024-03-11 17:40:00,40,8,16,46,110
2024-03-11 17:50:00,51,12,14,59,136
2024-03-11 18:00:00,52,7,9,43,111
2024-03-11 18:10:00,49,7,11,41,108
2024-03-11 18:20:00,38,4,7,28,77
2024-03-11 18:30:00,38,8,10,43,99
2024-03-11 18:40:00,42,4,7,37,90
2024-03-11 18:50:00,42,11,6,41,100
2024-03-11 19:00:00,32,14,4,30,80
2024-03-11 19:10:00,35,9,5,38,87
2024-03-11 19:20:00,42,15,3,37,97
2024-03-11 19:30:00,20,6,2,23,51
2024-03-11 19:40:00,35,6,2,39,82
2024-03-11 19:50:00,29,2,2,18,51
2024-03-11 20:00:00,30,8,7,30,75
2024-03-11 20:10:00,31,3,5,18,57
2024-03-11 20:20:00,23,5,4,13,45
2024-03-11 20:30:00,26,4,1,18,49
2024-03-11 20:40:00,24,2,1,28,55
2024-03-11 20:50:00,22,0,3,13,38
2024-03-11 21:00:00,21,7,2,19,49
2024-03-11 21:10:00,23,2,2,21,48
2024-03-11 21:20:00,27,8,2,18,55
2024-03-11 21:30:00,24,4,2,15,45
2024-03-11 21:40:00,18,4,5,10,37
2024-03-11 21:50:00,29,7,5,14,55
2024-03-11 22:00:00,22,7,3,16,48
2024-03-11 22:10:00,16,2,0,12,30
2024-03-11 22:20:00,16,4,1,17,38
2024-03-11 22:30:00,17,5,2,7,31
2024-03-11 22:40:00,13,1,1,14,29
2024-03-11 22:50:00,17,4,0,12,33
2024-03-11 23:00:00,7,0,1,4,12
2024-03-11 23:10:00,9,2,0,4,15
2024-03-11 23:20:00,4,0,2,2,8
2024-03-11 23:30:00,12,0,0,4,16
2024-03-11 23:40:00,10,0,2,4,16
2024-03-11 23:50:00,5,0,1,3,9
2024-03-12 00:00:00,1,0,1,1,3
2024-03-12 00:10:00,4,0,0,1,5
2024-03-12 00:20:00,2,0,0,1,3
2024-03-12 00:30:00,6,0,0,1,7
2024-03-12 00:40:00,6,0,0,1,7
2024-03-12 00:50:00,3,0,0,0,3
2024-03-12 01:00:00,3,0,0,1,4
2024-03-12 01:10:00,2,0,0,2,4
2024-03-12 01:20:00,1,0,0,1,2
2024-03-12 01:30:00,3,0,1,2,6
2024-03-12 01:40:00,2,0,0,1,3
2024-03-12 01:50:00,4,0,0,0,4
2024-03-12 02:00:00,2,0,0,3,5
2024-03-12 02:10:00,3,0,0,1,4
2024-03-12 02:20:00,3,0,0,0,3
2024-03-12 02:30:00,0,0,0,1,1
2024-03-12 02:40:00,0,0,0,2,2
2024-03-12 02:50:00,1,2,0,1,4
2024-03-12 03:00:00,0,0,0,0,0
2024-03-12 03:10:00,3,0,0,1,4
2024-03-12 03:20:00,5,0,0,0,5
2024-03-12 03:30:00,0,0,0,0,0
2024-03-12 03:40:00,0,0,0,2,2
2024-03-12 03:50:00,1,0,0,0,1
2024-03-12 04:00:00,3,0,0,1,4
2024-03-12 04:10:00,1,0,0,1,2
2024-03-12 04:20:00,1,0,0,0,1
2024-03-12 04:30:00,1,0,0,3,4
2024-03-12 04:40:00,1,0,0,0,1
2024-03-12 04:50:00,0,0,0,6,6
2024-03-12 05:00:00,2,0,0,6,8
2024-03-12 05:10:00,2,0,2,4,8
2024-03-12 05:20:00,5,0,0,7,12
2024-03-12 05:30:00,7,0,4,13,24
2024-03-12 05:40:00,10,0,3,11,24
2024-03-12 05:50:00,9,0,3,5,17
2024-03-12 06:00:00,9,3,3,10,25
2024-03-12 06:10:00,8,0,3,15,26
2024-03-12 06:20:00,16,0,0,23,39
2024-03-12 06:30:00,16,4,4,16,40
2024-03-12 06:40:00,17,1,2,27,47
2024-03-12 06:50:00,16,2,3,39,60
2024-03-12 07:00:00,18,3,5,32,58
2024-03-12 07:10:00,35,2,8,59,104
2024-03-12 07:20:00,37,1,3,62,103
2024-03-12 07:30:00,39,1,11,64,115
2024-03-12 07:40:00,38,1,13,60,112
2024-03-12 07:50:00,46,9,15,53,123
2024-03-12 08:00:00,46,5,16,74,141
2024-03-12 08:10:00,45,5,10,55,115
2024-03-12 08:20:00,45,0,8,76,129
2024-03-12 08:30:00,42,5,9,83,139
2024-03-12 08:40:00,46,7,12,79,144
2024-03-12 08:50:00,42,4,4,48,98
2024-03-12 09:00:00,43,4,8,61,116
2024-03-12 09:10:00,42,2,1,52,97
2024-03-12 09:20:00,37,4,4,43,88
2024-03-12 09:30:00,21,2,6,49,78
2024-03-12 09:40:00,46,3,9,45,103
2024-03-12 09:50:00,42,4,9,60,115
2024-03-12 10:00:00,40,2,2,52,96
2024-03-12 10:10:00,32,6,3,43,84
2024-03-12 10:20:00,35,1,4,34,74
2024-03-12 10:30:00,40,7,2,45,94
2024-03-12 10:40:00,52,2,13,38,105
2024-03-12 10:50:00,42,5,7,40,94
2024-03-12 11:00:00,36,5,6,35,82
2024-03-12 11:10:00,40,5,5,42,92
2024-03-12 11:20:00,36,2,2,38,78
2024-03-12 11:30:00,41,10,5,43,99
2024-03-12 11:40:00,43,5,5,46,99
2024-03-12 11:50:00,38,6,9,40,93
2024-03-12 12:00:00,48,6,7,39,100
2024-03-12 12:10:00,33,4,7,34,78
2024-03-12 12:20:00,49,4,7,44,104
2024-03-12 12:30:00,49,3,6,44,102
2024-03-12 12:40:00,36,4,5,41,86
2024-03-12 12:50:00,47,8,8,54,117
2024-03-12 13:00:00,46,7,5,40,98
2024-03-12 13:10:00,39,5,11,52,107
2024-03-12 13:20:00,53,4,6,42,105
2024-03-12 13:30:00,39,5,6,46,96
2024-03-12 13:40:00,38,5,5,35,83
2024-03-12 13:50:00,58,5,9,37,109
2024-03-12 14:00:00,41,2,10,43,96
2024-03-12 14:10:00,59,4,5,34,102
2024-03-12 14:20:00,46,2,4,42,94
2024-03-12 14:30:00,47,6,5,47,105
2024-03-12 14:40:00,55,2,6,42,105
2024-03-12 14:50:00,62,6,9,43,120
2024-03-12 15:00:00,51,7,4,52,114
2024-03-12 15:10:00,53,10,11,57,131
2024-03-12 15:20:00,60,13,7,56,136
2024-03-12 15:30:00,58,6,10,44,118
2024-03-12 15:40:00,44,7,6,54,111
2024-03-12 15:50:00,65,11,4,51,131
2024-03-12 16:00:00,54,10,7,50,121
2024-03-12 16:10:00,50,7,6,52,115
2024-03-12 16:20:00,65,7,2,49,123
2024-03-12 16:30:00,43,7,10,54,114
2024-03-12 16:40:00,55,9,3,54,121
2024-03-12 16:50:00,61,5,7,59,132
2024-03-12 17:00:00,60,3,3,58,124
2024-03-12 17:10:00,74,7,10,51,142
2024-03-12 17:20:00,56,10,10,46,122
2024-03-12 17:30:00,49,9,10,52,120
2024-03-12 17:40:00,48,10,15,61,134
2024-03-12 17:50:00,57,5,8,47,117
2024-03-12 18:00:00,45,5,7,44,101
2024-03-12 18:10:00,46,9,8,39,102
2024-03-12 18:20:00,38,8,8,26,80
2024-03-12 18:30:00,57,13,12,57,139
2024-03-12 18:40:00,45,13,3,43,104
2024-03-12 18:50:00,45,5,6,40,96
2024-03-12 19:00:00,37,7,13,51,108
2024-03-12 19:10:00,49,4,8,32,93
2024-03-12 19:20:00,37,5,6,38,86
2024-03-12 19:30:00,38,3,4,26,71
2024-03-12 19:40:00,25,4,6,25,60
2024-03-12 19:50:00,26,4,1,18,49
2024-03-12 20:00:00,24,11,6,32,73
2024-03-12 20:10:00,28,8,1,36,73
2024-03-12 20:20:00,28,4,1,36,69
2024-03-12 20:30:00,15,1,3,10,29
2024-03-12 20:40:00,22,0,1,18,41
2024-03-12 20:50:00,31,3,3,10,47
2024-03-12 21:00:00,27,5,5,20,57
2024-03-12 21:10:00,23,6,6,17,52
2024-03-12 21:20:00,15,1,3,14,33
2024-03-12 21:30:00,20,5,3,13,41
2024-03-12 21:40:00,21,5,2,8,36
2024-03-12 21:50:00,15,3,0,15,33
2024-03-12 22:00:00,18,3,3,14,38
2024-03-12 22:10:00,12,2,3,18,35
2024-03-12 22:20:00,15,1,1,5,22
2024-03-12 22:30:00,10,0,1,10,21
2024-03-12 22:40:00,18,2,5,11,36
2024-03-12 22:50:00,16,3,3,6,28
2024-03-12 23:00:00,19,5,0,5,29
2024-03-12 23:10:00,19,3,2,5,29
2024-03-12 23:20:00,19,3,2,4,28
2024-03-12 23:30:00,10,3,0,2,15
2024-03-12 23:40:00,8,2,1,3,14
2024-03-12 23:50:00,6,2,1,4,13
2024-03-13 00:00:00,7,3,2,4,16
2024-03-13 00:10:00,1,1,2,5,9
2024-03-13 00:20:00,5,1,0,2,8
2024-03-13 00:30:00,10,5,1,1,17
2024-03-13 00:40:00,7,2,0,0,9
2024-03-13 00:50:00,4,2,0,1,7
2024-03-13 01:00:00,2,0,1,2,5
2024-03-13 01:10:00,0,0,1,2,3
2024-03-13 01:20:00,5,0,1,2,8
2024-03-13 01:30:00,1,0,0,1,2
2024-03-13 01:40:00,3,0,0,0,3
2024-03-13 01:50:00,2,0,0,0,2
2024-03-13 02:00:00,1,0,1,2,4
2024-03-13 02:10:00,2,0,0,1,3
2024-03-13 02:20:00,2,0,1,2,5
2024-03-13 02:30:00,2,0,0,1,3
2024-03-13 02:40:00,1,0,1,0,2
2024-03-13 02:50:00,0,0,0,0,0
2024-03-13 03:00:00,0,0,0,1,1
2024-03-13 03:10:00,3,0,0,1,4
2024-03-13 03:20:00,1,1,0,3,5
2024-03-13 03:30:00,4,1,0,1,6
2024-03-13 03:40:00,2,1,1,0,4
2024-03-13 03:50:00,0,0,0,2,2
2024-03-13 04:00:00,5,0,0,0,5
2024-03-13 04:10:00,2,0,0,1,3
2024-03-13 04:20:00,1,0,0,1,2
2024-03-13 04:30:00,1,0,1,2,4
2024-03-13 04:40:00,1,0,0,0,1
2024-03-13 04:50:00,2,0,2,1,5
2024-03-13 05:00:00,2,0,1,8,11
2024-03-13 05:10:00,2,0,3,8,13
2024-03-13 05:20:00,5,0,5,3,13
2024-03-13 05:30:00,3,0,2,5,10
2024-03-13 05:40:00,6,1,3,10,20
2024-03-13 05:50:00,8,0,8,9,25
2024-03-13 06:00:00,10,0,7,10,27
2024-03-13 06:10:00,6,1,4,11,22
2024-03-13 06:20:00,15,2,1,17,35
2024-03-13 06:30:00,7,1,2,20,30
2024-03-13 06:40:00,19,3,6,19,47
2024-03-13 06:50:00,13,2,0,38,53
2024-03-13 07:00:00,12,2,10,36,60
2024-03-13 07:10:00,26,2,3,63,94
2024-03-13 07:20:00,45,1,5,55,106
2024-03-13 07:30:00,48,3,13,61,125
2024-03-13 07:40:00,54,3,13,48,118
2024-03-13 07:50:00,39,7,17,39,102
2024-03-13 08:00:00,39,1,17,56,113
2024-03-13 08:10:00,42,3,10,65,120
2024-03-13 08:20:00,40,4,10,56,110
2024-03-13 08:30:00,43,7,1,55,106
2024-03-13 08:40:00,38,5,7,55,105
2024-03-13 08:50:00,46,2,4,49,101
2024-03-13 09:00:00,44,5,6,53,108
2024-03-13 09:10:00,43,3,6,61,113
2024-03-13 09:20:00,32,5,11,44,92
2024-03-13 09:30:00,32,2,4,45,83
2024-03-13 09:40:00,34,7,5,51,97
2024-03-13 09:50:00,34,4,6,33,77
2024-03-13 10:00:00,37,3,2,39,81
2024-03-13 10:10:00,41,5,3,35,84
2024-03-13 10:20:00,37,0,3,33,73
2024-03-13 10:30:00,24,2,3,48,77
2024-03-13 10:40:00,40,4,4,49,97
2024-03-13 10:50:00,40,4,5,32,81
2024-03-13 11:00:00,29,4,7,53,93
2024-03-13 11:10:00,43,3,6,41,93
2024-03-13 11:20:00,53,8,1,48,110
2024-03-13 11:30:00,46,4,6,34,90
2024-03-13 11:40:00,36,4,9,53,102
2024-03-13 11:50:00,39,4,5,48,96
2024-03-13 12:00:00,41,4,5,51,101
2024-03-13 12:10:00,50,7,2,41,100
2024-03-13 12:20:00,35,8,5,38,86
2024-03-13 12:30:00,35,4,6,36,81
2024-03-13 12:40:00,46,4,7,46,103
2024-03-13 12:50:00,39,4,7,49,99
2024-03-13 13:00:00,45,3,6,33,87
2024-03-13 13:10:00,32,2,7,25,66
2024-03-13 13:20:00,38,5,2,41,86
2024-03-13 13:30:00,43,5,7,56,111
2024-03-13 13:40:00,54,3,4,49,110
2024-03-13 13:50:00,48,1,8,40,97
2024-03-13 14:00:00,51,6,8,42,107
2024-03-13 14:10:00,39,3,4,53,99
2024-03-13 14:20:00,43,3,4,36,86
2024-03-13 14:30:00,47,3,7,44,101
2024-03-13 14:40:00,51,7,8,42,108
2024-03-13 14:50:00,44,6,6,47,103
2024-03-13 15:00:00,55,8,7,41,111
2024-03-13 15:10:00,57,6,11,45,119
2024-03-13 15:20:00,47,5,6,43,101
2024-03-13 15:30:00,42,6,2,47,97
2024-03-13 15:40:00,57,10,1,43,111
2024-03-13 15:50:00,54,6,3,40,103
2024-03-13 16:00:00,55,6,8,38,107
2024-03-13 16:10:00,56,10,9,53,128
2024-03-13 16:20:00,59,5,14,40,118
2024-03-13 16:30:00,56,2,8,51,117
2024-03-13 16:40:00,46,8,10,61,125
2024-03-13 16:50:00,47,7,10,31,95
2024-03-13 17:00:00,61,5,10,57,133
2024-03-13 17:10:00,52,8,10,38,108
2024-03-13 17:20:00,64,8,7,46,125
2024-03-13 17:30:00,41,8,10,39,98
2024-03-13 17:40:00,58,10,13,43,124
2024-03-13 17:50:00,39,6,13,55,113
2024-03-13 18:00:00,44,7,7,43,101
2024-03-13 18:10:00,40,11,8,41,100
2024-03-13 18:20:00,37,3,10,43,93
2024-03-13 18:30:00,36,19,22,30,107
2024-03-13 18:40:00,36,8,14,39,97
2024-03-13 18:50:00,27,11,14,25,77
2024-03-13 19:00:00,29,6,8,32,75
2024-03-13 19:10:00,31,2,3,37,73
2024-03-13 19:20:00,32,11,9,25,77
2024-03-13 19:30:00,32,3,6,27,68
2024-03-13 19:40:00,31,5,5,29,70
2024-03-13 19:50:00,32,3,4,15,54
2024-03-13 20:00:00,22,2,1,28,53
2024-03-13 20:10:00,26,6,7,22,61
2024-03-13 20:20:00,30,6,6,14,56
2024-03-13 20:30:00,25,2,5,20,52
2024-03-13 20:40:00,16,3,3,13,35
2024-03-13 20:50:00,19,1,2,13,35
2024-03-13 21:00:00,22,3,1,11,37
2024-03-13 21:10:00,21,1,5,17,44
2024-03-13 21:20:00,38,7,1,20,66
2024-03-13 21:30:00,35,6,4,19,64
2024-03-13 21:40:00,18,3,2,20,43
2024-03-13 21:50:00,19,1,2,14,36
2024-03-13 22:00:00,24,1,1,15,41
2024-03-13 22:10:00,17,4,2,23,46
2024-03-13 22:20:00,17,2,3,13,35
2024-03-13 22:30:00,25,0,1,8,34
2024-03-13 22:40:00,16,2,3,4,25
2024-03-13 22:50:00,13,1,2,9,25
2024-03-13 23:00:00,10,4,1,7,22
2024-03-13 23:10:00,6,1,0,8,15
2024-03-13 23:20:00,16,3,2,6,27
2024-03-13 23:30:00,7,1,1,2,11
2024-03-13 23:40:00,10,2,0,3,15
2024-03-13 23:50:00,6,0,1,6,13
2024-03-14 00:00:00,5,1,0,3,9
2024-03-14 00:10:00,5,0,0,4,9
2024-03-14 00:20:00,2,0,0,1,3
2024-03-14 00:30:00,7,1,0,4,12
2024-03-14 00:40:00,5,0,0,0,5
2024-03-14 00:50:00,3,0,0,3,6
2024-03-14 01:00:00,7,1,0,4,12
2024-03-14 01:10:00,1,0,0,0,1
2024-03-14 01:20:00,5,0,0,2,7
2024-03-14 01:30:00,2,1,1,1,5
2024-03-14 01:40:00,1,0,0,1,2
2024-03-14 01:50:00,2,0,0,2,4
2024-03-14 02:00:00,2,0,0,4,6
2024-03-14 02:10:00,2,0,0,3,5
2024-03-14 02:20:00,0,0,2,0,2
2024-03-14 02:30:00,1,0,0,0,1
2024-03-14 02:40:00,1,0,0,0,1
2024-03-14 02:50:00,0,0,0,0,0
2024-03-14 03:00:00,2,0,0,1,3
2024-03-14 03:10:00,2,0,1,0,3
2024-03-14 03:20:00,1,2,0,0,3
2024-03-14 03:30:00,1,0,0,2,3
2024-03-14 03:40:00,0,0,2,0,2
2024-03-14 03:50:00,4,1,0,2,7
2024-03-14 04:00:00,1,0,0,0,1
2024-03-14 04:10:00,4,0,1,3,8
2024-03-14 04:20:00,1,0,0,1,2
2024-03-14 04:30:00,1,0,0,0,1
2024-03-14 04:40:00,1,0,0,0,1
2024-03-14 04:50:00,1,0,1,4,6
2024-03-14 05:00:00,1,0,0,7,8
2024-03-14 05:10:00,5,0,2,4,11
2024-03-14 05:20:00,4,0,2,3,9
2024-03-14 05:30:00,5,0,5,9,19
2024-03-14 05:40:00,5,0,5,12,22
2024-03-14 05:50:00,12,1,5,2,20
2024-03-14 06:00:00,7,0,4,17,28
2024-03-14 06:10:00,8,1,0,15,24
2024-03-14 06:20:00,10,0,1,26,37
2024-03-14 06:30:00,17,2,2,15,36
2024-03-14 06:40:00,24,2,3,24,53
2024-03-14 06:50:00,18,1,6,33,58
2024-03-14 07:00:00,22,6,6,32,66
2024-03-14 07:10:00,29,2,5,53,89
2024-03-14 07:20:00,37,7,5,61,110
2024-03-14 07:30:00,44,3,13,57,117
2024-03-14 07:40:00,52,6,15,46,119
2024-03-14 07:50:00,38,7,15,71,131
2024-03-14 08:00:00,37,3,6,54,100
2024-03-14 08:10:00,43,3,10,55,111
2024-03-14 08:20:00,43,3,4,54,104
2024-03-14 08:30:00,42,4,13,52,111
2024-03-14 08:40:00,45,5,8,64,122
2024-03-14 08:50:00,37,5,4,59,105
2024-03-14 09:00:00,34,8,5,63,110
2024-03-14 09:10:00,45,10,8,53,116
2024-03-14 09:20:00,29,3,2,43,77
2024-03-14 09:30:00,37,5,8,45,95
2024-03-14 09:40:00,34,4,8,46,92
2024-03-14 09:50:00,41,2,5,39,87
2024-03-14 10:00:00,45,4,3,37,89
2024-03-14 10:10:00,38,2,8,46,94
2024-03-14 10:20:00,45,2,7,45,99
2024-03-14 10:30:00,42,6,9,39,96
2024-03-14 10:40:00,38,7,5,40,90
2024-03-14 10:50:00,49,3,4,46,102
2024-03-14 11:00:00,36,3,5,46,90
2024-03-14 11:10:00,42,5,6,29,82
2024-03-14 11:20:00,49,4,6,34,93
2024-03-14 11:30:00,42,3,5,38,88
2024-03-14 11:40:00,41,5,4,39,89
2024-03-14 11:50:00,49,5,7,47,108
2024-03-14 12:00:00,45,7,11,46,109
2024-03-14 12:10:00,46,4,9,35,94
2024-03-14 12:20:00,43,3,5,48,99
2024-03-14 12:30:00,44,4,6,38,92
2024-03-14 12:40:00,39,6,4,46,95
2024-03-14 12:50:00,45,4,6,37,92
2024-03-14 13:00:00,67,13,7,38,125
2024-03-14 13:10:00,49,4,6,51,110
2024-03-14 13:20:00,61,5,7,56,129
2024-03-14 13:30:00,44,3,9,51,107
2024-03-14 13:40:00,41,10,8,41,100
2024-03-14 13:50:00,60,8,6,39,113
2024-03-14 14:00:00,42,7,11,41,101
2024-03-14 14:10:00,60,4,6,36,106
2024-03-14 14:20:00,48,4,7,46,105
2024-03-14 14:30:00,45,6,3,48,102
2024-03-14 14:40:00,57,6,7,50,120
2024-03-14 14:50:00,48,5,7,40,100
2024-03-14 15:00:00,37,8,8,33,86
2024-03-14 15:10:00,60,8,7,41,116
2024-03-14 15:20:00,40,9,15,51,115
2024-03-14 15:30:00,49,11,2,41,103
2024-03-14 15:40:00,57,5,10,56,128
2024-03-14 15:50:00,64,9,5,47,125
2024-03-14 16:00:00,61,12,11,34,118
2024-03-14 16:10:00,59,4,13,48,124
2024-03-14 16:20:00,55,4,11,47,117
2024-03-14 16:30:00,53,5,10,38,106
2024-03-14 16:40:00,64,3,7,38,112
2024-03-14 16:50:00,55,9,14,47,125
2024-03-14 17:00:00,59,7,7,40,113
2024-03-14 17:10:00,58,6,11,37,112
2024-03-14 17:20:00,59,10,6,54,129
2024-03-14 17:30:00,37,14,14,40,105
2024-03-14 17:40:00,59,10,7,40,116
2024-03-14 17:50:00,51,8,9,39,107
2024-03-14 18:00:00,47,7,10,44,108
2024-03-14 18:10:00,24,5,5,12,46
2024-03-14 18:20:00,21,2,4,13,40
2024-03-14 18:30:00,46,9,6,40,101
2024-03-14 18:40:00,56,8,10,38,112
2024-03-14 18:50:00,45,2,6,55,108
2024-03-14 19:00:00,30,4,9,49,92
2024-03-14 19:10:00,39,7,10,37,93
2024-03-14 19:20:00,45,11,5,43,104
2024-03-14 19:30:00,41,7,7,34,89
2024-03-14 19:40:00,46,2,2,38,88
2024-03-14 19:50:00,27,3,7,33,70
2024-03-14 20:00:00,17,8,3,27,55
2024-03-14 20:10:00,36,3,5,24,68
2024-03-14 20:20:00,31,3,3,28,65
2024-03-14 20:30:00,35,2,2,24,63
2024-03-14 20:40:00,28,2,2,18,50
2024-03-14 20:50:00,30,2,5,21,58
2024-03-14 21:00:00,25,2,4,15,46
2024-03-14 21:10:00,39,6,3,26,74
2024-03-14 21:20:00,29,0,7,14,50
2024-03-14 21:30:00,27,6,5,22,60
2024-03-14 21:40:00,24,7,2,20,53
2024-03-14 21:50:00,19,2,1,14,36
2024-03-14 22:00:00,16,0,1,22,39
2024-03-14 22:10:00,24,3,1,16,44
2024-03-14 22:20:00,27,4,1,11,43
2024-03-14 22:30:00,14,2,5,8,29
2024-03-14 22:40:00,12,0,3,7,22
2024-03-14 22:50:00,10,3,2,4,19
2024-03-14 23:00:00,12,4,0,10,26
2024-03-14 23:10:00,6,0,1,5,12
2024-03-14 23:20:00,11,2,1,3,17
2024-03-14 23:30:00,12,0,0,6,18
2024-03-14 23:40:00,5,0,0,7,12
2024-03-14 23:50:00,5,0,2,4,11
2024-03-15 00:00:00,11,1,0,0,12
2024-03-15 00:10:00,11,0,0,2,13
2024-03-15 00:20:00,2,0,0,4,6
2024-03-15 00:30:00,6,0,0,4,10
2024-03-15 00:40:00,3,0,0,3,6
2024-03-15 00:50:00,2,2,2,3,9
2024-03-15 01:00:00,4,2,0,2,8
2024-03-15 01:10:00,1,0,0,0,1
2024-03-15 01:20:00,1,0,0,2,3
2024-03-15 01:30:00,3,0,0,0,3
2024-03-15 01:40:00,1,0,0,1,2
2024-03-15 01:50:00,0,0,0,0,0
2024-03-15 02:00:00,8,0,0,1,9
2024-03-15 02:10:00,3,0,0,1,4
2024-03-15 02:20:00,1,0,0,3,4
2024-03-15 02:30:00,2,2,0,1,5
2024-03-15 02:40:00,1,0,0,2,3
2024-03-15 02:50:00,3,0,0,2,5
2024-03-15 03:00:00,0,0,1,1,2
2024-03-15 03:10:00,2,0,0,0,2
2024-03-15 03:20:00,2,2,0,2,6
2024-03-15 03:30:00,5,0,0,0,5
2024-03-15 03:40:00,1,0,0,2,3
2024-03-15 03:50:00,1,0,1,6,8
2024-03-15 04:00:00,3,0,0,0,3
2024-03-15 04:10:00,0,0,0,1,1
2024-03-15 04:20:00,2,0,2,3,7
2024-03-15 04:30:00,1,0,0,4,5
2024-03-15 04:40:00,2,0,2,3,7
2024-03-15 04:50:00,0,0,1,6,7
2024-03-15 05:00:00,5,1,0,2,8
2024-03-15 05:10:00,2,0,2,6,10
2024-03-15 05:20:00,3,1,2,3,9
2024-03-15 05:30:00,3,0,0,9,12
2024-03-15 05:40:00,7,0,5,11,23
2024-03-15 05:50:00,5,0,5,4,14
2024-03-15 06:00:00,7,1,2,9,19
2024-03-15 06:10:00,7,1,1,18,27
2024-03-15 06:20:00,11,0,3,27,41
2024-03-15 06:30:00,9,3,1,17,30
2024-03-15 06:40:00,16,3,4,20,43
2024-03-15 06:50:00,14,0,3,28,45
2024-03-15 07:00:00,25,2,3,44,74
2024-03-15 07:10:00,33,2,5,45,85
2024-03-15 07:20:00,33,7,3,57,100
2024-03-15 07:30:00,32,5,10,55,102
2024-03-15 07:40:00,49,6,9,49,113
2024-03-15 07:50:00,37,6,15,56,114
2024-03-15 08:00:00,37,5,7,40,89
2024-03-15 08:10:00,45,5,9,54,113
2024-03-15 08:20:00,37,4,8,50,99
2024-03-15 08:30:00,46,2,6,46,100
2024-03-15 08:40:00,39,2,5,43,89
2024-03-15 08:50:00,46,4,4,43,97
2024-03-15 09:00:00,42,4,9,47,102
2024-03-15 09:10:00,37,7,3,39,86
2024-03-15 09:20:00,50,2,6,48,106
2024-03-15 09:30:00,38,8,6,47,99
2024-03-15 09:40:00,50,4,7,43,104
2024-03-15 09:50:00,39,3,2,47,91
2024-03-15 10:00:00,45,5,8,38,96
2024-03-15 10:10:00,36,5,5,49,95
2024-03-15 10:20:00,47,3,5,34,89
2024-03-15 10:30:00,46,2,5,46,99
2024-03-15 10:40:00,50,2,8,46,106
2024-03-15 10:50:00,39,3,8,43,93
2024-03-15 11:00:00,42,2,6,44,94
2024-03-15 11:10:00,44,5,6,42,97
2024-03-15 11:20:00,42,7,5,39,93
2024-03-15 11:30:00,54,6,4,47,111
2024-03-15 11:40:00,42,7,8,46,103
2024-03-15 11:50:00,53,6,5,34,98
2024-03-15 12:00:00,58,7,6,43,114
2024-03-15 12:10:00,57,7,5,46,115
2024-03-15 12:20:00,48,7,6,40,101
2024-03-15 12:30:00,47,8,9,54,118
2024-03-15 12:40:00,41,7,4,45,97
2024-03-15 12:50:00,47,7,11,52,117
2024-03-15 13:00:00,63,8,6,46,123
2024-03-15 13:10:00,47,7,6,56,116
2024-03-15 13:20:00,58,7,10,40,115
2024-03-15 13:30:00,48,5,3,38,94
2024-03-15 13:40:00,52,4,11,47,114
2024-03-15 13:50:00,70,8,9,43,130
2024-03-15 14:00:00,44,6,8,42,100
2024-03-15 14:10:00,45,7,5,45,102
2024-03-15 14:20:00,52,6,9,35,102
2024-03-15 14:30:00,45,6,5,49,105
2024-03-15 14:40:00,50,6,7,32,95
2024-03-15 14:50:00,54,4,3,33,94
2024-03-15 15:00:00,63,1,5,55,124
2024-03-15 15:10:00,49,7,8,38,102
2024-03-15 15:20:00,58,7,8,35,108
2024-03-15 15:30:00,40,4,5,49,98
2024-03-15 15:40:00,59,7,9,41,116
2024-03-15 15:50:00,55,7,8,37,107
2024-03-15 16:00:00,50,12,5,44,111
2024-03-15 16:10:00,48,8,11,52,119
2024-03-15 16:20:00,41,4,8,41,94
2024-03-15 16:30:00,49,8,11,35,103
2024-03-15 16:40:00,47,8,6,46,107
2024-03-15 16:50:00,32,8,4,30,74
2024-03-15 17:00:00,58,5,8,37,108
2024-03-15 17:10:00,52,5,9,37,103
2024-03-15 17:20:00,46,4,15,46,111
2024-03-15 17:30:00,43,3,7,48,101
2024-03-15 17:40:00,51,5,7,49,112
2024-03-15 17:50:00,42,7,9,41,99
2024-03-15 18:00:00,51,7,4,43,105
2024-03-15 18:10:00,59,9,15,45,128
2024-03-15 18:20:00,40,7,5,22,74
2024-03-15 18:30:00,44,3,5,30,82
2024-03-15 18:40:00,53,5,6,53,117
2024-03-15 18:50:00,46,5,7,45,103
2024-03-15 19:00:00,41,10,7,41,99
2024-03-15 19:10:00,48,4,2,42,96
2024-03-15 19:20:00,25,3,10,29,67
2024-03-15 19:30:00,25,5,6,28,64
2024-03-15 19:40:00,31,5,2,43,81
2024-03-15 19:50:00,30,4,4,27,65
2024-03-15 20:00:00,38,7,3,19,67
2024-03-15 20:10:00,29,6,5,34,74
2024-03-15 20:20:00,23,2,2,29,56
2024-03-15 20:30:00,31,3,2,14,50
2024-03-15 20:40:00,27,1,4,19,51
2024-03-15 20:50:00,25,4,3,30,62
2024-03-15 21:00:00,19,1,5,13,38
2024-03-15 21:10:00,25,1,3,28,57
2024-03-15 21:20:00,36,7,2,18,63
2024-03-15 21:30:00,18,3,2,24,47
2024-03-15 21:40:00,26,4,2,13,45
2024-03-15 21:50:00,28,2,0,18,48
2024-03-15 22:00:00,25,1,2,15,43
2024-03-15 22:10:00,22,3,0,23,48
2024-03-15 22:20:00,26,4,3,24,57
2024-03-15 22:30:00,22,4,3,11,40
2024-03-15 22:40:00,22,0,5,15,42
2024-03-15 22:50:00,8,1,2,15,26
2024-03-15 23:00:00,13,2,1,16,32
2024-03-15 23:10:00,29,3,0,12,44
2024-03-15 23:20:00,21,2,0,7,30
2024-03-15 23:30:00,19,3,2,8,32
2024-03-15 23:40:00,12,0,1,8,21
2024-03-15 23:50:00,14,2,0,8,24
2024-03-16 00:00:00,14,1,5,9,29
2024-03-16 00:10:00,10,0,0,6,16
2024-03-16 00:20:00,5,1,2,11,19
2024-03-16 00:30:00,16,4,1,6,27
2024-03-16 00:40:00,6,0,1,5,12
2024-03-16 00:50:00,13,0,0,6,19
2024-03-16 01:00:00,3,2,2,8,15
2024-03-16 01:10:00,9,0,2,7,18
2024-03-16 01:20:00,7,1,2,6,16
2024-03-16 01:30:00,7,2,1,4,14
2024-03-16 01:40:00,17,4,2,9,32
2024-03-16 01:50:00,14,5,1,1,21
2024-03-16 02:00:00,7,1,0,5,13
2024-03-16 02:10:00,4,0,0,0,4
2024-03-16 02:20:00,4,1,0,1,6
2024-03-16 02:30:00,3,0,0,3,6
2024-03-16 02:40:00,2,0,0,3,5
2024-03-16 02:50:00,6,0,0,0,6
2024-03-16 03:00:00,2,0,0,2,4
2024-03-16 03:10:00,4,0,0,2,6
2024-03-16 03:20:00,6,1,0,1,8
2024-03-16 03:30:00,2,0,0,2,4
2024-03-16 03:40:00,2,0,0,5,7
2024-03-16 03:50:00,6,1,0,0,7
2024-03-16 04:00:00,5,0,0,2,7
2024-03-16 04:10:00,1,0,0,0,1
2024-03-16 04:20:00,3,0,0,2,5
2024-03-16 04:30:00,1,0,0,3,4
2024-03-16 04:40:00,1,0,0,2,3
2024-03-16 04:50:00,2,0,1,1,4
2024-03-16 05:00:00,3,0,0,0,3
2024-03-16 05:10:00,0,0,0,5,5
2024-03-16 05:20:00,1,0,0,5,6
2024-03-16 05:30:00,0,0,0,4,4
2024-03-16 05:40:00,3,0,0,2,5
2024-03-16 05:50:00,0,1,2,0,3
2024-03-16 06:00:00,4,0,1,1,6
2024-03-16 06:10:00,2,0,0,3,5
2024-03-16 06:20:00,5,0,1,7,13
2024-03-16 06:30:00,7,0,0,1,8
2024-03-16 06:40:00,4,1,0,5,10
2024-03-16 06:50:00,5,0,0,12,17
2024-03-16 07:00:00,8,0,0,7,15
2024-03-16 07:10:00,1,1,0,8,10
2024-03-16 07:20:00,8,0,2,9,19
2024-03-16 07:30:00,17,1,0,9,27
2024-03-16 07:40:00,7,1,5,9,22
2024-03-16 07:50:00,10,0,4,14,28
2024-03-16 08:00:00,13,1,2,13,29
2024-03-16 08:10:00,16,5,3,18,42
2024-03-16 08:20:00,16,1,3,20,40
2024-03-16 08:30:00,27,1,3,18,49
2024-03-16 08:40:00,20,2,2,25,49
2024-03-16 08:50:00,18,5,6,27,56
2024-03-16 09:00:00,22,0,4,22,48
2024-03-16 09:10:00,29,0,5,21,55
2024-03-16 09:20:00,34,7,2,26,69
2024-03-16 09:30:00,42,2,3,36,83
2024-03-16 09:40:00,46,0,6,45,97
2024-03-16 09:50:00,42,3,7,46,98
2024-03-16 10:00:00,37,2,4,43,86
2024-03-16 10:10:00,34,2,6,32,74
2024-03-16 10:20:00,48,3,6,48,105
2024-03-16 10:30:00,34,7,8,29,78
2024-03-16 10:40:00,38,5,6,36,85
2024-03-16 10:50:00,54,8,8,41,111
2024-03-16 11:00:00,53,2,8,42,105
2024-03-16 11:10:00,34,2,2,46,84
2024-03-16 11:20:00,42,1,9,28,80
2024-03-16 11:30:00,33,3,11,38,85
2024-03-16 11:40:00,51,7,5,43,106
2024-03-16 11:50:00,41,6,2,49,98
2024-03-16 12:00:00,44,4,5,46,99
2024-03-16 12:10:00,47,3,11,58,119
2024-03-16 12:20:00,46,4,7,43,100
2024-03-16 12:30:00,45,6,7,54,112
2024-03-16 12:40:00,38,6,4,52,100
2024-03-16 12:50:00,40,8,8,46,102
2024-03-16 13:00:00,38,6,5,43,92
2024-03-16 13:10:00,56,6,6,40,108
2024-03-16 13:20:00,40,4,6,40,90
2024-03-16 13:30:00,36,3,9,46,94
2024-03-16 13:40:00,33,7,11,51,102
2024-03-16 13:50:00,45,8,8,59,120
2024-03-16 14:00:00,47,5,9,62,123
2024-03-16 14:10:00,39,4,10,40,93
2024-03-16 14:20:00,43,9,5,47,104
2024-03-16 14:30:00,44,3,10,42,99
2024-03-16 14:40:00,46,6,6,40,98
2024-03-16 14:50:00,37,6,9,50,102
2024-03-16 15:00:00,50,4,4,30,88
2024-03-16 15:10:00,44,4,9,46,103
2024-03-16 15:20:00,39,5,10,25,79
2024-03-16 15:30:00,42,2,4,22,70
2024-03-16 15:40:00,39,5,7,33,84
2024-03-16 15:50:00,48,5,6,34,93
2024-03-16 16:00:00,33,5,9,28,75
2024-03-16 16:10:00,34,5,4,44,87
2024-03-16 16:20:00,27,4,4,22,57
2024-03-16 16:30:00,33,6,3,29,71
2024-03-16 16:40:00,33,2,4,19,58
2024-03-16 16:50:00,36,2,7,31,76
2024-03-16 17:00:00,41,6,2,33,82
2024-03-16 17:10:00,38,3,3,31,75
2024-03-16 17:20:00,42,8,3,28,81
2024-03-16 17:30:00,41,7,8,26,82
2024-03-16 17:40:00,46,4,6,31,87
2024-03-16 17:50:00,49,5,8,26,88
2024-03-16 18:00:00,66,3,4,36,109
2024-03-16 18:10:00,65,9,8,32,114
2024-03-16 18:20:00,70,4,10,26,110
2024-03-16 18:30:00,48,5,3,41,97
2024-03-16 18:40:00,36,5,1,41,83
2024-03-16 18:50:00,44,6,2,35,87
2024-03-16 19:00:00,52,4,5,41,102
2024-03-16 19:10:00,42,10,7,39,98
2024-03-16 19:20:00,39,1,8,28,76
2024-03-16 19:30:00,31,7,2,23,63
2024-03-16 19:40:00,34,2,3,35,74
2024-03-16 19:50:00,22,3,4,29,58
2024-03-16 20:00:00,21,3,3,25,52
2024-03-16 20:10:00,34,2,1,20,57
2024-03-16 20:20:00,20,3,1,24,48
2024-03-16 20:30:00,30,2,3,18,53
2024-03-16 20:40:00,26,5,2,21,54
2024-03-16 20:50:00,18,2,2,23,45
2024-03-16 21:00:00,19,0,0,15,34
2024-03-16 21:10:00,21,2,0,22,45
2024-03-16 21:20:00,24,0,0,26,50
2024-03-16 21:30:00,21,3,3,23,50
2024-03-16 21:40:00,26,2,0,15,43
2024-03-16 21:50:00,22,0,0,14,36
2024-03-16 22:00:00,21,3,3,17,44
2024-03-16 22:10:00,28,0,2,20,50
2024-03-16 22:20:00,32,2,1,16,51
2024-03-16 22:30:00,13,3,3,36,55
2024-03-16 22:40:00,18,6,0,18,42
2024-03-16 22:50:00,17,2,3,21,43
2024-03-16 23:00:00,10,1,2,13,26
2024-03-16 23:10:00,23,2,0,8,33
2024-03-16 23:20:00,20,2,0,9,31
2024-03-16 23:30:00,7,0,3,17,27
2024-03-16 23:40:00,15,0,0,9,24
2024-03-16 23:50:00,15,1,2,8,26
2024-03-17 00:00:00,18,7,2,8,35
2024-03-17 00:10:00,9,0,0,13,22
2024-03-17 00:20:00,13,0,0,15,28
2024-03-17 00:30:00,10,0,1,16,27
2024-03-17 00:40:00,10,3,2,10,25
2024-03-17 00:50:00,8,0,0,9,17
2024-03-17 01:00:00,18,1,0,9,28
2024-03-17 01:10:00,11,1,2,6,20
2024-03-17 01:20:00,10,0,0,2,12
2024-03-17 01:30:00,14,0,0,2,16
2024-03-17 01:40:00,7,0,2,8,17
2024-03-17 01:50:00,2,0,0,6,8
2024-03-17 02:00:00,7,0,0,5,12
2024-03-17 02:10:00,4,0,0,5,9
2024-03-17 02:20:00,4,0,0,4,8
2024-03-17 02:30:00,11,2,0,1,14
2024-03-17 02:40:00,3,0,0,1,4
2024-03-17 02:50:00,6,0,0,3,9
2024-03-17 03:00:00,4,0,0,3,7
2024-03-17 03:10:00,7,3,0,6,16
2024-03-17 03:20:00,5,0,0,5,10
2024-03-17 03:30:00,3,0,0,2,5
2024-03-17 03:40:00,5,0,0,3,8
2024-03-17 03:50:00,6,0,0,1,7
2024-03-17 04:00:00,4,0,0,3,7
2024-03-17 04:10:00,2,0,0,3,5
2024-03-17 04:20:00,2,0,0,2,4
2024-03-17 04:30:00,4,0,0,0,4
2024-03-17 04:40:00,5,0,0,2,7
2024-03-17 04:50:00,1,0,0,4,5
2024-03-17 05:00:00,0,0,0,2,2
2024-03-17 05:10:00,3,0,0,2,5
2024-03-17 05:20:00,1,0,0,5,6
2024-03-17 05:30:00,3,2,2,1,8
2024-03-17 05:40:00,6,0,0,2,8
2024-03-17 05:50:00,2,2,1,0,5
2024-03-17 06:00:00,0,0,0,2,2
2024-03-17 06:10:00,1,0,0,0,1
2024-03-17 06:20:00,2,0,1,0,3
2024-03-17 06:30:00,2,0,1,3,6
2024-03-17 06:40:00,4,0,1,0,5
2024-03-17 06:50:00,3,0,0,5,8
2024-03-17 07:00:00,2,0,0,1,3
2024-03-17 07:10:00,3,1,1,3,8
2024-03-17 07:20:00,3,0,1,2,6
2024-03-17 07:30:00,7,0,4,7,18
2024-03-17 07:40:00,5,0,1,4,10
2024-03-17 07:50:00,5,1,1,2,9
2024-03-17 08:00:00,10,3,0,6,19
2024-03-17 08:10:00,8,1,0,9,18
2024-03-17 08:20:00,6,0,2,7,15
2024-03-17 08:30:00,15,3,0,8,26
2024-03-17 08:40:00,16,1,1,6,24
2024-03-17 08:50:00,17,1,2,16,36
2024-03-17 09:00:00,16,1,1,13,31
2024-03-17 09:10:00,19,0,3,32,54
2024-03-17 09:20:00,25,0,1,32,58
2024-03-17 09:30:00,32,0,2,27,61
2024-03-17 09:40:00,26,0,4,26,56
2024-03-17 09:50:00,25,1,3,18,47
2024-03-17 10:00:00,23,3,1,18,45
2024-03-17 10:10:00,28,2,9,18,57
2024-03-17 10:20:00,26,2,2,19,49
2024-03-17 10:30:00,21,3,6,20,50
2024-03-17 10:40:00,19,3,3,27,52
2024-03-17 10:50:00,22,1,3,24,50
2024-03-17 11:00:00,25,2,3,20,50
2024-03-17 11:10:00,37,3,5,27,72
2024-03-17 11:20:00,29,2,4,26,61
2024-03-17 11:30:00,26,2,6,21,55
2024-03-17 11:40:00,29,1,6,32,68
2024-03-17 11:50:00,24,4,4,29,61
2024-03-17 12:00:00,28,3,3,29,63
2024-03-17 12:10:00,28,4,2,26,60
2024-03-17 12:20:00,26,10,4,33,73
2024-03-17 12:30:00,37,3,3,37,80
2024-03-17 12:40:00,41,6,4,33,84
2024-03-17 12:50:00,34,6,4,29,73
2024-03-17 13:00:00,36,2,6,38,82
2024-03-17 13:10:00,40,4,6,30,80
2024-03-17 13:20:00,38,2,3,33,76
2024-03-17 13:30:00,46,2,6,30,84
2024-03-17 13:40:00,39,6,8,26,79
2024-03-17 13:50:00,23,3,3,32,61
2024-03-17 14:00:00,37,4,6,32,79
2024-03-17 14:10:00,39,5,4,26,74
2024-03-17 14:20:00,39,5,5,39,88
2024-03-17 14:30:00,27,3,1,39,70
2024-03-17 14:40:00,35,4,12,36,87
2024-03-17 14:50:00,47,5,9,41,102
2024-03-17 15:00:00,51,10,10,35,106
2024-03-17 15:10:00,36,3,4,30,73
2024-03-17 15:20:00,23,4,2,31,60
2024-03-17 15:30:00,45,3,7,36,91
2024-03-17 15:40:00,37,2,10,39,88
2024-03-17 15:50:00,51,2,8,31,92
2024-03-17 16:00:00,27,2,4,27,60
2024-03-17 16:10:00,33,3,3,27,66
2024-03-17 16:20:00,26,1,13,34,74
2024-03-17 16:30:00,30,1,2,28,61
2024-03-17 16:40:00,33,1,7,30,71
2024-03-17 16:50:00,34,1,7,26,68
2024-03-17 17:00:00,27,2,4,34,67
2024-03-17 17:10:00,36,2,2,38,78
2024-03-17 17:20:00,28,2,9,33,72
2024-03-17 17:30:00,28,2,6,41,77
2024-03-17 17:40:00,44,1,8,40,93
2024-03-17 17:50:00,41,5,3,33,82
2024-03-17 18:00:00,35,1,5,38,79
2024-03-17 18:10:00,25,4,4,40,73
2024-03-17 18:20:00,31,1,5,35,72
2024-03-17 18:30:00,31,2,5,25,63
2024-03-17 18:40:00,32,8,7,26,73
2024-03-17 18:50:00,28,1,2,27,58
2024-03-17 19:00:00,36,0,4,39,79
2024-03-17 19:10:00,30,12,3,20,65
2024-03-17 19:20:00,16,5,8,23,52
2024-03-17 19:30:00,25,0,4,34,63
2024-03-17 19:40:00,23,5,3,32,63
2024-03-17 19:50:00,28,0,4,25,57
2024-03-17 20:00:00,29,5,2,37,73
2024-03-17 20:10:00,31,5,2,21,59
2024-03-17 20:20:00,24,1,5,27,57
2024-03-17 20:30:00,19,1,1,17,38
2024-03-17 20:40:00,28,4,4,17,53
2024-03-17 20:50:00,19,6,2,13,40
2024-03-17 21:00:00,15,2,2,18,37
2024-03-17 21:10:00,18,0,1,13,32
2024-03-17 21:20:00,14,8,3,15,40
2024-03-17 21:30:00,15,0,2,23,40
2024-03-17 21:40:00,24,1,0,9,34
2024-03-17 21:50:00,24,0,0,19,43
2024-03-17 22:00:00,22,2,3,13,40
2024-03-17 22:10:00,11,0,4,15,30
2024-03-17 22:20:00,12,0,0,4,16
2024-03-17 22:30:00,14,2,5,11,32
2024-03-17 22:40:00,11,2,0,2,15
2024-03-17 22:50:00,5,0,2,5,12
2024-03-17 23:00:00,12,0,1,3,16
2024-03-17 23:10:00,2,0,0,7,9
2024-03-17 23:20:00,9,0,0,4,13
2024-03-17 23:30:00,10,2,0,1,13
2024-03-17 23:40:00,4,0,0,2,6
2024-03-17 23:50:00,5,2,0,4,11
2024-03-18 00:00:00,2,0,0,3,5
2024-03-18 00:10:00,9,1,0,2,12
2024-03-18 00:20:00,3,1,0,4,8
2024-03-18 00:30:00,3,0,0,1,4
2024-03-18 00:40:00,6,0,0,1,7
2024-03-18 00:50:00,0,0,0,1,1
2024-03-18 01:00:00,5,0,0,0,5
2024-03-18 01:10:00,3,0,2,4,9
2024-03-18 01:20:00,4,0,0,2,6
2024-03-18 01:30:00,5,0,0,0,5
2024-03-18 01:40:00,2,0,0,1,3
2024-03-18 01:50:00,3,0,0,1,4
2024-03-18 02:00:00,0,2,0,5,7
2024-03-18 02:10:00,3,0,0,1,4
2024-03-18 02:20:00,0,0,0,2,2
2024-03-18 02:30:00,2,0,0,0,2
2024-03-18 02:40:00,0,0,2,0,2
2024-03-18 02:50:00,2,0,1,0,3
2024-03-18 03:00:00,0,0,0,0,0
2024-03-18 03:10:00,0,0,1,1,2
2024-03-18 03:20:00,5,0,0,0,5
2024-03-18 03:30:00,1,0,0,0,1
2024-03-18 03:40:00,4,0,0,1,5
2024-03-18 03:50:00,1,0,2,2,5
2024-03-18 04:00:00,3,0,0,1,4
2024-03-18 04:10:00,2,0,0,2,4
2024-03-18 04:20:00,0,0,0,2,2
2024-03-18 04:30:00,3,0,0,0,3
2024-03-18 04:40:00,2,0,2,2,6
2024-03-18 04:50:00,0,0,0,5,5
2024-03-18 05:00:00,5,0,1,4,10
2024-03-18 05:10:00,4,0,1,9,14
2024-03-18 05:20:00,8,0,2,5,15
2024-03-18 05:30:00,6,0,6,17,29
2024-03-18 05:40:00,9,3,4,12,28
2024-03-18 05:50:00,14,3,11,16,44
2024-03-18 06:00:00,9,0,4,23,36
2024-03-18 06:10:00,10,0,1,20,31
2024-03-18 06:20:00,21,1,3,24,49
2024-03-18 06:30:00,12,1,6,19,38
2024-03-18 06:40:00,23,3,4,21,51
2024-03-18 06:50:00,20,2,4,28,54
2024-03-18 07:00:00,21,1,9,39,70
2024-03-18 07:10:00,26,5,7,48,86
2024-03-18 07:20:00,33,7,18,59,117
2024-03-18 07:30:00,38,3,8,57,106
2024-03-18 07:40:00,49,2,15,56,122
2024-03-18 07:50:00,37,1,25,55,118
2024-03-18 08:00:00,42,5,13,61,121
2024-03-18 08:10:00,37,2,12,50,101
2024-03-18 08:20:00,33,6,17,64,120
2024-03-18 08:30:00,53,10,5,57,125
2024-03-18 08:40:00,52,7,5,43,107
2024-03-18 08:50:00,44,5,9,48,106
2024-03-18 09:00:00,41,4,7,44,96
2024-03-18 09:10:00,35,6,8,42,91
2024-03-18 09:20:00,39,5,5,42,91
2024-03-18 09:30:00,35,2,16,45,98
2024-03-18 09:40:00,27,5,3,47,82
2024-03-18 09:50:00,38,4,10,53,105
2024-03-18 10:00:00,42,6,5,39,92
2024-03-18 10:10:00,47,4,7,38,96
2024-03-18 10:20:00,34,6,6,40,86
2024-03-18 10:30:00,25,6,4,37,72
2024-03-18 10:40:00,49,6,5,37,97
2024-03-18 10:50:00,46,4,7,45,102
2024-03-18 11:00:00,41,2,10,54,107
2024-03-18 11:10:00,37,3,9,57,106
2024-03-18 11:20:00,36,4,4,43,87
2024-03-18 11:30:00,36,4,11,42,93
2024-03-18 11:40:00,54,6,1,33,94
2024-03-18 11:50:00,37,5,11,51,104
2024-03-18 12:00:00,42,4,13,43,102
2024-03-18 12:10:00,37,7,7,40,91
2024-03-18 12:20:00,50,4,4,41,99
2024-03-18 12:30:00,36,5,6,41,88
2024-03-18 12:40:00,38,4,6,47,95
2024-03-18 12:50:00,31,8,7,39,85
2024-03-18 13:00:00,46,5,5,32,88
2024-03-18 13:10:00,34,9,10,37,90
2024-03-18 13:20:00,37,11,5,35,88
2024-03-18 13:30:00,46,9,5,38,98
2024-03-18 13:40:00,39,5,10,40,94
2024-03-18 13:50:00,55,8,11,40,114
2024-03-18 14:00:00,44,10,8,36,98
2024-03-18 14:10:00,45,3,9,39,96
2024-03-18 14:20:00,41,8,7,44,100
2024-03-18 14:30:00,38,7,11,48,104
2024-03-18 14:40:00,41,9,3,44,97
2024-03-18 14:50:00,52,3,11,40,106
2024-03-18 15:00:00,41,5,4,40,90
2024-03-18 15:10:00,40,7,9,39,95
2024-03-18 15:20:00,34,12,6,32,84
2024-03-18 15:30:00,61,10,10,37,118
2024-03-18 15:40:00,40,10,4,31,85
2024-03-18 15:50:00,48,6,11,50,115
2024-03-18 16:00:00,47,11,14,39,111
2024-03-18 16:10:00,49,4,10,30,93
2024-03-18 16:20:00,38,3,7,43,91
2024-03-18 16:30:00,56,9,7,37,109
2024-03-18 16:40:00,28,9,7,40,84
2024-03-18 16:50:00,51,8,9,50,118
2024-03-18 17:00:00,44,14,6,43,107
2024-03-18 17:10:00,45,12,11,43,111
2024-03-18 17:20:00,49,4,6,48,107
2024-03-18 17:30:00,42,11,13,55,121
2024-03-18 17:40:00,53,13,12,40,118
2024-03-18 17:50:00,45,10,8,41,104
2024-03-18 18:00:00,46,11,8,33,98
2024-03-18 18:10:00,48,11,13,51,123
2024-03-18 18:20:00,37,15,10,39,101
2024-03-18 18:30:00,46,7,13,39,105
2024-03-18 18:40:00,40,7,9,30,86
2024-03-18 18:50:00,34,7,10,35,86
2024-03-18 19:00:00,52,13,5,34,104
2024-03-18 19:10:00,37,3,13,48,101
2024-03-18 19:20:00,37,4,6,33,80
2024-03-18 19:30:00,40,9,5,35,89
2024-03-18 19:40:00,53,4,6,36,99
2024-03-18 19:50:00,31,4,6,31,72
2024-03-18 20:00:00,19,1,3,27,50
2024-03-18 20:10:00,32,5,5,28,70
2024-03-18 20:20:00,25,1,5,36,67
2024-03-18 20:30:00,25,5,6,17,53
2024-03-18 20:40:00,21,3,2,29,55
2024-03-18 20:50:00,23,2,4,21,50
2024-03-18 21:00:00,15,10,3,21,49
2024-03-18 21:10:00,27,7,2,22,58
2024-03-18 21:20:00,22,2,1,21,46
2024-03-18 21:30:00,23,7,9,14,53
2024-03-18 21:40:00,20,0,5,16,41
2024-03-18 21:50:00,15,4,1,10,30
2024-03-18 22:00:00,16,2,3,15,36
2024-03-18 22:10:00,19,1,2,14,36
2024-03-18 22:20:00,20,1,2,13,36
2024-03-18 22:30:00,19,2,3,15,39
2024-03-18 22:40:00,12,1,2,10,25
2024-03-18 22:50:00,11,1,6,6,24
2024-03-18 23:00:00,5,1,1,6,13
2024-03-18 23:10:00,8,3,1,4,16
2024-03-18 23:20:00,10,2,0,4,16
2024-03-18 23:30:00,5,0,1,3,9
2024-03-18 23:40:00,5,0,0,4,9
2024-03-18 23:50:00,4,0,1,6,11
2024-03-19 00:00:00,5,1,0,4,10
2024-03-19 00:10:00,6,1,0,1,8
2024-03-19 00:20:00,7,0,1,3,11
2024-03-19 00:30:00,3,0,0,1,4
2024-03-19 00:40:00,6,1,1,5,13
2024-03-19 00:50:00,4,0,0,2,6
2024-03-19 01:00:00,3,0,0,0,3
2024-03-19 01:10:00,4,0,0,2,6
2024-03-19 01:20:00,4,0,0,1,5
2024-03-19 01:30:00,2,0,0,0,2
2024-03-19 01:40:00,4,0,0,0,4
2024-03-19 01:50:00,0,0,1,1,2
2024-03-19 02:00:00,1,0,0,1,2
2024-03-19 02:10:00,1,0,0,2,3
2024-03-19 02:20:00,2,0,0,0,2
2024-03-19 02:30:00,2,0,0,1,3
2024-03-19 02:40:00,2,1,0,1,4
2024-03-19 02:50:00,2,0,1,0,3
2024-03-19 03:00:00,0,0,1,1,2
2024-03-19 03:10:00,3,0,1,2,6
2024-03-19 03:20:00,1,1,0,1,3
2024-03-19 03:30:00,3,1,0,1,5
2024-03-19 03:40:00,1,0,1,2,4
2024-03-19 03:50:00,2,0,2,3,7
2024-03-19 04:00:00,3,1,0,0,4
2024-03-19 04:10:00,3,0,1,2,6
2024-03-19 04:20:00,1,0,1,2,4
2024-03-19 04:30:00,1,0,0,4,5
2024-03-19 04:40:00,0,0,2,2,4
2024-03-19 04:50:00,0,0,3,2,5
2024-03-19 05:00:00,4,0,0,12,16
2024-03-19 05:10:00,4,0,2,8,14
2024-03-19 05:20:00,6,0,0,7,13
2024-03-19 05:30:00,4,0,5,13,22
2024-03-19 05:40:00,10,3,6,17,36
2024-03-19 05:50:00,13,0,4,11,28
2024-03-19 06:00:00,3,0,2,11,16
2024-03-19 06:10:00,6,1,7,17,31
2024-03-19 06:20:00,21,1,5,21,48
2024-03-19 06:30:00,15,1,7,11,34
2024-03-19 06:40:00,27,5,3,28,63
2024-03-19 06:50:00,16,4,3,30,53
2024-03-19 07:00:00,20,3,6,43,72
2024-03-19 07:10:00,26,4,10,50,90
2024-03-19 07:20:00,44,3,6,56,109
2024-03-19 07:30:00,36,4,13,70,123
2024-03-19 07:40:00,45,2,8,69,124
2024-03-19 07:50:00,31,9,20,55,115
2024-03-19 08:00:00,34,9,18,42,103
2024-03-19 08:10:00,35,14,17,54,120
2024-03-19 08:20:00,49,5,15,53,122
2024-03-19 08:30:00,48,11,16,51,126
2024-03-19 08:40:00,55,3,7,44,109
2024-03-19 08:50:00,38,9,7,51,105
2024-03-19 09:00:00,37,8,8,44,97
2024-03-19 09:10:00,41,6,10,33,90
2024-03-19 09:20:00,34,5,7,49,95
2024-03-19 09:30:00,44,4,7,50,105
2024-03-19 09:40:00,25,5,6,33,69
2024-03-19 09:50:00,35,5,4,39,83
2024-03-19 10:00:00,41,4,6,36,87
2024-03-19 10:10:00,27,3,6,37,73
2024-03-19 10:20:00,45,1,6,48,100
2024-03-19 10:30:00,27,3,11,38,79
2024-03-19 10:40:00,35,3,4,34,76
2024-03-19 10:50:00,40,3,9,48,100
2024-03-19 11:00:00,51,5,2,51,109
2024-03-19 11:10:00,34,6,3,40,83
2024-03-19 11:20:00,36,10,6,44,96
2024-03-19 11:30:00,35,8,7,43,93
2024-03-19 11:40:00,29,4,7,39,79
2024-03-19 11:50:00,46,5,6,32,89
2024-03-19 12:00:00,46,7,5,39,97
2024-03-19 12:10:00,48,7,7,38,100
2024-03-19 12:20:00,37,9,12,40,98
2024-03-19 12:30:00,30,6,6,36,78
2024-03-19 12:40:00,33,9,10,43,95
2024-03-19 12:50:00,40,9,3,33,85
2024-03-19 13:00:00,38,3,8,44,93
2024-03-19 13:10:00,44,11,10,31,96
2024-03-19 13:20:00,24,5,3,42,74
2024-03-19 13:30:00,24,6,5,50,85
2024-03-19 13:40:00,52,1,13,40,106
2024-03-19 13:50:00,52,7,13,36,108
2024-03-19 14:00:00,36,6,11,30,83
2024-03-19 14:10:00,38,7,9,45,99
2024-03-19 14:20:00,37,7,6,35,85
2024-03-19 14:30:00,48,14,3,42,107
2024-03-19 14:40:00,44,8,10,45,107
2024-03-19 14:50:00,40,10,9,34,93
2024-03-19 15:00:00,49,7,7,49,112
2024-03-19 15:10:00,52,10,6,41,109
2024-03-19 15:20:00,41,7,7,49,104
2024-03-19 15:30:00,55,6,10,41,112
2024-03-19 15:40:00,38,4,15,55,112
2024-03-19 15:50:00,65,9,6,37,117
2024-03-19 16:00:00,37,12,9,38,96
2024-03-19 16:10:00,51,4,6,38,99
2024-03-19 16:20:00,45,4,10,44,103
2024-03-19 16:30:00,42,2,7,60,111
2024-03-19 16:40:00,39,11,11,50,111
2024-03-19 16:50:00,46,12,6,45,109
2024-03-19 17:00:00,33,13,10,46,102
2024-03-19 17:10:00,52,15,14,52,133
2024-03-19 17:20:00,41,10,19,52,122
2024-03-19 17:30:00,48,7,5,37,97
2024-03-19 17:40:00,55,9,7,55,126
2024-03-19 17:50:00,53,8,15,40,116
2024-03-19 18:00:00,55,10,12,43,120
2024-03-19 18:10:00,48,6,8,45,107
2024-03-19 18:20:00,40,8,10,39,97
2024-03-19 18:30:00,40,4,10,48,102
2024-03-19 18:40:00,40,10,21,39,110
2024-03-19 18:50:00,42,11,6,51,110
2024-03-19 19:00:00,49,9,9,48,115
2024-03-19 19:10:00,22,8,11,43,84
2024-03-19 19:20:00,47,5,9,37,98
2024-03-19 19:30:00,27,3,12,30,72
2024-03-19 19:40:00,38,2,5,31,76
2024-03-19 19:50:00,29,4,5,32,70
2024-03-19 20:00:00,39,5,5,27,76
2024-03-19 20:10:00,33,6,11,31,81
2024-03-19 20:20:00,28,6,2,24,60
2024-03-19 20:30:00,26,2,2,25,55
2024-03-19 20:40:00,27,8,4,23,62
2024-03-19 20:50:00,19,3,6,28,56
2024-03-19 21:00:00,26,0,7,18,51
2024-03-19 21:10:00,25,2,4,20,51
2024-03-19 21:20:00,31,1,2,11,45
2024-03-19 21:30:00,26,6,3,22,57
2024-03-19 21:40:00,26,5,3,22,56
2024-03-19 21:50:00,21,3,2,16,42
2024-03-19 22:00:00,26,2,0,18,46
2024-03-19 22:10:00,12,2,0,18,32
2024-03-19 22:20:00,22,11,5,20,58
2024-03-19 22:30:00,16,3,5,10,34
2024-03-19 22:40:00,15,3,1,4,23
2024-03-19 22:50:00,25,5,0,7,37
2024-03-19 23:00:00,13,5,4,6,28
2024-03-19 23:10:00,7,1,1,11,20
2024-03-19 23:20:00,10,0,5,8,23
2024-03-19 23:30:00,8,1,0,6,15
2024-03-19 23:40:00,7,2,0,4,13
2024-03-19 23:50:00,7,0,0,3,10
2024-03-20 00:00:00,4,0,0,5,9
2024-03-20 00:10:00,8,0,0,0,8
2024-03-20 00:20:00,2,0,0,3,5
2024-03-20 00:30:00,7,0,2,3,12
2024-03-20 00:40:00,5,4,1,2,12
2024-03-20 00:50:00,3,2,0,5,10
2024-03-20 01:00:00,2,1,0,1,4
2024-03-20 01:10:00,9,0,0,2,11
2024-03-20 01:20:00,5,0,0,3,8
2024-03-20 01:30:00,1,0,1,2,4
2024-03-20 01:40:00,2,0,0,1,3
2024-03-20 01:50:00,6,0,0,1,7
2024-03-20 02:00:00,0,0,0,2,2
2024-03-20 02:10:00,0,2,0,1,3
2024-03-20 02:20:00,1,0,0,0,1
2024-03-20 02:30:00,0,0,0,0,0
2024-03-20 02:40:00,0,0,0,0,0
2024-03-20 02:50:00,3,0,1,1,5
2024-03-20 03:00:00,1,0,0,2,3
2024-03-20 03:10:00,3,1,0,1,5
2024-03-20 03:20:00,7,0,0,0,7
2024-03-20 03:30:00,2,3,0,2,7
2024-03-20 03:40:00,1,0,0,2,3
2024-03-20 03:50:00,0,0,3,4,7
2024-03-20 04:00:00,3,0,0,1,4
2024-03-20 04:10:00,2,0,0,0,2
2024-03-20 04:20:00,0,0,2,2,4
2024-03-20 04:30:00,2,0,0,2,4
2024-03-20 04:40:00,1,0,0,1,2
2024-03-20 04:50:00,1,0,0,7,8
2024-03-20 05:00:00,4,2,1,8,15
2024-03-20 05:10:00,8,0,1,11,20
2024-03-20 05:20:00,8,0,3,2,13
2024-03-20 05:30:00,7,2,3,11,23
2024-03-20 05:40:00,6,0,6,12,24
2024-03-20 05:50:00,16,0,7,13,36
2024-03-20 06:00:00,7,3,3,17,30
2024-03-20 06:10:00,11,2,1,12,26
2024-03-20 06:20:00,17,2,5,21,45
2024-03-20 06:30:00,10,1,5,14,30
2024-03-20 06:40:00,22,8,9,24,63
2024-03-20 06:50:00,18,2,3,34,57
2024-03-20 07:00:00,17,2,11,42,72
2024-03-20 07:10:00,39,2,5,52,98
2024-03-20 07:20:00,49,8,9,64,130
2024-03-20 07:30:00,35,6,11,76,128
2024-03-20 07:40:00,52,4,13,52,121
2024-03-20 07:50:00,41,3,10,51,105
2024-03-20 08:00:00,48,8,16,52,124
2024-03-20 08:10:00,34,5,14,65,118
2024-03-20 08:20:00,37,4,8,59,108
2024-03-20 08:30:00,46,10,16,49,121
2024-03-20 08:40:00,50,9,8,50,117
2024-03-20 08:50:00,47,3,5,44,99
2024-03-20 09:00:00,38,3,5,52,98
2024-03-20 09:10:00,26,6,8,50,90
2024-03-20 09:20:00,29,8,6,44,87
2024-03-20 09:30:00,27,8,9,41,85
2024-03-20 09:40:00,46,12,9,37,104
2024-03-20 09:50:00,34,3,4,32,73
2024-03-20 10:00:00,34,4,7,49,94
2024-03-20 10:10:00,43,5,6,42,96
2024-03-20 10:20:00,34,10,9,40,93
2024-03-20 10:30:00,38,2,7,44,91
2024-03-20 10:40:00,35,5,11,43,94
2024-03-20 10:50:00,46,5,2,42,95
2024-03-20 11:00:00,36,4,6,39,85
2024-03-20 11:10:00,44,6,11,29,90
2024-03-20 11:20:00,45,4,7,35,91
2024-03-20 11:30:00,33,4,7,41,85
2024-03-20 11:40:00,58,8,7,35,108
2024-03-20 11:50:00,42,1,8,36,87
2024-03-20 12:00:00,40,4,7,43,94
2024-03-20 12:10:00,38,4,9,47,98
2024-03-20 12:20:00,45,6,8,42,101
2024-03-20 12:30:00,41,8,5,48,102
2024-03-20 12:40:00,27,5,9,43,84
2024-03-20 12:50:00,37,7,5,42,91
2024-03-20 13:00:00,38,7,7,38,90
2024-03-20 13:10:00,43,8,8,43,102
2024-03-20 13:20:00,31,0,12,49,92
2024-03-20 13:30:00,44,10,8,37,99
2024-03-20 13:40:00,42,8,5,38,93
2024-03-20 13:50:00,39,6,7,36,88
2024-03-20 14:00:00,66,9,7,32,114
2024-03-20 14:10:00,33,11,11,46,101
2024-03-20 14:20:00,28,2,5,35,70
2024-03-20 14:30:00,41,11,12,43,107
2024-03-20 14:40:00,62,2,8,39,111
2024-03-20 14:50:00,32,13,12,55,112
2024-03-20 15:00:00,43,2,10,41,96
2024-03-20 15:10:00,49,4,8,39,100
2024-03-20 15:20:00,39,6,10,50,105
2024-03-20 15:30:00,30,4,17,36,87
2024-03-20 15:40:00,47,11,7,50,115
2024-03-20 15:50:00,44,7,8,48,107
2024-03-20 16:00:00,67,9,13,36,125
2024-03-20 16:10:00,37,7,10,30,84
2024-03-20 16:20:00,31,6,10,33,80
2024-03-20 16:30:00,52,9,11,59,131
2024-03-20 16:40:00,46,11,6,36,99
2024-03-20 16:50:00,42,4,13,43,102
2024-03-20 17:00:00,37,11,6,59,113
2024-03-20 17:10:00,59,8,11,45,123
2024-03-20 17:20:00,44,9,11,42,106
2024-03-20 17:30:00,48,12,10,49,119
2024-03-20 17:40:00,50,6,21,40,117
2024-03-20 17:50:00,53,11,10,40,114
2024-03-20 18:00:00,49,10,13,42,114
2024-03-20 18:10:00,47,6,8,43,104
2024-03-20 18:20:00,36,4,10,39,89
2024-03-20 18:30:00,43,3,10,37,93
2024-03-20 18:40:00,33,8,12,36,89
2024-03-20 18:50:00,47,8,13,42,110
2024-03-20 19:00:00,43,8,10,42,103
2024-03-20 19:10:00,34,8,9,38,89
2024-03-20 19:20:00,30,3,14,44,91
2024-03-20 19:30:00,32,4,8,22,66
2024-03-20 19:40:00,32,6,7,37,82
2024-03-20 19:50:00,41,4,4,22,71
2024-03-20 20:00:00,28,1,6,29,64
2024-03-20 20:10:00,38,6,8,23,75
2024-03-20 20:20:00,29,5,3,28,65
2024-03-20 20:30:00,23,8,7,31,69
2024-03-20 20:40:00,29,4,1,22,56
2024-03-20 20:50:00,26,6,2,13,47
2024-03-20 21:00:00,23,6,2,12,43
2024-03-20 21:10:00,26,7,2,17,52
2024-03-20 21:20:00,25,5,4,25,59
2024-03-20 21:30:00,21,2,5,16,44
2024-03-20 21:40:00,30,6,6,23,65
2024-03-20 21:50:00,17,2,3,17,39
2024-03-20 22:00:00,37,3,2,21,63
2024-03-20 22:10:00,22,5,0,17,44
2024-03-20 22:20:00,15,7,2,15,39
2024-03-20 22:30:00,12,0,3,11,26
2024-03-20 22:40:00,23,0,3,8,34
2024-03-20 22:50:00,13,2,1,13,29
2024-03-20 23:00:00,16,1,0,9,26
2024-03-20 23:10:00,10,0,4,12,26
2024-03-20 23:20:00,20,4,0,18,42
2024-03-20 23:30:00,11,0,0,4,15
2024-03-20 23:40:00,8,1,0,3,12
2024-03-20 23:50:00,4,1,0,5,10
2024-03-21 00:00:00,7,0,0,0,7
2024-03-21 00:10:00,8,1,0,1,10
2024-03-21 00:20:00,5,0,0,8,13
2024-03-21 00:30:00,5,0,0,1,6
2024-03-21 00:40:00,5,1,1,1,8
2024-03-21 00:50:00,2,0,0,2,4
2024-03-21 01:00:00,4,2,0,2,8
2024-03-21 01:10:00,7,2,0,1,10
2024-03-21 01:20:00,1,0,0,3,4
2024-03-21 01:30:00,4,3,0,5,12
2024-03-21 01:40:00,4,0,0,0,4
2024-03-21 01:50:00,3,0,0,0,3
2024-03-21 02:00:00,0,0,0,4,4
2024-03-21 02:10:00,0,0,0,1,1
2024-03-21 02:20:00,3,0,0,2,5
2024-03-21 02:30:00,1,0,0,2,3
2024-03-21 02:40:00,3,0,0,1,4
2024-03-21 02:50:00,4,2,0,1,7
2024-03-21 03:00:00,1,0,1,0,2
2024-03-21 03:10:00,2,0,4,2,8
2024-03-21 03:20:00,5,0,0,3,8
2024-03-21 03:30:00,0,0,0,0,0
2024-03-21 03:40:00,5,0,2,3,10
2024-03-21 03:50:00,2,0,0,2,4
2024-03-21 04:00:00,1,0,0,1,2
2024-03-21 04:10:00,3,0,1,4,8
2024-03-21 04:20:00,3,0,0,7,10
2024-03-21 04:30:00,2,0,0,2,4
2024-03-21 04:40:00,2,0,0,3,5
2024-03-21 04:50:00,2,2,0,4,8
2024-03-21 05:00:00,3,1,2,5,11
2024-03-21 05:10:00,6,1,2,9,18
2024-03-21 05:20:00,8,0,5,7,20
2024-03-21 05:30:00,6,0,4,16,26
2024-03-21 05:40:00,6,3,8,9,26
2024-03-21 05:50:00,17,1,2,12,32
2024-03-21 06:00:00,5,1,3,10,19
2024-03-21 06:10:00,14,1,0,18,33
2024-03-21 06:20:00,18,4,10,17,49
2024-03-21 06:30:00,11,3,6,18,38
2024-03-21 06:40:00,22,2,7,29,60
2024-03-21 06:50:00,19,1,6,44,70
2024-03-21 07:00:00,16,7,5,31,59
2024-03-21 07:10:00,32,2,5,49,88
2024-03-21 07:20:00,37,4,11,69,121
2024-03-21 07:30:00,43,9,5,60,117
2024-03-21 07:40:00,42,5,12,39,98
2024-03-21 07:50:00,31,1,6,47,85
2024-03-21 08:00:00,47,4,14,50,115
2024-03-21 08:10:00,31,9,10,58,108
2024-03-21 08:20:00,41,6,6,43,96
2024-03-21 08:30:00,31,6,7,46,90
2024-03-21 08:40:00,36,2,7,36,81
2024-03-21 08:50:00,39,8,15,52,114
2024-03-21 09:00:00,41,4,15,43,103
2024-03-21 09:10:00,34,3,7,34,78
2024-03-21 09:20:00,24,2,11,59,96
2024-03-21 09:30:00,36,5,5,37,83
2024-03-21 09:40:00,42,6,6,45,99
2024-03-21 09:50:00,40,4,13,42,99
2024-03-21 10:00:00,49,1,6,42,98
2024-03-21 10:10:00,38,7,6,35,86
2024-03-21 10:20:00,42,9,7,39,97
2024-03-21 10:30:00,42,3,7,33,85
2024-03-21 10:40:00,34,4,8,43,89
2024-03-21 10:50:00,48,0,6,33,87
2024-03-21 11:00:00,39,5,4,38,86
2024-03-21 11:10:00,35,7,8,38,88
2024-03-21 11:20:00,41,8,9,34,92
2024-03-21 11:30:00,51,10,4,44,109
2024-03-21 11:40:00,43,3,11,35,92
2024-03-21 11:50:00,33,7,5,37,82
2024-03-21 12:00:00,43,3,15,40,101
2024-03-21 12:10:00,49,9,12,45,115
2024-03-21 12:20:00,50,5,7,41,103
2024-03-21 12:30:00,42,8,10,40,100
2024-03-21 12:40:00,43,3,9,57,112
2024-03-21 12:50:00,38,11,5,38,92
2024-03-21 13:00:00,51,6,4,43,104
2024-03-21 13:10:00,34,8,7,39,88
2024-03-21 13:20:00,40,4,7,40,91
2024-03-21 13:30:00,39,9,6,48,102
2024-03-21 13:40:00,45,4,9,40,98
2024-03-21 13:50:00,40,7,9,36,92
2024-03-21 14:00:00,42,7,6,51,106
2024-03-21 14:10:00,32,6,8,42,88
2024-03-21 14:20:00,55,7,7,35,104
2024-03-21 14:30:00,53,13,13,43,122
2024-03-21 14:40:00,50,6,11,38,105
2024-03-21 14:50:00,47,5,13,41,106
2024-03-21 15:00:00,48,7,9,43,107
2024-03-21 15:10:00,40,11,12,49,112
2024-03-21 15:20:00,48,14,4,30,96
2024-03-21 15:30:00,46,6,5,33,90
2024-03-21 15:40:00,44,5,23,58,130
2024-03-21 15:50:00,57,8,17,41,123
2024-03-21 16:00:00,45,9,10,37,101
2024-03-21 16:10:00,51,7,10,43,111
2024-03-21 16:20:00,30,8,14,29,81
2024-03-21 16:30:00,42,4,12,49,107
2024-03-21 16:40:00,41,7,8,32,88
2024-03-21 16:50:00,48,15,11,46,120
2024-03-21 17:00:00,49,9,12,39,109
2024-03-21 17:10:00,57,13,9,40,119
2024-03-21 17:20:00,33,9,10,39,91
2024-03-21 17:30:00,42,5,15,42,104
2024-03-21 17:40:00,56,10,17,32,115
2024-03-21 17:50:00,35,5,10,38,88
2024-03-21 18:00:00,56,10,6,32,104
2024-03-21 18:10:00,58,9,3,50,120
2024-03-21 18:20:00,50,9,15,37,111
2024-03-21 18:30:00,40,11,13,44,108
2024-03-21 18:40:00,42,9,16,42,109
2024-03-21 18:50:00,58,11,9,34,112
2024-03-21 19:00:00,45,6,6,36,93
2024-03-21 19:10:00,47,11,6,44,108
2024-03-21 19:20:00,34,4,10,49,97
2024-03-21 19:30:00,42,4,2,33,81
2024-03-21 19:40:00,36,11,5,34,86
2024-03-21 19:50:00,34,1,11,27,73
2024-03-21 20:00:00,48,5,7,30,90
2024-03-21 20:10:00,34,3,10,27,74
2024-03-21 20:20:00,32,4,11,34,81
2024-03-21 20:30:00,21,6,6,24,57
2024-03-21 20:40:00,26,1,2,24,53
2024-03-21 20:50:00,25,2,6,23,56
2024-03-21 21:00:00,29,6,6,17,58
2024-03-21 21:10:00,25,2,11,14,52
2024-03-21 21:20:00,16,4,7,21,48
2024-03-21 21:30:00,23,0,1,23,47
2024-03-21 21:40:00,26,6,4,19,55
2024-03-21 21:50:00,22,5,3,22,52
2024-03-21 22:00:00,14,5,4,23,46
2024-03-21 22:10:00,26,11,0,21,58
2024-03-21 22:20:00,25,9,2,16,52
2024-03-21 22:30:00,22,2,5,9,38
2024-03-21 22:40:00,20,6,3,11,40
2024-03-21 22:50:00,14,6,2,13,35
2024-03-21 23:00:00,8,2,5,11,26
2024-03-21 23:10:00,14,1,4,6,25
2024-03-21 23:20:00,20,1,1,10,32
2024-03-21 23:30:00,8,2,0,11,21
2024-03-21 23:40:00,12,0,1,6,19
2024-03-21 23:50:00,9,2,3,5,19
2024-03-22 00:00:00,7,1,0,7,15
2024-03-22 00:10:00,7,0,0,1,8
2024-03-22 00:20:00,9,1,0,4,14
2024-03-22 00:30:00,11,0,0,6,17
2024-03-22 00:40:00,3,2,2,2,9
2024-03-22 00:50:00,4,0,0,5,9
2024-03-22 01:00:00,6,0,0,1,7
2024-03-22 01:10:00,2,2,0,1,5
2024-03-22 01:20:00,1,0,0,4,5
2024-03-22 01:30:00,5,0,0,2,7
2024-03-22 01:40:00,6,0,0,1,7
2024-03-22 01:50:00,1,0,0,7,8
2024-03-22 02:00:00,5,0,0,1,6
2024-03-22 02:10:00,3,0,0,1,4
2024-03-22 02:20:00,8,2,0,0,10
2024-03-22 02:30:00,4,0,0,3,7
2024-03-22 02:40:00,0,0,0,2,2
2024-03-22 02:50:00,1,0,0,0,1
2024-03-22 03:00:00,2,0,1,0,3
2024-03-22 03:10:00,5,2,0,1,8
2024-03-22 03:20:00,2,0,0,1,3
2024-03-22 03:30:00,3,0,0,1,4
2024-03-22 03:40:00,0,2,0,1,3
2024-03-22 03:50:00,2,0,2,1,5
2024-03-22 04:00:00,3,0,0,0,3
2024-03-22 04:10:00,1,0,0,2,3
2024-03-22 04:20:00,0,0,0,1,1
2024-03-22 04:30:00,0,0,0,2,2
2024-03-22 04:40:00,3,0,3,1,7
2024-03-22 04:50:00,0,0,3,4,7
2024-03-22 05:00:00,3,0,0,9,12
2024-03-22 05:10:00,4,0,2,7,13
2024-03-22 05:20:00,5,0,3,3,11
2024-03-22 05:30:00,5,1,1,4,11
2024-03-22 05:40:00,3,0,7,10,20
2024-03-22 05:50:00,15,0,2,11,28
2024-03-22 06:00:00,8,0,5,17,30
2024-03-22 06:10:00,4,1,0,14,19
2024-03-22 06:20:00,12,5,2,21,40
2024-03-22 06:30:00,11,2,2,9,24
2024-03-22 06:40:00,14,1,6,22,43
2024-03-22 06:50:00,21,5,2,29,57
2024-03-22 07:00:00,19,2,2,36,59
2024-03-22 07:10:00,25,1,6,47,79
2024-03-22 07:20:00,41,2,9,62,114
2024-03-22 07:30:00,49,5,5,52,111
2024-03-22 07:40:00,41,6,7,50,104
2024-03-22 07:50:00,50,7,17,49,123
2024-03-22 08:00:00,54,2,7,48,111
2024-03-22 08:10:00,35,2,11,47,95
2024-03-22 08:20:00,39,10,6,45,100
2024-03-22 08:30:00,32,4,8,49,93
2024-03-22 08:40:00,48,4,11,51,114
2024-03-22 08:50:00,45,3,4,30,82
2024-03-22 09:00:00,40,1,5,33,79
2024-03-22 09:10:00,41,2,2,35,80
2024-03-22 09:20:00,39,6,11,46,102
2024-03-22 09:30:00,36,6,7,41,90
2024-03-22 09:40:00,31,7,3,41,82
2024-03-22 09:50:00,45,5,6,46,102
2024-03-22 10:00:00,63,6,6,41,116
2024-03-22 10:10:00,63,5,10,55,133
2024-03-22 10:20:00,32,3,5,52,92
2024-03-22 10:30:00,40,6,7,49,102
2024-03-22 10:40:00,41,5,5,42,93
2024-03-22 10:50:00,45,9,10,32,96
2024-03-22 11:00:00,43,2,4,42,91
2024-03-22 11:10:00,60,1,7,31,99
2024-03-22 11:20:00,47,10,5,45,107
2024-03-22 11:30:00,49,8,9,39,105
2024-03-22 11:40:00,36,11,8,41,96
2024-03-22 11:50:00,44,6,6,47,103
2024-03-22 12:00:00,51,19,5,42,117
2024-03-22 12:10:00,45,7,9,41,102
2024-03-22 12:20:00,44,8,9,33,94
2024-03-22 12:30:00,41,8,8,51,108
2024-03-22 12:40:00,47,6,4,49,106
2024-03-22 12:50:00,58,11,7,35,111
2024-03-22 13:00:00,55,6,7,44,112
2024-03-22 13:10:00,39,5,6,41,91
2024-03-22 13:20:00,64,2,2,45,113
2024-03-22 13:30:00,53,6,7,41,107
2024-03-22 13:40:00,56,6,7,41,110
2024-03-22 13:50:00,45,12,7,40,104
2024-03-22 14:00:00,56,7,7,38,108
2024-03-22 14:10:00,51,3,8,43,105
2024-03-22 14:20:00,62,7,9,45,123
2024-03-22 14:30:00,40,9,8,42,99
2024-03-22 14:40:00,45,5,4,41,95
2024-03-22 14:50:00,57,6,8,38,109
2024-03-22 15:00:00,64,9,12,65,150
2024-03-22 15:10:00,46,3,6,46,101
2024-03-22 15:20:00,76,8,7,43,134
2024-03-22 15:30:00,61,5,7,46,119
2024-03-22 15:40:00,48,4,4,44,100
2024-03-22 15:50:00,43,6,9,52,110
2024-03-22 16:00:00,66,6,5,34,111
2024-03-22 16:10:00,51,6,6,43,106
2024-03-22 16:20:00,54,9,10,45,118
2024-03-22 16:30:00,42,7,16,43,108
2024-03-22 16:40:00,57,9,5,34,105
2024-03-22 16:50:00,50,4,9,39,102
2024-03-22 17:00:00,44,3,9,44,100
2024-03-22 17:10:00,53,7,5,54,119
2024-03-22 17:20:00,48,9,11,40,108
2024-03-22 17:30:00,51,2,6,44,103
2024-03-22 17:40:00,52,8,8,51,119
2024-03-22 17:50:00,55,8,6,44,113
2024-03-22 18:00:00,49,11,8,50,118
2024-03-22 18:10:00,45,5,9,37,96
2024-03-22 18:20:00,54,5,9,29,97
2024-03-22 18:30:00,24,3,2,14,43
2024-03-22 18:40:00,17,4,3,12,36
2024-03-22 18:50:00,27,10,5,26,68
2024-03-22 19:00:00,50,3,9,40,102
2024-03-22 19:10:00,34,1,7,36,78
2024-03-22 19:20:00,43,6,6,40,95
2024-03-22 19:30:00,39,7,0,29,75
2024-03-22 19:40:00,21,4,3,34,62
2024-03-22 19:50:00,27,2,9,17,55
2024-03-22 20:00:00,29,5,4,30,68
2024-03-22 20:10:00,23,2,5,27,57
2024-03-22 20:20:00,34,1,3,26,64
2024-03-22 20:30:00,30,4,3,13,50
2024-03-22 20:40:00,30,3,2,17,52
2024-03-22 20:50:00,29,3,1,15,48
2024-03-22 21:00:00,29,2,3,25,59
2024-03-22 21:10:00,31,0,0,16,47
2024-03-22 21:20:00,16,7,6,25,54
2024-03-22 21:30:00,19,4,0,13,36
2024-03-22 21:40:00,29,2,5,22,58
2024-03-22 21:50:00,16,4,0,8,28
2024-03-22 22:00:00,21,5,1,20,47
2024-03-22 22:10:00,33,1,2,19,55
2024-03-22 22:20:00,26,4,1,26,57
2024-03-22 22:30:00,15,6,1,24,46
2024-03-22 22:40:00,12,0,1,16,29
2024-03-22 22:50:00,17,1,3,15,36
2024-03-22 23:00:00,16,0,3,7,26
2024-03-22 23:10:00,15,9,2,14,40
2024-03-22 23:20:00,14,2,0,9,25
2024-03-22 23:30:00,12,1,0,10,23
2024-03-22 23:40:00,14,2,1,4,21
2024-03-22 23:50:00,9,0,0,8,17
2024-03-23 00:00:00,12,0,0,9,21
2024-03-23 00:10:00,13,0,0,7,20
2024-03-23 00:20:00,5,0,1,2,8
2024-03-23 00:30:00,11,0,1,4,16
2024-03-23 00:40:00,9,0,0,4,13
2024-03-23 00:50:00,11,0,0,2,13
2024-03-23 01:00:00,4,0,0,11,15
2024-03-23 01:10:00,8,2,1,2,13
2024-03-23 01:20:00,1,1,0,2,4
2024-03-23 01:30:00,7,1,1,10,19
2024-03-23 01:40:00,6,0,0,3,9
2024-03-23 01:50:00,8,1,0,4,13
2024-03-23 02:00:00,5,0,0,6,11
2024-03-23 02:10:00,7,0,0,5,12
2024-03-23 02:20:00,6,0,0,2,8
2024-03-23 02:30:00,4,0,1,2,7
2024-03-23 02:40:00,4,0,0,2,6
2024-03-23 02:50:00,3,3,0,0,6
2024-03-23 03:00:00,7,0,0,2,9
2024-03-23 03:10:00,3,0,0,3,6
2024-03-23 03:20:00,6,0,0,1,7
2024-03-23 03:30:00,2,0,3,1,6
2024-03-23 03:40:00,5,0,0,0,5
2024-03-23 03:50:00,1,0,0,4,5
2024-03-23 04:00:00,3,1,0,0,4
2024-03-23 04:10:00,3,0,0,1,4
2024-03-23 04:20:00,5,0,0,1,6
2024-03-23 04:30:00,2,0,0,1,3
2024-03-23 04:40:00,7,0,0,0,7
2024-03-23 04:50:00,3,0,2,6,11
2024-03-23 05:00:00,4,0,0,5,9
2024-03-23 05:10:00,1,0,1,2,4
2024-03-23 05:20:00,9,0,1,4,14
2024-03-23 05:30:00,1,0,0,1,2
2024-03-23 05:40:00,2,0,0,1,3
2024-03-23 05:50:00,2,0,0,4,6
2024-03-23 06:00:00,7,1,0,2,10
2024-03-23 06:10:00,4,0,1,2,7
2024-03-23 06:20:00,9,0,0,6,15
2024-03-23 06:30:00,7,1,0,5,13
2024-03-23 06:40:00,8,2,0,6,16
2024-03-23 06:50:00,8,1,2,10,21
2024-03-23 07:00:00,7,1,1,5,14
2024-03-23 07:10:00,4,0,1,4,9
2024-03-23 07:20:00,13,1,0,10,24
2024-03-23 07:30:00,6,2,0,6,14
2024-03-23 07:40:00,6,0,0,10,16
2024-03-23 07:50:00,10,2,2,9,23
2024-03-23 08:00:00,9,2,0,18,29
2024-03-23 08:10:00,21,2,4,15,42
2024-03-23 08:20:00,20,3,2,15,40
2024-03-23 08:30:00,22,0,0,19,41
2024-03-23 08:40:00,24,5,4,29,62
2024-03-23 08:50:00,27,2,0,22,51
2024-03-23 09:00:00,21,4,2,19,46
2024-03-23 09:10:00,29,2,4,26,61
2024-03-23 09:20:00,26,3,2,33,64
2024-03-23 09:30:00,26,2,8,34,70
2024-03-23 09:40:00,34,2,4,35,75
2024-03-23 09:50:00,37,4,2,43,86
2024-03-23 10:00:00,30,2,3,32,67
2024-03-23 10:10:00,37,5,3,49,94
2024-03-23 10:20:00,31,2,8,33,74
2024-03-23 10:30:00,39,2,5,30,76
2024-03-23 10:40:00,31,3,7,36,77
2024-03-23 10:50:00,40,7,5,27,79
2024-03-23 11:00:00,43,5,7,25,80
2024-03-23 11:10:00,33,1,2,44,80
2024-03-23 11:20:00,30,5,8,41,84
2024-03-23 11:30:00,32,3,2,43,80
2024-03-23 11:40:00,35,7,4,48,94
2024-03-23 11:50:00,32,4,5,42,83
2024-03-23 12:00:00,45,5,10,42,102
2024-03-23 12:10:00,44,8,4,43,99
2024-03-23 12:20:00,45,6,11,42,104
2024-03-23 12:30:00,52,5,6,38,101
2024-03-23 12:40:00,43,11,4,33,91
2024-03-23 12:50:00,60,4,1,36,101
2024-03-23 13:00:00,40,2,5,36,83
2024-03-23 13:10:00,48,7,2,35,92
2024-03-23 13:20:00,37,3,4,22,66
2024-03-23 13:30:00,42,4,2,32,80
2024-03-23 13:40:00,36,6,10,44,96
2024-03-23 13:50:00,37,8,8,46,99
2024-03-23 14:00:00,45,4,4,41,94
2024-03-23 14:10:00,43,5,4,37,89
2024-03-23 14:20:00,53,6,6,35,100
2024-03-23 14:30:00,39,4,7,43,93
2024-03-23 14:40:00,45,6,2,17,70
2024-03-23 14:50:00,42,4,5,27,78
2024-03-23 15:00:00,46,7,9,27,89
2024-03-23 15:10:00,39,3,6,40,88
2024-03-23 15:20:00,40,4,4,39,87
2024-03-23 15:30:00,35,3,3,30,71
2024-03-23 15:40:00,45,5,4,37,91
2024-03-23 15:50:00,44,33,4,36,117
2024-03-23 16:00:00,41,3,8,27,79
2024-03-23 16:10:00,29,3,3,33,68
2024-03-23 16:20:00,43,3,2,20,68
2024-03-23 16:30:00,32,2,3,26,63
2024-03-23 16:40:00,32,1,4,31,68
2024-03-23 16:50:00,41,4,7,36,88
2024-03-23 17:00:00,30,6,5,29,70
2024-03-23 17:10:00,34,8,5,32,79
2024-03-23 17:20:00,42,5,1,38,86
2024-03-23 17:30:00,27,3,2,31,63
2024-03-23 17:40:00,55,3,4,33,95
2024-03-23 17:50:00,41,3,4,29,77
2024-03-23 18:00:00,33,3,4,36,76
2024-03-23 18:10:00,35,5,3,36,79
2024-03-23 18:20:00,38,5,9,37,89
2024-03-23 18:30:00,38,4,5,34,81
2024-03-23 18:40:00,30,2,3,29,64
2024-03-23 18:50:00,27,5,7,30,69
2024-03-23 19:00:00,49,3,3,41,96
2024-03-23 19:10:00,33,3,7,38,81
2024-03-23 19:20:00,33,1,0,30,64
2024-03-23 19:30:00,27,2,3,23,55
2024-03-23 19:40:00,32,6,3,20,61
2024-03-23 19:50:00,41,2,9,26,78
2024-03-23 20:00:00,38,4,5,32,79
2024-03-23 20:10:00,21,5,4,27,57
2024-03-23 20:20:00,26,3,1,31,61
2024-03-23 20:30:00,23,0,2,20,45
2024-03-23 20:40:00,27,4,2,26,59
2024-03-23 20:50:00,23,4,2,11,40
2024-03-23 21:00:00,26,2,2,21,51
2024-03-23 21:10:00,19,0,3,23,45
2024-03-23 21:20:00,22,2,2,11,37
2024-03-23 21:30:00,19,1,0,24,44
2024-03-23 21:40:00,17,4,2,12,35
2024-03-23 21:50:00,26,1,1,16,44
2024-03-23 22:00:00,15,4,1,9,29
2024-03-23 22:10:00,32,5,2,10,49
2024-03-23 22:20:00,16,0,2,12,30
2024-03-23 22:30:00,21,0,0,21,42
2024-03-23 22:40:00,14,1,0,27,42
2024-03-23 22:50:00,16,2,1,14,33
2024-03-23 23:00:00,22,2,0,19,43
2024-03-23 23:10:00,22,3,0,10,35
2024-03-23 23:20:00,17,0,0,5,22
2024-03-23 23:30:00,19,1,1,11,32
2024-03-23 23:40:00,18,3,0,5,26
2024-03-23 23:50:00,12,0,4,12,28
2024-03-24 00:00:00,16,1,1,8,26
2024-03-24 00:10:00,4,1,0,6,11
2024-03-24 00:20:00,9,0,1,6,16
2024-03-24 00:30:00,12,1,1,7,21
2024-03-24 00:40:00,7,1,1,5,14
2024-03-24 00:50:00,14,0,0,6,20
2024-03-24 01:00:00,1,2,3,8,14
2024-03-24 01:10:00,7,0,0,8,15
2024-03-24 01:20:00,5,0,0,6,11
2024-03-24 01:30:00,5,0,0,4,9
2024-03-24 01:40:00,3,0,0,2,5
2024-03-24 01:50:00,3,2,0,4,9
2024-03-24 02:00:00,15,0,1,4,20
2024-03-24 02:10:00,9,0,0,6,15
2024-03-24 02:20:00,3,0,0,5,8
2024-03-24 02:30:00,7,0,0,5,12
2024-03-24 02:40:00,6,2,0,6,14
2024-03-24 02:50:00,6,0,0,4,10
2024-03-24 03:00:00,6,2,1,3,12
2024-03-24 03:10:00,6,1,0,4,11
2024-03-24 03:20:00,7,2,0,3,12
2024-03-24 03:30:00,1,0,0,2,3
2024-03-24 03:40:00,4,2,0,1,7
2024-03-24 03:50:00,7,0,0,1,8
2024-03-24 04:00:00,1,0,0,4,5
2024-03-24 04:10:00,3,0,0,0,3
2024-03-24 04:20:00,0,0,0,0,0
2024-03-24 04:30:00,2,0,0,3,5
2024-03-24 04:40:00,2,0,0,0,2
2024-03-24 04:50:00,2,0,0,1,3
2024-03-24 05:00:00,2,1,0,2,5
2024-03-24 05:10:00,2,0,0,1,3
2024-03-24 05:20:00,5,1,0,4,10
2024-03-24 05:30:00,3,0,1,1,5
2024-03-24 05:40:00,6,0,0,1,7
2024-03-24 05:50:00,3,0,0,5,8
2024-03-24 06:00:00,4,2,0,0,6
2024-03-24 06:10:00,4,1,0,0,5
2024-03-24 06:20:00,4,1,0,5,10
2024-03-24 06:30:00,3,0,0,4,7
2024-03-24 06:40:00,4,1,0,6,11
2024-03-24 06:50:00,5,1,0,4,10
2024-03-24 07:00:00,2,0,0,7,9
2024-03-24 07:10:00,1,0,0,4,5
2024-03-24 07:20:00,4,0,0,2,6
2024-03-24 07:30:00,6,1,1,2,10
2024-03-24 07:40:00,5,0,0,5,10
2024-03-24 07:50:00,7,0,0,7,14
2024-03-24 08:00:00,16,0,1,4,21
2024-03-24 08:10:00,12,0,1,7,20
2024-03-24 08:20:00,7,1,2,6,16
2024-03-24 08:30:00,6,1,6,12,25
2024-03-24 08:40:00,19,0,0,11,30
2024-03-24 08:50:00,10,3,1,9,23
2024-03-24 09:00:00,12,0,1,12,25
2024-03-24 09:10:00,12,0,1,15,28
2024-03-24 09:20:00,20,1,4,9,34
2024-03-24 09:30:00,14,1,3,27,45
2024-03-24 09:40:00,28,1,2,26,57
2024-03-24 09:50:00,19,0,4,20,43
2024-03-24 10:00:00,22,2,4,14,42
2024-03-24 10:10:00,19,0,5,21,45
2024-03-24 10:20:00,13,1,2,20,36
2024-03-24 10:30:00,21,6,2,22,51
2024-03-24 10:40:00,24,0,6,16,46
2024-03-24 10:50:00,18,1,2,22,43
2024-03-24 11:00:00,20,3,5,21,49
2024-03-24 11:10:00,27,3,3,15,48
2024-03-24 11:20:00,26,1,2,29,58
2024-03-24 11:30:00,24,0,5,33,62
2024-03-24 11:40:00,26,3,3,26,58
2024-03-24 11:50:00,30,2,1,20,53
2024-03-24 12:00:00,37,3,1,31,72
2024-03-24 12:10:00,39,4,3,26,72
2024-03-24 12:20:00,32,3,3,22,60
2024-03-24 12:30:00,24,1,3,21,49
2024-03-24 12:40:00,24,1,3,24,52
2024-03-24 12:50:00,25,2,9,25,61
2024-03-24 13:00:00,21,3,3,21,48
2024-03-24 13:10:00,32,1,4,15,52
2024-03-24 13:20:00,29,2,3,26,60
2024-03-24 13:30:00,39,6,3,27,75
2024-03-24 13:40:00,31,3,3,28,65
2024-03-24 13:50:00,21,1,8,25,55
2024-03-24 14:00:00,27,2,3,18,50
2024-03-24 14:10:00,34,1,7,35,77
2024-03-24 14:20:00,30,1,5,32,68
2024-03-24 14:30:00,26,3,6,34,69
2024-03-24 14:40:00,25,4,10,25,64
2024-03-24 14:50:00,26,2,11,32,71
2024-03-24 15:00:00,28,4,4,27,63
2024-03-24 15:10:00,30,5,8,28,71
2024-03-24 15:20:00,31,3,3,33,70
2024-03-24 15:30:00,31,3,4,25,63
2024-03-24 15:40:00,30,3,3,33,69
2024-03-24 15:50:00,32,5,7,30,74
2024-03-24 16:00:00,35,3,7,29,74
2024-03-24 16:10:00,33,4,4,27,68
2024-03-24 16:20:00,22,2,8,29,61
2024-03-24 16:30:00,36,4,3,29,72
2024-03-24 16:40:00,33,2,8,25,68
2024-03-24 16:50:00,30,0,1,33,64
2024-03-24 17:00:00,25,1,3,38,67
2024-03-24 17:10:00,27,2,2,27,58
2024-03-24 17:20:00,33,1,2,34,70
2024-03-24 17:30:00,37,1,4,24,66
2024-03-24 17:40:00,24,0,6,29,59
2024-03-24 17:50:00,39,2,6,34,81
2024-03-24 18:00:00,24,4,3,26,57
2024-03-24 18:10:00,28,1,1,19,49
2024-03-24 18:20:00,24,4,3,29,60
2024-03-24 18:30:00,26,1,0,30,57
2024-03-24 18:40:00,30,2,6,24,62
2024-03-24 18:50:00,30,1,7,31,69
2024-03-24 19:00:00,20,3,6,22,51
2024-03-24 19:10:00,20,2,6,22,50
2024-03-24 19:20:00,17,1,1,15,34
2024-03-24 19:30:00,13,2,1,20,36
2024-03-24 19:40:00,24,2,3,21,50
2024-03-24 19:50:00,19,1,2,18,40
2024-03-24 20:00:00,16,2,5,22,45
2024-03-24 20:10:00,17,4,5,10,36
2024-03-24 20:20:00,29,1,5,25,60
2024-03-24 20:30:00,24,1,3,17,45
2024-03-24 20:40:00,20,0,4,13,37
2024-03-24 20:50:00,23,1,5,16,45
2024-03-24 21:00:00,19,4,2,10,35
2024-03-24 21:10:00,19,0,0,10,29
2024-03-24 21:20:00,16,3,4,15,38
2024-03-24 21:30:00,27,2,3,16,48
2024-03-24 21:40:00,16,4,0,16,36
2024-03-24 21:50:00,17,0,2,12,31
2024-03-24 22:00:00,16,4,1,22,43
2024-03-24 22:10:00,19,0,0,15,34
2024-03-24 22:20:00,12,0,1,7,20
2024-03-24 22:30:00,15,0,0,14,29
2024-03-24 22:40:00,5,2,0,8,15
2024-03-24 22:50:00,9,1,1,4,15
2024-03-24 23:00:00,7,0,1,4,12
2024-03-24 23:10:00,8,2,0,7,17
2024-03-24 23:20:00,7,0,1,3,11
2024-03-24 23:30:00,9,0,0,6,15
2024-03-24 23:40:00,9,3,0,7,19
2024-03-24 23:50:00,5,0,1,2,8
2024-03-25 00:00:00,5,0,0,0,5
2024-03-25 00:10:00,5,0,0,4,9
2024-03-25 00:20:00,4,0,1,3,8
2024-03-25 00:30:00,5,2,0,1,8
2024-03-25 00:40:00,3,1,0,2,6
2024-03-25 00:50:00,5,0,0,1,6
2024-03-25 01:00:00,6,0,0,1,7
2024-03-25 01:10:00,0,0,0,4,4
2024-03-25 01:20:00,0,0,0,1,1
2024-03-25 01:30:00,5,0,0,4,9
2024-03-25 01:40:00,1,0,1,4,6
2024-03-25 01:50:00,2,1,0,1,4
2024-03-25 02:00:00,1,1,0,2,4
2024-03-25 02:10:00,4,0,0,0,4
2024-03-25 02:20:00,1,0,0,1,2
2024-03-25 02:30:00,1,0,1,1,3
2024-03-25 02:40:00,2,0,0,0,2
2024-03-25 02:50:00,2,0,0,0,2
2024-03-25 03:00:00,2,0,1,3,6
2024-03-25 03:10:00,4,0,0,0,4
2024-03-25 03:20:00,3,0,0,0,3
2024-03-25 03:30:00,1,0,0,1,2
2024-03-25 03:40:00,5,0,0,0,5
2024-03-25 03:50:00,4,0,0,0,4
2024-03-25 04:00:00,5,0,0,0,5
2024-03-25 04:10:00,0,0,0,1,1
2024-03-25 04:20:00,0,0,1,1,2
2024-03-25 04:30:00,2,0,0,0,2
2024-03-25 04:40:00,5,0,0,0,5
2024-03-25 04:50:00,2,0,0,2,4
2024-03-25 05:00:00,2,0,0,5,7
2024-03-25 05:10:00,1,0,2,4,7
2024-03-25 05:20:00,7,0,3,5,15
2024-03-25 05:30:00,3,0,0,9,12
2024-03-25 05:40:00,3,0,5,16,24
2024-03-25 05:50:00,12,1,3,18,34
2024-03-25 06:00:00,6,0,1,14,21
2024-03-25 06:10:00,5,0,1,11,17
2024-03-25 06:20:00,14,0,2,13,29
2024-03-25 06:30:00,11,3,4,19,37
2024-03-25 06:40:00,15,2,3,17,37
2024-03-25 06:50:00,10,0,5,24,39
2024-03-25 07:00:00,15,0,3,32,50
2024-03-25 07:10:00,18,2,5,29,54
2024-03-25 07:20:00,22,2,4,31,59
2024-03-25 07:30:00,28,3,6,26,63
2024-03-25 07:40:00,29,2,2,25,58
2024-03-25 07:50:00,20,2,3,31,56
2024-03-25 08:00:00,33,5,4,28,70
2024-03-25 08:10:00,26,4,8,35,73
2024-03-25 08:20:00,33,1,9,34,77
2024-03-25 08:30:00,40,7,7,116,170
2024-03-25 08:40:00,38,6,9,51,104
2024-03-25 08:50:00,40,4,4,46,94
2024-03-25 09:00:00,38,5,6,37,86
2024-03-25 09:10:00,27,2,6,39,74
2024-03-25 09:20:00,37,2,10,31,80
2024-03-25 09:30:00,38,0,7,51,96
2024-03-25 09:40:00,38,3,5,36,82
2024-03-25 09:50:00,33,2,2,39,76
2024-03-25 10:00:00,39,6,5,34,84
2024-03-25 10:10:00,39,5,8,34,86
2024-03-25 10:20:00,38,6,7,41,92
2024-03-25 10:30:00,34,8,3,40,85
2024-03-25 10:40:00,49,4,4,48,105
2024-03-25 10:50:00,40,3,6,35,84
2024-03-25 11:00:00,39,3,11,37,90
2024-03-25 11:10:00,45,5,7,34,91
2024-03-25 11:20:00,49,2,8,33,92
2024-03-25 11:30:00,52,4,7,48,111
2024-03-25 11:40:00,37,6,9,38,90
2024-03-25 11:50:00,47,4,9,37,97
2024-03-25 12:00:00,46,7,4,47,104
2024-03-25 12:10:00,47,3,14,34,98
2024-03-25 12:20:00,38,9,8,36,91
2024-03-25 12:30:00,45,8,9,44,106
2024-03-25 12:40:00,41,4,6,35,86
2024-03-25 12:50:00,45,4,1,35,85
2024-03-25 13:00:00,38,5,5,38,86
2024-03-25 13:10:00,40,5,8,35,88
2024-03-25 13:20:00,39,6,3,31,79
2024-03-25 13:30:00,43,7,2,41,93
2024-03-25 13:40:00,30,4,13,40,87
2024-03-25 13:50:00,41,6,4,34,85
2024-03-25 14:00:00,41,4,5,49,99
2024-03-25 14:10:00,43,7,8,44,102
2024-03-25 14:20:00,48,7,6,35,96
2024-03-25 14:30:00,47,6,8,34,95
2024-03-25 14:40:00,42,10,8,41,101
2024-03-25 14:50:00,43,4,9,46,102
2024-03-25 15:00:00,43,5,9,39,96
2024-03-25 15:10:00,52,4,6,41,103
2024-03-25 15:20:00,52,5,9,33,99
2024-03-25 15:30:00,51,7,7,42,107
2024-03-25 15:40:00,50,16,9,48,123
2024-03-25 15:50:00,49,9,11,37,106
2024-03-25 16:00:00,54,9,9,41,113
2024-03-25 16:10:00,49,1,3,41,94
2024-03-25 16:20:00,61,6,8,41,116
2024-03-25 16:30:00,46,13,9,35,103
2024-03-25 16:40:00,43,5,12,45,105
2024-03-25 16:50:00,52,8,10,42,112
2024-03-25 17:00:00,63,7,6,39,115
2024-03-25 17:10:00,47,10,11,41,109
2024-03-25 17:20:00,52,9,5,30,96
2024-03-25 17:30:00,50,3,7,40,100
2024-03-25 17:40:00,55,3,8,46,112
2024-03-25 17:50:00,61,7,10,28,106
2024-03-25 18:00:00,35,5,5,47,92
2024-03-25 18:10:00,53,5,9,41,108
2024-03-25 18:20:00,48,8,11,28,95
2024-03-25 18:30:00,39,8,6,42,95
2024-03-25 18:40:00,45,7,5,38,95
2024-03-25 18:50:00,44,4,13,34,95
2024-03-25 19:00:00,39,6,9,34,88
2024-03-25 19:10:00,32,2,8,36,78
2024-03-25 19:20:00,30,9,4,34,77
2024-03-25 19:30:00,38,6,7,21,72
2024-03-25 19:40:00,31,6,6,29,72
2024-03-25 19:50:00,23,2,10,31,66
2024-03-25 20:00:00,28,1,5,36,70
2024-03-25 20:10:00,33,3,3,18,57
2024-03-25 20:20:00,33,2,4,30,69
2024-03-25 20:30:00,20,3,4,24,51
2024-03-25 20:40:00,20,3,3,14,40
2024-03-25 20:50:00,17,1,4,19,41
2024-03-25 21:00:00,17,1,4,21,43
2024-03-25 21:10:00,13,1,8,19,41
2024-03-25 21:20:00,17,3,3,8,31
2024-03-25 21:30:00,28,2,2,13,45
2024-03-25 21:40:00,21,3,3,15,42
2024-03-25 21:50:00,15,3,3,5,26
2024-03-25 22:00:00,17,0,3,9,29
2024-03-25 22:10:00,22,1,1,22,46
2024-03-25 22:20:00,16,2,2,12,32
2024-03-25 22:30:00,18,3,2,10,33
2024-03-25 22:40:00,17,1,0,10,28
2024-03-25 22:50:00,13,1,1,4,19
2024-03-25 23:00:00,6,0,0,15,21
2024-03-25 23:10:00,12,1,0,4,17
2024-03-25 23:20:00,13,0,1,6,20
2024-03-25 23:30:00,11,3,2,5,21
2024-03-25 23:40:00,5,2,1,5,13
2024-03-25 23:50:00,4,1,0,6,11
2024-03-26 00:00:00,6,1,0,0,7
2024-03-26 00:10:00,4,1,0,5,10
2024-03-26 00:20:00,5,0,3,5,13
2024-03-26 00:30:00,5,0,0,5,10
2024-03-26 00:40:00,4,1,0,2,7
2024-03-26 00:50:00,2,2,0,4,8
2024-03-26 01:00:00,3,0,0,1,4
2024-03-26 01:10:00,1,1,0,1,3
2024-03-26 01:20:00,4,0,0,3,7
2024-03-26 01:30:00,4,0,0,2,6
2024-03-26 01:40:00,4,1,0,3,8
2024-03-26 01:50:00,2,0,0,1,3
2024-03-26 02:00:00,0,0,0,2,2
2024-03-26 02:10:00,2,0,0,1,3
2024-03-26 02:20:00,4,0,0,3,7
2024-03-26 02:30:00,1,0,0,2,3
2024-03-26 02:40:00,0,0,0,0,0
2024-03-26 02:50:00,1,0,0,1,2
2024-03-26 03:00:00,0,1,0,2,3
2024-03-26 03:10:00,5,0,2,1,8
2024-03-26 03:20:00,4,1,0,0,5
2024-03-26 03:30:00,1,0,0,2,3
2024-03-26 03:40:00,1,0,0,2,3
2024-03-26 03:50:00,4,0,3,1,8
2024-03-26 04:00:00,1,0,0,1,2
2024-03-26 04:10:00,2,0,0,3,5
2024-03-26 04:20:00,2,0,0,1,3
2024-03-26 04:30:00,0,0,2,3,5
2024-03-26 04:40:00,2,0,0,2,4
2024-03-26 04:50:00,1,0,1,4,6
2024-03-26 05:00:00,2,0,0,4,6
2024-03-26 05:10:00,4,0,3,3,10
2024-03-26 05:20:00,5,0,2,8,15
2024-03-26 05:30:00,4,0,1,10,15
2024-03-26 05:40:00,8,0,4,13,25
2024-03-26 05:50:00,18,0,3,13,34
2024-03-26 06:00:00,4,0,4,11,19
2024-03-26 06:10:00,7,0,0,13,20
2024-03-26 06:20:00,16,0,2,10,28
2024-03-26 06:30:00,10,2,4,13,29
2024-03-26 06:40:00,23,4,5,19,51
2024-03-26 06:50:00,13,3,5,25,46
2024-03-26 07:00:00,11,3,4,24,42
2024-03-26 07:10:00,22,3,9,31,65
2024-03-26 07:20:00,22,0,5,23,50
2024-03-26 07:30:00,19,3,6,35,63
2024-03-26 07:40:00,22,3,12,41,78
2024-03-26 07:50:00,34,3,5,43,85
2024-03-26 08:00:00,30,3,6,31,70
2024-03-26 08:10:00,31,9,10,53,103
2024-03-26 08:20:00,43,9,6,38,96
2024-03-26 08:30:00,39,7,4,42,92
2024-03-26 08:40:00,30,3,9,38,80
2024-03-26 08:50:00,22,3,3,33,61
2024-03-26 09:00:00,40,4,14,41,99
2024-03-26 09:10:00,30,5,8,41,84
2024-03-26 09:20:00,32,2,4,35,73
2024-03-26 09:30:00,42,5,6,49,102
2024-03-26 09:40:00,24,2,6,38,70
2024-03-26 09:50:00,36,3,5,30,74
2024-03-26 10:00:00,37,4,1,27,69
2024-03-26 10:10:00,37,4,4,36,81
2024-03-26 10:20:00,47,8,6,33,94
2024-03-26 10:30:00,36,1,8,40,85
2024-03-26 10:40:00,51,4,6,37,98
2024-03-26 10:50:00,30,3,2,37,72
2024-03-26 11:00:00,44,6,4,34,88
2024-03-26 11:10:00,40,5,6,34,85
2024-03-26 11:20:00,43,4,4,32,83
2024-03-26 11:30:00,46,4,7,32,89
2024-03-26 11:40:00,40,6,6,37,89
2024-03-26 11:50:00,43,3,8,38,92
2024-03-26 12:00:00,40,2,7,36,85
2024-03-26 12:10:00,43,5,4,36,88
2024-03-26 12:20:00,41,5,1,34,81
2024-03-26 12:30:00,45,4,6,35,90
2024-03-26 12:40:00,51,4,4,35,94
2024-03-26 12:50:00,38,4,7,54,103
2024-03-26 13:00:00,40,9,6,32,87
2024-03-26 13:10:00,41,8,6,33,88
2024-03-26 13:20:00,38,5,2,27,72
2024-03-26 13:30:00,35,8,3,33,79
2024-03-26 13:40:00,43,3,6,34,86
2024-03-26 13:50:00,41,7,7,31,86
2024-03-26 14:00:00,34,3,8,27,72
2024-03-26 14:10:00,49,11,5,39,104
2024-03-26 14:20:00,50,4,6,41,101
2024-03-26 14:30:00,44,4,9,40,97
2024-03-26 14:40:00,53,10,9,41,113
2024-03-26 14:50:00,59,4,7,41,111
2024-03-26 15:00:00,42,8,8,36,94
2024-03-26 15:10:00,56,10,12,38,116
2024-03-26 15:20:00,51,8,4,37,100
2024-03-26 15:30:00,51,7,12,36,106
2024-03-26 15:40:00,54,12,7,48,121
2024-03-26 15:50:00,55,6,4,31,96
2024-03-26 16:00:00,52,10,9,41,112
2024-03-26 16:10:00,47,6,13,44,110
2024-03-26 16:20:00,54,4,11,36,105
2024-03-26 16:30:00,37,4,6,42,89
2024-03-26 16:40:00,57,11,9,40,117
2024-03-26 16:50:00,48,7,7,28,90
2024-03-26 17:00:00,51,9,13,29,102
2024-03-26 17:10:00,50,9,6,32,97
2024-03-26 17:20:00,46,6,9,48,109
2024-03-26 17:30:00,47,6,3,37,93
2024-03-26 17:40:00,65,5,8,54,132
2024-03-26 17:50:00,37,5,7,48,97
2024-03-26 18:00:00,45,3,5,33,86
2024-03-26 18:10:00,46,8,7,41,102
2024-03-26 18:20:00,43,5,11,32,91
2024-03-26 18:30:00,44,7,6,35,92
2024-03-26 18:40:00,48,7,13,35,103
2024-03-26 18:50:00,41,6,11,34,92
2024-03-26 19:00:00,35,3,6,28,72
2024-03-26 19:10:00,35,5,9,34,83
2024-03-26 19:20:00,46,8,5,32,91
2024-03-26 19:30:00,39,6,6,32,83
2024-03-26 19:40:00,32,2,3,28,65
2024-03-26 19:50:00,23,2,2,25,52
2024-03-26 20:00:00,26,3,5,38,72
2024-03-26 20:10:00,37,5,3,30,75
2024-03-26 20:20:00,25,10,7,22,64
2024-03-26 20:30:00,30,3,4,24,61
2024-03-26 20:40:00,23,2,2,12,39
2024-03-26 20:50:00,21,3,6,13,43
2024-03-26 21:00:00,18,1,4,18,41
2024-03-26 21:10:00,19,2,2,14,37
2024-03-26 21:20:00,20,4,3,13,40
2024-03-26 21:30:00,17,3,2,7,29
2024-03-26 21:40:00,25,0,3,18,46
2024-03-26 21:50:00,32,1,0,11,44
2024-03-26 22:00:00,21,2,1,8,32
2024-03-26 22:10:00,14,3,1,15,33
2024-03-26 22:20:00,27,6,3,6,42
2024-03-26 22:30:00,7,5,0,12,24
2024-03-26 22:40:00,11,1,2,9,23
2024-03-26 22:50:00,18,1,2,7,28
2024-03-26 23:00:00,11,1,0,10,22
2024-03-26 23:10:00,19,3,0,4,26
2024-03-26 23:20:00,5,2,2,13,22
2024-03-26 23:30:00,15,0,1,9,25
2024-03-26 23:40:00,6,1,0,5,12
2024-03-26 23:50:00,12,1,0,10,23
2024-03-27 00:00:00,10,0,2,4,16
2024-03-27 00:10:00,5,2,0,4,11
2024-03-27 00:20:00,12,1,2,0,15
2024-03-27 00:30:00,2,0,0,10,12
2024-03-27 00:40:00,5,2,0,1,8
2024-03-27 00:50:00,1,0,0,2,3
2024-03-27 01:00:00,1,0,0,2,3
2024-03-27 01:10:00,1,0,0,2,3
2024-03-27 01:20:00,2,0,0,1,3
2024-03-27 01:30:00,3,0,0,2,5
2024-03-27 01:40:00,2,0,0,0,2
2024-03-27 01:50:00,4,1,0,2,7
2024-03-27 02:00:00,2,0,0,1,3
2024-03-27 02:10:00,2,1,0,0,3
2024-03-27 02:20:00,1,0,0,1,2
2024-03-27 02:30:00,3,0,0,2,5
2024-03-27 02:40:00,0,0,1,3,4
2024-03-27 02:50:00,2,0,0,1,3
2024-03-27 03:00:00,2,0,0,2,4
2024-03-27 03:10:00,4,3,0,0,7
2024-03-27 03:20:00,5,0,0,1,6
2024-03-27 03:30:00,4,0,0,0,4
2024-03-27 03:40:00,0,0,1,1,2
2024-03-27 03:50:00,3,0,0,2,5
2024-03-27 04:00:00,1,0,0,2,3
2024-03-27 04:10:00,1,0,0,1,2
2024-03-27 04:20:00,0,0,0,0,0
2024-03-27 04:30:00,1,0,0,1,2
2024-03-27 04:40:00,0,0,0,1,1
2024-03-27 04:50:00,2,0,1,3,6
2024-03-27 05:00:00,4,0,0,3,7
2024-03-27 05:10:00,3,0,3,7,13
2024-03-27 05:20:00,3,0,0,4,7
2024-03-27 05:30:00,4,0,2,8,14
2024-03-27 05:40:00,11,0,6,11,28
2024-03-27 05:50:00,7,0,1,10,18
2024-03-27 06:00:00,7,0,3,16,26
2024-03-27 06:10:00,9,1,2,9,21
2024-03-27 06:20:00,12,1,2,12,27
2024-03-27 06:30:00,13,1,3,11,28
2024-03-27 06:40:00,20,1,5,17,43
2024-03-27 06:50:00,11,2,7,20,40
2024-03-27 07:00:00,15,5,2,31,53
2024-03-27 07:10:00,16,6,6,22,50
2024-03-27 07:20:00,22,3,4,37,66
2024-03-27 07:30:00,28,6,6,30,70
2024-03-27 07:40:00,23,3,8,37,71
2024-03-27 07:50:00,32,3,4,46,85
2024-03-27 08:00:00,23,2,7,29,61
2024-03-27 08:10:00,36,4,8,42,90
2024-03-27 08:20:00,47,4,10,38,99
2024-03-27 08:30:00,40,6,5,46,97
2024-03-27 08:40:00,39,7,14,37,97
2024-03-27 08:50:00,40,10,5,42,97
2024-03-27 09:00:00,30,5,5,26,66
2024-03-27 09:10:00,36,3,4,43,86
2024-03-27 09:20:00,40,5,2,37,84
2024-03-27 09:30:00,40,2,2,46,90
2024-03-27 09:40:00,37,6,4,37,84
2024-03-27 09:50:00,47,4,6,50,107
2024-03-27 10:00:00,43,7,1,32,83
2024-03-27 10:10:00,46,2,5,34,87
2024-03-27 10:20:00,39,5,2,27,73
2024-03-27 10:30:00,31,0,4,41,76
2024-03-27 10:40:00,36,6,6,33,81
2024-03-27 10:50:00,27,2,5,38,72
2024-03-27 11:00:00,41,6,2,45,94
2024-03-27 11:10:00,43,7,15,34,99
2024-03-27 11:20:00,44,2,7,32,85
2024-03-27 11:30:00,41,7,5,46,99
2024-03-27 11:40:00,51,3,4,54,112
2024-03-27 11:50:00,52,5,5,27,89
2024-03-27 12:00:00,40,9,8,41,98
2024-03-27 12:10:00,39,7,5,36,87
2024-03-27 12:20:00,43,4,4,45,96
2024-03-27 12:30:00,33,9,8,39,89
2024-03-27 12:40:00,42,7,8,39,96
2024-03-27 12:50:00,43,4,6,47,100
2024-03-27 13:00:00,49,5,4,41,99
2024-03-27 13:10:00,46,4,7,29,86
2024-03-27 13:20:00,49,7,5,34,95
2024-03-27 13:30:00,43,3,9,33,88
2024-03-27 13:40:00,41,4,4,34,83
2024-03-27 13:50:00,40,7,10,32,89
2024-03-27 14:00:00,37,7,4,29,77
2024-03-27 14:10:00,44,5,5,43,97
2024-03-27 14:20:00,53,5,4,38,100
2024-03-27 14:30:00,44,4,7,36,91
2024-03-27 14:40:00,44,6,2,36,88
2024-03-27 14:50:00,47,5,4,45,101
2024-03-27 15:00:00,46,4,9,46,105
2024-03-27 15:10:00,45,5,4,32,86
2024-03-27 15:20:00,59,3,4,41,107
2024-03-27 15:30:00,44,3,8,35,90
2024-03-27 15:40:00,44,6,10,42,102
2024-03-27 15:50:00,41,8,5,42,96
2024-03-27 16:00:00,50,3,5,41,99
2024-03-27 16:10:00,42,8,7,36,93
2024-03-27 16:20:00,55,5,5,42,107
2024-03-27 16:30:00,44,9,7,41,101
2024-03-27 16:40:00,61,9,9,41,120
2024-03-27 16:50:00,56,4,8,38,106
2024-03-27 17:00:00,49,10,7,38,104
2024-03-27 17:10:00,48,5,7,40,100
2024-03-27 17:20:00,55,5,4,38,102
2024-03-27 17:30:00,55,11,9,37,112
2024-03-27 17:40:00,36,5,7,46,94
2024-03-27 17:50:00,46,13,3,44,106
2024-03-27 18:00:00,39,6,9,39,93
2024-03-27 18:10:00,45,10,11,25,91
2024-03-27 18:20:00,33,6,9,31,79
2024-03-27 18:30:00,33,0,7,41,81
2024-03-27 18:40:00,26,7,8,32,73
2024-03-27 18:50:00,30,5,19,30,84
2024-03-27 19:00:00,29,8,10,32,79
2024-03-27 19:10:00,28,9,4,26,67
2024-03-27 19:20:00,35,4,7,20,66
2024-03-27 19:30:00,23,6,5,21,55
2024-03-27 19:40:00,23,3,4,21,51
2024-03-27 19:50:00,23,3,0,23,49
2024-03-27 20:00:00,17,4,4,17,42
2024-03-27 20:10:00,18,4,4,14,40
2024-03-27 20:20:00,17,4,5,28,54
2024-03-27 20:30:00,15,2,2,15,34
2024-03-27 20:40:00,16,2,2,19,39
2024-03-27 20:50:00,22,2,2,20,46
2024-03-27 21:00:00,20,3,2,13,38
2024-03-27 21:10:00,29,1,3,24,57
2024-03-27 21:20:00,18,1,4,17,40
2024-03-27 21:30:00,31,1,2,15,49
2024-03-27 21:40:00,14,3,1,18,36
2024-03-27 21:50:00,23,4,4,8,39
2024-03-27 22:00:00,25,3,2,7,37
2024-03-27 22:10:00,21,1,2,16,40
2024-03-27 22:20:00,20,0,1,10,31
2024-03-27 22:30:00,10,1,0,15,26
2024-03-27 22:40:00,20,0,1,11,32
2024-03-27 22:50:00,12,1,0,6,19
2024-03-27 23:00:00,22,2,0,7,31
2024-03-27 23:10:00,7,0,1,9,17
2024-03-27 23:20:00,12,0,1,9,22
2024-03-27 23:30:00,13,1,1,5,20
2024-03-27 23:40:00,7,1,1,3,12
2024-03-27 23:50:00,5,2,1,5,13
2024-03-28 00:00:00,4,0,0,6,10
2024-03-28 00:10:00,4,0,2,4,10
2024-03-28 00:20:00,13,0,2,5,20
2024-03-28 00:30:00,2,0,0,5,7
2024-03-28 00:40:00,4,2,1,5,12
2024-03-28 00:50:00,4,0,0,1,5
2024-03-28 01:00:00,5,0,0,3,8
2024-03-28 01:10:00,8,0,0,3,11
2024-03-28 01:20:00,2,0,0,3,5
2024-03-28 01:30:00,3,0,0,2,5
2024-03-28 01:40:00,7,1,0,4,12
2024-03-28 01:50:00,3,0,0,4,7
2024-03-28 02:00:00,0,0,0,2,2
2024-03-28 02:10:00,3,0,0,4,7
2024-03-28 02:20:00,0,0,0,0,0
2024-03-28 02:30:00,2,2,0,1,5
2024-03-28 02:40:00,4,1,0,0,5
2024-03-28 02:50:00,0,0,5,3,8
2024-03-28 03:00:00,3,0,0,1,4
2024-03-28 03:10:00,1,0,0,1,2
2024-03-28 03:20:00,7,0,0,1,8
2024-03-28 03:30:00,1,0,0,1,2
2024-03-28 03:40:00,0,0,1,1,2
2024-03-28 03:50:00,1,0,0,3,4
2024-03-28 04:00:00,3,0,0,1,4
2024-03-28 04:10:00,0,0,0,1,1
2024-03-28 04:20:00,1,0,0,0,1
2024-03-28 04:30:00,2,0,0,1,3
2024-03-28 04:40:00,0,0,1,2,3
2024-03-28 04:50:00,2,0,1,2,5
2024-03-28 05:00:00,7,0,0,7,14
2024-03-28 05:10:00,2,0,3,3,8
2024-03-28 05:20:00,7,0,2,2,11
2024-03-28 05:30:00,2,0,4,11,17
2024-03-28 05:40:00,8,0,4,7,19
2024-03-28 05:50:00,15,0,0,12,27
2024-03-28 06:00:00,6,0,1,7,14
2024-03-28 06:10:00,8,0,0,14,22
2024-03-28 06:20:00,9,0,4,15,28
2024-03-28 06:30:00,11,4,1,9,25
2024-03-28 06:40:00,14,1,6,16,37
2024-03-28 06:50:00,18,3,2,11,34
2024-03-28 07:00:00,12,2,0,19,33
2024-03-28 07:10:00,21,3,4,13,41
2024-03-28 07:20:00,17,2,9,30,58
2024-03-28 07:30:00,29,4,5,23,61
2024-03-28 07:40:00,31,4,9,39,83
2024-03-28 07:50:00,35,8,10,33,86
2024-03-28 08:00:00,29,4,9,39,81
2024-03-28 08:10:00,33,2,6,45,86
2024-03-28 08:20:00,45,3,8,43,99
2024-03-28 08:30:00,34,4,3,57,98
2024-03-28 08:40:00,40,5,3,46,94
2024-03-28 08:50:00,39,8,2,42,91
2024-03-28 09:00:00,35,5,3,25,68
2024-03-28 09:10:00,42,7,4,38,91
2024-03-28 09:20:00,43,5,7,48,103
2024-03-28 09:30:00,34,2,3,33,72
2024-03-28 09:40:00,42,2,5,44,93
2024-03-28 09:50:00,47,3,3,45,98
2024-03-28 10:00:00,43,6,5,41,95
2024-03-28 10:10:00,47,0,9,42,98
2024-03-28 10:20:00,40,5,4,49,98
2024-03-28 10:30:00,35,1,2,35,73
2024-03-28 10:40:00,49,7,4,35,95
2024-03-28 10:50:00,56,7,12,52,127
2024-03-28 11:00:00,39,3,7,39,88
2024-03-28 11:10:00,45,5,12,42,104
2024-03-28 11:20:00,49,4,5,31,89
2024-03-28 11:30:00,44,6,8,35,93
2024-03-28 11:40:00,40,7,6,40,93
2024-03-28 11:50:00,42,7,5,41,95
2024-03-28 12:00:00,46,4,5,41,96
2024-03-28 12:10:00,53,4,5,46,108
2024-03-28 12:20:00,49,6,13,50,118
2024-03-28 12:30:00,44,4,11,48,107
2024-03-28 12:40:00,41,6,7,35,89
2024-03-28 12:50:00,40,9,11,35,95
2024-03-28 13:00:00,32,11,4,31,78
2024-03-28 13:10:00,43,6,4,47,100
2024-03-28 13:20:00,43,12,4,39,98
2024-03-28 13:30:00,38,5,7,42,92
2024-03-28 13:40:00,47,7,4,33,91
2024-03-28 13:50:00,40,7,6,36,89
2024-03-28 14:00:00,43,6,6,40,95
2024-03-28 14:10:00,54,11,8,33,106
2024-03-28 14:20:00,53,9,7,44,113
2024-03-28 14:30:00,42,2,7,40,91
2024-03-28 14:40:00,53,10,5,36,104
2024-03-28 14:50:00,46,5,6,42,99
2024-03-28 15:00:00,54,9,4,45,112
2024-03-28 15:10:00,54,11,11,48,124
2024-03-28 15:20:00,59,15,9,47,130
2024-03-28 15:30:00,51,7,1,47,106
2024-03-28 15:40:00,47,3,11,43,104
2024-03-28 15:50:00,46,7,7,39,99
2024-03-28 16:00:00,54,7,7,42,110
2024-03-28 16:10:00,44,9,17,52,122
2024-03-28 16:20:00,53,14,7,45,119
2024-03-28 16:30:00,50,12,5,43,110
2024-03-28 16:40:00,49,2,7,63,121
2024-03-28 16:50:00,52,10,13,41,116
2024-03-28 17:00:00,47,5,5,31,88
2024-03-28 17:10:00,47,2,10,36,95
2024-03-28 17:20:00,56,9,5,45,115
2024-03-28 17:30:00,56,5,8,37,106
2024-03-28 17:40:00,61,5,7,43,116
2024-03-28 17:50:00,51,4,5,40,100
2024-03-28 18:00:00,50,4,7,40,101
2024-03-28 18:10:00,41,6,5,40,92
2024-03-28 18:20:00,43,2,7,37,89
2024-03-28 18:30:00,36,3,9,46,94
2024-03-28 18:40:00,48,4,5,39,96
2024-03-28 18:50:00,42,7,5,33,87
2024-03-28 19:00:00,34,6,8,32,80
2024-03-28 19:10:00,41,5,2,21,69
2024-03-28 19:20:00,43,9,6,31,89
2024-03-28 19:30:00,34,6,8,25,73
2024-03-28 19:40:00,52,5,2,29,88
2024-03-28 19:50:00,36,5,6,26,73
2024-03-28 20:00:00,31,1,8,32,72
2024-03-28 20:10:00,31,5,3,24,63
2024-03-28 20:20:00,38,4,3,27,72
2024-03-28 20:30:00,28,5,9,35,77
2024-03-28 20:40:00,28,2,1,20,51
2024-03-28 20:50:00,38,1,3,21,63
2024-03-28 21:00:00,22,1,6,17,46
2024-03-28 21:10:00,23,5,2,33,63
2024-03-28 21:20:00,17,1,6,20,44
2024-03-28 21:30:00,25,8,4,18,55
2024-03-28 21:40:00,20,2,3,25,50
2024-03-28 21:50:00,25,2,3,17,47
2024-03-28 22:00:00,19,1,1,17,38
2024-03-28 22:10:00,33,3,4,23,63
2024-03-28 22:20:00,22,1,4,13,40
2024-03-28 22:30:00,22,3,1,14,40
2024-03-28 22:40:00,29,0,4,10,43
2024-03-28 22:50:00,13,3,0,14,30
2024-03-28 23:00:00,20,1,1,12,34
2024-03-28 23:10:00,15,1,4,17,37
2024-03-28 23:20:00,18,1,1,13,33
2024-03-28 23:30:00,12,1,0,7,20
2024-03-28 23:40:00,11,0,1,9,21
2024-03-28 23:50:00,14,4,0,8,26
2024-03-29 00:00:00,13,2,2,5,22
2024-03-29 00:10:00,12,0,1,11,24
2024-03-29 00:20:00,14,2,0,9,25
2024-03-29 00:30:00,6,0,0,5,11
2024-03-29 00:40:00,6,0,0,9,15
2024-03-29 00:50:00,11,0,0,6,17
2024-03-29 01:00:00,9,0,0,5,14
2024-03-29 01:10:00,7,0,0,6,13
2024-03-29 01:20:00,3,0,0,3,6
2024-03-29 01:30:00,3,0,0,1,4
2024-03-29 01:40:00,7,0,0,2,9
2024-03-29 01:50:00,2,0,2,6,10
2024-03-29 02:00:00,5,0,0,4,9
2024-03-29 02:10:00,5,0,0,5,10
2024-03-29 02:20:00,3,0,0,2,5
2024-03-29 02:30:00,3,0,1,1,5
2024-03-29 02:40:00,5,0,0,6,11
2024-03-29 02:50:00,4,0,0,1,5
2024-03-29 03:00:00,4,0,0,8,12
2024-03-29 03:10:00,7,0,0,2,9
2024-03-29 03:20:00,4,0,0,4,8
2024-03-29 03:30:00,3,1,0,3,7
2024-03-29 03:40:00,2,0,0,1,3
2024-03-29 03:50:00,3,0,0,1,4
2024-03-29 04:00:00,4,2,0,1,7
2024-03-29 04:10:00,1,0,0,0,1
2024-03-29 04:20:00,0,0,0,1,1
2024-03-29 04:30:00,0,0,0,1,1
2024-03-29 04:40:00,0,0,0,1,1
2024-03-29 04:50:00,2,0,0,1,3
2024-03-29 05:00:00,0,0,0,1,1
2024-03-29 05:10:00,1,1,0,3,5
2024-03-29 05:20:00,4,0,0,3,7
2024-03-29 05:30:00,3,1,0,3,7
2024-03-29 05:40:00,5,1,0,2,8
2024-03-29 05:50:00,1,0,0,1,2
2024-03-29 06:00:00,2,0,0,3,5
2024-03-29 06:10:00,5,0,1,2,8
2024-03-29 06:20:00,3,0,0,4,7
2024-03-29 06:30:00,2,0,0,2,4
2024-03-29 06:40:00,0,0,0,3,3
2024-03-29 06:50:00,3,0,1,6,10
2024-03-29 07:00:00,2,0,0,0,2
2024-03-29 07:10:00,7,0,0,3,10
2024-03-29 07:20:00,8,0,1,3,12
2024-03-29 07:30:00,5,0,0,5,10
2024-03-29 07:40:00,4,0,0,7,11
2024-03-29 07:50:00,7,0,0,3,10
2024-03-29 08:00:00,5,1,0,5,11
2024-03-29 08:10:00,6,1,1,2,10
2024-03-29 08:20:00,6,0,1,12,19
2024-03-29 08:30:00,8,0,0,6,14
2024-03-29 08:40:00,7,0,1,12,20
2024-03-29 08:50:00,13,1,5,6,25
2024-03-29 09:00:00,13,1,0,7,21
2024-03-29 09:10:00,13,2,1,12,28
2024-03-29 09:20:00,16,1,3,8,28
2024-03-29 09:30:00,14,0,2,27,43
2024-03-29 09:40:00,27,1,0,23,51
2024-03-29 09:50:00,21,0,7,20,48
2024-03-29 10:00:00,17,2,3,15,37
2024-03-29 10:10:00,14,0,4,23,41
2024-03-29 10:20:00,23,0,1,14,38
2024-03-29 10:30:00,11,1,1,13,26
2024-03-29 10:40:00,20,0,1,15,36
2024-03-29 10:50:00,14,2,2,17,35
2024-03-29 11:00:00,22,1,2,13,38
2024-03-29 11:10:00,14,1,0,23,38
2024-03-29 11:20:00,21,0,5,31,57
2024-03-29 11:30:00,21,1,2,12,36
2024-03-29 11:40:00,19,3,3,12,37
2024-03-29 11:50:00,26,2,4,14,46
2024-03-29 12:00:00,23,3,3,22,51
2024-03-29 12:10:00,21,2,4,17,44
2024-03-29 12:20:00,26,4,3,24,57
2024-03-29 12:30:00,29,1,4,25,59
2024-03-29 12:40:00,26,2,1,28,57
2024-03-29 12:50:00,30,2,2,20,54
2024-03-29 13:00:00,28,1,1,25,55
2024-03-29 13:10:00,24,2,7,21,54
2024-03-29 13:20:00,23,1,2,22,48
2024-03-29 13:30:00,21,3,1,33,58
2024-03-29 13:40:00,21,2,1,26,50
2024-03-29 13:50:00,27,3,4,30,64
2024-03-29 14:00:00,25,1,6,22,54
2024-03-29 14:10:00,22,1,7,25,55
2024-03-29 14:20:00,28,4,3,24,59
2024-03-29 14:30:00,24,4,4,23,55
2024-03-29 14:40:00,27,4,2,32,65
2024-03-29 14:50:00,30,2,4,32,68
2024-03-29 15:00:00,36,1,3,25,65
2024-03-29 15:10:00,18,3,3,20,44
2024-03-29 15:20:00,32,3,6,27,68
2024-03-29 15:30:00,18,1,3,45,67
2024-03-29 15:40:00,24,1,5,15,45
2024-03-29 15:50:00,27,1,2,31,61
2024-03-29 16:00:00,25,2,5,26,58
2024-03-29 16:10:00,21,1,4,20,46
2024-03-29 16:20:00,18,1,3,20,42
2024-03-29 16:30:00,26,5,2,21,54
2024-03-29 16:40:00,14,1,4,29,48
2024-03-29 16:50:00,24,3,7,23,57
2024-03-29 17:00:00,29,2,2,18,51
2024-03-29 17:10:00,15,8,2,22,47
2024-03-29 17:20:00,23,5,3,21,52
2024-03-29 17:30:00,24,2,4,31,61
2024-03-29 17:40:00,34,1,3,26,64
2024-03-29 17:50:00,26,1,3,30,60
2024-03-29 18:00:00,40,3,2,25,70
2024-03-29 18:10:00,26,3,4,27,60
2024-03-29 18:20:00,31,4,1,27,63
2024-03-29 18:30:00,19,3,1,26,49
2024-03-29 18:40:00,20,0,4,21,45
2024-03-29 18:50:00,23,4,4,28,59
2024-03-29 19:00:00,16,4,6,16,42
2024-03-29 19:10:00,24,6,9,22,61
2024-03-29 19:20:00,18,4,4,21,47
2024-03-29 19:30:00,23,5,2,18,48
2024-03-29 19:40:00,21,0,2,12,35
2024-03-29 19:50:00,12,1,1,19,33
2024-03-29 20:00:00,14,1,4,20,39
2024-03-29 20:10:00,9,4,2,15,30
2024-03-29 20:20:00,13,3,1,19,36
2024-03-29 20:30:00,18,1,0,14,33
2024-03-29 20:40:00,23,0,4,13,40
2024-03-29 20:50:00,23,2,3,10,38
2024-03-29 21:00:00,20,3,1,12,36
2024-03-29 21:10:00,12,1,2,11,26
2024-03-29 21:20:00,19,1,1,17,38
2024-03-29 21:30:00,17,0,0,8,25
2024-03-29 21:40:00,17,0,0,12,29
2024-03-29 21:50:00,19,1,2,13,35
2024-03-29 22:00:00,12,1,1,5,19
2024-03-29 22:10:00,23,4,1,7,35
2024-03-29 22:20:00,9,0,2,10,21
2024-03-29 22:30:00,10,0,0,6,16
2024-03-29 22:40:00,6,1,1,7,15
2024-03-29 22:50:00,13,0,1,8,22
2024-03-29 23:00:00,14,0,0,7,21
2024-03-29 23:10:00,9,1,1,7,18
2024-03-29 23:20:00,11,1,3,6,21
2024-03-29 23:30:00,4,3,1,12,20
2024-03-29 23:40:00,10,0,0,6,16
2024-03-29 23:50:00,9,1,0,9,19
2024-03-30 00:00:00,5,0,0,4,9
2024-03-30 00:10:00,5,1,0,2,8
2024-03-30 00:20:00,10,1,2,2,15
2024-03-30 00:30:00,2,2,0,5,9
2024-03-30 00:40:00,6,0,0,3,9
2024-03-30 00:50:00,7,1,1,4,13
2024-03-30 01:00:00,6,0,0,3,9
2024-03-30 01:10:00,7,1,1,2,11
2024-03-30 01:20:00,4,1,0,6,11
2024-03-30 01:30:00,2,1,0,4,7
2024-03-30 01:40:00,2,0,0,1,3
2024-03-30 01:50:00,2,0,0,0,2
2024-03-30 02:00:00,5,1,2,1,9
2024-03-30 02:10:00,5,0,0,0,5
2024-03-30 02:20:00,4,0,0,4,8
2024-03-30 02:30:00,6,0,0,2,8
2024-03-30 02:40:00,0,0,0,1,1
2024-03-30 02:50:00,1,0,0,2,3
2024-03-30 03:00:00,3,0,2,2,7
2024-03-30 03:10:00,4,0,0,5,9
2024-03-30 03:20:00,2,0,0,4,6
2024-03-30 03:30:00,0,0,2,2,4
2024-03-30 03:40:00,3,2,0,0,5
2024-03-30 03:50:00,5,1,0,1,7
2024-03-30 04:00:00,4,1,0,0,5
2024-03-30 04:10:00,1,0,0,0,1
2024-03-30 04:20:00,3,0,0,1,4
2024-03-30 04:30:00,2,2,2,1,7
2024-03-30 04:40:00,1,0,0,2,3
2024-03-30 04:50:00,1,0,0,2,3
2024-03-30 05:00:00,1,0,0,4,5
2024-03-30 05:10:00,2,0,0,4,6
2024-03-30 05:20:00,0,0,0,3,3
2024-03-30 05:30:00,4,0,1,3,8
2024-03-30 05:40:00,3,0,2,2,7
2024-03-30 05:50:00,5,0,0,1,6
2024-03-30 06:00:00,3,0,0,1,4
2024-03-30 06:10:00,6,0,0,2,8
2024-03-30 06:20:00,6,1,0,8,15
2024-03-30 06:30:00,4,1,1,5,11
2024-03-30 06:40:00,6,0,0,7,13
2024-03-30 06:50:00,9,0,0,10,19
2024-03-30 07:00:00,6,0,0,4,10
2024-03-30 07:10:00,9,0,1,7,17
2024-03-30 07:20:00,7,0,1,10,18
2024-03-30 07:30:00,16,1,0,6,23
2024-03-30 07:40:00,13,0,0,13,26
2024-03-30 07:50:00,11,0,1,15,27
2024-03-30 08:00:00,17,3,5,12,37
2024-03-30 08:10:00,19,2,4,17,42
2024-03-30 08:20:00,24,2,2,16,44
2024-03-30 08:30:00,17,2,2,15,36
2024-03-30 08:40:00,28,4,4,20,56
2024-03-30 08:50:00,25,2,3,27,57
2024-03-30 09:00:00,29,4,0,22,55
2024-03-30 09:10:00,28,4,4,32,68
2024-03-30 09:20:00,29,2,4,34,69
2024-03-30 09:30:00,33,3,3,31,70
2024-03-30 09:40:00,40,5,7,42,94
2024-03-30 09:50:00,38,3,8,49,98
2024-03-30 10:00:00,35,1,4,50,90
2024-03-30 10:10:00,38,4,7,38,87
2024-03-30 10:20:00,45,5,5,31,86
2024-03-30 10:30:00,44,2,7,27,80
2024-03-30 10:40:00,36,3,2,37,78
2024-03-30 10:50:00,53,7,9,36,105
2024-03-30 11:00:00,50,3,3,39,95
2024-03-30 11:10:00,38,6,11,38,93
2024-03-30 11:20:00,32,1,7,42,82
2024-03-30 11:30:00,42,1,2,44,89
2024-03-30 11:40:00,46,8,13,45,112
2024-03-30 11:50:00,46,6,8,40,100
2024-03-30 12:00:00,47,5,6,36,94
2024-03-30 12:10:00,32,5,12,41,90
2024-03-30 12:20:00,50,5,7,39,101
2024-03-30 12:30:00,39,3,6,41,89
2024-03-30 12:40:00,48,2,9,53,112
2024-03-30 12:50:00,42,1,7,44,94
2024-03-30 13:00:00,33,6,10,39,88
2024-03-30 13:10:00,34,10,5,37,86
2024-03-30 13:20:00,38,6,7,35,86
2024-03-30 13:30:00,50,2,10,40,102
2024-03-30 13:40:00,41,4,6,45,96
2024-03-30 13:50:00,32,1,6,25,64
2024-03-30 14:00:00,42,4,6,33,85
2024-03-30 14:10:00,39,6,4,35,84
2024-03-30 14:20:00,45,5,3,32,85
2024-03-30 14:30:00,42,5,1,29,77
2024-03-30 14:40:00,37,5,6,33,81
2024-03-30 14:50:00,34,5,6,21,66
2024-03-30 15:00:00,44,3,3,22,72
2024-03-30 15:10:00,35,6,4,30,75
2024-03-30 15:20:00,41,3,7,25,76
2024-03-30 15:30:00,47,5,3,30,85
2024-03-30 15:40:00,37,4,6,33,80
2024-03-30 15:50:00,36,1,2,26,65
2024-03-30 16:00:00,29,2,9,21,61
2024-03-30 16:10:00,38,8,5,25,76
2024-03-30 16:20:00,36,4,8,30,78
2024-03-30 16:30:00,43,5,7,23,78
2024-03-30 16:40:00,37,2,3,24,66
2024-03-30 16:50:00,40,4,4,27,75
2024-03-30 17:00:00,29,3,4,25,61
2024-03-30 17:10:00,27,3,4,35,69
2024-03-30 17:20:00,40,2,9,30,81
2024-03-30 17:30:00,38,3,4,25,70
2024-03-30 17:40:00,26,3,2,26,57
2024-03-30 17:50:00,32,5,4,26,67
2024-03-30 18:00:00,46,3,4,36,89
2024-03-30 18:10:00,32,8,1,36,77
2024-03-30 18:20:00,36,5,2,22,65
2024-03-30 18:30:00,35,2,2,27,66
2024-03-30 18:40:00,31,1,7,28,67
2024-03-30 18:50:00,25,2,5,24,56
2024-03-30 19:00:00,23,3,2,21,49
2024-03-30 19:10:00,23,2,3,21,49
2024-03-30 19:20:00,24,2,4,38,68
2024-03-30 19:30:00,29,2,3,29,63
2024-03-30 19:40:00,29,5,0,34,68
2024-03-30 19:50:00,25,6,4,21,56
2024-03-30 20:00:00,18,6,5,19,48
2024-03-30 20:10:00,24,4,2,22,52
2024-03-30 20:20:00,25,3,4,24,56
2024-03-30 20:30:00,33,7,5,22,67
2024-03-30 20:40:00,16,4,0,25,45
2024-03-30 20:50:00,24,0,0,21,45
2024-03-30 21:00:00,20,0,1,13,34
2024-03-30 21:10:00,21,7,2,16,46
2024-03-30 21:20:00,25,0,1,8,34
2024-03-30 21:30:00,21,0,2,25,48
2024-03-30 21:40:00,11,5,3,15,34
2024-03-30 21:50:00,16,2,0,22,40
2024-03-30 22:00:00,15,2,2,22,41
2024-03-30 22:10:00,22,3,3,20,48
2024-03-30 22:20:00,16,2,2,8,28
2024-03-30 22:30:00,9,0,0,15,24
2024-03-30 22:40:00,18,6,1,11,36
2024-03-30 22:50:00,16,1,0,8,25
2024-03-30 23:00:00,13,0,1,6,20
2024-03-30 23:10:00,19,2,3,15,39
2024-03-30 23:20:00,16,1,3,16,36
2024-03-30 23:30:00,12,2,0,11,25
2024-03-30 23:40:00,9,0,1,8,18
2024-03-30 23:50:00,10,1,2,5,18
2024-03-31 00:00:00,7,2,0,6,15
2024-03-31 00:10:00,3,2,0,6,11
2024-03-31 00:20:00,15,1,0,4,20
2024-03-31 00:30:00,9,1,1,4,15
2024-03-31 00:40:00,2,0,2,1,5
2024-03-31 00:50:00,9,0,0,5,14
2024-03-31 01:00:00,10,0,0,4,14
2024-03-31 01:10:00,7,1,0,8,16
2024-03-31 01:20:00,6,0,0,2,8
2024-03-31 01:30:00,8,0,0,3,11
2024-03-31 01:40:00,6,0,0,1,7
2024-03-31 01:50:00,5,0,0,3,8
2024-03-31 02:00:00,0,0,0,0,0
2024-03-31 02:10:00,0,0,0,0,0
2024-03-31 02:20:00,0,0,0,0,0
2024-03-31 02:30:00,0,0,0,0,0
2024-03-31 02:40:00,0,0,0,0,0
2024-03-31 02:50:00,0,0,0,0,0
2024-03-31 03:00:00,0,0,0,0,0
2024-03-31 03:10:00,0,0,0,0,0
2024-03-31 03:20:00,0,0,0,0,0
2024-03-31 03:30:00,0,0,0,0,0
2024-03-31 03:40:00,0,0,0,0,0
2024-03-31 03:50:00,0,0,0,0,0
2024-03-31 04:00:00,3,0,0,3,6
2024-03-31 04:10:00,8,0,0,1,9
2024-03-31 04:20:00,4,0,1,3,8
2024-03-31 04:30:00,2,0,0,3,5
2024-03-31 04:40:00,2,0,0,4,6
2024-03-31 04:50:00,6,2,2,1,11
2024-03-31 05:00:00,2,0,1,2,5
2024-03-31 05:10:00,3,0,0,1,4
2024-03-31 05:20:00,2,1,2,3,8
2024-03-31 05:30:00,1,0,1,6,8
2024-03-31 05:40:00,5,0,2,4,11
2024-03-31 05:50:00,2,0,1,1,4
2024-03-31 06:00:00,4,0,0,0,4
2024-03-31 06:10:00,3,0,1,1,5
2024-03-31 06:20:00,2,0,0,2,4
2024-03-31 06:30:00,1,1,0,0,2
2024-03-31 06:40:00,4,0,0,3,7
2024-03-31 06:50:00,4,0,1,5,10
2024-03-31 07:00:00,3,0,0,2,5
2024-03-31 07:10:00,2,0,0,1,3
2024-03-31 07:20:00,1,0,0,4,5
2024-03-31 07:30:00,3,0,1,1,5
2024-03-31 07:40:00,1,1,0,6,8
2024-03-31 07:50:00,7,0,0,6,13
2024-03-31 08:00:00,5,0,0,1,6
2024-03-31 08:10:00,4,1,0,7,12
2024-03-31 08:20:00,9,2,1,6,18
2024-03-31 08:30:00,9,1,0,7,17
2024-03-31 08:40:00,6,0,1,10,17
2024-03-31 08:50:00,6,0,1,11,18
2024-03-31 09:00:00,9,1,1,10,21
2024-03-31 09:10:00,14,1,2,6,23
2024-03-31 09:20:00,17,2,0,10,29
2024-03-31 09:30:00,11,1,2,21,35
2024-03-31 09:40:00,15,2,2,29,48
2024-03-31 09:50:00,22,2,2,17,43
2024-03-31 10:00:00,17,2,8,16,43
2024-03-31 10:10:00,19,0,5,19,43
2024-03-31 10:20:00,15,2,4,17,38
2024-03-31 10:30:00,14,5,3,22,44
2024-03-31 10:40:00,24,2,2,29,57
2024-03-31 10:50:00,19,1,3,14,37
2024-03-31 11:00:00,30,3,4,13,50
2024-03-31 11:10:00,28,2,3,20,53
2024-03-31 11:20:00,30,6,5,20,61
2024-03-31 11:30:00,22,3,5,29,59
2024-03-31 11:40:00,30,3,8,19,60
2024-03-31 11:50:00,36,2,3,23,64
2024-03-31 12:00:00,22,2,6,27,57
2024-03-31 12:10:00,30,1,4,27,62
2024-03-31 12:20:00,33,1,4,37,75
2024-03-31 12:30:00,29,3,7,24,63
2024-03-31 12:40:00,39,5,3,29,76
2024-03-31 12:50:00,32,4,4,28,68
2024-03-31 13:00:00,30,3,8,31,72
2024-03-31 13:10:00,22,6,2,26,56
2024-03-31 13:20:00,36,1,3,24,64
2024-03-31 13:30:00,29,3,1,23,56
2024-03-31 13:40:00,29,1,3,17,50
2024-03-31 13:50:00,25,3,7,19,54
2024-03-31 14:00:00,30,4,5,22,61
2024-03-31 14:10:00,29,3,2,20,54
2024-03-31 14:20:00,28,2,3,20,53
2024-03-31 14:30:00,22,2,3,30,57
2024-03-31 14:40:00,35,0,3,19,57
2024-03-31 14:50:00,28,5,1,23,57
2024-03-31 15:00:00,33,2,5,31,71
2024-03-31 15:10:00,26,3,3,29,61
2024-03-31 15:20:00,34,3,5,25,67
2024-03-31 15:30:00,16,6,9,37,68
2024-03-31 15:40:00,24,2,6,27,59
2024-03-31 15:50:00,26,1,6,26,59
2024-03-31 16:00:00,28,2,5,28,63
2024-03-31 16:10:00,28,4,2,21,55
2024-03-31 16:20:00,23,2,4,36,65
2024-03-31 16:30:00,31,2,6,27,66
2024-03-31 16:40:00,23,2,3,28,56
2024-03-31 16:50:00,22,1,5,23,51
2024-03-31 17:00:00,33,2,9,26,70
2024-03-31 17:10:00,32,3,3,30,68
2024-03-31 17:20:00,24,1,4,30,59
2024-03-31 17:30:00,21,1,8,30,60
2024-03-31 17:40:00,35,4,1,29,69
2024-03-31 17:50:00,38,6,4,33,81
2024-03-31 18:00:00,31,4,3,34,72
2024-03-31 18:10:00,22,4,6,27,59
2024-03-31 18:20:00,29,4,5,22,60
2024-03-31 18:30:00,24,4,4,31,63
2024-03-31 18:40:00,30,2,7,28,67
2024-03-31 18:50:00,22,1,2,26,51
2024-03-31 19:00:00,29,2,0,33,64
2024-03-31 19:10:00,22,5,2,28,57
2024-03-31 19:20:00,31,4,3,26,64
2024-03-31 19:30:00,31,3,5,26,65
2024-03-31 19:40:00,25,2,2,28,57
2024-03-31 19:50:00,16,1,9,24,50
2024-03-31 20:00:00,18,4,2,11,35
2024-03-31 20:10:00,24,1,8,23,56
2024-03-31 20:20:00,12,4,5,28,49
2024-03-31 20:30:00,23,2,1,18,44
2024-03-31 20:40:00,26,1,2,23,52
2024-03-31 20:50:00,20,4,4,16,44
2024-03-31 21:00:00,18,3,3,22,46
2024-03-31 21:10:00,10,0,2,20,32
2024-03-31 21:20:00,13,2,0,18,33
2024-03-31 21:30:00,35,7,5,13,60
2024-03-31 21:40:00,16,2,2,20,40
2024-03-31 21:50:00,33,3,1,22,59
2024-03-31 22:00:00,23,2,0,14,39
2024-03-31 22:10:00,15,4,0,13,32
2024-03-31 22:20:00,13,0,2,12,27
2024-03-31 22:30:00,15,4,1,14,34
2024-03-31 22:40:00,16,3,1,17,37
2024-03-31 22:50:00,4,0,1,14,19
2024-03-31 23:00:00,13,0,0,7,20
2024-03-31 23:10:00,13,2,0,8,23
2024-03-31 23:20:00,9,0,1,7,17
2024-03-31 23:30:00,9,0,0,4,13
2024-03-31 23:40:00,7,1,1,9,18
2024-03-31 23:50:00,6,1,0,3,10
2024-04-01 00:00:00,7,1,1,11,20
2024-04-01 00:10:00,7,0,2,5,14
2024-04-01 00:20:00,9,0,0,4,13
2024-04-01 00:30:00,8,1,0,7,16
2024-04-01 00:40:00,7,0,1,5,13
2024-04-01 00:50:00,9,0,0,5,14
2024-04-01 01:00:00,2,1,0,7,10
2024-04-01 01:10:00,8,1,1,5,15
2024-04-01 01:20:00,7,0,1,4,12
2024-04-01 01:30:00,7,0,0,4,11
2024-04-01 01:40:00,4,0,0,4,8
2024-04-01 01:50:00,3,1,0,4,8
2024-04-01 02:00:00,4,0,0,2,6
2024-04-01 02:10:00,10,0,1,3,14
2024-04-01 02:20:00,5,1,0,2,8
2024-04-01 02:30:00,7,0,0,3,10
2024-04-01 02:40:00,3,3,0,4,10
2024-04-01 02:50:00,4,1,0,3,8
2024-04-01 03:00:00,5,0,0,4,9
2024-04-01 03:10:00,1,0,0,3,4
2024-04-01 03:20:00,3,1,0,1,5
2024-04-01 03:30:00,3,1,3,3,10
2024-04-01 03:40:00,0,0,1,4,5
2024-04-01 03:50:00,1,0,1,1,3
2024-04-01 04:00:00,5,1,0,1,7
2024-04-01 04:10:00,2,2,0,2,6
2024-04-01 04:20:00,3,0,1,1,5
2024-04-01 04:30:00,0,0,0,2,2
2024-04-01 04:40:00,0,0,0,0,0
2024-04-01 04:50:00,2,2,0,1,5
2024-04-01 05:00:00,1,0,1,1,3
2024-04-01 05:10:00,4,2,2,2,10
2024-04-01 05:20:00,3,1,1,6,11
2024-04-01 05:30:00,1,0,1,2,4
2024-04-01 05:40:00,3,0,0,7,10
2024-04-01 05:50:00,3,3,2,3,11
2024-04-01 06:00:00,0,0,0,1,1
2024-04-01 06:10:00,4,1,0,0,5
2024-04-01 06:20:00,2,1,0,1,4
2024-04-01 06:30:00,6,2,0,1,9
2024-04-01 06:40:00,5,1,1,7,14
2024-04-01 06:50:00,3,0,1,4,8
2024-04-01 07:00:00,1,0,0,4,5
2024-04-01 07:10:00,3,0,2,2,7
2024-04-01 07:20:00,4,0,2,1,7
2024-04-01 07:30:00,6,0,0,2,8
2024-04-01 07:40:00,3,0,0,7,10
2024-04-01 07:50:00,4,2,2,6,14
2024-04-01 08:00:00,3,0,0,4,7
2024-04-01 08:10:00,0,0,0,5,5
2024-04-01 08:20:00,4,1,0,5,10
2024-04-01 08:30:00,11,1,0,4,16
2024-04-01 08:40:00,6,0,1,8,15
2024-04-01 08:50:00,10,1,0,8,19
2024-04-01 09:00:00,7,1,1,14,23
2024-04-01 09:10:00,7,1,0,9,17
2024-04-01 09:20:00,10,0,0,12,22
2024-04-01 09:30:00,9,0,0,11,20
2024-04-01 09:40:00,19,0,2,14,35
2024-04-01 09:50:00,16,2,0,16,34
2024-04-01 10:00:00,15,1,3,9,28
2024-04-01 10:10:00,18,0,2,13,33
2024-04-01 10:20:00,17,1,2,16,36
2024-04-01 10:30:00,12,0,1,11,24
2024-04-01 10:40:00,19,1,3,17,40
2024-04-01 10:50:00,15,3,4,16,38
2024-04-01 11:00:00,18,4,2,25,49
2024-04-01 11:10:00,26,1,4,13,44
2024-04-01 11:20:00,21,0,4,17,42
2024-04-01 11:30:00,22,2,4,14,42
2024-04-01 11:40:00,15,0,4,15,34
2024-04-01 11:50:00,22,4,3,20,49
2024-04-01 12:00:00,27,4,2,19,52
2024-04-01 12:10:00,28,3,5,29,65
2024-04-01 12:20:00,27,0,0,25,52
2024-04-01 12:30:00,19,1,5,28,53
2024-04-01 12:40:00,26,0,2,30,58
2024-04-01 12:50:00,23,1,3,21,48
2024-04-01 13:00:00,25,2,3,19,49
2024-04-01 13:10:00,22,1,4,15,42
2024-04-01 13:20:00,22,1,5,18,46
2024-04-01 13:30:00,31,0,1,23,55
2024-04-01 13:40:00,31,1,4,30,66
2024-04-01 13:50:00,31,4,3,26,64
2024-04-01 14:00:00,27,2,4,26,59
2024-04-01 14:10:00,32,1,4,24,61
2024-04-01 14:20:00,26,2,1,22,51
2024-04-01 14:30:00,23,2,10,23,58
2024-04-01 14:40:00,22,4,3,15,44
2024-04-01 14:50:00,28,3,6,40,77
2024-04-01 15:00:00,33,4,6,28,71
2024-04-01 15:10:00,22,1,5,24,52
2024-04-01 15:20:00,24,3,6,22,55
2024-04-01 15:30:00,35,3,4,24,66
2024-04-01 15:40:00,29,8,5,22,64
2024-04-01 15:50:00,29,2,4,29,64
2024-04-01 16:00:00,24,1,1,33,59
2024-04-01 16:10:00,36,6,4,30,76
2024-04-01 16:20:00,32,2,3,25,62
2024-04-01 16:30:00,24,2,3,21,50
2024-04-01 16:40:00,26,0,7,24,57
2024-04-01 16:50:00,25,1,4,22,52
2024-04-01 17:00:00,23,2,6,28,59
2024-04-01 17:10:00,25,2,4,28,59
2024-04-01 17:20:00,29,3,6,18,56
2024-04-01 17:30:00,35,1,2,33,71
2024-04-01 17:40:00,29,3,4,26,62
2024-04-01 17:50:00,29,0,2,31,62
2024-04-01 18:00:00,22,0,5,32,59
2024-04-01 18:10:00,25,2,4,22,53
2024-04-01 18:20:00,25,2,2,29,58
2024-04-01 18:30:00,21,2,3,29,55
2024-04-01 18:40:00,23,3,4,25,55
2024-04-01 18:50:00,25,1,6,31,63
2024-04-01 19:00:00,23,5,2,15,45
2024-04-01 19:10:00,34,1,4,21,60
2024-04-01 19:20:00,31,2,4,18,55
2024-04-01 19:30:00,21,0,5,33,59
2024-04-01 19:40:00,28,2,4,25,59
2024-04-01 19:50:00,23,2,8,22,55
2024-04-01 20:00:00,19,1,4,14,38
2024-04-01 20:10:00,19,2,8,20,49
2024-04-01 20:20:00,17,2,7,19,45
2024-04-01 20:30:00,20,5,2,9,36
2024-04-01 20:40:00,21,1,2,17,41
2024-04-01 20:50:00,17,0,2,11,30
2024-04-01 21:00:00,16,2,3,16,37
2024-04-01 21:10:00,13,3,0,19,35
2024-04-01 21:20:00,9,2,1,10,22
2024-04-01 21:30:00,17,2,2,14,35
2024-04-01 21:40:00,12,5,1,8,26
2024-04-01 21:50:00,14,0,4,25,43
2024-04-01 22:00:00,12,4,0,15,31
2024-04-01 22:10:00,13,3,4,13,33
2024-04-01 22:20:00,13,0,3,8,24
2024-04-01 22:30:00,14,5,0,9,28
2024-04-01 22:40:00,6,1,1,8,16
2024-04-01 22:50:00,14,0,2,10,26
2024-04-01 23:00:00,16,0,0,12,28
2024-04-01 23:10:00,26,2,0,9,37
2024-04-01 23:20:00,22,2,2,8,34
2024-04-01 23:30:00,10,2,1,12,25
2024-04-01 23:40:00,11,4,1,2,18
2024-04-01 23:50:00,16,2,3,4,25
2024-04-02 00:00:00,9,2,0,4,15
2024-04-02 00:10:00,2,2,1,5,10
2024-04-02 00:20:00,5,0,0,7,12
2024-04-02 00:30:00,7,2,1,2,12
2024-04-02 00:40:00,9,5,0,3,17
2024-04-02 00:50:00,4,0,2,5,11
2024-04-02 01:00:00,5,0,0,0,5
2024-04-02 01:10:00,8,0,0,1,9
2024-04-02 01:20:00,5,0,0,4,9
2024-04-02 01:30:00,0,0,0,0,0
2024-04-02 01:40:00,2,0,0,0,2
2024-04-02 01:50:00,2,0,0,0,2
2024-04-02 02:00:00,2,0,0,5,7
2024-04-02 02:10:00,0,0,1,1,2
2024-04-02 02:20:00,2,0,0,1,3
2024-04-02 02:30:00,2,0,0,0,2
2024-04-02 02:40:00,2,0,0,3,5
2024-04-02 02:50:00,0,0,1,1,2
2024-04-02 03:00:00,1,0,1,6,8
2024-04-02 03:10:00,1,2,0,1,4
2024-04-02 03:20:00,4,0,0,1,5
2024-04-02 03:30:00,1,0,0,3,4
2024-04-02 03:40:00,1,0,0,1,2
2024-04-02 03:50:00,3,0,2,0,5
2024-04-02 04:00:00,4,0,2,0,6
2024-04-02 04:10:00,0,0,0,2,2
2024-04-02 04:20:00,0,0,0,2,2
2024-04-02 04:30:00,0,0,0,2,2
2024-04-02 04:40:00,3,0,0,2,5
2024-04-02 04:50:00,3,0,0,5,8
2024-04-02 05:00:00,4,0,2,6,12
2024-04-02 05:10:00,8,0,1,3,12
2024-04-02 05:20:00,5,0,0,6,11
2024-04-02 05:30:00,2,0,2,11,15
2024-04-02 05:40:00,13,0,0,12,25
2024-04-02 05:50:00,16,4,5,6,31
2024-04-02 06:00:00,10,0,3,7,20
2024-04-02 06:10:00,10,0,0,16,26
2024-04-02 06:20:00,11,1,0,16,28
2024-04-02 06:30:00,13,1,3,20,37
2024-04-02 06:40:00,20,2,6,16,44
2024-04-02 06:50:00,23,0,0,24,47
2024-04-02 07:00:00,12,0,3,12,27
2024-04-02 07:10:00,16,2,4,26,48
2024-04-02 07:20:00,17,0,5,27,49
2024-04-02 07:30:00,20,2,4,39,65
2024-04-02 07:40:00,31,5,2,33,71
2024-04-02 07:50:00,26,2,11,31,70
2024-04-02 08:00:00,31,0,9,28,68
2024-04-02 08:10:00,34,2,8,40,84
2024-04-02 08:20:00,38,3,16,39,96
2024-04-02 08:30:00,38,5,6,40,89
2024-04-02 08:40:00,23,3,6,28,60
2024-04-02 08:50:00,45,28,7,36,116
2024-04-02 09:00:00,30,29,1,40,100
2024-04-02 09:10:00,34,3,4,41,82
2024-04-02 09:20:00,40,1,5,30,76
2024-04-02 09:30:00,29,2,4,30,65
2024-04-02 09:40:00,36,1,3,42,82
2024-04-02 09:50:00,31,2,3,40,76
2024-04-02 10:00:00,40,4,2,48,94
2024-04-02 10:10:00,38,2,7,34,81
2024-04-02 10:20:00,33,5,4,29,71
2024-04-02 10:30:00,40,3,5,42,90
2024-04-02 10:40:00,47,1,6,32,86
2024-04-02 10:50:00,54,7,5,29,95
2024-04-02 11:00:00,35,4,5,38,82
2024-04-02 11:10:00,42,5,11,40,98
2024-04-02 11:20:00,48,5,3,35,91
2024-04-02 11:30:00,32,6,4,48,90
2024-04-02 11:40:00,28,1,3,34,66
2024-04-02 11:50:00,44,3,6,46,99
2024-04-02 12:00:00,38,5,5,35,83
2024-04-02 12:10:00,36,5,4,23,68
2024-04-02 12:20:00,36,3,2,34,75
2024-04-02 12:30:00,38,4,4,42,88
2024-04-02 12:40:00,39,5,5,32,81
2024-04-02 12:50:00,46,7,2,43,98
2024-04-02 13:00:00,44,5,5,41,95
2024-04-02 13:10:00,48,5,8,34,95
2024-04-02 13:20:00,27,8,7,41,83
2024-04-02 13:30:00,44,10,3,31,88
2024-04-02 13:40:00,44,1,6,31,82
2024-04-02 13:50:00,32,3,6,28,69
2024-04-02 14:00:00,31,5,3,31,70
2024-04-02 14:10:00,36,4,6,39,85
2024-04-02 14:20:00,44,1,3,37,85
2024-04-02 14:30:00,57,5,1,21,84
2024-04-02 14:40:00,50,9,7,25,91
2024-04-02 14:50:00,45,2,4,37,88
2024-04-02 15:00:00,49,7,5,36,97
2024-04-02 15:10:00,37,7,9,47,100
2024-04-02 15:20:00,61,6,5,34,106
2024-04-02 15:30:00,39,7,3,46,95
2024-04-02 15:40:00,49,6,4,46,105
2024-04-02 15:50:00,41,2,5,36,84
2024-04-02 16:00:00,56,7,9,34,106
2024-04-02 16:10:00,48,2,5,32,87
2024-04-02 16:20:00,60,7,12,42,121
2024-04-02 16:30:00,44,2,5,39,90
2024-04-02 16:40:00,56,7,2,30,95
2024-04-02 16:50:00,39,8,1,36,84
2024-04-02 17:00:00,37,2,8,47,94
2024-04-02 17:10:00,49,4,14,35,102
2024-04-02 17:20:00,66,9,8,30,113
2024-04-02 17:30:00,51,6,6,45,108
2024-04-02 17:40:00,43,9,6,36,94
2024-04-02 17:50:00,50,8,21,41,120
2024-04-02 18:00:00,49,6,7,37,99
2024-04-02 18:10:00,49,8,20,30,107
2024-04-02 18:20:00,42,6,11,24,83
2024-04-02 18:30:00,33,2,9,29,73
2024-04-02 18:40:00,42,5,6,34,87
2024-04-02 18:50:00,39,6,9,34,88
2024-04-02 19:00:00,36,4,4,26,70
2024-04-02 19:10:00,41,2,8,34,85
2024-04-02 19:20:00,34,3,5,30,72
2024-04-02 19:30:00,21,3,2,14,40
2024-04-02 19:40:00,32,4,3,21,60
2024-04-02 19:50:00,32,2,2,22,58
2024-04-02 20:00:00,24,3,3,22,52
2024-04-02 20:10:00,17,1,1,18,37
2024-04-02 20:20:00,24,2,2,29,57
2024-04-02 20:30:00,15,1,6,20,42
2024-04-02 20:40:00,19,1,2,28,50
2024-04-02 20:50:00,16,2,1,18,37
2024-04-02 21:00:00,19,2,2,8,31
2024-04-02 21:10:00,12,5,0,17,34
2024-04-02 21:20:00,30,5,5,18,58
2024-04-02 21:30:00,21,1,2,13,37
2024-04-02 21:40:00,16,1,3,20,40
2024-04-02 21:50:00,16,5,1,12,34
2024-04-02 22:00:00,14,1,0,18,33
2024-04-02 22:10:00,16,2,3,7,28
2024-04-02 22:20:00,15,7,1,7,30
2024-04-02 22:30:00,14,2,1,10,27
2024-04-02 22:40:00,8,3,1,6,18
2024-04-02 22:50:00,11,4,4,9,28
2024-04-02 23:00:00,8,1,0,8,17
2024-04-02 23:10:00,9,1,0,3,13
2024-04-02 23:20:00,10,0,0,4,14
2024-04-02 23:30:00,13,2,0,5,20
2024-04-02 23:40:00,5,0,1,3,9
2024-04-02 23:50:00,8,2,2,7,19
2024-04-03 00:00:00,8,0,0,2,10
2024-04-03 00:10:00,9,1,0,0,10
2024-04-03 00:20:00,4,0,0,6,10
2024-04-03 00:30:00,7,0,0,3,10
2024-04-03 00:40:00,6,0,0,3,9
2024-04-03 00:50:00,3,0,1,3,7
2024-04-03 01:00:00,6,0,0,2,8
2024-04-03 01:10:00,2,0,0,2,4
2024-04-03 01:20:00,1,0,0,2,3
2024-04-03 01:30:00,3,0,0,0,3
2024-04-03 01:40:00,2,0,0,0,2
2024-04-03 01:50:00,4,0,0,1,5
2024-04-03 02:00:00,3,2,1,3,9
2024-04-03 02:10:00,3,0,0,0,3
2024-04-03 02:20:00,1,0,0,2,3
2024-04-03 02:30:00,1,0,0,1,2
2024-04-03 02:40:00,2,0,0,3,5
2024-04-03 02:50:00,1,0,0,0,1
2024-04-03 03:00:00,0,0,0,1,1
2024-04-03 03:10:00,3,0,1,0,4
2024-04-03 03:20:00,5,0,0,2,7
2024-04-03 03:30:00,2,0,0,3,5
2024-04-03 03:40:00,1,0,0,2,3
2024-04-03 03:50:00,5,0,0,0,5
2024-04-03 04:00:00,2,0,0,2,4
2024-04-03 04:10:00,8,2,0,2,12
2024-04-03 04:20:00,3,1,1,1,6
2024-04-03 04:30:00,0,0,0,5,5
2024-04-03 04:40:00,1,0,0,1,2
2024-04-03 04:50:00,1,0,0,3,4
2024-04-03 05:00:00,3,0,0,2,5
2024-04-03 05:10:00,3,0,1,6,10
2024-04-03 05:20:00,11,3,1,4,19
2024-04-03 05:30:00,4,0,1,6,11
2024-04-03 05:40:00,8,0,2,11,21
2024-04-03 05:50:00,7,0,2,11,20
2024-04-03 06:00:00,9,0,0,3,12
2024-04-03 06:10:00,10,0,1,15,26
2024-04-03 06:20:00,11,0,2,21,34
2024-04-03 06:30:00,6,1,0,18,25
2024-04-03 06:40:00,20,2,1,20,43
2024-04-03 06:50:00,12,0,2,22,36
2024-04-03 07:00:00,12,0,6,21,39
2024-04-03 07:10:00,13,2,1,26,42
2024-04-03 07:20:00,22,6,2,33,63
2024-04-03 07:30:00,28,0,4,29,61
2024-04-03 07:40:00,24,3,4,36,67
2024-04-03 07:50:00,31,1,5,17,54
2024-04-03 08:00:00,29,0,7,37,73
2024-04-03 08:10:00,37,4,14,28,83
2024-04-03 08:20:00,29,3,2,38,72
2024-04-03 08:30:00,30,4,3,37,74
2024-04-03 08:40:00,43,6,7,39,95
2024-04-03 08:50:00,36,3,5,43,87
2024-04-03 09:00:00,32,1,8,36,77
2024-04-03 09:10:00,34,7,1,28,70
2024-04-03 09:20:00,34,1,7,36,78
2024-04-03 09:30:00,26,4,4,25,59
2024-04-03 09:40:00,50,2,6,42,100
2024-04-03 09:50:00,38,2,6,32,78
2024-04-03 10:00:00,30,5,3,30,68
2024-04-03 10:10:00,32,4,3,38,77
2024-04-03 10:20:00,38,2,7,39,86
2024-04-03 10:30:00,29,2,2,34,67
2024-04-03 10:40:00,28,7,5,37,77
2024-04-03 10:50:00,52,4,6,42,104
2024-04-03 11:00:00,37,5,6,34,82
2024-04-03 11:10:00,40,2,2,24,68
2024-04-03 11:20:00,35,10,7,40,92
2024-04-03 11:30:00,34,3,6,34,77
2024-04-03 11:40:00,35,7,6,46,94
2024-04-03 11:50:00,41,5,3,38,87
2024-04-03 12:00:00,46,3,7,21,77
2024-04-03 12:10:00,54,5,5,36,100
2024-04-03 12:20:00,41,9,8,43,101
2024-04-03 12:30:00,40,5,5,36,86
2024-04-03 12:40:00,40,4,2,35,81
2024-04-03 12:50:00,54,7,8,34,103
2024-04-03 13:00:00,43,4,5,33,85
2024-04-03 13:10:00,51,6,2,33,92
2024-04-03 13:20:00,45,8,4,38,95
2024-04-03 13:30:00,43,7,5,34,89
2024-04-03 13:40:00,34,5,4,38,81
2024-04-03 13:50:00,37,6,6,36,85
2024-04-03 14:00:00,44,6,5,38,93
2024-04-03 14:10:00,40,6,7,40,93
2024-04-03 14:20:00,55,8,5,27,95
2024-04-03 14:30:00,32,4,2,50,88
2024-04-03 14:40:00,42,4,5,38,89
2024-04-03 14:50:00,52,7,5,37,101
2024-04-03 15:00:00,43,3,7,42,95
2024-04-03 15:10:00,51,2,7,40,100
2024-04-03 15:20:00,44,6,6,31,87
2024-04-03 15:30:00,44,9,5,28,86
2024-04-03 15:40:00,44,4,8,37,93
2024-04-03 15:50:00,46,0,3,41,90
2024-04-03 16:00:00,50,3,7,27,87
2024-04-03 16:10:00,49,7,6,29,91
2024-04-03 16:20:00,47,1,5,33,86
2024-04-03 16:30:00,44,3,9,32,88
2024-04-03 16:40:00,44,6,11,44,105
2024-04-03 16:50:00,46,3,6,34,89
2024-04-03 17:00:00,38,3,10,43,94
2024-04-03 17:10:00,50,8,2,35,95
2024-04-03 17:20:00,45,9,8,42,104
2024-04-03 17:30:00,44,3,4,37,88
2024-04-03 17:40:00,38,5,9,39,91
2024-04-03 17:50:00,46,9,4,29,88
2024-04-03 18:00:00,43,9,6,38,96
2024-04-03 18:10:00,45,2,11,39,97
2024-04-03 18:20:00,39,6,6,29,80
2024-04-03 18:30:00,42,8,4,33,87
2024-04-03 18:40:00,50,5,10,25,90
2024-04-03 18:50:00,31,4,6,24,65
2024-04-03 19:00:00,46,7,2,26,81
2024-04-03 19:10:00,32,8,1,23,64
2024-04-03 19:20:00,25,2,9,20,56
2024-04-03 19:30:00,32,1,4,27,64
2024-04-03 19:40:00,32,3,4,25,64
2024-04-03 19:50:00,22,3,4,18,47
2024-04-03 20:00:00,21,1,4,17,43
2024-04-03 20:10:00,20,2,1,16,39
2024-04-03 20:20:00,22,3,4,23,52
2024-04-03 20:30:00,30,3,1,35,69
2024-04-03 20:40:00,22,4,3,26,55
2024-04-03 20:50:00,25,3,3,26,57
2024-04-03 21:00:00,21,2,1,22,46
2024-04-03 21:10:00,19,6,4,27,56
2024-04-03 21:20:00,16,3,2,22,43
2024-04-03 21:30:00,26,4,3,10,43
2024-04-03 21:40:00,21,6,1,20,48
2024-04-03 21:50:00,25,0,1,12,38
2024-04-03 22:00:00,3,0,2,22,27
2024-04-03 22:10:00,23,3,3,21,50
2024-04-03 22:20:00,19,1,0,10,30
2024-04-03 22:30:00,15,0,3,11,29
2024-04-03 22:40:00,18,0,1,6,25
2024-04-03 22:50:00,12,4,1,17,34
2024-04-03 23:00:00,7,0,0,8,15
2024-04-03 23:10:00,10,0,0,6,16
2024-04-03 23:20:00,9,0,0,5,14
2024-04-03 23:30:00,9,1,0,3,13
2024-04-03 23:40:00,5,1,1,4,11
2024-04-03 23:50:00,14,0,1,6,21
2024-04-04 00:00:00,2,0,0,1,3
2024-04-04 00:10:00,3,1,0,3,7
2024-04-04 00:20:00,4,1,0,8,13
2024-04-04 00:30:00,4,1,1,4,10
2024-04-04 00:40:00,7,0,2,2,11
2024-04-04 00:50:00,3,0,2,4,9
2024-04-04 01:00:00,2,0,1,2,5
2024-04-04 01:10:00,6,0,1,4,11
2024-04-04 01:20:00,3,0,0,3,6
2024-04-04 01:30:00,1,0,2,3,6
2024-04-04 01:40:00,2,0,0,2,4
2024-04-04 01:50:00,1,0,1,1,3
2024-04-04 02:00:00,1,2,1,1,5
2024-04-04 02:10:00,0,0,0,1,1
2024-04-04 02:20:00,1,0,0,1,2
2024-04-04 02:30:00,1,0,1,1,3
2024-04-04 02:40:00,3,0,0,1,4
2024-04-04 02:50:00,0,0,4,1,5
2024-04-04 03:00:00,1,0,0,2,3
2024-04-04 03:10:00,3,0,0,1,4
2024-04-04 03:20:00,6,0,0,0,6
2024-04-04 03:30:00,2,0,1,3,6
2024-04-04 03:40:00,3,0,1,4,8
2024-04-04 03:50:00,0,0,0,0,0
2024-04-04 04:00:00,3,0,0,0,3
2024-04-04 04:10:00,2,0,0,3,5
2024-04-04 04:20:00,2,1,0,2,5
2024-04-04 04:30:00,2,0,0,1,3
2024-04-04 04:40:00,1,0,0,2,3
2024-04-04 04:50:00,1,0,1,3,5
2024-04-04 05:00:00,2,0,2,2,6
2024-04-04 05:10:00,2,0,2,7,11
2024-04-04 05:20:00,5,1,1,6,13
2024-04-04 05:30:00,1,0,0,5,6
2024-04-04 05:40:00,8,0,5,11,24
2024-04-04 05:50:00,8,0,2,10,20
2024-04-04 06:00:00,7,0,0,7,14
2024-04-04 06:10:00,6,1,3,10,20
2024-04-04 06:20:00,13,1,1,14,29
2024-04-04 06:30:00,8,1,5,16,30
2024-04-04 06:40:00,17,2,3,16,38
2024-04-04 06:50:00,18,2,2,18,40
2024-04-04 07:00:00,6,1,2,14,23
2024-04-04 07:10:00,17,1,1,27,46
2024-04-04 07:20:00,21,4,3,24,52
2024-04-04 07:30:00,20,3,4,34,61
2024-04-04 07:40:00,25,5,2,33,65
2024-04-04 07:50:00,25,1,5,37,68
2024-04-04 08:00:00,36,4,4,36,80
2024-04-04 08:10:00,33,3,8,32,76
2024-04-04 08:20:00,33,4,11,26,74
2024-04-04 08:30:00,35,2,5,34,76
2024-04-04 08:40:00,32,2,8,31,73
2024-04-04 08:50:00,33,6,7,44,90
2024-04-04 09:00:00,28,2,8,41,79
2024-04-04 09:10:00,31,3,7,37,78
2024-04-04 09:20:00,32,4,3,28,67
2024-04-04 09:30:00,38,3,5,39,85
2024-04-04 09:40:00,30,7,6,30,73
2024-04-04 09:50:00,50,3,3,41,97
2024-04-04 10:00:00,46,4,7,41,98
2024-04-04 10:10:00,35,1,4,42,82
2024-04-04 10:20:00,44,6,3,34,87
2024-04-04 10:30:00,41,6,5,34,86
2024-04-04 10:40:00,41,5,5,30,81
2024-04-04 10:50:00,42,2,5,48,97
2024-04-04 11:00:00,38,5,2,34,79
2024-04-04 11:10:00,37,3,2,36,78
2024-04-04 11:20:00,34,9,3,34,80
2024-04-04 11:30:00,42,3,5,41,91
2024-04-04 11:40:00,33,4,3,37,77
2024-04-04 11:50:00,33,4,4,46,87
2024-04-04 12:00:00,49,6,4,41,100
2024-04-04 12:10:00,39,5,5,41,90
2024-04-04 12:20:00,46,8,7,28,89
2024-04-04 12:30:00,40,6,3,46,95
2024-04-04 12:40:00,41,2,6,40,89
2024-04-04 12:50:00,34,3,11,23,71
2024-04-04 13:00:00,28,4,7,30,69
2024-04-04 13:10:00,34,3,2,30,69
2024-04-04 13:20:00,39,5,3,26,73
2024-04-04 13:30:00,33,5,6,32,76
2024-04-04 13:40:00,34,6,3,29,72
2024-04-04 13:50:00,36,5,6,37,84
2024-04-04 14:00:00,34,1,5,36,76
2024-04-04 14:10:00,47,5,3,37,92
2024-04-04 14:20:00,36,4,6,50,96
2024-04-04 14:30:00,40,18,4,32,94
2024-04-04 14:40:00,41,6,5,47,99
2024-04-04 14:50:00,40,1,9,28,78
2024-04-04 15:00:00,38,5,6,44,93
2024-04-04 15:10:00,41,5,6,44,96
2024-04-04 15:20:00,42,5,3,36,86
2024-04-04 15:30:00,36,6,4,37,83
2024-04-04 15:40:00,55,4,3,55,117
2024-04-04 15:50:00,49,0,2,35,86
2024-04-04 16:00:00,47,7,2,40,96
2024-04-04 16:10:00,47,5,9,35,96
2024-04-04 16:20:00,53,5,4,39,101
2024-04-04 16:30:00,47,6,11,31,95
2024-04-04 16:40:00,41,5,5,29,80
2024-04-04 16:50:00,41,2,3,41,87
2024-04-04 17:00:00,53,7,5,34,99
2024-04-04 17:10:00,42,3,7,40,92
2024-04-04 17:20:00,43,4,4,36,87
2024-04-04 17:30:00,46,7,4,38,95
2024-04-04 17:40:00,44,2,10,44,100
2024-04-04 17:50:00,48,4,6,32,90
2024-04-04 18:00:00,42,3,4,46,95
2024-04-04 18:10:00,52,8,9,35,104
2024-04-04 18:20:00,36,3,9,28,76
2024-04-04 18:30:00,50,3,4,32,89
2024-04-04 18:40:00,42,3,8,38,91
2024-04-04 18:50:00,35,5,8,29,77
2024-04-04 19:00:00,41,7,2,38,88
2024-04-04 19:10:00,39,6,3,29,77
2024-04-04 19:20:00,39,4,7,32,82
2024-04-04 19:30:00,32,4,4,18,58
2024-04-04 19:40:00,37,3,2,25,67
2024-04-04 19:50:00,27,6,5,23,61
2024-04-04 20:00:00,27,0,8,22,57
2024-04-04 20:10:00,26,3,2,13,44
2024-04-04 20:20:00,26,4,3,14,47
2024-04-04 20:30:00,23,3,6,8,40
2024-04-04 20:40:00,22,2,2,20,46
2024-04-04 20:50:00,21,0,4,12,37
2024-04-04 21:00:00,26,4,1,15,46
2024-04-04 21:10:00,20,2,1,13,36
2024-04-04 21:20:00,14,2,3,18,37
2024-04-04 21:30:00,14,6,5,21,46
2024-04-04 21:40:00,21,3,6,19,49
2024-04-04 21:50:00,16,0,1,14,31
2024-04-04 22:00:00,10,1,4,15,30
2024-04-04 22:10:00,19,2,3,21,45
2024-04-04 22:20:00,7,1,4,8,20
2024-04-04 22:30:00,17,8,5,16,46
2024-04-04 22:40:00,20,5,4,10,39
2024-04-04 22:50:00,15,0,4,14,33
2024-04-04 23:00:00,7,0,2,7,16
2024-04-04 23:10:00,8,0,3,11,22
2024-04-04 23:20:00,12,1,3,9,25
2024-04-04 23:30:00,11,1,0,3,15
2024-04-04 23:40:00,14,0,0,3,17
2024-04-04 23:50:00,9,1,1,1,12
2024-04-05 00:00:00,8,0,1,7,16
2024-04-05 00:10:00,4,1,1,2,8
2024-04-05 00:20:00,6,1,0,2,9
2024-04-05 00:30:00,6,0,1,5,12
2024-04-05 00:40:00,9,0,1,2,12
2024-04-05 00:50:00,7,0,1,4,12
2024-04-05 01:00:00,3,0,0,6,9
2024-04-05 01:10:00,5,1,0,2,8
2024-04-05 01:20:00,4,1,0,3,8
2024-04-05 01:30:00,2,0,2,2,6
2024-04-05 01:40:00,3,0,2,2,7
2024-04-05 01:50:00,2,1,0,2,5
2024-04-05 02:00:00,1,0,0,0,1
