datetime,V22Z,V51Z,V52Z,V83Z,V111Z,V112Z,Total
2024-03-01 01:00:00,2,0,0,3,0,0,5
2024-03-01 01:10:00,1,0,0,8,0,0,9
2024-03-01 01:20:00,2,0,1,3,0,0,6
2024-03-01 01:30:00,0,0,2,3,0,0,5
2024-03-01 01:40:00,0,1,2,7,0,0,10
2024-03-01 01:50:00,1,0,0,5,0,0,6
2024-03-01 02:00:00,0,0,0,2,0,0,2
2024-03-01 02:10:00,0,0,1,2,0,0,3
2024-03-01 02:20:00,0,1,0,5,0,0,6
2024-03-01 02:30:00,0,0,1,3,0,0,4
2024-03-01 02:40:00,0,0,0,1,0,0,1
2024-03-01 02:50:00,1,0,1,2,0,0,4
2024-03-01 03:00:00,0,0,0,4,0,0,4
2024-03-01 03:10:00,0,0,0,0,0,0,0
2024-03-01 03:20:00,0,0,0,3,0,0,3
2024-03-01 03:30:00,0,0,2,3,0,0,5
2024-03-01 03:40:00,0,0,0,6,0,0,6
2024-03-01 03:50:00,2,0,0,0,0,0,2
2024-03-01 04:00:00,0,2,0,4,0,0,6
2024-03-01 04:10:00,0,3,0,7,0,0,10
2024-03-01 04:20:00,1,0,1,1,0,0,3
2024-03-01 04:30:00,0,0,1,2,0,0,3
2024-03-01 04:40:00,2,1,3,6,0,0,12
2024-03-01 04:50:00,0,2,2,4,0,0,8
2024-03-01 05:00:00,0,3,0,8,0,0,11
2024-03-01 05:10:00,1,4,3,12,0,0,20
2024-03-01 05:20:00,2,2,3,18,0,1,26
2024-03-01 05:30:00,1,10,1,20,0,0,32
2024-03-01 05:40:00,7,9,3,21,0,1,41
2024-03-01 05:50:00,4,7,7,17,0,0,35
2024-03-01 06:00:00,6,0,7,18,0,0,31
2024-03-01 06:10:00,3,9,5,16,0,0,33
2024-03-01 06:20:00,7,9,3,20,0,0,39
2024-03-01 06:30:00,6,8,8,18,0,1,41
2024-03-01 06:40:00,7,9,5,17,0,0,38
2024-03-01 06:50:00,5,7,7,17,0,1,37
2024-03-01 07:00:00,10,6,5,13,0,3,37
2024-03-01 07:10:00,12,9,12,17,0,3,53
2024-03-01 07:20:00,10,13,9,14,0,3,49
2024-03-01 07:30:00,16,16,17,11,3,6,69
2024-03-01 07:40:00,18,23,13,13,0,4,71
2024-03-01 07:50:00,13,20,7,11,0,1,52
2024-03-01 08:00:00,11,15,13,12,0,1,52
2024-03-01 08:10:00,16,19,6,17,0,1,59
2024-03-01 08:20:00,17,19,16,15,0,3,70
2024-03-01 08:30:00,8,13,10,17,0,2,50
2024-03-01 08:40:00,10,16,6,22,1,2,57
2024-03-01 08:50:00,11,10,10,9,0,3,43
2024-03-01 09:00:00,11,13,9,12,0,3,48
2024-03-01 09:10:00,13,16,7,26,0,2,64
2024-03-01 09:20:00,14,19,10,19,1,2,65
2024-03-01 09:30:00,16,10,11,29,1,4,71
2024-03-01 09:40:00,7,20,13,10,0,1,51
2024-03-01 09:50:00,16,12,16,11,0,5,60
2024-03-01 10:00:00,15,11,9,18,0,0,53
2024-03-01 10:10:00,18,17,12,24,0,1,72
2024-03-01 10:20:00,15,9,16,5,0,7,52
2024-03-01 10:30:00,12,16,9,0,0,2,39
2024-03-01 10:40:00,6,16,9,14,3,1,49
2024-03-01 10:50:00,10,14,14,11,0,3,52
2024-03-01 11:00:00,14,13,16,18,4,2,67
2024-03-01 11:10:00,8,8,15,16,0,2,49
2024-03-01 11:20:00,14,11,12,21,1,1,60
2024-03-01 11:30:00,13,7,11,20,1,4,56
2024-03-01 11:40:00,5,20,17,8,0,2,52
2024-03-01 11:50:00,31,10,12,5,0,2,60
2024-03-01 12:00:00,13,16,12,7,1,3,52
2024-03-01 12:10:00,16,19,14,6,0,1,56
2024-03-01 12:20:00,8,17,13,8,0,3,49
2024-03-01 12:30:00,14,13,20,5,6,4,62
2024-03-01 12:40:00,16,18,15,5,0,5,59
2024-03-01 12:50:00,11,13,13,1,0,8,46
2024-03-01 13:00:00,10,13,14,12,1,3,53
2024-03-01 13:10:00,0,8,1,9,7,3,28
2024-03-01 13:20:00,10,19,11,15,1,8,64
2024-03-01 13:30:00,9,6,10,18,2,6,51
2024-03-01 13:40:00,16,11,9,12,0,5,53
2024-03-01 13:50:00,14,14,14,6,1,2,51
2024-03-01 14:00:00,12,11,16,19,0,3,61
2024-03-01 14:10:00,11,16,10,16,1,3,57
2024-03-01 14:20:00,15,11,11,18,1,4,60
2024-03-01 14:30:00,9,11,10,19,0,1,50
2024-03-01 14:40:00,14,15,12,8,2,2,53
2024-03-01 14:50:00,15,15,8,22,3,7,70
2024-03-01 15:00:00,19,15,11,22,0,3,70
2024-03-01 15:10:00,14,12,9,18,0,3,56
2024-03-01 15:20:00,9,13,7,16,1,3,49
2024-03-01 15:30:00,7,7,10,25,0,1,50
2024-03-01 15:40:00,12,10,11,24,2,2,61
2024-03-01 15:50:00,14,13,11,19,0,1,58
2024-03-01 16:00:00,7,7,4,11,1,2,32
2024-03-01 16:10:00,8,18,5,20,1,6,58
2024-03-01 16:20:00,10,14,11,30,0,2,67
2024-03-01 16:30:00,9,9,14,16,1,3,52
2024-03-01 16:40:00,12,13,10,15,3,6,59
2024-03-01 16:50:00,10,8,12,27,1,4,62
2024-03-01 17:00:00,13,16,12,22,0,3,66
2024-03-01 17:10:00,15,15,13,18,1,3,65
2024-03-01 17:20:00,12,14,6,12,0,3,47
2024-03-01 17:30:00,11,13,8,24,2,2,60
2024-03-01 17:40:00,9,10,7,16,0,5,47
2024-03-01 17:50:00,11,21,6,20,0,1,59
2024-03-01 18:00:00,17,11,10,20,0,8,66
2024-03-01 18:10:00,17,11,10,19,1,0,58
2024-03-01 18:20:00,18,21,10,22,0,6,77
2024-03-01 18:30:00,12,8,7,15,2,1,45
2024-03-01 18:40:00,11,9,13,20,0,5,58
2024-03-01 18:50:00,14,15,8,18,0,2,57
2024-03-01 19:00:00,14,10,9,24,0,3,60
2024-03-01 19:10:00,8,7,11,22,0,4,52
2024-03-01 19:20:00,7,11,5,18,0,1,42
2024-03-01 19:30:00,9,4,10,19,0,4,46
2024-03-01 19:40:00,10,8,8,25,0,1,52
2024-03-01 19:50:00,9,4,8,20,0,4,45
2024-03-01 20:00:00,12,10,5,23,0,2,52
2024-03-01 20:10:00,7,12,9,19,0,1,48
2024-03-01 20:20:00,6,6,6,23,1,0,42
2024-03-01 20:30:00,7,11,6,15,1,0,40
2024-03-01 20:40:00,6,6,6,17,0,0,35
2024-03-01 20:50:00,6,7,9,15,0,1,38
2024-03-01 21:00:00,7,7,8,19,0,1,42
2024-03-01 21:10:00,2,5,4,14,0,1,26
2024-03-01 21:20:00,2,7,5,17,0,2,33
2024-03-01 21:30:00,5,6,5,18,0,0,34
2024-03-01 21:40:00,8,4,3,25,0,0,40
2024-03-01 21:50:00,1,6,5,15,0,1,28
2024-03-01 22:00:00,6,6,7,18,0,0,37
2024-03-01 22:10:00,5,12,5,21,0,0,43
2024-03-01 22:20:00,2,6,5,19,0,1,33
2024-03-01 22:30:00,5,5,5,20,0,1,36
2024-03-01 22:40:00,3,3,6,12,0,1,25
2024-03-01 22:50:00,3,32,5,14,0,0,54
2024-03-01 23:00:00,5,2,5,17,0,0,29
2024-03-01 23:10:00,5,5,4,19,0,0,33
2024-03-01 23:20:00,7,6,7,20,0,1,41
2024-03-01 23:30:00,5,4,5,10,0,0,24
2024-03-01 23:40:00,3,3,8,17,0,0,31
2024-03-01 23:50:00,5,3,3,13,0,0,24
2024-03-02 00:00:00,6,1,2,10,0,0,19
2024-03-02 00:10:00,3,9,3,17,0,0,32
2024-03-02 00:20:00,2,0,4,14,0,0,20
2024-03-02 00:30:00,1,0,1,12,0,0,14
2024-03-02 00:40:00,0,2,3,16,0,0,21
2024-03-02 00:50:00,0,2,1,6,0,0,9
2024-03-02 01:00:00,0,1,3,9,0,0,13
2024-03-02 01:10:00,3,3,4,7,0,0,17
2024-03-02 01:20:00,0,2,2,8,0,0,12
2024-03-02 01:30:00,1,1,4,8,0,0,14
2024-03-02 01:40:00,0,1,1,12,0,0,14
2024-03-02 01:50:00,0,1,0,5,0,0,6
2024-03-02 02:00:00,1,3,3,4,0,0,11
2024-03-02 02:10:00,2,1,1,8,0,0,12
2024-03-02 02:20:00,2,0,0,6,0,0,8
2024-03-02 02:30:00,2,1,2,5,0,0,10
2024-03-02 02:40:00,0,1,2,6,0,0,9
2024-03-02 02:50:00,1,2,0,3,0,0,6
2024-03-02 03:00:00,3,0,2,5,0,0,10
2024-03-02 03:10:00,2,2,1,8,0,0,13
2024-03-02 03:20:00,1,2,1,2,0,0,6
2024-03-02 03:30:00,0,0,2,8,0,0,10
2024-03-02 03:40:00,0,2,1,6,0,0,9
2024-03-02 03:50:00,0,1,0,5,0,0,6
2024-03-02 04:00:00,0,0,1,1,0,0,2
2024-03-02 04:10:00,0,7,1,5,0,0,13
2024-03-02 04:20:00,1,1,1,5,0,0,8
2024-03-02 04:30:00,0,1,2,2,0,0,5
2024-03-02 04:40:00,3,1,0,8,0,0,12
2024-03-02 04:50:00,1,2,2,5,0,0,10
2024-03-02 05:00:00,0,2,1,6,0,0,9
2024-03-02 05:10:00,2,3,1,15,0,0,21
2024-03-02 05:20:00,1,5,3,13,0,0,22
2024-03-02 05:30:00,0,4,1,16,0,0,21
2024-03-02 05:40:00,3,6,0,15,0,0,24
2024-03-02 05:50:00,0,11,4,7,0,0,22
2024-03-02 06:00:00,2,5,1,10,0,0,18
2024-03-02 06:10:00,2,5,1,6,0,0,14
2024-03-02 06:20:00,1,4,1,11,0,1,18
2024-03-02 06:30:00,2,6,2,13,0,0,23
2024-03-02 06:40:00,2,3,2,14,0,0,21
2024-03-02 06:50:00,3,5,0,11,0,2,21
2024-03-02 07:00:00,1,8,1,14,0,0,24
2024-03-02 07:10:00,10,4,3,8,0,0,25
2024-03-02 07:20:00,2,4,2,11,0,1,20
2024-03-02 07:30:00,3,4,1,12,0,0,20
2024-03-02 07:40:00,2,5,2,18,0,0,27
2024-03-02 07:50:00,7,7,3,20,0,1,38
2024-03-02 08:00:00,5,3,4,14,0,0,26
2024-03-02 08:10:00,5,5,6,12,0,0,28
2024-03-02 08:20:00,6,4,3,17,0,0,30
2024-03-02 08:30:00,4,4,4,19,0,0,31
2024-03-02 08:40:00,6,9,0,17,0,1,33
2024-03-02 08:50:00,7,9,4,27,0,0,47
2024-03-02 09:00:00,7,2,6,19,0,2,36
2024-03-02 09:10:00,8,9,4,21,1,5,48
2024-03-02 09:20:00,6,8,5,21,0,2,42
2024-03-02 09:30:00,9,20,6,27,1,0,63
2024-03-02 09:40:00,8,9,8,19,0,1,45
2024-03-02 09:50:00,9,6,6,15,0,2,38
2024-03-02 10:00:00,12,4,7,18,0,0,41
2024-03-02 10:10:00,10,15,8,20,1,3,57
2024-03-02 10:20:00,12,6,7,25,0,1,51
2024-03-02 10:30:00,10,9,9,24,0,1,53
2024-03-02 10:40:00,11,14,7,28,0,2,62
2024-03-02 10:50:00,11,8,8,21,0,2,50
2024-03-02 11:00:00,13,9,10,18,0,0,50
2024-03-02 11:10:00,14,12,9,32,0,1,68
2024-03-02 11:20:00,9,11,10,20,2,0,52
2024-03-02 11:30:00,12,8,6,26,0,2,54
2024-03-02 11:40:00,10,18,6,25,1,3,63
2024-03-02 11:50:00,17,13,6,22,0,2,60
2024-03-02 12:00:00,8,18,10,27,1,0,64
2024-03-02 12:10:00,13,18,6,26,2,4,69
2024-03-02 12:20:00,13,18,9,11,0,2,53
2024-03-02 12:30:00,6,11,16,26,4,2,65
2024-03-02 12:40:00,15,11,9,21,0,3,59
2024-03-02 12:50:00,12,15,12,21,0,2,62
2024-03-02 13:00:00,14,23,7,24,0,3,71
2024-03-02 13:10:00,9,14,6,30,1,1,61
2024-03-02 13:20:00,8,14,6,22,1,1,52
2024-03-02 13:30:00,10,8,6,31,1,2,58
2024-03-02 13:40:00,10,15,6,18,2,4,55
2024-03-02 13:50:00,11,14,6,29,0,3,63
2024-03-02 14:00:00,11,10,11,22,0,5,59
2024-03-02 14:10:00,12,9,12,17,1,3,54
2024-03-02 14:20:00,6,17,6,29,0,3,61
2024-03-02 14:30:00,13,9,9,18,0,3,52
2024-03-02 14:40:00,14,11,3,17,0,1,46
2024-03-02 14:50:00,9,7,8,16,0,0,40
2024-03-02 15:00:00,11,10,8,14,0,1,44
2024-03-02 15:10:00,5,14,9,16,0,1,45
2024-03-02 15:20:00,8,12,8,16,0,1,45
2024-03-02 15:30:00,10,10,7,18,0,1,46
2024-03-02 15:40:00,10,8,9,19,1,1,48
2024-03-02 15:50:00,5,12,6,20,1,10,54
2024-03-02 16:00:00,8,18,3,14,0,0,43
2024-03-02 16:10:00,7,18,10,32,0,5,72
2024-03-02 16:20:00,9,13,9,27,1,2,61
2024-03-02 16:30:00,3,10,9,22,1,1,46
2024-03-02 16:40:00,7,5,9,20,1,2,44
2024-03-02 16:50:00,9,11,7,25,0,2,54
2024-03-02 17:00:00,6,7,6,19,0,1,39
2024-03-02 17:10:00,10,13,7,24,0,2,56
2024-03-02 17:20:00,13,8,6,21,0,3,51
2024-03-02 17:30:00,7,8,11,13,0,3,42
2024-03-02 17:40:00,9,15,11,23,0,2,60
2024-03-02 17:50:00,10,9,12,19,1,2,53
2024-03-02 18:00:00,17,10,9,20,1,1,58
2024-03-02 18:10:00,10,6,13,21,0,2,52
2024-03-02 18:20:00,4,9,12,22,0,1,48
2024-03-02 18:30:00,10,9,11,33,0,1,64
2024-03-02 18:40:00,14,6,14,19,1,1,55
2024-03-02 18:50:00,13,5,9,23,1,4,55
2024-03-02 19:00:00,9,13,8,25,1,2,58
2024-03-02 19:10:00,3,10,8,24,0,3,48
2024-03-02 19:20:00,6,9,6,21,0,2,44
2024-03-02 19:30:00,9,9,7,21,1,1,48
2024-03-02 19:40:00,6,5,8,23,0,3,45
2024-03-02 19:50:00,7,7,10,24,0,1,49
2024-03-02 20:00:00,10,8,8,14,0,1,41
2024-03-02 20:10:00,14,9,6,22,0,1,52
2024-03-02 20:20:00,6,9,2,22,0,1,40
2024-03-02 20:30:00,7,3,6,18,0,1,35
2024-03-02 20:40:00,5,7,10,26,0,2,50
2024-03-02 20:50:00,4,8,5,25,0,0,42
2024-03-02 21:00:00,6,4,8,21,0,0,39
2024-03-02 21:10:00,2,3,10,11,0,1,27
2024-03-02 21:20:00,6,5,6,18,0,0,35
2024-03-02 21:30:00,4,3,8,18,0,1,34
2024-03-02 21:40:00,5,4,8,14,0,0,31
2024-03-02 21:50:00,5,3,4,16,0,0,28
2024-03-02 22:00:00,4,0,5,13,1,0,23
2024-03-02 22:10:00,4,8,6,18,0,0,36
2024-03-02 22:20:00,3,3,4,20,1,0,31
2024-03-02 22:30:00,1,1,4,20,0,0,26
2024-03-02 22:40:00,5,2,5,20,0,1,33
2024-03-02 22:50:00,6,15,2,16,0,2,41
2024-03-02 23:00:00,4,8,3,19,0,2,36
2024-03-02 23:10:00,2,4,3,17,0,0,26
2024-03-02 23:20:00,2,7,9,12,1,0,31
2024-03-02 23:30:00,1,6,5,17,0,1,30
2024-03-02 23:40:00,5,3,0,14,0,0,22
2024-03-02 23:50:00,0,7,3,10,0,1,21
2024-03-03 00:00:00,3,4,2,7,0,0,16
2024-03-03 00:10:00,3,7,5,10,0,0,25
2024-03-03 00:20:00,3,0,4,15,0,0,22
2024-03-03 00:30:00,1,2,6,14,0,0,23
2024-03-03 00:40:00,3,4,3,20,0,0,30
2024-03-03 00:50:00,3,5,4,11,0,0,23
2024-03-03 01:00:00,2,0,1,12,0,0,15
2024-03-03 01:10:00,1,2,5,12,0,0,20
2024-03-03 01:20:00,3,1,0,12,0,0,16
2024-03-03 01:30:00,2,0,4,10,0,0,16
2024-03-03 01:40:00,3,1,1,13,0,0,18
2024-03-03 01:50:00,1,0,2,7,0,0,10
2024-03-03 02:00:00,1,6,1,6,0,0,14
2024-03-03 02:10:00,1,1,1,8,0,0,11
2024-03-03 02:20:00,2,1,1,7,0,0,11
2024-03-03 02:30:00,1,0,2,7,0,0,10
2024-03-03 02:40:00,0,1,3,11,0,0,15
2024-03-03 02:50:00,0,2,1,5,0,0,8
2024-03-03 03:00:00,1,0,1,7,0,0,9
2024-03-03 03:10:00,0,4,1,6,0,0,11
2024-03-03 03:20:00,1,0,1,7,0,0,9
2024-03-03 03:30:00,2,0,4,9,0,0,15
2024-03-03 03:40:00,2,3,3,5,0,0,13
2024-03-03 03:50:00,0,2,1,3,0,0,6
2024-03-03 04:00:00,2,0,0,2,0,0,4
2024-03-03 04:10:00,0,2,2,4,0,0,8
2024-03-03 04:20:00,0,1,0,3,0,0,4
2024-03-03 04:30:00,1,0,3,4,0,0,8
2024-03-03 04:40:00,0,2,0,7,0,0,9
2024-03-03 04:50:00,1,0,0,9,0,0,10
2024-03-03 05:00:00,3,1,3,5,0,0,12
2024-03-03 05:10:00,0,2,3,7,0,0,12
2024-03-03 05:20:00,0,2,1,11,0,0,14
2024-03-03 05:30:00,0,1,4,17,0,0,22
2024-03-03 05:40:00,5,1,2,14,0,0,22
2024-03-03 05:50:00,2,1,3,14,0,0,20
2024-03-03 06:00:00,1,1,0,8,0,0,10
2024-03-03 06:10:00,5,8,5,10,0,1,29
2024-03-03 06:20:00,0,4,3,6,0,0,13
2024-03-03 06:30:00,1,1,1,10,0,0,13
2024-03-03 06:40:00,1,4,3,8,0,0,16
2024-03-03 06:50:00,0,2,3,6,0,1,12
2024-03-03 07:00:00,2,0,2,8,0,0,12
2024-03-03 07:10:00,3,8,3,10,0,0,24
2024-03-03 07:20:00,1,1,0,8,0,3,13
2024-03-03 07:30:00,0,3,1,8,0,0,12
2024-03-03 07:40:00,4,2,2,16,0,1,25
2024-03-03 07:50:00,0,3,5,6,0,1,15
2024-03-03 08:00:00,3,2,1,6,0,0,12
2024-03-03 08:10:00,1,4,3,15,0,1,24
2024-03-03 08:20:00,0,1,3,6,0,0,10
2024-03-03 08:30:00,3,3,2,14,1,0,23
2024-03-03 08:40:00,6,3,6,18,0,0,33
2024-03-03 08:50:00,4,2,4,20,0,2,32
2024-03-03 09:00:00,7,6,2,15,0,0,30
2024-03-03 09:10:00,10,1,1,17,1,1,31
2024-03-03 09:20:00,7,6,3,14,0,0,30
2024-03-03 09:30:00,5,1,2,18,0,0,26
2024-03-03 09:40:00,17,6,1,20,0,0,44
2024-03-03 09:50:00,4,8,3,21,1,4,41
2024-03-03 10:00:00,10,2,1,21,0,0,34
2024-03-03 10:10:00,5,5,7,13,2,1,33
2024-03-03 10:20:00,10,4,1,22,1,0,38
2024-03-03 10:30:00,9,8,10,13,0,0,40
2024-03-03 10:40:00,4,5,8,22,0,0,39
2024-03-03 10:50:00,7,14,4,19,0,3,47
2024-03-03 11:00:00,7,9,5,23,0,2,46
2024-03-03 11:10:00,10,9,2,19,0,1,41
2024-03-03 11:20:00,10,4,5,26,0,2,47
2024-03-03 11:30:00,11,8,8,20,0,0,47
2024-03-03 11:40:00,5,14,8,23,0,0,50
2024-03-03 11:50:00,8,11,8,22,0,0,49
2024-03-03 12:00:00,6,10,5,26,1,1,49
2024-03-03 12:10:00,9,10,6,26,0,2,53
2024-03-03 12:20:00,12,8,5,28,3,0,56
2024-03-03 12:30:00,6,10,4,25,1,1,47
2024-03-03 12:40:00,6,17,2,26,0,1,52
2024-03-03 12:50:00,9,13,5,35,0,2,64
2024-03-03 13:00:00,8,13,3,45,0,3,72
2024-03-03 13:10:00,15,18,7,36,0,1,77
2024-03-03 13:20:00,11,12,2,34,0,0,59
2024-03-03 13:30:00,8,17,8,29,1,2,65
2024-03-03 13:40:00,10,11,9,19,0,0,49
2024-03-03 13:50:00,5,8,7,26,0,1,47
2024-03-03 14:00:00,10,3,7,19,0,2,41
2024-03-03 14:10:00,8,9,7,22,0,4,50
2024-03-03 14:20:00,12,14,7,27,1,1,62
2024-03-03 14:30:00,10,12,5,17,0,2,46
2024-03-03 14:40:00,6,6,7,25,0,1,45
2024-03-03 14:50:00,12,10,8,24,1,0,55
2024-03-03 15:00:00,3,15,7,26,0,1,52
2024-03-03 15:10:00,10,11,10,19,2,3,55
2024-03-03 15:20:00,8,10,12,26,1,2,59
2024-03-03 15:30:00,9,14,8,21,0,3,55
2024-03-03 15:40:00,6,8,5,24,0,1,44
2024-03-03 15:50:00,11,13,8,18,3,1,54
2024-03-03 16:00:00,5,14,9,21,0,1,50
2024-03-03 16:10:00,11,9,14,18,3,1,56
2024-03-03 16:20:00,7,16,9,25,0,2,59
2024-03-03 16:30:00,3,7,8,21,2,2,43
2024-03-03 16:40:00,9,12,6,22,0,0,49
2024-03-03 16:50:00,5,5,10,23,0,0,43
2024-03-03 17:00:00,5,10,5,18,2,1,41
2024-03-03 17:10:00,9,12,6,16,1,2,46
2024-03-03 17:20:00,7,11,13,22,0,0,53
2024-03-03 17:30:00,19,21,9,19,0,0,68
2024-03-03 17:40:00,11,13,7,22,0,0,53
2024-03-03 17:50:00,8,11,2,23,0,0,44
2024-03-03 18:00:00,6,9,7,28,0,1,51
2024-03-03 18:10:00,16,7,11,22,0,0,56
2024-03-03 18:20:00,8,11,11,14,1,0,45
2024-03-03 18:30:00,7,5,7,19,0,0,38
2024-03-03 18:40:00,6,9,10,19,0,3,47
2024-03-03 18:50:00,10,7,10,19,0,2,48
2024-03-03 19:00:00,5,8,5,17,1,1,37
2024-03-03 19:10:00,4,5,12,20,0,0,41
2024-03-03 19:20:00,9,8,6,19,0,1,43
2024-03-03 19:30:00,7,4,3,30,0,0,44
2024-03-03 19:40:00,8,5,7,18,0,0,38
2024-03-03 19:50:00,3,8,13,22,0,1,47
2024-03-03 20:00:00,9,4,9,18,0,1,41
2024-03-03 20:10:00,9,9,7,19,0,0,44
2024-03-03 20:20:00,7,5,3,26,0,0,41
2024-03-03 20:30:00,4,4,6,19,0,0,33
2024-03-03 20:40:00,3,7,4,21,0,0,35
2024-03-03 20:50:00,4,4,3,10,0,0,21
2024-03-03 21:00:00,3,7,1,12,0,1,24
2024-03-03 21:10:00,5,7,2,20,0,2,36
2024-03-03 21:20:00,1,3,5,15,0,0,24
2024-03-03 21:30:00,5,2,3,13,0,0,23
2024-03-03 21:40:00,4,6,4,13,0,0,27
2024-03-03 21:50:00,2,4,1,15,0,0,22
2024-03-03 22:00:00,3,4,4,12,0,0,23
2024-03-03 22:10:00,4,5,9,10,0,0,28
2024-03-03 22:20:00,2,3,6,14,0,0,25
2024-03-03 22:30:00,2,4,5,14,0,1,26
2024-03-03 22:40:00,2,1,4,13,0,0,20
2024-03-03 22:50:00,2,4,2,9,0,0,17
2024-03-03 23:00:00,2,4,5,6,0,0,17
2024-03-03 23:10:00,5,5,5,10,0,0,25
2024-03-03 23:20:00,0,3,1,11,0,0,15
2024-03-03 23:30:00,2,0,1,7,0,0,10
2024-03-03 23:40:00,3,2,4,8,0,0,17
2024-03-03 23:50:00,0,1,2,7,0,0,10
2024-03-04 00:00:00,0,2,2,6,0,0,10
2024-03-04 00:10:00,2,5,4,5,0,0,16
2024-03-04 00:20:00,0,1,0,7,0,0,8
2024-03-04 00:30:00,1,0,2,6,0,0,9
2024-03-04 00:40:00,0,1,0,8,0,0,9
2024-03-04 00:50:00,0,3,1,4,0,0,8
2024-03-04 01:00:00,0,2,0,5,0,0,7
2024-03-04 01:10:00,2,1,0,5,0,0,8
2024-03-04 01:20:00,2,1,0,7,0,0,10
2024-03-04 01:30:00,0,0,1,3,0,0,4
2024-03-04 01:40:00,0,1,1,5,0,0,7
2024-03-04 01:50:00,0,0,1,4,0,0,5
2024-03-04 02:00:00,0,0,1,3,0,0,4
2024-03-04 02:10:00,0,0,1,3,0,0,4
2024-03-04 02:20:00,0,0,0,3,0,0,3
2024-03-04 02:30:00,0,0,0,0,0,0,0
2024-03-04 02:40:00,0,0,0,3,0,0,3
2024-03-04 02:50:00,0,0,3,2,0,0,5
2024-03-04 03:00:00,0,0,0,1,0,0,1
2024-03-04 03:10:00,0,0,0,4,0,0,4
2024-03-04 03:20:00,0,1,3,3,0,0,7
2024-03-04 03:30:00,1,0,2,5,0,0,8
2024-03-04 03:40:00,0,0,1,3,0,0,4
2024-03-04 03:50:00,1,0,0,3,0,0,4
2024-03-04 04:00:00,0,0,1,7,0,0,8
2024-03-04 04:10:00,0,1,1,6,0,0,8
2024-03-04 04:20:00,4,1,0,5,0,0,10
2024-03-04 04:30:00,0,0,0,2,0,0,2
2024-03-04 04:40:00,0,3,2,4,0,0,9
2024-03-04 04:50:00,0,1,5,5,0,0,11
2024-03-04 05:00:00,0,5,4,7,0,0,16
2024-03-04 05:10:00,4,6,3,11,0,0,24
2024-03-04 05:20:00,3,2,0,11,0,0,16
2024-03-04 05:30:00,1,6,5,15,0,1,28
2024-03-04 05:40:00,3,14,10,18,0,0,45
2024-03-04 05:50:00,7,7,6,22,0,1,43
2024-03-04 06:00:00,9,3,3,15,0,0,30
2024-03-04 06:10:00,7,6,5,21,0,0,39
2024-03-04 06:20:00,2,13,6,20,0,2,43
2024-03-04 06:30:00,3,5,3,17,0,1,29
2024-03-04 06:40:00,5,6,5,17,0,2,35
2024-03-04 06:50:00,5,11,6,13,0,1,36
2024-03-04 07:00:00,12,15,6,9,0,1,43
2024-03-04 07:10:00,9,23,11,22,0,0,65
2024-03-04 07:20:00,10,15,17,13,1,1,57
2024-03-04 07:30:00,14,24,18,16,3,2,77
2024-03-04 07:40:00,7,33,12,11,2,3,68
2024-03-04 07:50:00,13,20,9,3,1,3,49
2024-03-04 08:00:00,12,18,6,21,0,2,59
2024-03-04 08:10:00,7,17,9,20,1,5,59
2024-03-04 08:20:00,5,18,8,19,1,6,57
2024-03-04 08:30:00,10,11,8,12,0,5,46
2024-03-04 08:40:00,9,25,11,20,0,1,66
2024-03-04 08:50:00,13,22,10,12,0,2,59
2024-03-04 09:00:00,13,15,11,6,0,1,46
2024-03-04 09:10:00,3,16,11,19,1,2,52
2024-03-04 09:20:00,6,11,11,14,2,1,45
2024-03-04 09:30:00,8,27,17,12,0,6,70
2024-03-04 09:40:00,7,24,11,14,1,3,60
2024-03-04 09:50:00,5,15,9,10,2,1,42
2024-03-04 10:00:00,1,16,12,24,1,2,56
2024-03-04 10:10:00,7,16,6,25,1,0,55
2024-03-04 10:20:00,6,16,12,18,0,1,53
2024-03-04 10:30:00,7,6,15,14,1,0,43
2024-03-04 10:40:00,8,14,12,9,0,3,46
2024-03-04 10:50:00,9,12,13,14,0,5,53
2024-03-04 11:00:00,8,33,21,22,2,2,88
2024-03-04 11:10:00,8,6,10,20,0,3,47
2024-03-04 11:20:00,6,13,10,17,0,3,49
2024-03-04 11:30:00,7,22,14,20,0,0,63
2024-03-04 11:40:00,8,7,11,9,2,1,38
2024-03-04 11:50:00,7,16,11,23,0,1,58
2024-03-04 12:00:00,8,14,14,16,1,2,55
2024-03-04 12:10:00,3,9,14,16,0,7,49
2024-03-04 12:20:00,8,21,9,24,1,2,65
2024-03-04 12:30:00,8,12,14,20,0,3,57
2024-03-04 12:40:00,7,10,18,18,0,2,55
2024-03-04 12:50:00,5,13,16,19,2,2,57
2024-03-04 13:00:00,13,12,12,13,0,1,51
2024-03-04 13:10:00,23,13,12,12,3,5,68
2024-03-04 13:20:00,11,17,15,19,0,5,67
2024-03-04 13:30:00,14,9,13,17,0,7,60
2024-03-04 13:40:00,14,12,16,22,2,5,71
2024-03-04 13:50:00,11,10,11,20,0,6,58
2024-03-04 14:00:00,8,11,10,10,0,3,42
2024-03-04 14:10:00,10,14,12,27,1,2,66
2024-03-04 14:20:00,14,16,12,22,0,3,67
2024-03-04 14:30:00,15,10,16,12,0,2,55
2024-03-04 14:40:00,11,16,12,7,0,5,51
2024-03-04 14:50:00,8,13,15,19,1,3,59
2024-03-04 15:00:00,10,11,16,21,0,3,61
2024-03-04 15:10:00,9,16,16,21,2,8,72
2024-03-04 15:20:00,10,14,11,19,0,5,59
2024-03-04 15:30:00,3,19,12,18,3,4,59
2024-03-04 15:40:00,7,13,10,17,0,4,51
2024-03-04 15:50:00,9,13,10,19,0,2,53
2024-03-04 16:00:00,16,17,14,13,0,10,70
2024-03-04 16:10:00,7,18,10,17,3,6,61
2024-03-04 16:20:00,7,22,16,14,0,3,62
2024-03-04 16:30:00,9,19,12,25,1,3,69
2024-03-04 16:40:00,16,20,21,9,0,1,67
2024-03-04 16:50:00,10,20,9,22,2,3,66
2024-03-04 17:00:00,14,9,16,14,1,3,57
2024-03-04 17:10:00,14,17,13,16,2,1,63
2024-03-04 17:20:00,11,12,15,14,0,5,57
2024-03-04 17:30:00,12,10,13,20,0,2,57
2024-03-04 17:40:00,11,17,11,18,0,2,59
2024-03-04 17:50:00,17,19,12,18,0,4,70
2024-03-04 18:00:00,11,22,12,15,1,2,63
2024-03-04 18:10:00,8,6,14,18,1,1,48
2024-03-04 18:20:00,12,11,13,17,0,3,56
2024-03-04 18:30:00,12,12,16,18,1,1,60
2024-03-04 18:40:00,12,7,7,15,0,0,41
2024-03-04 18:50:00,8,11,6,27,0,1,53
2024-03-04 19:00:00,13,11,7,18,0,1,50
2024-03-04 19:10:00,8,7,12,19,0,1,47
2024-03-04 19:20:00,6,8,8,30,0,3,55
2024-03-04 19:30:00,9,9,5,19,0,0,42
2024-03-04 19:40:00,8,5,6,21,0,0,40
2024-03-04 19:50:00,8,8,8,20,0,3,47
2024-03-04 20:00:00,8,4,9,23,0,2,46
2024-03-04 20:10:00,3,6,6,20,0,2,37
2024-03-04 20:20:00,4,5,8,21,0,0,38
2024-03-04 20:30:00,10,6,6,19,0,1,42
2024-03-04 20:40:00,8,9,9,18,0,1,45
2024-03-04 20:50:00,6,9,7,20,0,0,42
2024-03-04 21:00:00,4,8,7,18,0,0,37
2024-03-04 21:10:00,9,5,6,17,0,0,37
2024-03-04 21:20:00,5,9,3,22,0,2,41
2024-03-04 21:30:00,4,6,9,21,0,1,41
2024-03-04 21:40:00,7,1,6,22,0,0,36
2024-03-04 21:50:00,1,4,5,12,0,0,22
2024-03-04 22:00:00,6,8,2,15,0,1,32
2024-03-04 22:10:00,5,5,5,16,0,1,32
2024-03-04 22:20:00,2,2,8,13,0,0,25
2024-03-04 22:30:00,3,1,4,12,1,1,22
2024-03-04 22:40:00,8,4,4,13,0,0,29
2024-03-04 22:50:00,3,3,8,7,0,0,21
2024-03-04 23:00:00,2,2,4,10,0,0,18
2024-03-04 23:10:00,9,4,4,18,0,0,35
2024-03-04 23:20:00,0,3,1,5,0,0,9
2024-03-04 23:30:00,0,1,1,6,0,0,8
2024-03-04 23:40:00,3,3,3,14,0,0,23
2024-03-04 23:50:00,2,1,0,7,0,0,10
2024-03-05 00:00:00,1,10,3,11,0,0,25
2024-03-05 00:10:00,11,3,3,10,0,0,27
2024-03-05 00:20:00,1,2,3,6,0,0,12
2024-03-05 00:30:00,0,1,2,4,0,0,7
2024-03-05 00:40:00,1,1,2,9,0,0,13
2024-03-05 00:50:00,0,2,0,2,0,0,4
2024-03-05 01:00:00,0,0,0,7,0,0,7
2024-03-05 01:10:00,1,1,2,5,0,0,9
2024-03-05 01:20:00,2,0,0,6,0,0,8
2024-03-05 01:30:00,0,0,2,5,0,0,7
2024-03-05 01:40:00,0,1,0,1,0,0,2
2024-03-05 01:50:00,0,2,2,2,0,0,6
2024-03-05 02:00:00,0,0,3,3,0,1,7
2024-03-05 02:10:00,2,0,0,4,0,0,6
2024-03-05 02:20:00,0,0,1,1,0,0,2
2024-03-05 02:30:00,0,0,1,2,0,0,3
2024-03-05 02:40:00,1,0,0,6,0,0,7
2024-03-05 02:50:00,1,0,1,6,0,0,8
2024-03-05 03:00:00,0,0,3,2,0,0,5
2024-03-05 03:10:00,0,0,1,1,0,0,2
2024-03-05 03:20:00,0,0,0,5,0,0,5
2024-03-05 03:30:00,0,1,0,1,0,0,2
2024-03-05 03:40:00,0,0,0,3,0,0,3
2024-03-05 03:50:00,0,0,0,2,0,0,2
2024-03-05 04:00:00,0,0,0,5,0,0,5
2024-03-05 04:10:00,1,2,2,4,0,0,9
2024-03-05 04:20:00,2,1,0,3,0,0,6
2024-03-05 04:30:00,0,0,1,7,0,0,8
2024-03-05 04:40:00,2,1,1,2,0,0,6
2024-03-05 04:50:00,1,3,1,3,0,0,8
2024-03-05 05:00:00,1,4,1,10,0,0,16
2024-03-05 05:10:00,2,6,2,10,0,0,20
2024-03-05 05:20:00,2,3,2,10,0,0,17
2024-03-05 05:30:00,3,8,4,25,0,0,40
2024-03-05 05:40:00,6,7,4,17,0,0,34
2024-03-05 05:50:00,3,7,4,17,0,0,31
2024-03-05 06:00:00,4,7,4,14,1,0,30
2024-03-05 06:10:00,7,6,3,15,0,2,33
2024-03-05 06:20:00,5,7,2,20,1,0,35
2024-03-05 06:30:00,3,5,6,22,0,1,37
2024-03-05 06:40:00,1,21,7,18,1,0,48
2024-03-05 06:50:00,3,5,6,16,0,0,30
2024-03-05 07:00:00,28,10,12,12,1,0,63
2024-03-05 07:10:00,16,19,9,16,0,2,62
2024-03-05 07:20:00,16,12,8,10,0,2,48
2024-03-05 07:30:00,23,16,13,14,0,1,67
2024-03-05 07:40:00,12,47,9,11,3,3,85
2024-03-05 07:50:00,10,26,10,16,0,4,66
2024-03-05 08:00:00,13,24,14,13,1,4,69
2024-03-05 08:10:00,14,26,13,12,0,1,66
2024-03-05 08:20:00,11,22,6,20,0,4,63
2024-03-05 08:30:00,14,21,11,12,0,1,59
2024-03-05 08:40:00,10,15,12,3,1,2,43
2024-03-05 08:50:00,13,19,12,9,0,1,54
2024-03-05 09:00:00,9,19,11,21,0,1,61
2024-03-05 09:10:00,12,14,8,12,1,0,47
2024-03-05 09:20:00,14,18,11,21,0,2,66
2024-03-05 09:30:00,10,15,12,0,1,3,41
2024-03-05 09:40:00,9,24,10,0,2,1,46
2024-03-05 09:50:00,13,12,10,0,0,5,40
2024-03-05 10:00:00,14,12,10,11,0,1,48
2024-03-05 10:10:00,9,13,19,25,1,2,69
2024-03-05 10:20:00,8,13,15,11,2,1,50
2024-03-05 10:30:00,10,7,15,19,1,1,53
2024-03-05 10:40:00,14,13,7,0,0,5,39
2024-03-05 10:50:00,6,10,16,0,0,0,32
2024-03-05 11:00:00,11,13,18,21,0,3,66
2024-03-05 11:10:00,14,9,12,13,0,1,49
2024-03-05 11:20:00,10,13,14,26,1,1,65
2024-03-05 11:30:00,13,16,10,14,1,4,58
2024-03-05 11:40:00,10,16,14,8,0,1,49
2024-03-05 11:50:00,10,10,7,27,0,1,55
2024-03-05 12:00:00,8,10,10,13,0,3,44
2024-03-05 12:10:00,13,14,18,13,1,1,60
2024-03-05 12:20:00,13,21,11,22,0,2,69
2024-03-05 12:30:00,12,10,10,15,0,2,49
2024-03-05 12:40:00,11,13,14,18,1,1,58
2024-03-05 12:50:00,6,17,18,18,3,3,65
2024-03-05 13:00:00,12,15,16,18,1,2,64
2024-03-05 13:10:00,22,24,15,6,2,1,70
2024-03-05 13:20:00,12,20,11,16,0,3,62
2024-03-05 13:30:00,10,14,9,7,1,4,45
2024-03-05 13:40:00,19,18,12,18,0,4,71
2024-03-05 13:50:00,13,17,10,13,2,5,60
2024-03-05 14:00:00,11,15,12,21,1,4,64
2024-03-05 14:10:00,7,7,11,16,1,2,44
2024-03-05 14:20:00,11,16,14,15,0,2,58
2024-03-05 14:30:00,10,16,14,12,0,0,52
2024-03-05 14:40:00,12,18,11,11,0,3,55
2024-03-05 14:50:00,16,12,17,10,0,4,59
2024-03-05 15:00:00,17,14,9,18,0,2,60
2024-03-05 15:10:00,7,20,12,12,0,2,53
2024-03-05 15:20:00,15,17,9,21,1,1,64
2024-03-05 15:30:00,9,10,16,22,1,2,60
2024-03-05 15:40:00,14,21,7,27,2,6,77
2024-03-05 15:50:00,15,11,9,13,1,0,49
2024-03-05 16:00:00,15,13,14,23,0,13,78
2024-03-05 16:10:00,10,15,16,20,2,2,65
2024-03-05 16:20:00,12,22,9,20,0,1,64
2024-03-05 16:30:00,14,18,10,9,0,3,54
2024-03-05 16:40:00,11,17,12,9,0,2,51
2024-03-05 16:50:00,22,15,10,16,1,1,65
2024-03-05 17:00:00,9,15,8,23,1,2,58
2024-03-05 17:10:00,11,15,7,16,4,3,56
2024-03-05 17:20:00,9,15,10,24,0,3,61
2024-03-05 17:30:00,12,15,14,14,0,2,57
2024-03-05 17:40:00,14,13,10,18,0,3,58
2024-03-05 17:50:00,11,13,12,18,1,4,59
2024-03-05 18:00:00,18,16,13,17,0,1,65
2024-03-05 18:10:00,19,14,8,15,0,2,58
2024-03-05 18:20:00,12,13,15,14,0,4,58
2024-03-05 18:30:00,6,10,11,20,0,2,49
2024-03-05 18:40:00,13,8,11,19,0,2,53
2024-03-05 18:50:00,11,18,12,24,1,1,67
2024-03-05 19:00:00,10,9,10,22,1,3,55
2024-03-05 19:10:00,13,10,9,27,0,1,60
2024-03-05 19:20:00,11,10,7,20,1,1,50
2024-03-05 19:30:00,6,8,5,22,2,5,48
2024-03-05 19:40:00,11,10,7,23,0,0,51
2024-03-05 19:50:00,16,4,10,19,0,2,51
2024-03-05 20:00:00,7,11,6,20,0,2,46
2024-03-05 20:10:00,7,6,9,17,0,0,39
2024-03-05 20:20:00,10,6,6,19,1,0,42
2024-03-05 20:30:00,7,9,10,19,1,0,46
2024-03-05 20:40:00,15,6,9,24,1,1,56
2024-03-05 20:50:00,13,9,7,18,0,0,47
2024-03-05 21:00:00,11,6,6,20,0,0,43
2024-03-05 21:10:00,3,4,8,18,0,3,36
2024-03-05 21:20:00,9,7,4,15,0,0,35
2024-03-05 21:30:00,13,3,10,14,1,2,43
2024-03-05 21:40:00,3,1,4,19,0,0,27
2024-03-05 21:50:00,2,11,8,14,2,0,37
2024-03-05 22:00:00,5,4,5,12,0,3,29
2024-03-05 22:10:00,4,7,5,23,0,1,40
2024-03-05 22:20:00,4,5,3,13,0,1,26
2024-03-05 22:30:00,1,2,4,14,1,1,23
2024-03-05 22:40:00,5,4,4,14,0,1,28
2024-03-05 22:50:00,2,6,6,7,0,0,21
2024-03-05 23:00:00,5,2,5,11,0,0,23
2024-03-05 23:10:00,2,6,3,18,0,1,30
2024-03-05 23:20:00,2,5,3,11,0,0,21
2024-03-05 23:30:00,0,1,4,9,0,0,14
2024-03-05 23:40:00,3,12,3,11,0,0,29
2024-03-05 23:50:00,0,0,3,6,0,0,9
2024-03-06 00:00:00,0,4,0,7,0,0,11
2024-03-06 00:10:00,6,6,4,11,0,0,27
2024-03-06 00:20:00,2,2,1,3,7,0,15
2024-03-06 00:30:00,0,1,0,5,0,0,6
2024-03-06 00:40:00,0,1,3,15,0,0,19
2024-03-06 00:50:00,1,4,1,5,0,0,11
2024-03-06 01:00:00,0,0,4,8,0,0,12
2024-03-06 01:10:00,0,2,2,6,0,0,10
2024-03-06 01:20:00,0,0,1,3,0,0,4
2024-03-06 01:30:00,0,0,4,0,0,1,5
2024-03-06 01:40:00,0,1,1,2,0,0,4
2024-03-06 01:50:00,0,0,0,1,0,0,1
2024-03-06 02:00:00,1,0,2,1,3,0,7
2024-03-06 02:10:00,2,0,0,6,0,0,8
2024-03-06 02:20:00,0,0,0,5,0,0,5
2024-03-06 02:30:00,1,0,1,2,0,0,4
2024-03-06 02:40:00,0,0,0,0,0,0,0
2024-03-06 02:50:00,0,2,1,1,0,0,4
2024-03-06 03:00:00,0,1,0,4,0,0,5
2024-03-06 03:10:00,0,0,2,4,0,0,6
2024-03-06 03:20:00,0,0,1,4,0,0,5
2024-03-06 03:30:00,0,0,0,4,0,0,4
2024-03-06 03:40:00,1,0,2,3,0,0,6
2024-03-06 03:50:00,0,2,2,6,0,0,10
2024-03-06 04:00:00,1,2,3,3,0,0,9
2024-03-06 04:10:00,0,1,0,7,0,0,8
2024-03-06 04:20:00,3,1,0,4,0,0,8
2024-03-06 04:30:00,0,0,1,4,0,0,5
2024-03-06 04:40:00,1,1,2,3,0,0,7
2024-03-06 04:50:00,1,1,1,10,0,0,13
2024-03-06 05:00:00,0,4,0,9,0,0,13
2024-03-06 05:10:00,3,6,3,11,0,1,24
2024-03-06 05:20:00,1,4,0,16,0,0,21
2024-03-06 05:30:00,3,8,6,13,0,1,31
2024-03-06 05:40:00,1,9,6,17,0,0,33
2024-03-06 05:50:00,9,8,7,15,0,0,39
2024-03-06 06:00:00,7,4,2,19,0,0,32
2024-03-06 06:10:00,3,8,5,21,0,2,39
2024-03-06 06:20:00,2,14,10,14,0,5,45
2024-03-06 06:30:00,3,7,5,22,0,1,38
2024-03-06 06:40:00,5,6,4,18,1,0,34
2024-03-06 06:50:00,7,10,10,13,0,0,40
2024-03-06 07:00:00,12,17,7,16,0,1,53
2024-03-06 07:10:00,14,17,8,19,1,4,63
2024-03-06 07:20:00,10,15,10,20,0,4,59
2024-03-06 07:30:00,10,23,9,16,0,2,60
2024-03-06 07:40:00,15,19,9,17,1,1,62
2024-03-06 07:50:00,9,18,14,10,2,3,56
2024-03-06 08:00:00,11,19,7,27,1,5,70
2024-03-06 08:10:00,3,21,15,21,1,0,61
2024-03-06 08:20:00,1,19,12,17,0,6,55
2024-03-06 08:30:00,1,16,8,11,1,2,39
2024-03-06 08:40:00,0,17,13,9,0,1,40
2024-03-06 08:50:00,0,21,12,18,0,0,51
2024-03-06 09:00:00,10,8,9,21,1,3,52
2024-03-06 09:10:00,19,10,5,24,0,2,60
2024-03-06 09:20:00,4,7,11,15,3,2,42
2024-03-06 09:30:00,6,10,15,18,0,2,51
2024-03-06 09:40:00,3,13,9,12,0,2,39
2024-03-06 09:50:00,4,9,13,28,0,1,55
2024-03-06 10:00:00,7,15,16,17,0,3,58
2024-03-06 10:10:00,12,10,10,17,0,1,50
2024-03-06 10:20:00,1,9,14,10,0,3,37
2024-03-06 10:30:00,2,14,14,13,0,4,47
2024-03-06 10:40:00,2,17,13,9,0,4,45
2024-03-06 10:50:00,0,16,14,12,0,2,44
2024-03-06 11:00:00,7,17,12,10,0,3,49
2024-03-06 11:10:00,5,12,17,24,1,1,60
2024-03-06 11:20:00,5,13,13,14,1,3,49
2024-03-06 11:30:00,7,15,12,12,1,0,47
2024-03-06 11:40:00,5,22,11,17,0,2,57
2024-03-06 11:50:00,1,14,13,18,0,0,46
2024-03-06 12:00:00,1,14,14,13,0,2,44
2024-03-06 12:10:00,6,14,11,22,0,2,55
2024-03-06 12:20:00,6,10,12,11,1,3,43
2024-03-06 12:30:00,3,11,17,17,1,0,49
2024-03-06 12:40:00,11,11,9,19,0,1,51
2024-03-06 12:50:00,5,12,12,14,3,3,49
2024-03-06 13:00:00,0,18,10,18,2,0,48
2024-03-06 13:10:00,2,11,16,18,3,2,52
2024-03-06 13:20:00,4,21,12,10,3,9,59
2024-03-06 13:30:00,1,13,12,6,5,1,38
2024-03-06 13:40:00,4,19,12,15,4,2,56
2024-03-06 13:50:00,6,9,16,27,2,4,64
2024-03-06 14:00:00,13,16,12,21,0,2,64
2024-03-06 14:10:00,14,12,12,11,1,2,52
2024-03-06 14:20:00,14,13,16,11,1,3,58
2024-03-06 14:30:00,0,12,16,16,4,0,48
2024-03-06 14:40:00,10,11,16,12,0,3,52
2024-03-06 14:50:00,15,12,15,19,1,1,63
2024-03-06 15:00:00,9,5,7,28,0,1,50
2024-03-06 15:10:00,7,9,3,20,1,5,45
2024-03-06 15:20:00,13,17,9,10,0,3,52
2024-03-06 15:30:00,15,16,12,24,2,3,72
2024-03-06 15:40:00,11,15,11,17,0,1,55
2024-03-06 15:50:00,12,10,12,16,1,4,55
2024-03-06 16:00:00,12,11,14,31,0,3,71
2024-03-06 16:10:00,11,12,16,19,0,7,65
2024-03-06 16:20:00,11,10,7,17,0,6,51
2024-03-06 16:30:00,11,13,9,11,5,5,54
2024-03-06 16:40:00,9,10,12,9,0,2,42
2024-03-06 16:50:00,12,17,12,23,1,1,66
2024-03-06 17:00:00,15,17,11,24,0,5,72
2024-03-06 17:10:00,5,9,12,21,0,2,49
2024-03-06 17:20:00,14,13,15,19,0,2,63
2024-03-06 17:30:00,13,6,10,17,0,1,47
2024-03-06 17:40:00,10,16,12,16,0,3,57
2024-03-06 17:50:00,14,19,9,20,0,5,67
2024-03-06 18:00:00,8,15,17,18,1,1,60
2024-03-06 18:10:00,13,12,13,17,0,2,57
2024-03-06 18:20:00,17,16,8,23,0,2,66
2024-03-06 18:30:00,9,14,14,21,0,7,65
2024-03-06 18:40:00,12,9,13,23,0,2,59
2024-03-06 18:50:00,10,15,12,14,0,2,53
2024-03-06 19:00:00,8,11,7,13,0,3,42
2024-03-06 19:10:00,13,2,11,21,0,2,49
2024-03-06 19:20:00,17,10,9,32,0,3,71
2024-03-06 19:30:00,8,7,5,15,0,2,37
2024-03-06 19:40:00,5,16,11,16,0,0,48
2024-03-06 19:50:00,11,8,11,28,0,2,60
2024-03-06 20:00:00,9,9,8,16,0,2,44
2024-03-06 20:10:00,12,4,11,24,0,4,55
2024-03-06 20:20:00,6,7,9,20,0,0,42
2024-03-06 20:30:00,11,3,9,19,0,1,43
2024-03-06 20:40:00,5,2,5,20,0,3,35
2024-03-06 20:50:00,2,6,9,16,0,2,35
2024-03-06 21:00:00,6,9,4,16,0,1,36
2024-03-06 21:10:00,3,5,10,16,0,0,34
2024-03-06 21:20:00,8,10,7,15,0,0,40
2024-03-06 21:30:00,4,4,7,18,1,0,34
2024-03-06 21:40:00,5,5,7,14,0,0,31
2024-03-06 21:50:00,4,6,7,14,0,1,32
2024-03-06 22:00:00,4,7,2,12,0,0,25
2024-03-06 22:10:00,6,7,7,9,0,0,29
2024-03-06 22:20:00,1,1,5,16,0,1,24
2024-03-06 22:30:00,6,4,6,11,0,1,28
2024-03-06 22:40:00,5,4,4,11,0,0,24
2024-03-06 22:50:00,3,8,3,12,0,1,27
2024-03-06 23:00:00,2,2,4,13,0,0,21
2024-03-06 23:10:00,2,3,6,16,0,0,27
2024-03-06 23:20:00,1,4,3,11,0,1,20
2024-03-06 23:30:00,1,2,1,5,0,0,9
2024-03-06 23:40:00,3,4,2,17,0,1,27
2024-03-06 23:50:00,1,0,2,5,0,1,9
2024-03-07 00:00:00,1,3,4,4,0,0,12
2024-03-07 00:10:00,3,7,3,9,0,2,24
2024-03-07 00:20:00,0,0,1,5,0,1,7
2024-03-07 00:30:00,0,1,1,5,0,0,7
2024-03-07 00:40:00,2,2,0,7,0,0,11
2024-03-07 00:50:00,0,1,3,6,0,0,10
2024-03-07 01:00:00,0,0,2,5,0,0,7
2024-03-07 01:10:00,2,3,0,4,0,0,9
2024-03-07 01:20:00,0,0,3,3,0,0,6
2024-03-07 01:30:00,1,0,0,3,0,0,4
2024-03-07 01:40:00,0,2,0,3,0,0,5
2024-03-07 01:50:00,1,3,2,2,0,0,8
2024-03-07 02:00:00,0,0,0,2,0,0,2
2024-03-07 02:10:00,0,0,0,4,0,0,4
2024-03-07 02:20:00,0,0,1,2,0,0,3
2024-03-07 02:30:00,0,0,2,2,0,0,4
2024-03-07 02:40:00,1,0,1,3,0,0,5
2024-03-07 02:50:00,0,0,1,4,0,0,5
2024-03-07 03:00:00,0,0,1,3,0,0,4
2024-03-07 03:10:00,0,1,0,0,0,0,1
2024-03-07 03:20:00,0,0,2,2,0,0,4
2024-03-07 03:30:00,0,0,0,5,0,0,5
2024-03-07 03:40:00,0,0,0,1,0,0,1
2024-03-07 03:50:00,0,0,0,4,0,0,4
2024-03-07 04:00:00,2,0,4,4,0,0,10
2024-03-07 04:10:00,0,1,0,5,0,0,6
2024-03-07 04:20:00,1,2,1,4,0,0,8
2024-03-07 04:30:00,2,0,0,5,0,0,7
2024-03-07 04:40:00,0,2,2,6,0,0,10
2024-03-07 04:50:00,0,2,1,4,0,0,7
2024-03-07 05:00:00,0,3,1,8,0,0,12
2024-03-07 05:10:00,5,9,4,7,0,0,25
2024-03-07 05:20:00,2,3,2,9,0,0,16
2024-03-07 05:30:00,2,6,6,17,0,0,31
2024-03-07 05:40:00,9,6,2,15,0,0,32
2024-03-07 05:50:00,8,8,7,18,1,0,42
2024-03-07 06:00:00,3,3,4,15,0,0,25
2024-03-07 06:10:00,4,9,3,14,0,0,30
2024-03-07 06:20:00,3,7,5,22,0,1,38
2024-03-07 06:30:00,4,5,6,14,0,0,29
2024-03-07 06:40:00,7,10,5,23,0,3,48
2024-03-07 06:50:00,5,11,12,20,0,2,50
2024-03-07 07:00:00,9,9,6,16,0,0,40
2024-03-07 07:10:00,10,7,10,26,1,2,56
2024-03-07 07:20:00,12,11,8,13,0,2,46
2024-03-07 07:30:00,18,14,8,15,0,1,56
2024-03-07 07:40:00,15,23,16,18,0,3,75
2024-03-07 07:50:00,13,11,8,18,0,2,52
2024-03-07 08:00:00,11,15,12,26,1,2,67
2024-03-07 08:10:00,11,16,11,20,0,8,66
2024-03-07 08:20:00,11,17,7,22,1,4,62
2024-03-07 08:30:00,11,13,11,15,1,0,51
2024-03-07 08:40:00,15,13,8,15,0,4,55
2024-03-07 08:50:00,8,19,9,23,0,2,61
2024-03-07 09:00:00,10,13,15,21,0,0,59
2024-03-07 09:10:00,17,15,6,21,1,3,63
2024-03-07 09:20:00,10,13,10,20,0,4,57
2024-03-07 09:30:00,11,13,5,29,0,3,61
2024-03-07 09:40:00,17,16,8,17,0,4,62
2024-03-07 09:50:00,11,11,7,17,0,4,50
2024-03-07 10:00:00,14,17,13,17,1,1,63
2024-03-07 10:10:00,13,17,8,14,0,2,54
2024-03-07 10:20:00,6,9,15,15,0,4,49
2024-03-07 10:30:00,10,5,11,30,0,4,60
2024-03-07 10:40:00,10,11,7,33,0,0,61
2024-03-07 10:50:00,13,12,9,14,0,3,51
2024-03-07 11:00:00,13,12,14,16,1,2,58
2024-03-07 11:10:00,14,14,8,13,7,2,58
2024-03-07 11:20:00,12,14,10,22,1,5,64
2024-03-07 11:30:00,10,24,12,19,1,5,71
2024-03-07 11:40:00,13,9,7,24,0,2,55
2024-03-07 11:50:00,17,12,11,26,0,3,69
2024-03-07 12:00:00,18,11,20,27,1,3,80
2024-03-07 12:10:00,8,16,13,21,0,4,62
2024-03-07 12:20:00,26,17,14,10,0,1,68
2024-03-07 12:30:00,51,10,16,26,2,3,108
2024-03-07 12:40:00,12,16,12,20,0,4,64
2024-03-07 12:50:00,9,20,17,34,1,8,89
2024-03-07 13:00:00,16,17,7,12,2,10,64
2024-03-07 13:10:00,17,21,11,14,1,6,70
2024-03-07 13:20:00,14,22,13,12,2,6,69
2024-03-07 13:30:00,10,8,10,9,5,3,45
2024-03-07 13:40:00,8,7,12,19,0,3,49
2024-03-07 13:50:00,7,12,10,20,0,8,57
2024-03-07 14:00:00,13,8,10,19,1,1,52
2024-03-07 14:10:00,3,13,11,14,1,3,45
2024-03-07 14:20:00,9,11,17,17,1,3,58
2024-03-07 14:30:00,16,20,15,10,4,2,67
2024-03-07 14:40:00,16,17,12,14,0,5,64
2024-03-07 14:50:00,8,15,10,13,1,6,53
2024-03-07 15:00:00,17,17,12,16,1,5,68
2024-03-07 15:10:00,14,20,11,10,0,4,59
2024-03-07 15:20:00,18,14,12,14,0,3,61
2024-03-07 15:30:00,10,17,15,15,0,1,58
2024-03-07 15:40:00,15,17,10,11,0,2,55
2024-03-07 15:50:00,9,16,13,16,3,2,59
2024-03-07 16:00:00,10,17,13,21,1,2,64
2024-03-07 16:10:00,13,17,5,12,0,2,49
2024-03-07 16:20:00,10,26,13,15,0,5,69
2024-03-07 16:30:00,15,21,19,14,1,1,71
2024-03-07 16:40:00,15,18,11,15,1,3,63
2024-03-07 16:50:00,16,15,14,4,2,3,54
2024-03-07 17:00:00,16,14,6,21,0,1,58
2024-03-07 17:10:00,13,7,9,24,1,1,55
2024-03-07 17:20:00,16,15,10,13,0,3,57
2024-03-07 17:30:00,13,13,10,21,1,3,61
2024-03-07 17:40:00,10,14,10,11,0,4,49
2024-03-07 17:50:00,11,17,15,16,0,3,62
2024-03-07 18:00:00,12,16,16,16,0,1,61
2024-03-07 18:10:00,21,15,13,16,1,10,76
2024-03-07 18:20:00,12,15,14,8,1,2,52
2024-03-07 18:30:00,11,11,10,17,1,2,52
2024-03-07 18:40:00,8,11,10,17,0,1,47
2024-03-07 18:50:00,19,15,8,23,0,2,67
2024-03-07 19:00:00,10,10,5,23,0,2,50
2024-03-07 19:10:00,10,12,12,16,0,0,50
2024-03-07 19:20:00,4,10,7,20,0,1,42
2024-03-07 19:30:00,13,7,7,32,0,2,61
2024-03-07 19:40:00,7,7,11,20,0,0,45
2024-03-07 19:50:00,8,7,11,20,0,2,48
2024-03-07 20:00:00,15,11,7,17,1,1,52
2024-03-07 20:10:00,9,6,11,22,0,1,49
2024-03-07 20:20:00,6,8,5,18,0,0,37
2024-03-07 20:30:00,8,7,2,19,0,0,36
2024-03-07 20:40:00,6,4,5,21,0,1,37
2024-03-07 20:50:00,4,10,8,17,0,0,39
2024-03-07 21:00:00,8,7,14,22,0,0,51
2024-03-07 21:10:00,9,8,5,20,0,0,42
2024-03-07 21:20:00,9,11,3,16,0,0,39
2024-03-07 21:30:00,7,3,8,17,0,0,35
2024-03-07 21:40:00,8,3,2,23,0,0,36
2024-03-07 21:50:00,4,6,9,18,1,0,38
2024-03-07 22:00:00,4,4,5,23,0,0,36
2024-03-07 22:10:00,5,5,9,13,0,0,32
2024-03-07 22:20:00,3,12,4,9,0,2,30
2024-03-07 22:30:00,4,6,5,13,0,0,28
2024-03-07 22:40:00,4,3,6,11,0,0,24
2024-03-07 22:50:00,4,5,4,12,0,0,25
2024-03-07 23:00:00,2,2,2,11,0,0,17
2024-03-07 23:10:00,6,6,4,13,0,0,29
2024-03-07 23:20:00,3,5,7,7,0,1,23
2024-03-07 23:30:00,2,3,2,5,0,0,12
2024-03-07 23:40:00,2,4,2,10,0,0,18
2024-03-07 23:50:00,1,0,2,6,0,0,9
2024-03-08 00:00:00,2,2,2,5,0,0,11
2024-03-08 00:10:00,2,3,1,13,0,0,19
2024-03-08 00:20:00,0,1,4,6,0,0,11
2024-03-08 00:30:00,0,1,2,6,0,0,9
2024-03-08 00:40:00,2,1,1,13,0,0,17
2024-03-08 00:50:00,0,1,5,0,0,0,6
2024-03-08 01:00:00,0,0,0,3,0,0,3
2024-03-08 01:10:00,1,0,2,7,0,0,10
2024-03-08 01:20:00,0,0,2,4,0,0,6
2024-03-08 01:30:00,0,0,0,4,0,0,4
2024-03-08 01:40:00,0,2,0,1,0,0,3
2024-03-08 01:50:00,0,0,1,1,0,0,2
2024-03-08 02:00:00,2,0,1,1,0,0,4
2024-03-08 02:10:00,0,0,2,5,0,0,7
2024-03-08 02:20:00,2,0,0,2,0,0,4
2024-03-08 02:30:00,0,0,0,2,0,0,2
2024-03-08 02:40:00,0,1,0,4,0,0,5
2024-03-08 02:50:00,1,0,1,3,0,0,5
2024-03-08 03:00:00,0,0,1,1,0,0,2
2024-03-08 03:10:00,0,0,2,2,0,0,4
2024-03-08 03:20:00,0,0,0,3,0,0,3
2024-03-08 03:30:00,0,0,0,6,0,0,6
2024-03-08 03:40:00,0,0,0,5,0,0,5
2024-03-08 03:50:00,0,1,0,0,0,0,1
2024-03-08 04:00:00,2,0,0,1,0,0,3
2024-03-08 04:10:00,1,1,1,9,0,0,12
2024-03-08 04:20:00,1,2,0,4,0,0,7
2024-03-08 04:30:00,0,0,0,5,0,0,5
2024-03-08 04:40:00,0,1,2,5,0,0,8
2024-03-08 04:50:00,3,2,0,7,0,1,13
2024-03-08 05:00:00,0,5,2,8,0,0,15
2024-03-08 05:10:00,1,5,2,13,0,0,21
2024-03-08 05:20:00,4,3,2,13,0,1,23
2024-03-08 05:30:00,3,5,3,21,0,0,32
2024-03-08 05:40:00,2,6,2,17,0,0,27
2024-03-08 05:50:00,2,8,2,20,0,0,32
2024-03-08 06:00:00,6,2,6,14,0,0,28
2024-03-08 06:10:00,6,8,4,19,0,0,37
2024-03-08 06:20:00,2,6,2,24,0,2,36
2024-03-08 06:30:00,5,5,2,14,0,0,26
2024-03-08 06:40:00,2,10,3,23,0,0,38
2024-03-08 06:50:00,6,25,6,23,0,0,60
2024-03-08 07:00:00,10,10,7,23,0,0,50
2024-03-08 07:10:00,10,3,7,24,0,1,45
2024-03-08 07:20:00,10,9,10,20,1,10,60
2024-03-08 07:30:00,13,12,15,8,2,2,52
2024-03-08 07:40:00,14,16,10,17,2,1,60
2024-03-08 07:50:00,15,13,8,18,1,1,56
2024-03-08 08:00:00,13,11,8,23,0,0,55
2024-03-08 08:10:00,18,11,5,20,1,2,57
2024-03-08 08:20:00,15,14,15,31,0,1,76
2024-03-08 08:30:00,9,11,7,14,1,1,43
2024-03-08 08:40:00,12,12,7,14,0,1,46
2024-03-08 08:50:00,10,10,15,16,0,3,54
2024-03-08 09:00:00,9,20,10,22,0,1,62
2024-03-08 09:10:00,16,8,14,19,0,4,61
2024-03-08 09:20:00,14,12,16,21,0,3,66
2024-03-08 09:30:00,17,10,9,18,4,2,60
2024-03-08 09:40:00,17,9,9,28,1,2,66
2024-03-08 09:50:00,9,13,8,22,1,1,54
2024-03-08 10:00:00,27,10,10,21,1,5,74
2024-03-08 10:10:00,28,11,12,15,0,0,66
2024-03-08 10:20:00,40,10,8,32,0,2,92
2024-03-08 10:30:00,19,14,9,18,0,4,64
2024-03-08 10:40:00,9,12,9,6,0,2,38
2024-03-08 10:50:00,26,17,14,6,0,0,63
2024-03-08 11:00:00,28,9,10,19,1,0,67
2024-03-08 11:10:00,15,14,13,22,1,4,69
2024-03-08 11:20:00,12,21,8,28,2,2,73
2024-03-08 11:30:00,16,23,12,8,2,3,64
2024-03-08 11:40:00,19,15,14,15,1,6,70
2024-03-08 11:50:00,14,9,10,34,4,3,74
2024-03-08 12:00:00,26,12,10,28,1,3,80
2024-03-08 12:10:00,11,22,14,26,1,6,80
2024-03-08 12:20:00,18,18,11,27,1,5,80
2024-03-08 12:30:00,25,18,12,33,3,4,95
2024-03-08 12:40:00,11,24,13,34,0,5,87
2024-03-08 12:50:00,16,20,8,26,1,3,74
2024-03-08 13:00:00,27,20,8,34,2,5,96
2024-03-08 13:10:00,8,16,12,13,2,4,55
2024-03-08 13:20:00,11,16,8,19,0,1,55
2024-03-08 13:30:00,11,11,13,18,2,5,60
2024-03-08 13:40:00,9,13,9,29,0,2,62
2024-03-08 13:50:00,17,13,14,31,1,4,80
2024-03-08 14:00:00,11,18,12,22,0,2,65
2024-03-08 14:10:00,15,19,8,14,0,2,58
2024-03-08 14:20:00,17,15,11,24,0,5,72
2024-03-08 14:30:00,11,19,14,18,4,1,67
2024-03-08 14:40:00,16,16,9,17,1,3,62
2024-03-08 14:50:00,17,12,11,19,1,0,60
2024-03-08 15:00:00,9,17,19,15,0,5,65
2024-03-08 15:10:00,11,19,9,14,0,5,58
2024-03-08 15:20:00,10,14,6,19,0,5,54
2024-03-08 15:30:00,20,12,8,24,1,4,69
2024-03-08 15:40:00,8,14,7,22,1,3,55
2024-03-08 15:50:00,7,12,11,15,0,4,49
2024-03-08 16:00:00,15,14,14,22,0,5,70
2024-03-08 16:10:00,13,16,10,23,1,8,71
2024-03-08 16:20:00,17,12,13,24,0,3,69
2024-03-08 16:30:00,15,12,15,23,0,4,69
2024-03-08 16:40:00,16,11,10,17,0,0,54
2024-03-08 16:50:00,9,9,17,19,0,3,57
2024-03-08 17:00:00,9,16,12,21,2,2,62
2024-03-08 17:10:00,8,16,9,16,0,2,51
2024-03-08 17:20:00,19,20,15,23,0,2,79
2024-03-08 17:30:00,9,11,9,19,0,1,49
2024-03-08 17:40:00,16,14,16,13,0,4,63
2024-03-08 17:50:00,8,8,13,20,0,2,51
2024-03-08 18:00:00,20,15,9,30,1,5,80
2024-03-08 18:10:00,22,7,10,20,0,1,60
2024-03-08 18:20:00,12,12,8,21,0,2,55
2024-03-08 18:30:00,11,11,4,17,0,2,45
2024-03-08 18:40:00,15,6,7,18,0,2,48
2024-03-08 18:50:00,13,9,9,20,0,5,56
2024-03-08 19:00:00,8,5,11,19,0,1,44
2024-03-08 19:10:00,12,6,10,10,0,0,38
2024-03-08 19:20:00,7,13,7,21,0,2,50
2024-03-08 19:30:00,13,2,6,19,0,1,41
2024-03-08 19:40:00,10,3,5,23,0,0,41
2024-03-08 19:50:00,7,7,7,20,1,3,45
2024-03-08 20:00:00,3,5,8,21,1,2,40
2024-03-08 20:10:00,11,6,9,19,0,0,45
2024-03-08 20:20:00,9,5,6,20,0,2,42
2024-03-08 20:30:00,4,9,7,21,0,1,42
2024-03-08 20:40:00,7,5,5,22,0,2,41
2024-03-08 20:50:00,6,8,8,16,0,0,38
2024-03-08 21:00:00,10,10,7,29,0,0,56
2024-03-08 21:10:00,2,4,5,18,0,0,29
2024-03-08 21:20:00,5,6,4,14,0,1,30
2024-03-08 21:30:00,9,4,5,20,0,0,38
2024-03-08 21:40:00,7,6,6,21,0,0,40
2024-03-08 21:50:00,3,9,9,40,0,1,62
2024-03-08 22:00:00,3,10,8,22,1,0,44
2024-03-08 22:10:00,7,5,8,16,0,0,36
2024-03-08 22:20:00,4,4,10,21,0,0,39
2024-03-08 22:30:00,5,6,4,20,1,0,36
2024-03-08 22:40:00,4,5,5,12,0,0,26
2024-03-08 22:50:00,1,23,5,13,0,0,42
2024-03-08 23:00:00,2,1,13,15,0,1,32
2024-03-08 23:10:00,6,7,6,25,0,0,44
2024-03-08 23:20:00,3,1,4,13,0,0,21
2024-03-08 23:30:00,3,0,7,16,0,1,27
2024-03-08 23:40:00,2,2,4,8,0,0,16
2024-03-08 23:50:00,1,4,5,11,1,0,22
2024-03-09 00:00:00,0,5,2,11,0,0,18
2024-03-09 00:10:00,3,5,4,9,0,0,21
2024-03-09 00:20:00,3,3,7,14,0,0,27
2024-03-09 00:30:00,2,1,5,6,0,0,14
2024-03-09 00:40:00,1,5,4,14,0,0,24
2024-03-09 00:50:00,4,4,3,8,0,0,19
2024-03-09 01:00:00,0,0,2,6,0,0,8
2024-03-09 01:10:00,2,6,4,13,0,0,25
2024-03-09 01:20:00,0,4,1,6,0,0,11
2024-03-09 01:30:00,1,0,2,14,0,0,17
2024-03-09 01:40:00,0,2,2,7,0,0,11
2024-03-09 01:50:00,0,0,2,7,0,0,9
2024-03-09 02:00:00,0,2,4,7,0,0,13
2024-03-09 02:10:00,2,1,1,10,0,0,14
2024-03-09 02:20:00,2,1,1,2,0,0,6
2024-03-09 02:30:00,0,0,0,8,0,0,8
2024-03-09 02:40:00,0,3,1,10,0,0,14
2024-03-09 02:50:00,1,1,6,8,0,0,16
2024-03-09 03:00:00,0,0,0,7,0,0,7
2024-03-09 03:10:00,1,4,1,4,0,0,10
2024-03-09 03:20:00,1,0,1,4,0,0,6
2024-03-09 03:30:00,0,0,2,2,0,0,4
2024-03-09 03:40:00,0,1,3,4,0,0,8
2024-03-09 03:50:00,0,0,1,4,0,0,5
2024-03-09 04:00:00,1,0,1,2,0,0,4
2024-03-09 04:10:00,1,3,1,5,0,0,10
2024-03-09 04:20:00,1,3,0,3,0,0,7
2024-03-09 04:30:00,0,0,0,4,0,0,4
2024-03-09 04:40:00,1,2,1,10,0,0,14
2024-03-09 04:50:00,0,2,1,7,0,0,10
2024-03-09 05:00:00,1,0,1,5,0,0,7
2024-03-09 05:10:00,3,7,2,10,0,0,22
2024-03-09 05:20:00,0,4,3,9,0,0,16
2024-03-09 05:30:00,4,2,2,16,0,0,24
2024-03-09 05:40:00,2,5,4,15,0,0,26
2024-03-09 05:50:00,2,6,2,8,0,0,18
2024-03-09 06:00:00,2,3,0,9,0,0,14
2024-03-09 06:10:00,4,3,4,10,0,0,21
2024-03-09 06:20:00,1,5,1,7,0,0,14
2024-03-09 06:30:00,3,1,4,18,0,0,26
2024-03-09 06:40:00,1,9,3,13,0,0,26
2024-03-09 06:50:00,0,3,1,9,0,0,13
2024-03-09 07:00:00,2,3,2,12,1,0,20
2024-03-09 07:10:00,1,6,2,14,0,0,23
2024-03-09 07:20:00,3,5,1,12,0,0,21
2024-03-09 07:30:00,3,5,3,13,0,0,24
2024-03-09 07:40:00,2,4,3,19,0,0,28
2024-03-09 07:50:00,6,6,4,21,0,0,37
2024-03-09 08:00:00,6,2,2,19,0,0,29
2024-03-09 08:10:00,3,5,5,19,0,1,33
2024-03-09 08:20:00,2,7,4,15,0,1,29
2024-03-09 08:30:00,8,5,2,20,0,1,36
2024-03-09 08:40:00,5,10,3,16,2,1,37
2024-03-09 08:50:00,4,10,8,26,0,0,48
2024-03-09 09:00:00,4,9,8,22,0,2,45
2024-03-09 09:10:00,9,13,4,28,0,2,56
2024-03-09 09:20:00,13,3,3,28,0,1,48
2024-03-09 09:30:00,11,5,5,21,0,3,45
2024-03-09 09:40:00,20,6,8,22,3,1,60
2024-03-09 09:50:00,11,8,7,29,0,1,56
2024-03-09 10:00:00,16,7,5,27,1,1,57
2024-03-09 10:10:00,13,12,5,25,0,1,56
2024-03-09 10:20:00,20,17,6,31,0,2,76
2024-03-09 10:30:00,7,8,8,25,0,3,51
2024-03-09 10:40:00,27,18,7,31,0,2,85
2024-03-09 10:50:00,9,9,7,26,0,0,51
2024-03-09 11:00:00,5,13,9,26,0,3,56
2024-03-09 11:10:00,17,13,9,26,3,0,68
2024-03-09 11:20:00,12,10,7,27,1,2,59
2024-03-09 11:30:00,14,16,7,27,4,2,70
2024-03-09 11:40:00,13,12,12,23,1,0,61
2024-03-09 11:50:00,10,10,10,27,0,2,59
2024-03-09 12:00:00,9,15,11,20,1,4,60
2024-03-09 12:10:00,16,9,7,20,1,4,57
2024-03-09 12:20:00,16,11,12,25,0,3,67
2024-03-09 12:30:00,17,11,8,35,4,2,77
2024-03-09 12:40:00,22,15,9,31,0,4,81
2024-03-09 12:50:00,13,16,10,30,0,2,71
2024-03-09 13:00:00,18,12,15,19,0,1,65
2024-03-09 13:10:00,13,17,5,26,0,4,65
2024-03-09 13:20:00,7,7,10,28,0,2,54
2024-03-09 13:30:00,13,11,14,26,0,13,77
2024-03-09 13:40:00,15,9,12,35,0,0,71
2024-03-09 13:50:00,10,18,7,38,0,1,74
2024-03-09 14:00:00,8,22,12,30,2,0,74
2024-03-09 14:10:00,9,19,9,30,0,3,70
2024-03-09 14:20:00,12,12,11,16,1,9,61
2024-03-09 14:30:00,9,10,7,20,0,2,48
2024-03-09 14:40:00,11,11,8,23,0,3,56
2024-03-09 14:50:00,9,15,9,22,2,3,60
2024-03-09 15:00:00,12,9,11,11,1,6,50
2024-03-09 15:10:00,12,9,10,28,1,3,63
2024-03-09 15:20:00,11,16,10,22,1,3,63
2024-03-09 15:30:00,10,10,6,18,1,3,48
2024-03-09 15:40:00,8,7,10,17,1,4,47
2024-03-09 15:50:00,9,16,9,19,2,1,56
2024-03-09 16:00:00,6,13,12,26,0,3,60
2024-03-09 16:10:00,12,6,8,23,3,7,59
2024-03-09 16:20:00,8,11,10,17,0,2,48
2024-03-09 16:30:00,8,4,12,26,0,0,50
2024-03-09 16:40:00,17,14,7,18,1,2,59
2024-03-09 16:50:00,5,8,14,18,0,1,46
2024-03-09 17:00:00,6,9,9,15,0,8,47
2024-03-09 17:10:00,6,7,9,23,1,1,47
2024-03-09 17:20:00,7,7,7,24,0,2,47
2024-03-09 17:30:00,7,13,10,28,1,3,62
2024-03-09 17:40:00,16,5,11,21,1,1,55
2024-03-09 17:50:00,10,7,7,26,0,1,51
2024-03-09 18:00:00,10,6,12,22,2,2,54
2024-03-09 18:10:00,11,12,3,18,0,2,46
2024-03-09 18:20:00,8,7,10,16,0,1,42
2024-03-09 18:30:00,12,9,10,19,0,3,53
2024-03-09 18:40:00,6,9,10,23,0,1,49
2024-03-09 18:50:00,10,12,16,19,0,1,58
2024-03-09 19:00:00,8,13,9,22,0,2,54
2024-03-09 19:10:00,11,8,5,45,0,3,72
2024-03-09 19:20:00,6,13,8,27,0,3,57
2024-03-09 19:30:00,5,3,8,28,2,2,48
2024-03-09 19:40:00,9,7,7,17,1,2,43
2024-03-09 19:50:00,8,5,7,23,0,3,46
2024-03-09 20:00:00,7,8,6,21,1,0,43
2024-03-09 20:10:00,6,8,6,23,0,2,45
2024-03-09 20:20:00,4,7,5,26,0,0,42
2024-03-09 20:30:00,7,4,6,20,0,0,37
2024-03-09 20:40:00,5,4,5,23,0,0,37
2024-03-09 20:50:00,9,8,10,17,0,0,44
2024-03-09 21:00:00,7,9,7,19,0,0,42
2024-03-09 21:10:00,4,2,4,15,0,0,25
2024-03-09 21:20:00,2,4,4,22,0,0,32
2024-03-09 21:30:00,4,5,7,10,0,0,26
2024-03-09 21:40:00,7,6,4,15,0,0,32
2024-03-09 21:50:00,6,8,9,16,0,0,39
2024-03-09 22:00:00,0,4,7,17,1,0,29
2024-03-09 22:10:00,2,4,11,15,0,0,32
2024-03-09 22:20:00,4,4,7,16,0,0,31
2024-03-09 22:30:00,7,4,4,16,0,0,31
2024-03-09 22:40:00,3,1,10,17,0,3,34
2024-03-09 22:50:00,5,5,7,14,0,0,31
2024-03-09 23:00:00,6,6,9,15,0,0,36
2024-03-09 23:10:00,7,7,1,13,1,1,30
2024-03-09 23:20:00,2,2,8,14,0,0,26
2024-03-09 23:30:00,1,3,5,15,0,0,24
2024-03-09 23:40:00,5,1,3,13,0,1,23
2024-03-09 23:50:00,3,6,6,21,0,1,37
2024-03-10 00:00:00,0,3,4,13,0,0,20
2024-03-10 00:10:00,7,6,6,9,0,0,28
2024-03-10 00:20:00,1,4,5,8,0,0,18
2024-03-10 00:30:00,0,3,4,9,0,0,16
2024-03-10 00:40:00,4,2,3,19,0,0,28
2024-03-10 00:50:00,1,1,2,13,0,0,17
2024-03-10 01:00:00,4,1,1,12,0,0,18
2024-03-10 01:10:00,1,2,3,11,0,0,17
2024-03-10 01:20:00,3,1,4,8,1,0,17
2024-03-10 01:30:00,0,1,2,7,0,0,10
2024-03-10 01:40:00,0,2,4,11,0,0,17
2024-03-10 01:50:00,1,0,1,8,0,0,10
2024-03-10 02:00:00,3,2,2,4,0,0,11
2024-03-10 02:10:00,1,1,2,9,0,0,13
2024-03-10 02:20:00,2,1,5,11,0,0,19
2024-03-10 02:30:00,1,0,3,6,0,0,10
2024-03-10 02:40:00,3,4,2,12,0,0,21
2024-03-10 02:50:00,0,3,2,6,0,0,11
2024-03-10 03:00:00,0,0,5,7,0,0,12
2024-03-10 03:10:00,0,4,1,6,0,0,11
2024-03-10 03:20:00,1,0,0,3,0,0,4
2024-03-10 03:30:00,1,0,1,7,0,0,9
2024-03-10 03:40:00,1,2,1,6,0,0,10
2024-03-10 03:50:00,1,0,1,8,0,0,10
2024-03-10 04:00:00,0,3,3,5,0,0,11
2024-03-10 04:10:00,0,2,0,13,0,0,15
2024-03-10 04:20:00,0,2,0,7,0,0,9
2024-03-10 04:30:00,2,1,2,6,0,0,11
2024-03-10 04:40:00,0,2,0,15,0,1,18
2024-03-10 04:50:00,1,0,1,2,0,0,4
2024-03-10 05:00:00,1,0,3,2,0,0,6
2024-03-10 05:10:00,0,2,3,10,0,0,15
2024-03-10 05:20:00,1,1,1,6,0,0,9
2024-03-10 05:30:00,2,1,3,16,0,0,22
2024-03-10 05:40:00,4,4,2,15,0,0,25
2024-03-10 05:50:00,1,3,2,12,0,0,18
2024-03-10 06:00:00,0,1,2,8,0,0,11
2024-03-10 06:10:00,2,2,2,11,0,0,17
2024-03-10 06:20:00,3,1,3,9,0,0,16
2024-03-10 06:30:00,3,0,5,8,0,0,16
2024-03-10 06:40:00,1,4,1,10,0,1,17
2024-03-10 06:50:00,0,2,1,10,0,0,13
2024-03-10 07:00:00,0,0,1,5,0,0,6
2024-03-10 07:10:00,3,2,2,8,0,0,15
2024-03-10 07:20:00,0,2,1,7,0,0,10
2024-03-10 07:30:00,2,1,1,9,0,0,13
2024-03-10 07:40:00,4,1,0,13,0,0,18
2024-03-10 07:50:00,3,4,1,6,0,0,14
2024-03-10 08:00:00,3,0,1,6,0,0,10
2024-03-10 08:10:00,3,3,2,8,0,0,16
2024-03-10 08:20:00,2,4,3,7,0,1,17
2024-03-10 08:30:00,2,3,4,11,0,0,20
2024-03-10 08:40:00,5,2,3,15,0,0,25
2024-03-10 08:50:00,1,4,3,11,0,0,19
2024-03-10 09:00:00,4,2,6,10,0,0,22
2024-03-10 09:10:00,4,4,1,15,0,0,24
2024-03-10 09:20:00,6,4,3,7,0,0,20
2024-03-10 09:30:00,5,3,7,18,0,0,33
2024-03-10 09:40:00,8,2,4,17,1,0,32
2024-03-10 09:50:00,7,7,4,21,0,0,39
2024-03-10 10:00:00,9,1,5,18,0,0,33
2024-03-10 10:10:00,8,7,9,20,0,0,44
2024-03-10 10:20:00,4,8,6,18,0,0,36
2024-03-10 10:30:00,8,9,5,21,0,0,43
2024-03-10 10:40:00,9,3,5,24,0,0,41
2024-03-10 10:50:00,6,5,5,24,0,0,40
2024-03-10 11:00:00,2,9,10,23,0,0,44
2024-03-10 11:10:00,8,5,7,23,1,0,44
2024-03-10 11:20:00,11,2,4,19,0,0,36
2024-03-10 11:30:00,10,6,5,23,1,0,45
2024-03-10 11:40:00,11,9,5,24,0,1,50
2024-03-10 11:50:00,7,5,5,23,0,1,41
2024-03-10 12:00:00,9,4,5,19,0,2,39
2024-03-10 12:10:00,9,8,7,22,2,0,48
2024-03-10 12:20:00,11,7,7,30,0,3,58
2024-03-10 12:30:00,10,4,4,27,0,1,46
2024-03-10 12:40:00,8,10,9,25,0,0,52
2024-03-10 12:50:00,5,8,9,20,0,0,42
2024-03-10 13:00:00,16,10,10,21,0,0,57
2024-03-10 13:10:00,8,9,7,25,0,1,50
2024-03-10 13:20:00,11,14,11,18,0,3,57
2024-03-10 13:30:00,5,6,7,23,0,0,41
2024-03-10 13:40:00,3,3,2,21,0,0,29
2024-03-10 13:50:00,11,5,5,21,0,3,45
2024-03-10 14:00:00,8,9,6,24,0,1,48
2024-03-10 14:10:00,7,12,8,24,2,1,54
2024-03-10 14:20:00,8,9,5,27,0,1,50
2024-03-10 14:30:00,6,4,11,30,0,3,54
2024-03-10 14:40:00,6,7,10,20,0,2,45
2024-03-10 14:50:00,11,10,11,26,1,2,61
2024-03-10 15:00:00,8,5,7,19,1,1,41
2024-03-10 15:10:00,8,9,7,22,0,3,49
2024-03-10 15:20:00,8,7,10,27,0,0,52
2024-03-10 15:30:00,11,9,7,26,2,1,56
2024-03-10 15:40:00,11,14,10,17,0,0,52
2024-03-10 15:50:00,5,8,6,23,0,1,43
2024-03-10 16:00:00,9,13,8,26,0,1,57
2024-03-10 16:10:00,5,9,9,20,0,1,44
2024-03-10 16:20:00,7,13,6,21,1,1,49
2024-03-10 16:30:00,7,10,10,21,1,1,50
2024-03-10 16:40:00,9,6,14,20,0,1,50
2024-03-10 16:50:00,7,10,6,20,1,0,44
2024-03-10 17:00:00,7,4,18,21,3,1,54
2024-03-10 17:10:00,9,10,7,14,1,0,41
2024-03-10 17:20:00,6,13,11,22,1,15,68
2024-03-10 17:30:00,6,4,8,18,1,2,39
2024-03-10 17:40:00,12,7,8,18,0,0,45
2024-03-10 17:50:00,12,9,7,17,0,2,47
2024-03-10 18:00:00,6,8,6,15,1,3,39
2024-03-10 18:10:00,8,6,12,15,0,0,41
2024-03-10 18:20:00,6,6,3,20,0,0,35
2024-03-10 18:30:00,10,6,7,19,0,2,44
2024-03-10 18:40:00,6,8,3,27,0,3,47
2024-03-10 18:50:00,5,10,3,21,0,0,39
2024-03-10 19:00:00,4,3,5,22,0,0,34
2024-03-10 19:10:00,5,10,13,18,0,1,47
2024-03-10 19:20:00,6,7,8,18,1,1,41
2024-03-10 19:30:00,10,3,7,23,0,1,44
2024-03-10 19:40:00,10,10,8,16,0,1,45
2024-03-10 19:50:00,5,7,9,25,0,0,46
2024-03-10 20:00:00,3,6,6,19,0,1,35
2024-03-10 20:10:00,6,5,9,23,0,0,43
2024-03-10 20:20:00,10,9,6,24,0,0,49
2024-03-10 20:30:00,5,5,7,13,0,0,30
2024-03-10 20:40:00,5,7,6,21,0,0,39
2024-03-10 20:50:00,4,5,4,16,0,0,29
2024-03-10 21:00:00,4,6,5,20,0,1,36
2024-03-10 21:10:00,5,10,8,18,0,1,42
2024-03-10 21:20:00,2,5,4,14,0,0,25
2024-03-10 21:30:00,9,1,10,18,0,0,38
2024-03-10 21:40:00,5,7,3,17,0,0,32
2024-03-10 21:50:00,6,6,7,16,0,0,35
2024-03-10 22:00:00,1,4,4,16,0,1,26
2024-03-10 22:10:00,4,6,8,12,0,0,30
2024-03-10 22:20:00,2,4,4,13,0,0,23
2024-03-10 22:30:00,3,1,5,13,0,0,22
2024-03-10 22:40:00,4,1,6,10,0,0,21
2024-03-10 22:50:00,5,2,2,11,0,0,20
2024-03-10 23:00:00,1,3,3,13,0,0,20
2024-03-10 23:10:00,3,3,1,9,0,1,17
2024-03-10 23:20:00,0,0,1,8,0,0,9
2024-03-10 23:30:00,0,1,2,9,0,0,12
2024-03-10 23:40:00,1,3,1,7,0,0,12
2024-03-10 23:50:00,1,4,0,2,0,0,7
2024-03-11 00:00:00,1,2,1,5,0,0,9
2024-03-11 00:10:00,7,4,3,7,0,0,21
2024-03-11 00:20:00,3,1,1,6,0,0,11
2024-03-11 00:30:00,0,0,2,4,0,0,6
2024-03-11 00:40:00,0,1,1,3,0,0,5
2024-03-11 00:50:00,0,2,2,4,0,0,8
2024-03-11 01:00:00,0,0,1,0,0,0,1
2024-03-11 01:10:00,2,1,0,3,0,0,6
2024-03-11 01:20:00,0,0,0,0,0,0,0
2024-03-11 01:30:00,3,0,0,2,0,0,5
2024-03-11 01:40:00,0,0,1,3,0,0,4
2024-03-11 01:50:00,1,1,0,2,0,0,4
2024-03-11 02:00:00,1,0,0,0,0,0,1
2024-03-11 02:10:00,3,0,1,2,0,0,6
2024-03-11 02:20:00,1,0,1,5,0,0,7
2024-03-11 02:30:00,0,1,2,2,0,0,5
2024-03-11 02:40:00,1,0,0,1,0,0,2
2024-03-11 02:50:00,0,0,0,1,0,0,1
2024-03-11 03:00:00,0,0,0,1,0,0,1
2024-03-11 03:10:00,0,0,1,0,0,0,1
2024-03-11 03:20:00,0,0,1,3,0,0,4
2024-03-11 03:30:00,1,2,0,2,0,0,5
2024-03-11 03:40:00,0,0,0,2,0,0,2
2024-03-11 03:50:00,0,0,0,2,0,0,2
2024-03-11 04:00:00,1,0,0,5,0,0,6
2024-03-11 04:10:00,1,1,1,26,0,0,29
2024-03-11 04:20:00,1,2,0,1,0,0,4
2024-03-11 04:30:00,0,0,1,1,0,0,2
2024-03-11 04:40:00,0,1,2,2,0,0,5
2024-03-11 04:50:00,1,0,2,4,0,0,7
2024-03-11 05:00:00,4,4,2,8,0,0,18
2024-03-11 05:10:00,0,7,2,11,0,1,21
2024-03-11 05:20:00,6,4,2,12,0,0,24
2024-03-11 05:30:00,3,13,2,18,0,0,36
2024-03-11 05:40:00,3,10,4,21,0,0,38
2024-03-11 05:50:00,6,5,5,19,0,0,35
2024-03-11 06:00:00,9,4,6,13,0,0,32
2024-03-11 06:10:00,5,9,4,14,0,0,32
2024-03-11 06:20:00,5,15,7,22,0,0,49
2024-03-11 06:30:00,3,2,5,12,0,1,23
2024-03-11 06:40:00,4,5,5,20,0,1,35
2024-03-11 06:50:00,4,7,8,20,0,1,40
2024-03-11 07:00:00,7,14,8,13,0,0,42
2024-03-11 07:10:00,8,20,7,17,0,2,54
2024-03-11 07:20:00,15,15,8,14,1,4,57
2024-03-11 07:30:00,13,27,13,10,0,4,67
2024-03-11 07:40:00,9,31,9,17,0,2,68
2024-03-11 07:50:00,15,20,9,15,0,1,60
2024-03-11 08:00:00,14,18,11,15,0,3,61
2024-03-11 08:10:00,16,14,10,24,0,0,64
2024-03-11 08:20:00,12,20,9,13,0,3,57
2024-03-11 08:30:00,8,17,11,8,0,4,48
2024-03-11 08:40:00,18,12,15,10,0,3,58
2024-03-11 08:50:00,14,18,8,17,0,1,58
2024-03-11 09:00:00,11,17,14,18,0,4,64
2024-03-11 09:10:00,9,27,7,10,0,1,54
2024-03-11 09:20:00,14,12,9,17,1,2,55
2024-03-11 09:30:00,16,15,13,12,1,6,63
2024-03-11 09:40:00,12,10,11,1,1,0,35
2024-03-11 09:50:00,12,8,12,0,1,2,35
2024-03-11 10:00:00,11,14,8,16,3,3,55
2024-03-11 10:10:00,12,15,12,12,1,1,53
2024-03-11 10:20:00,16,12,10,12,1,3,54
2024-03-11 10:30:00,20,8,12,21,0,4,65
2024-03-11 10:40:00,14,14,9,7,0,2,46
2024-03-11 10:50:00,12,15,9,6,1,2,45
2024-03-11 11:00:00,11,12,12,23,0,1,59
2024-03-11 11:10:00,11,13,11,19,0,2,56
2024-03-11 11:20:00,20,16,11,26,2,3,78
2024-03-11 11:30:00,21,21,9,17,0,2,70
2024-03-11 11:40:00,15,21,9,16,1,3,65
2024-03-11 11:50:00,13,18,7,26,0,1,65
2024-03-11 12:00:00,18,21,14,31,0,4,88
2024-03-11 12:10:00,17,13,14,17,0,1,62
2024-03-11 12:20:00,14,18,11,15,1,6,65
2024-03-11 12:30:00,38,11,12,25,0,1,87
2024-03-11 12:40:00,24,16,11,19,0,2,72
2024-03-11 12:50:00,9,11,12,20,0,2,54
2024-03-11 13:00:00,23,14,11,14,0,4,66
2024-03-11 13:10:00,17,17,10,23,2,4,73
2024-03-11 13:20:00,11,17,10,22,1,2,63
2024-03-11 13:30:00,11,6,7,16,3,4,47
2024-03-11 13:40:00,11,6,13,19,0,1,50
2024-03-11 13:50:00,13,9,11,14,0,2,49
2024-03-11 14:00:00,11,12,13,11,0,1,48
2024-03-11 14:10:00,11,13,12,18,11,2,67
2024-03-11 14:20:00,14,11,12,17,2,4,60
2024-03-11 14:30:00,23,11,13,20,0,3,70
2024-03-11 14:40:00,15,14,14,16,2,4,65
2024-03-11 14:50:00,10,7,15,17,0,2,51
2024-03-11 15:00:00,16,17,10,18,0,1,62
2024-03-11 15:10:00,9,6,11,20,1,1,48
2024-03-11 15:20:00,8,10,12,20,0,1,51
2024-03-11 15:30:00,11,8,8,16,0,2,45
2024-03-11 15:40:00,15,22,11,12,1,2,63
2024-03-11 15:50:00,7,13,11,19,0,4,54
2024-03-11 16:00:00,10,27,12,35,0,3,87
2024-03-11 16:10:00,9,16,11,22,0,4,62
2024-03-11 16:20:00,7,10,8,21,0,4,50
2024-03-11 16:30:00,15,23,8,13,1,8,68
2024-03-11 16:40:00,10,17,21,13,1,3,65
2024-03-11 16:50:00,8,14,14,30,2,3,71
2024-03-11 17:00:00,11,27,9,22,1,1,71
2024-03-11 17:10:00,10,9,10,17,2,6,54
2024-03-11 17:20:00,14,19,14,14,1,2,64
2024-03-11 17:30:00,7,9,9,26,1,1,53
2024-03-11 17:40:00,8,16,12,23,1,3,63
2024-03-11 17:50:00,9,16,10,19,0,2,56
2024-03-11 18:00:00,13,15,6,0,0,7,41
2024-03-11 18:10:00,7,7,13,0,1,2,30
2024-03-11 18:20:00,8,12,9,0,0,0,29
2024-03-11 18:30:00,11,9,8,17,0,3,48
2024-03-11 18:40:00,20,9,14,14,0,2,59
2024-03-11 18:50:00,9,16,9,19,0,2,55
2024-03-11 19:00:00,8,12,8,26,0,0,54
2024-03-11 19:10:00,7,6,10,17,0,0,40
2024-03-11 19:20:00,12,13,8,16,0,0,49
2024-03-11 19:30:00,9,9,9,22,0,1,50
2024-03-11 19:40:00,6,7,8,21,0,0,42
2024-03-11 19:50:00,8,9,7,18,1,0,43
2024-03-11 20:00:00,8,7,7,25,0,2,49
2024-03-11 20:10:00,3,9,5,20,0,0,37
2024-03-11 20:20:00,7,8,4,14,0,2,35
2024-03-11 20:30:00,8,2,8,19,0,0,37
2024-03-11 20:40:00,3,5,10,23,0,1,42
2024-03-11 20:50:00,1,10,6,21,0,0,38
2024-03-11 21:00:00,4,4,5,25,0,2,40
2024-03-11 21:10:00,9,4,2,18,0,0,33
2024-03-11 21:20:00,1,7,7,19,0,0,34
2024-03-11 21:30:00,6,10,3,16,0,1,36
2024-03-11 21:40:00,1,7,10,18,0,0,36
2024-03-11 21:50:00,6,6,3,16,0,0,31
2024-03-11 22:00:00,4,8,6,13,0,0,31
2024-03-11 22:10:00,6,5,13,19,0,1,44
2024-03-11 22:20:00,3,6,7,12,0,0,28
2024-03-11 22:30:00,9,3,6,15,0,1,34
2024-03-11 22:40:00,1,5,6,12,0,0,24
2024-03-11 22:50:00,1,3,1,10,0,0,15
2024-03-11 23:00:00,2,2,6,12,0,2,24
2024-03-11 23:10:00,4,3,5,12,0,0,24
2024-03-11 23:20:00,1,3,5,4,0,0,13
2024-03-11 23:30:00,1,0,3,12,1,0,17
2024-03-11 23:40:00,2,3,3,11,0,0,19
2024-03-11 23:50:00,0,4,3,4,0,0,11
2024-03-12 00:00:00,5,3,2,6,0,0,16
2024-03-12 00:10:00,1,4,2,9,0,0,16
2024-03-12 00:20:00,2,0,3,4,0,0,9
2024-03-12 00:30:00,1,1,1,9,0,0,12
2024-03-12 00:40:00,1,1,3,8,0,0,13
2024-03-12 00:50:00,1,3,2,3,0,0,9
2024-03-12 01:00:00,0,0,1,13,0,0,14
2024-03-12 01:10:00,1,1,0,5,0,0,7
2024-03-12 01:20:00,0,0,1,2,0,0,3
2024-03-12 01:30:00,0,1,2,5,0,0,8
2024-03-12 01:40:00,0,2,0,3,0,0,5
2024-03-12 01:50:00,0,1,2,4,0,0,7
2024-03-12 02:00:00,0,0,1,3,0,0,4
2024-03-12 02:10:00,0,0,0,3,0,0,3
2024-03-12 02:20:00,0,1,1,3,0,0,5
2024-03-12 02:30:00,0,1,0,2,0,0,3
2024-03-12 02:40:00,0,0,0,1,0,0,1
2024-03-12 02:50:00,0,0,0,3,0,0,3
2024-03-12 03:00:00,0,0,0,1,0,0,1
2024-03-12 03:10:00,0,0,2,0,0,0,2
2024-03-12 03:20:00,0,0,0,2,0,0,2
2024-03-12 03:30:00,0,0,0,3,0,0,3
2024-03-12 03:40:00,0,0,0,1,0,0,1
2024-03-12 03:50:00,0,0,0,5,0,0,5
2024-03-12 04:00:00,1,0,2,7,0,0,10
2024-03-12 04:10:00,0,1,1,4,0,0,6
2024-03-12 04:20:00,4,1,1,1,0,0,7
2024-03-12 04:30:00,1,0,2,2,0,0,5
2024-03-12 04:40:00,0,3,1,4,0,0,8
2024-03-12 04:50:00,1,1,3,7,0,0,12
2024-03-12 05:00:00,0,3,2,8,0,0,13
2024-03-12 05:10:00,3,9,2,11,0,0,25
2024-03-12 05:20:00,4,4,2,19,0,0,29
2024-03-12 05:30:00,2,7,3,13,0,1,26
2024-03-12 05:40:00,6,7,3,19,0,0,35
2024-03-12 05:50:00,4,5,4,15,0,0,28
2024-03-12 06:00:00,5,5,6,19,0,0,35
2024-03-12 06:10:00,1,8,0,22,0,1,32
2024-03-12 06:20:00,4,7,6,17,0,0,34
2024-03-12 06:30:00,4,4,7,19,0,2,36
2024-03-12 06:40:00,6,7,7,16,0,1,37
2024-03-12 06:50:00,8,8,10,15,0,1,42
2024-03-12 07:00:00,11,12,13,17,0,3,56
2024-03-12 07:10:00,9,9,10,13,1,3,45
2024-03-12 07:20:00,10,9,10,19,0,2,50
2024-03-12 07:30:00,17,12,10,13,1,5,58
2024-03-12 07:40:00,6,31,12,17,0,4,70
2024-03-12 07:50:00,14,20,13,11,0,2,60
2024-03-12 08:00:00,13,22,8,18,0,1,62
2024-03-12 08:10:00,11,21,9,15,0,2,58
2024-03-12 08:20:00,12,14,11,13,1,4,55
2024-03-12 08:30:00,18,18,12,18,0,1,67
2024-03-12 08:40:00,12,26,8,18,0,1,65
2024-03-12 08:50:00,17,16,7,15,0,4,59
2024-03-12 09:00:00,8,20,10,9,1,3,51
2024-03-12 09:10:00,12,20,10,25,0,1,68
2024-03-12 09:20:00,7,12,11,17,0,3,50
2024-03-12 09:30:00,5,10,7,10,0,0,32
2024-03-12 09:40:00,12,13,8,4,2,2,41
2024-03-12 09:50:00,8,9,6,8,1,1,33
2024-03-12 10:00:00,13,12,7,20,0,2,54
2024-03-12 10:10:00,5,15,11,16,0,0,47
2024-03-12 10:20:00,10,12,18,14,1,1,56
2024-03-12 10:30:00,4,15,14,20,3,3,59
2024-03-12 10:40:00,7,12,8,12,0,3,42
2024-03-12 10:50:00,11,13,11,14,0,3,52
2024-03-12 11:00:00,11,9,9,18,0,2,49
2024-03-12 11:10:00,14,11,11,16,1,4,57
2024-03-12 11:20:00,13,13,11,13,0,0,50
2024-03-12 11:30:00,10,11,12,23,0,3,59
2024-03-12 11:40:00,10,9,17,19,0,1,56
2024-03-12 11:50:00,15,17,14,21,0,1,68
2024-03-12 12:00:00,6,14,12,21,0,1,54
2024-03-12 12:10:00,16,10,16,19,0,2,63
2024-03-12 12:20:00,13,11,15,11,1,5,56
2024-03-12 12:30:00,10,10,16,19,0,3,58
2024-03-12 12:40:00,12,14,14,21,0,0,61
2024-03-12 12:50:00,10,11,10,10,0,6,47
2024-03-12 13:00:00,14,10,14,22,1,3,64
2024-03-12 13:10:00,23,8,8,12,2,7,60
2024-03-12 13:20:00,17,10,14,14,1,5,61
2024-03-12 13:30:00,9,8,11,17,0,4,49
2024-03-12 13:40:00,10,9,11,10,0,2,42
2024-03-12 13:50:00,6,14,13,21,2,0,56
2024-03-12 14:00:00,12,11,15,13,4,1,56
2024-03-12 14:10:00,13,16,13,19,1,1,63
2024-03-12 14:20:00,11,12,10,13,1,4,51
2024-03-12 14:30:00,14,14,16,11,3,6,64
2024-03-12 14:40:00,12,19,13,9,4,2,59
2024-03-12 14:50:00,14,18,13,17,3,2,67
2024-03-12 15:00:00,13,14,10,17,1,4,59
2024-03-12 15:10:00,12,19,9,13,1,2,56
2024-03-12 15:20:00,13,14,10,20,0,4,61
2024-03-12 15:30:00,20,10,13,16,0,1,60
2024-03-12 15:40:00,11,18,8,12,1,3,53
2024-03-12 15:50:00,10,8,14,19,0,5,56
2024-03-12 16:00:00,8,12,15,18,1,9,63
2024-03-12 16:10:00,12,12,12,17,0,2,55
2024-03-12 16:20:00,16,9,10,13,1,5,54
2024-03-12 16:30:00,10,18,13,15,1,1,58
2024-03-12 16:40:00,15,19,7,13,2,3,59
2024-03-12 16:50:00,12,17,8,17,0,1,55
2024-03-12 17:00:00,8,19,4,20,0,2,53
2024-03-12 17:10:00,11,13,11,11,1,3,50
2024-03-12 17:20:00,16,11,13,16,1,3,60
2024-03-12 17:30:00,17,9,13,24,0,3,66
2024-03-12 17:40:00,11,16,7,22,0,1,57
2024-03-12 17:50:00,14,21,11,19,0,3,68
2024-03-12 18:00:00,14,18,20,14,0,0,66
2024-03-12 18:10:00,12,12,12,16,2,0,54
2024-03-12 18:20:00,14,12,8,19,0,0,53
2024-03-12 18:30:00,9,11,8,23,0,1,52
2024-03-12 18:40:00,9,8,14,16,0,1,48
2024-03-12 18:50:00,14,13,13,19,0,1,60
2024-03-12 19:00:00,7,7,15,24,1,0,54
2024-03-12 19:10:00,7,9,12,21,0,2,51
2024-03-12 19:20:00,6,9,10,15,1,1,42
2024-03-12 19:30:00,11,10,7,17,1,4,50
2024-03-12 19:40:00,7,10,5,21,1,1,45
2024-03-12 19:50:00,9,7,11,24,0,1,52
2024-03-12 20:00:00,9,9,7,17,0,1,43
2024-03-12 20:10:00,8,6,9,16,1,1,41
2024-03-12 20:20:00,3,5,5,19,0,2,34
2024-03-12 20:30:00,7,9,6,12,0,0,34
2024-03-12 20:40:00,8,5,6,25,0,2,46
2024-03-12 20:50:00,5,8,8,20,0,0,41
2024-03-12 21:00:00,7,6,6,18,0,0,37
2024-03-12 21:10:00,3,10,7,18,0,0,38
2024-03-12 21:20:00,5,9,5,21,0,0,40
2024-03-12 21:30:00,3,7,6,20,0,1,37
2024-03-12 21:40:00,3,6,7,18,0,0,34
2024-03-12 21:50:00,5,24,6,14,0,0,49
2024-03-12 22:00:00,10,5,6,15,0,0,36
2024-03-12 22:10:00,5,4,6,16,0,0,31
2024-03-12 22:20:00,0,8,7,19,0,0,34
2024-03-12 22:30:00,20,12,4,11,0,0,47
2024-03-12 22:40:00,3,2,3,22,0,0,30
2024-03-12 22:50:00,3,7,5,7,1,0,23
2024-03-12 23:00:00,7,7,4,14,0,1,33
2024-03-12 23:10:00,3,2,4,12,0,0,21
2024-03-12 23:20:00,0,3,4,9,0,0,16
2024-03-12 23:30:00,2,0,2,8,0,0,12
2024-03-12 23:40:00,8,1,4,12,0,0,25
2024-03-12 23:50:00,1,7,2,6,0,0,16
2024-03-13 00:00:00,1,1,1,6,0,0,9
2024-03-13 00:10:00,3,7,4,14,0,0,28
2024-03-13 00:20:00,2,0,1,4,0,0,7
2024-03-13 00:30:00,0,1,0,2,0,0,3
2024-03-13 00:40:00,0,1,1,11,0,0,13
2024-03-13 00:50:00,0,2,1,4,0,0,7
2024-03-13 01:00:00,1,2,2,6,0,0,11
2024-03-13 01:10:00,0,2,0,4,0,0,6
2024-03-13 01:20:00,0,0,1,4,0,0,5
2024-03-13 01:30:00,5,0,0,3,0,0,8
2024-03-13 01:40:00,0,0,2,2,0,0,4
2024-03-13 01:50:00,1,0,1,3,0,0,5
2024-03-13 02:00:00,0,0,0,3,0,0,3
2024-03-13 02:10:00,0,3,0,5,0,0,8
2024-03-13 02:20:00,0,1,1,2,0,0,4
2024-03-13 02:30:00,0,0,0,3,0,0,3
2024-03-13 02:40:00,0,1,0,3,0,0,4
2024-03-13 02:50:00,0,0,0,3,0,0,3
2024-03-13 03:00:00,0,0,0,3,0,0,3
2024-03-13 03:10:00,2,1,0,3,0,0,6
2024-03-13 03:20:00,1,0,2,2,0,0,5
2024-03-13 03:30:00,0,1,0,3,0,0,4
2024-03-13 03:40:00,0,0,0,4,0,0,4
2024-03-13 03:50:00,4,0,1,0,0,0,5
2024-03-13 04:00:00,0,0,1,9,0,0,10
2024-03-13 04:10:00,0,1,0,7,0,0,8
2024-03-13 04:20:00,1,3,3,3,0,0,10
2024-03-13 04:30:00,1,0,0,3,0,0,4
2024-03-13 04:40:00,0,2,3,3,0,0,8
2024-03-13 04:50:00,1,3,0,5,0,0,9
2024-03-13 05:00:00,0,2,3,7,0,0,12
2024-03-13 05:10:00,3,4,3,8,0,0,18
2024-03-13 05:20:00,5,4,4,15,0,1,29
2024-03-13 05:30:00,1,8,5,17,0,0,31
2024-03-13 05:40:00,16,6,3,25,0,0,50
2024-03-13 05:50:00,7,5,5,16,0,0,33
2024-03-13 06:00:00,8,3,3,15,0,0,29
2024-03-13 06:10:00,7,9,5,26,0,0,47
2024-03-13 06:20:00,5,7,3,19,0,0,34
2024-03-13 06:30:00,2,5,4,26,0,1,38
2024-03-13 06:40:00,4,8,5,14,0,0,31
2024-03-13 06:50:00,7,14,10,17,0,0,48
2024-03-13 07:00:00,11,18,7,18,0,1,55
2024-03-13 07:10:00,10,25,7,17,0,1,60
2024-03-13 07:20:00,6,18,11,17,0,4,56
2024-03-13 07:30:00,18,11,11,6,1,2,49
2024-03-13 07:40:00,12,22,9,13,1,2,59
2024-03-13 07:50:00,19,31,8,19,0,3,80
2024-03-13 08:00:00,13,16,11,19,0,0,59
2024-03-13 08:10:00,16,20,10,14,0,1,61
2024-03-13 08:20:00,12,22,13,13,0,1,61
2024-03-13 08:30:00,14,12,10,12,1,2,51
2024-03-13 08:40:00,14,22,8,7,0,1,52
2024-03-13 08:50:00,18,14,7,9,0,1,49
2024-03-13 09:00:00,12,19,14,7,1,3,56
2024-03-13 09:10:00,11,17,15,16,1,3,63
2024-03-13 09:20:00,13,10,8,13,1,1,46
2024-03-13 09:30:00,14,12,9,8,0,2,45
2024-03-13 09:40:00,15,14,17,1,0,9,56
2024-03-13 09:50:00,9,16,10,12,0,2,49
2024-03-13 10:00:00,10,10,11,13,0,3,47
2024-03-13 10:10:00,12,11,8,7,0,1,39
2024-03-13 10:20:00,17,16,6,20,0,6,65
2024-03-13 10:30:00,14,13,10,14,2,3,56
2024-03-13 10:40:00,11,17,15,13,0,1,57
2024-03-13 10:50:00,13,17,17,13,0,3,63
2024-03-13 11:00:00,10,9,19,16,0,2,56
2024-03-13 11:10:00,15,12,15,9,1,2,54
2024-03-13 11:20:00,10,10,14,22,0,0,56
2024-03-13 11:30:00,16,12,16,15,1,2,62
2024-03-13 11:40:00,9,15,17,20,0,1,62
2024-03-13 11:50:00,12,11,14,18,0,2,57
2024-03-13 12:00:00,9,13,18,28,0,2,70
2024-03-13 12:10:00,10,10,14,12,0,1,47
2024-03-13 12:20:00,22,9,14,24,0,8,77
2024-03-13 12:30:00,20,8,17,15,0,3,63
2024-03-13 12:40:00,13,14,13,14,1,2,57
2024-03-13 12:50:00,14,15,14,20,1,4,68
2024-03-13 13:00:00,13,15,15,9,2,3,57
2024-03-13 13:10:00,17,21,12,15,1,7,73
2024-03-13 13:20:00,7,19,12,18,2,4,62
2024-03-13 13:30:00,8,16,11,20,1,1,57
2024-03-13 13:40:00,17,16,14,19,1,2,69
2024-03-13 13:50:00,10,14,17,27,0,6,74
2024-03-13 14:00:00,11,12,14,17,0,1,55
2024-03-13 14:10:00,8,9,13,23,0,2,55
2024-03-13 14:20:00,13,14,16,21,2,4,70
2024-03-13 14:30:00,10,14,9,24,3,2,62
2024-03-13 14:40:00,8,13,10,15,1,2,49
2024-03-13 14:50:00,7,14,12,15,3,2,53
2024-03-13 15:00:00,11,9,22,17,2,3,64
2024-03-13 15:10:00,12,14,16,16,0,2,60
2024-03-13 15:20:00,10,17,19,17,1,2,66
2024-03-13 15:30:00,14,3,23,17,2,2,61
2024-03-13 15:40:00,11,13,25,21,0,4,74
2024-03-13 15:50:00,15,12,23,15,0,2,67
2024-03-13 16:00:00,14,13,28,12,1,3,71
2024-03-13 16:10:00,5,14,19,12,0,0,50
2024-03-13 16:20:00,12,21,20,20,0,2,75
2024-03-13 16:30:00,8,17,25,11,2,1,64
2024-03-13 16:40:00,16,15,14,20,0,1,66
2024-03-13 16:50:00,13,20,18,22,0,3,76
2024-03-13 17:00:00,10,10,20,13,0,4,57
2024-03-13 17:10:00,13,11,15,16,0,2,57
2024-03-13 17:20:00,14,22,23,16,0,2,77
2024-03-13 17:30:00,15,11,28,16,0,8,78
2024-03-13 17:40:00,11,12,15,19,1,2,60
2024-03-13 17:50:00,12,15,18,22,0,4,71
2024-03-13 18:00:00,8,27,21,15,2,2,75
2024-03-13 18:10:00,12,11,20,15,1,3,62
2024-03-13 18:20:00,36,10,15,21,0,2,84
2024-03-13 18:30:00,8,8,13,16,0,2,47
2024-03-13 18:40:00,19,10,12,22,2,1,66
2024-03-13 18:50:00,7,10,11,18,0,1,47
2024-03-13 19:00:00,6,7,12,14,2,3,44
2024-03-13 19:10:00,9,5,10,28,0,1,53
2024-03-13 19:20:00,9,11,7,19,0,1,47
2024-03-13 19:30:00,9,7,11,21,0,0,48
2024-03-13 19:40:00,12,9,11,19,1,2,54
2024-03-13 19:50:00,13,8,14,14,0,4,53
2024-03-13 20:00:00,13,9,13,15,0,1,51
2024-03-13 20:10:00,9,5,9,17,0,0,40
2024-03-13 20:20:00,5,16,11,21,1,0,54
2024-03-13 20:30:00,6,4,6,18,0,1,35
2024-03-13 20:40:00,7,4,8,16,0,0,35
2024-03-13 20:50:00,2,12,6,21,0,2,43
2024-03-13 21:00:00,12,6,9,16,0,2,45
2024-03-13 21:10:00,3,5,5,18,0,0,31
2024-03-13 21:20:00,6,5,9,14,0,1,35
2024-03-13 21:30:00,9,4,6,20,0,1,40
2024-03-13 21:40:00,1,6,12,22,0,0,41
2024-03-13 21:50:00,1,4,2,8,0,0,15
2024-03-13 22:00:00,2,4,2,18,0,0,26
2024-03-13 22:10:00,3,9,11,20,0,1,44
2024-03-13 22:20:00,4,1,10,19,0,0,34
2024-03-13 22:30:00,3,4,6,14,0,1,28
2024-03-13 22:40:00,3,2,10,19,0,0,34
2024-03-13 22:50:00,6,3,7,13,0,0,29
2024-03-13 23:00:00,5,20,4,13,0,0,42
2024-03-13 23:10:00,2,4,6,17,0,0,29
2024-03-13 23:20:00,0,3,6,10,0,0,19
2024-03-13 23:30:00,1,3,4,10,0,0,18
2024-03-13 23:40:00,2,1,1,12,0,0,16
2024-03-13 23:50:00,1,7,1,8,0,0,17
2024-03-14 00:00:00,2,2,3,9,0,0,16
2024-03-14 00:10:00,2,2,3,8,0,1,16
2024-03-14 00:20:00,2,2,3,9,0,0,16
2024-03-14 00:30:00,0,0,1,4,0,0,5
2024-03-14 00:40:00,0,2,4,5,0,0,11
2024-03-14 00:50:00,0,1,2,9,0,0,12
2024-03-14 01:00:00,0,1,0,9,0,0,10
2024-03-14 01:10:00,0,0,1,4,0,0,5
2024-03-14 01:20:00,1,0,0,6,0,0,7
2024-03-14 01:30:00,0,1,0,5,0,0,6
2024-03-14 01:40:00,0,0,2,5,0,0,7
2024-03-14 01:50:00,0,0,4,3,0,0,7
2024-03-14 02:00:00,0,0,0,2,0,0,2
2024-03-14 02:10:00,0,0,1,2,0,0,3
2024-03-14 02:20:00,1,0,0,3,0,0,4
2024-03-14 02:30:00,0,0,1,3,0,0,4
2024-03-14 02:40:00,0,0,0,0,0,0,0
2024-03-14 02:50:00,1,1,1,5,0,0,8
2024-03-14 03:00:00,0,0,1,1,0,0,2
2024-03-14 03:10:00,0,0,1,0,0,0,1
2024-03-14 03:20:00,0,0,1,6,0,0,7
2024-03-14 03:30:00,0,0,1,0,0,0,1
2024-03-14 03:40:00,2,0,3,3,0,0,8
2024-03-14 03:50:00,0,0,0,4,0,0,4
2024-03-14 04:00:00,0,1,1,6,0,0,8
2024-03-14 04:10:00,0,1,0,4,0,0,5
2024-03-14 04:20:00,1,1,2,3,0,0,7
2024-03-14 04:30:00,0,1,2,7,0,0,10
2024-03-14 04:40:00,0,1,2,3,0,0,6
2024-03-14 04:50:00,0,2,2,5,0,0,9
2024-03-14 05:00:00,1,2,0,6,0,0,9
2024-03-14 05:10:00,3,8,4,11,0,0,26
2024-03-14 05:20:00,3,2,3,15,0,0,23
2024-03-14 05:30:00,2,10,4,19,0,0,35
2024-03-14 05:40:00,9,4,4,15,0,1,33
2024-03-14 05:50:00,6,12,6,13,0,0,37
2024-03-14 06:00:00,4,5,7,18,0,0,34
2024-03-14 06:10:00,3,15,2,19,0,0,39
2024-03-14 06:20:00,3,6,5,21,0,3,38
2024-03-14 06:30:00,8,1,9,16,0,1,35
2024-03-14 06:40:00,7,4,13,17,0,1,42
2024-03-14 06:50:00,9,22,11,22,0,1,65
2024-03-14 07:00:00,7,14,11,20,0,0,52
2024-03-14 07:10:00,11,11,14,19,0,1,56
2024-03-14 07:20:00,9,21,8,23,1,5,67
2024-03-14 07:30:00,9,19,23,6,3,3,63
2024-03-14 07:40:00,22,18,18,12,1,4,75
2024-03-14 07:50:00,14,18,13,14,1,2,62
2024-03-14 08:00:00,14,21,12,20,0,2,69
2024-03-14 08:10:00,19,15,10,5,0,3,52
2024-03-14 08:20:00,9,15,15,25,1,3,68
2024-03-14 08:30:00,13,11,16,19,0,1,60
2024-03-14 08:40:00,13,9,12,16,0,1,51
2024-03-14 08:50:00,12,10,15,21,0,5,63
2024-03-14 09:00:00,6,9,7,19,0,2,43
2024-03-14 09:10:00,8,13,19,12,0,2,54
2024-03-14 09:20:00,9,9,20,24,0,0,62
2024-03-14 09:30:00,17,14,17,24,0,1,73
2024-03-14 09:40:00,7,13,21,14,1,5,61
2024-03-14 09:50:00,11,18,18,4,2,3,56
2024-03-14 10:00:00,15,13,11,21,1,5,66
2024-03-14 10:10:00,19,15,18,10,0,2,64
2024-03-14 10:20:00,17,13,11,24,0,1,66
2024-03-14 10:30:00,10,10,21,24,1,4,70
2024-03-14 10:40:00,11,15,22,12,2,5,67
2024-03-14 10:50:00,9,22,19,12,1,2,65
2024-03-14 11:00:00,9,12,17,21,3,4,66
2024-03-14 11:10:00,11,11,22,17,1,2,64
2024-03-14 11:20:00,23,18,17,19,2,7,86
2024-03-14 11:30:00,11,15,18,21,0,4,69
2024-03-14 11:40:00,12,17,23,17,0,1,70
2024-03-14 11:50:00,10,15,23,30,1,3,82
2024-03-14 12:00:00,11,18,16,22,0,5,72
2024-03-14 12:10:00,8,20,27,27,0,3,85
2024-03-14 12:20:00,19,18,16,25,1,3,82
2024-03-14 12:30:00,16,11,22,25,0,1,75
2024-03-14 12:40:00,11,13,23,21,0,5,73
2024-03-14 12:50:00,7,20,15,29,0,3,74
2024-03-14 13:00:00,10,13,21,12,1,3,60
2024-03-14 13:10:00,17,16,21,2,1,8,65
2024-03-14 13:20:00,8,23,18,23,0,3,75
2024-03-14 13:30:00,9,18,20,21,2,3,73
2024-03-14 13:40:00,13,12,20,24,0,1,70
2024-03-14 13:50:00,9,17,25,10,0,4,65
2024-03-14 14:00:00,10,15,16,23,1,6,71
2024-03-14 14:10:00,14,17,16,15,1,5,68
2024-03-14 14:20:00,9,20,22,17,1,5,74
2024-03-14 14:30:00,11,16,22,26,0,2,77
2024-03-14 14:40:00,8,21,25,17,0,3,74
2024-03-14 14:50:00,10,19,19,12,0,4,64
2024-03-14 15:00:00,9,11,17,30,1,1,69
2024-03-14 15:10:00,11,13,19,7,2,1,53
2024-03-14 15:20:00,24,13,18,26,3,4,88
2024-03-14 15:30:00,9,17,23,10,0,3,62
2024-03-14 15:40:00,10,18,15,9,1,4,57
2024-03-14 15:50:00,11,14,15,14,1,3,58
2024-03-14 16:00:00,13,15,19,25,0,5,77
2024-03-14 16:10:00,10,19,23,15,2,3,72
2024-03-14 16:20:00,9,18,20,25,0,3,75
2024-03-14 16:30:00,14,14,23,17,2,8,78
2024-03-14 16:40:00,14,21,31,17,1,3,87
2024-03-14 16:50:00,15,21,22,3,0,1,62
2024-03-14 17:00:00,11,22,21,14,1,3,72
2024-03-14 17:10:00,13,17,19,14,1,4,68
2024-03-14 17:20:00,11,25,16,27,0,4,83
2024-03-14 17:30:00,12,18,20,16,0,4,70
2024-03-14 17:40:00,9,11,16,19,1,5,61
2024-03-14 17:50:00,15,12,27,17,3,5,79
2024-03-14 18:00:00,24,16,22,21,0,3,86
2024-03-14 18:10:00,18,12,19,21,0,4,74
2024-03-14 18:20:00,20,22,16,20,1,4,83
2024-03-14 18:30:00,13,24,12,19,2,0,70
2024-03-14 18:40:00,5,19,14,22,2,2,64
2024-03-14 18:50:00,7,11,13,21,1,5,58
2024-03-14 19:00:00,9,5,8,22,0,1,45
2024-03-14 19:10:00,9,7,17,17,1,0,51
2024-03-14 19:20:00,10,9,13,30,0,4,66
2024-03-14 19:30:00,9,5,10,17,0,4,45
2024-03-14 19:40:00,8,10,13,19,0,1,51
2024-03-14 19:50:00,7,8,13,22,0,1,51
2024-03-14 20:00:00,9,15,10,24,0,2,60
2024-03-14 20:10:00,13,4,11,15,0,0,43
2024-03-14 20:20:00,9,15,7,22,0,2,55
2024-03-14 20:30:00,8,9,5,23,0,0,45
2024-03-14 20:40:00,2,3,5,23,0,0,33
2024-03-14 20:50:00,4,9,6,16,0,1,36
2024-03-14 21:00:00,8,5,6,15,0,1,35
2024-03-14 21:10:00,4,7,7,18,0,2,38
2024-03-14 21:20:00,4,8,8,24,0,1,45
2024-03-14 21:30:00,8,5,7,20,1,0,41
2024-03-14 21:40:00,6,4,6,19,0,0,35
2024-03-14 21:50:00,1,4,8,11,0,2,26
2024-03-14 22:00:00,6,4,9,15,0,1,35
2024-03-14 22:10:00,6,4,7,14,0,0,31
2024-03-14 22:20:00,3,3,7,14,0,1,28
2024-03-14 22:30:00,3,3,6,11,0,0,23
2024-03-14 22:40:00,6,4,9,20,0,0,39
2024-03-14 22:50:00,1,4,1,14,0,0,20
2024-03-14 23:00:00,3,4,5,9,0,0,21
2024-03-14 23:10:00,4,18,8,13,0,0,43
2024-03-14 23:20:00,1,2,1,10,0,0,14
2024-03-14 23:30:00,1,0,1,7,0,0,9
2024-03-14 23:40:00,1,4,1,11,0,0,17
2024-03-14 23:50:00,2,1,1,8,0,0,12
2024-03-15 00:00:00,0,3,2,8,0,0,13
2024-03-15 00:10:00,3,4,3,11,0,0,21
2024-03-15 00:20:00,3,3,1,6,0,0,13
2024-03-15 00:30:00,5,0,3,5,0,0,13
2024-03-15 00:40:00,0,2,3,8,0,0,13
2024-03-15 00:50:00,0,2,2,3,1,0,8
2024-03-15 01:00:00,1,3,8,5,0,0,17
2024-03-15 01:10:00,1,3,0,8,0,0,12
2024-03-15 01:20:00,1,0,2,4,0,0,7
2024-03-15 01:30:00,2,1,0,7,0,0,10
2024-03-15 01:40:00,0,1,2,5,0,0,8
2024-03-15 01:50:00,0,0,0,6,0,0,6
2024-03-15 02:00:00,0,0,0,4,0,0,4
2024-03-15 02:10:00,0,0,1,5,0,0,6
2024-03-15 02:20:00,0,1,1,6,0,0,8
2024-03-15 02:30:00,0,0,0,3,0,0,3
2024-03-15 02:40:00,0,1,1,1,0,0,3
2024-03-15 02:50:00,0,0,2,0,0,0,2
2024-03-15 03:00:00,0,0,0,6,0,0,6
2024-03-15 03:10:00,0,1,0,4,0,0,5
2024-03-15 03:20:00,0,0,1,1,0,0,2
2024-03-15 03:30:00,0,2,1,4,0,0,7
2024-03-15 03:40:00,0,1,1,3,0,0,5
2024-03-15 03:50:00,1,1,0,1,0,0,3
2024-03-15 04:00:00,1,0,1,4,0,0,6
2024-03-15 04:10:00,0,2,0,8,0,0,10
2024-03-15 04:20:00,1,0,1,3,0,0,5
2024-03-15 04:30:00,0,0,1,2,0,0,3
2024-03-15 04:40:00,1,1,3,8,0,0,13
2024-03-15 04:50:00,3,1,1,2,0,0,7
2024-03-15 05:00:00,0,2,3,11,0,0,16
2024-03-15 05:10:00,3,5,1,9,0,0,18
2024-03-15 05:20:00,4,3,3,16,0,0,26
2024-03-15 05:30:00,1,5,3,16,0,0,25
2024-03-15 05:40:00,5,7,4,17,0,1,34
2024-03-15 05:50:00,4,8,4,13,0,0,29
2024-03-15 06:00:00,8,7,5,15,0,1,36
2024-03-15 06:10:00,2,6,6,24,0,3,41
2024-03-15 06:20:00,4,3,6,25,0,1,39
2024-03-15 06:30:00,2,2,8,18,0,0,30
2024-03-15 06:40:00,4,6,5,19,0,1,35
2024-03-15 06:50:00,7,8,10,14,0,0,39
2024-03-15 07:00:00,13,9,11,22,0,0,55
2024-03-15 07:10:00,11,15,15,22,0,1,64
2024-03-15 07:20:00,11,11,13,11,2,2,50
2024-03-15 07:30:00,8,14,15,11,3,1,52
2024-03-15 07:40:00,10,19,14,12,2,2,59
2024-03-15 07:50:00,17,19,12,21,0,3,72
2024-03-15 08:00:00,9,14,13,21,0,2,59
2024-03-15 08:10:00,9,8,16,22,1,4,60
2024-03-15 08:20:00,16,15,15,18,1,2,67
2024-03-15 08:30:00,17,13,12,13,0,2,57
2024-03-15 08:40:00,12,11,14,8,0,3,48
2024-03-15 08:50:00,13,13,23,15,0,2,66
2024-03-15 09:00:00,8,12,18,14,1,4,57
2024-03-15 09:10:00,8,10,13,13,0,2,46
2024-03-15 09:20:00,18,20,16,30,1,3,88
2024-03-15 09:30:00,11,16,21,23,0,3,74
2024-03-15 09:40:00,10,15,12,13,0,6,56
2024-03-15 09:50:00,4,18,18,9,3,2,54
2024-03-15 10:00:00,7,9,27,12,2,6,63
2024-03-15 10:10:00,7,11,15,1,2,2,38
2024-03-15 10:20:00,10,12,19,15,0,1,57
2024-03-15 10:30:00,10,11,16,11,0,5,53
2024-03-15 10:40:00,10,11,15,8,0,1,45
2024-03-15 10:50:00,10,19,12,11,1,2,55
2024-03-15 11:00:00,19,16,14,14,0,1,64
2024-03-15 11:10:00,9,12,17,11,0,1,50
2024-03-15 11:20:00,9,20,20,10,0,1,60
2024-03-15 11:30:00,12,11,24,13,0,1,61
2024-03-15 11:40:00,11,24,25,12,0,4,76
2024-03-15 11:50:00,16,12,17,15,0,2,62
2024-03-15 12:00:00,14,14,21,20,0,2,71
2024-03-15 12:10:00,13,10,22,17,2,0,64
2024-03-15 12:20:00,17,13,24,15,0,1,70
2024-03-15 12:30:00,14,10,14,12,0,6,56
2024-03-15 12:40:00,8,12,24,16,0,4,64
2024-03-15 12:50:00,13,12,19,12,0,2,58
2024-03-15 13:00:00,14,14,21,16,1,1,67
2024-03-15 13:10:00,17,14,26,5,2,6,70
2024-03-15 13:20:00,21,20,19,11,1,3,75
2024-03-15 13:30:00,16,9,18,16,0,2,61
2024-03-15 13:40:00,10,14,23,16,1,2,66
2024-03-15 13:50:00,9,16,15,9,0,1,50
2024-03-15 14:00:00,11,7,24,8,1,3,54
2024-03-15 14:10:00,10,14,23,28,0,2,77
2024-03-15 14:20:00,13,12,14,15,1,3,58
2024-03-15 14:30:00,16,13,25,16,1,3,74
2024-03-15 14:40:00,10,18,25,12,0,1,66
2024-03-15 14:50:00,7,5,20,15,0,3,50
2024-03-15 15:00:00,14,11,17,17,0,5,64
2024-03-15 15:10:00,12,9,18,18,1,1,59
2024-03-15 15:20:00,11,16,19,13,0,4,63
2024-03-15 15:30:00,12,15,17,19,1,9,73
2024-03-15 15:40:00,12,12,23,17,0,1,65
2024-03-15 15:50:00,11,19,18,22,1,0,71
2024-03-15 16:00:00,14,14,12,14,0,2,56
2024-03-15 16:10:00,13,7,18,19,4,1,62
2024-03-15 16:20:00,10,15,18,20,0,0,63
2024-03-15 16:30:00,15,10,13,26,1,2,67
2024-03-15 16:40:00,14,14,18,27,2,7,82
2024-03-15 16:50:00,16,15,15,20,1,2,69
2024-03-15 17:00:00,10,21,19,20,1,0,71
2024-03-15 17:10:00,7,15,14,27,0,3,66
2024-03-15 17:20:00,10,8,16,26,4,3,67
2024-03-15 17:30:00,9,10,16,26,2,4,67
2024-03-15 17:40:00,16,8,10,23,0,4,61
2024-03-15 17:50:00,9,11,10,24,0,1,55
2024-03-15 18:00:00,10,9,17,22,0,0,58
2024-03-15 18:10:00,11,20,21,21,0,1,74
2024-03-15 18:20:00,13,11,11,14,0,3,52
2024-03-15 18:30:00,16,4,13,12,0,8,53
2024-03-15 18:40:00,13,12,24,14,2,1,66
2024-03-15 18:50:00,17,9,9,17,2,3,57
2024-03-15 19:00:00,14,8,11,17,0,1,51
2024-03-15 19:10:00,7,11,10,24,0,1,53
2024-03-15 19:20:00,8,7,10,19,0,0,44
2024-03-15 19:30:00,10,12,5,24,0,1,52
2024-03-15 19:40:00,3,14,11,16,0,2,46
2024-03-15 19:50:00,11,8,6,18,1,1,45
2024-03-15 20:00:00,16,10,10,22,0,1,59
2024-03-15 20:10:00,11,8,12,21,2,1,55
2024-03-15 20:20:00,8,11,10,29,0,0,58
2024-03-15 20:30:00,10,10,7,22,0,0,49
2024-03-15 20:40:00,16,5,7,23,0,0,51
2024-03-15 20:50:00,5,8,4,23,0,1,41
2024-03-15 21:00:00,5,8,11,22,1,3,50
2024-03-15 21:10:00,6,8,8,16,1,2,41
2024-03-15 21:20:00,7,8,5,20,0,0,40
2024-03-15 21:30:00,8,7,7,18,0,1,41
2024-03-15 21:40:00,10,2,6,23,0,1,42
2024-03-15 21:50:00,6,17,10,19,0,0,52
2024-03-15 22:00:00,11,5,4,18,1,1,40
2024-03-15 22:10:00,6,11,7,21,0,0,45
2024-03-15 22:20:00,4,6,9,21,0,0,40
2024-03-15 22:30:00,6,4,6,24,0,0,40
2024-03-15 22:40:00,8,4,5,17,1,1,36
2024-03-15 22:50:00,4,6,5,16,0,0,31
2024-03-15 23:00:00,2,15,7,14,0,1,39
2024-03-15 23:10:00,1,7,7,13,0,0,28
2024-03-15 23:20:00,5,2,4,10,0,0,21
2024-03-15 23:30:00,5,0,2,14,0,1,22
2024-03-15 23:40:00,8,3,3,18,0,0,32
2024-03-15 23:50:00,0,3,3,12,0,0,18
2024-03-16 00:00:00,2,8,6,12,0,0,28
2024-03-16 00:10:00,2,4,6,10,0,0,22
2024-03-16 00:20:00,1,4,2,8,0,0,15
2024-03-16 00:30:00,3,2,6,15,0,0,26
2024-03-16 00:40:00,2,2,2,7,0,1,14
2024-03-16 00:50:00,2,3,1,8,0,0,14
2024-03-16 01:00:00,2,5,2,5,0,0,14
2024-03-16 01:10:00,0,5,4,11,0,0,20
2024-03-16 01:20:00,0,0,5,8,0,0,13
2024-03-16 01:30:00,3,0,2,5,1,0,11
2024-03-16 01:40:00,0,1,3,9,0,0,13
2024-03-16 01:50:00,3,0,2,10,0,0,15
2024-03-16 02:00:00,1,4,0,5,0,0,10
2024-03-16 02:10:00,0,1,2,8,0,0,11
2024-03-16 02:20:00,4,1,0,10,0,0,15
2024-03-16 02:30:00,0,0,1,2,0,0,3
2024-03-16 02:40:00,0,1,2,5,0,0,8
2024-03-16 02:50:00,0,0,1,7,0,0,8
2024-03-16 03:00:00,0,0,2,5,0,0,7
2024-03-16 03:10:00,2,4,2,9,0,0,17
2024-03-16 03:20:00,1,0,0,4,0,0,5
2024-03-16 03:30:00,1,0,0,3,0,0,4
2024-03-16 03:40:00,0,2,1,11,0,0,14
2024-03-16 03:50:00,2,0,0,2,0,0,4
2024-03-16 04:00:00,1,0,0,7,0,0,8
2024-03-16 04:10:00,0,1,0,5,0,0,6
2024-03-16 04:20:00,3,1,0,6,0,0,10
2024-03-16 04:30:00,0,0,1,2,0,0,3
2024-03-16 04:40:00,0,1,0,8,0,0,9
2024-03-16 04:50:00,0,1,2,8,0,0,11
2024-03-16 05:00:00,0,0,2,4,0,0,6
2024-03-16 05:10:00,1,5,0,14,0,0,20
2024-03-16 05:20:00,0,8,2,15,0,1,26
2024-03-16 05:30:00,4,1,3,16,0,1,25
2024-03-16 05:40:00,1,5,2,10,0,0,18
2024-03-16 05:50:00,3,6,2,17,0,0,28
2024-03-16 06:00:00,2,3,0,5,0,0,10
2024-03-16 06:10:00,4,4,3,7,0,0,18
2024-03-16 06:20:00,0,4,2,7,0,0,13
2024-03-16 06:30:00,1,1,2,9,0,0,13
2024-03-16 06:40:00,1,3,4,15,0,0,23
2024-03-16 06:50:00,1,3,3,11,0,1,19
2024-03-16 07:00:00,1,2,1,9,0,0,13
2024-03-16 07:10:00,4,3,1,11,0,0,19
2024-03-16 07:20:00,5,4,4,7,0,1,21
2024-03-16 07:30:00,2,5,5,8,0,0,20
2024-03-16 07:40:00,3,5,8,21,0,0,37
2024-03-16 07:50:00,5,4,1,10,0,0,20
2024-03-16 08:00:00,3,4,3,12,3,1,26
2024-03-16 08:10:00,5,11,2,12,0,0,30
2024-03-16 08:20:00,2,10,5,11,0,0,28
2024-03-16 08:30:00,4,3,2,19,0,0,28
2024-03-16 08:40:00,2,5,6,23,0,0,36
2024-03-16 08:50:00,16,15,4,16,0,1,52
2024-03-16 09:00:00,2,6,7,25,0,0,40
2024-03-16 09:10:00,5,10,5,18,0,4,42
2024-03-16 09:20:00,4,4,9,26,0,5,48
2024-03-16 09:30:00,9,6,12,24,0,6,57
2024-03-16 09:40:00,4,10,6,17,0,3,40
2024-03-16 09:50:00,10,14,10,23,0,1,58
2024-03-16 10:00:00,9,9,8,21,0,1,48
2024-03-16 10:10:00,16,9,12,30,0,1,68
2024-03-16 10:20:00,12,9,6,24,0,1,52
2024-03-16 10:30:00,7,12,11,24,1,1,56
2024-03-16 10:40:00,11,18,10,22,1,6,68
2024-03-16 10:50:00,10,11,11,20,0,4,56
2024-03-16 11:00:00,7,11,13,26,0,3,60
2024-03-16 11:10:00,10,10,9,21,0,1,51
2024-03-16 11:20:00,8,11,10,20,0,1,50
2024-03-16 11:30:00,13,14,9,20,1,2,59
2024-03-16 11:40:00,13,11,13,18,0,2,57
2024-03-16 11:50:00,4,11,8,19,0,4,46
2024-03-16 12:00:00,12,9,15,19,0,2,57
2024-03-16 12:10:00,13,10,18,16,0,2,59
2024-03-16 12:20:00,9,11,15,22,0,3,60
2024-03-16 12:30:00,13,13,8,20,0,3,57
2024-03-16 12:40:00,13,17,12,20,0,0,62
2024-03-16 12:50:00,14,8,10,21,0,0,53
2024-03-16 13:00:00,11,10,11,18,2,7,59
2024-03-16 13:10:00,15,9,10,17,0,4,55
2024-03-16 13:20:00,15,6,8,20,1,2,52
2024-03-16 13:30:00,15,7,11,23,0,1,57
2024-03-16 13:40:00,10,6,12,23,0,3,54
2024-03-16 13:50:00,10,9,10,15,0,1,45
2024-03-16 14:00:00,10,12,18,13,2,1,56
2024-03-16 14:10:00,8,17,14,20,1,0,60
2024-03-16 14:20:00,7,14,16,21,0,0,58
2024-03-16 14:30:00,10,10,9,16,0,3,48
2024-03-16 14:40:00,9,7,10,17,0,3,46
2024-03-16 14:50:00,14,11,17,20,1,2,65
2024-03-16 15:00:00,10,13,16,22,0,2,63
2024-03-16 15:10:00,8,6,14,21,0,2,51
2024-03-16 15:20:00,6,14,16,21,0,1,58
2024-03-16 15:30:00,13,7,9,27,0,0,56
2024-03-16 15:40:00,10,7,13,18,0,1,49
2024-03-16 15:50:00,10,6,13,28,1,1,59
2024-03-16 16:00:00,6,8,16,20,0,1,51
2024-03-16 16:10:00,9,8,11,22,0,1,51
2024-03-16 16:20:00,8,9,12,25,0,3,57
2024-03-16 16:30:00,8,10,15,22,0,4,59
2024-03-16 16:40:00,7,5,21,17,2,4,56
2024-03-16 16:50:00,10,9,14,20,0,3,56
2024-03-16 17:00:00,11,3,14,20,0,3,51
2024-03-16 17:10:00,8,12,7,21,0,2,50
2024-03-16 17:20:00,13,9,16,19,0,1,58
2024-03-16 17:30:00,7,9,13,24,1,2,56
2024-03-16 17:40:00,4,12,11,18,0,0,45
2024-03-16 17:50:00,7,14,13,21,1,4,60
2024-03-16 18:00:00,11,13,16,19,0,3,62
2024-03-16 18:10:00,8,9,13,25,0,4,59
2024-03-16 18:20:00,7,10,15,18,0,2,52
2024-03-16 18:30:00,9,8,11,22,0,2,52
2024-03-16 18:40:00,5,5,14,18,0,1,43
2024-03-16 18:50:00,5,9,11,16,0,2,43
2024-03-16 19:00:00,7,7,11,21,0,1,47
2024-03-16 19:10:00,4,7,10,22,1,1,45
2024-03-16 19:20:00,5,9,6,20,0,3,43
2024-03-16 19:30:00,9,5,8,19,0,0,41
2024-03-16 19:40:00,8,5,8,23,0,1,45
2024-03-16 19:50:00,4,15,8,17,0,2,46
2024-03-16 20:00:00,8,8,10,22,0,1,49
2024-03-16 20:10:00,9,5,4,23,0,0,41
2024-03-16 20:20:00,8,11,9,20,0,2,50
2024-03-16 20:30:00,3,5,3,24,0,1,36
2024-03-16 20:40:00,3,5,4,21,0,1,34
2024-03-16 20:50:00,4,4,2,21,0,1,32
2024-03-16 21:00:00,3,7,5,25,0,0,40
2024-03-16 21:10:00,4,6,5,26,0,1,42
2024-03-16 21:20:00,6,5,6,18,0,0,35
2024-03-16 21:30:00,3,3,7,16,0,0,29
2024-03-16 21:40:00,4,6,5,20,1,1,37
2024-03-16 21:50:00,4,6,6,18,0,1,35
2024-03-16 22:00:00,3,7,6,19,0,1,36
2024-03-16 22:10:00,9,9,10,18,0,0,46
2024-03-16 22:20:00,3,6,6,15,0,0,30
2024-03-16 22:30:00,5,2,6,13,0,0,26
2024-03-16 22:40:00,4,4,8,21,0,0,37
2024-03-16 22:50:00,3,8,7,16,0,0,34
2024-03-16 23:00:00,2,6,2,17,0,1,28
2024-03-16 23:10:00,4,2,6,14,2,0,28
2024-03-16 23:20:00,3,2,4,15,0,0,24
2024-03-16 23:30:00,4,0,2,12,0,0,18
2024-03-16 23:40:00,5,4,5,22,0,2,38
2024-03-16 23:50:00,1,1,8,9,0,0,19
2024-03-17 00:00:00,6,2,1,10,0,0,19
2024-03-17 00:10:00,8,5,5,16,0,0,34
2024-03-17 00:20:00,1,5,3,15,0,0,24
2024-03-17 00:30:00,2,1,3,12,0,0,18
2024-03-17 00:40:00,2,4,7,12,0,0,25
2024-03-17 00:50:00,4,4,7,9,0,0,24
2024-03-17 01:00:00,4,0,1,9,0,1,15
2024-03-17 01:10:00,1,1,3,16,0,0,21
2024-03-17 01:20:00,0,2,4,5,0,0,11
2024-03-17 01:30:00,2,3,1,12,0,0,18
2024-03-17 01:40:00,0,2,1,13,0,0,16
2024-03-17 01:50:00,1,1,2,8,0,0,12
2024-03-17 02:00:00,1,1,5,6,0,0,13
2024-03-17 02:10:00,2,2,5,9,0,0,18
2024-03-17 02:20:00,0,0,0,10,0,0,10
2024-03-17 02:30:00,1,2,0,9,0,0,12
2024-03-17 02:40:00,0,5,1,7,0,0,13
2024-03-17 02:50:00,1,1,2,6,0,0,10
2024-03-17 03:00:00,1,0,0,4,0,0,5
2024-03-17 03:10:00,2,6,2,7,0,0,17
2024-03-17 03:20:00,3,1,0,5,0,0,9
2024-03-17 03:30:00,1,0,2,6,0,0,9
2024-03-17 03:40:00,1,1,1,8,0,0,11
2024-03-17 03:50:00,1,1,0,5,0,0,7
2024-03-17 04:00:00,0,0,1,5,0,0,6
2024-03-17 04:10:00,0,2,1,4,0,0,7
2024-03-17 04:20:00,0,0,2,4,0,0,6
2024-03-17 04:30:00,0,1,1,5,0,0,7
2024-03-17 04:40:00,1,1,1,11,0,0,14
2024-03-17 04:50:00,1,0,2,5,0,0,8
2024-03-17 05:00:00,1,0,2,4,0,0,7
2024-03-17 05:10:00,0,1,2,10,0,0,13
2024-03-17 05:20:00,1,1,7,7,0,0,16
2024-03-17 05:30:00,2,1,6,21,0,0,30
2024-03-17 05:40:00,2,2,4,13,0,0,21
2024-03-17 05:50:00,0,1,4,13,0,1,19
2024-03-17 06:00:00,0,0,1,6,0,0,7
2024-03-17 06:10:00,4,1,2,9,0,0,16
2024-03-17 06:20:00,0,1,1,7,0,0,9
2024-03-17 06:30:00,0,0,4,8,0,0,12
2024-03-17 06:40:00,1,6,2,7,0,0,16
2024-03-17 06:50:00,0,6,1,8,0,0,15
2024-03-17 07:00:00,0,1,5,9,0,0,15
2024-03-17 07:10:00,2,1,0,8,0,0,11
2024-03-17 07:20:00,7,1,1,11,0,0,20
2024-03-17 07:30:00,0,1,1,5,0,0,7
2024-03-17 07:40:00,3,2,2,16,0,0,23
2024-03-17 07:50:00,1,3,1,5,0,0,10
2024-03-17 08:00:00,2,3,3,3,0,0,11
2024-03-17 08:10:00,1,3,1,13,0,0,18
2024-03-17 08:20:00,1,4,3,9,0,0,17
2024-03-17 08:30:00,3,1,3,12,0,0,19
2024-03-17 08:40:00,2,2,2,15,0,0,21
2024-03-17 08:50:00,5,2,3,7,0,0,17
2024-03-17 09:00:00,3,3,3,7,0,1,17
2024-03-17 09:10:00,5,7,1,14,0,0,27
2024-03-17 09:20:00,3,4,6,16,0,0,29
2024-03-17 09:30:00,5,2,7,15,1,1,31
2024-03-17 09:40:00,9,6,7,21,0,0,43
2024-03-17 09:50:00,7,3,10,17,0,1,38
2024-03-17 10:00:00,8,3,3,21,0,0,35
2024-03-17 10:10:00,5,7,6,17,0,1,36
2024-03-17 10:20:00,8,6,3,19,0,0,36
2024-03-17 10:30:00,8,11,10,17,0,0,46
2024-03-17 10:40:00,3,11,7,25,0,0,46
2024-03-17 10:50:00,16,10,4,19,0,0,49
2024-03-17 11:00:00,4,9,3,17,1,0,34
2024-03-17 11:10:00,8,4,1,23,3,0,39
2024-03-17 11:20:00,8,13,11,24,1,0,57
2024-03-17 11:30:00,9,5,3,21,0,0,38
2024-03-17 11:40:00,8,11,9,17,0,0,45
2024-03-17 11:50:00,7,13,7,24,0,2,53
2024-03-17 12:00:00,17,5,12,21,1,0,56
2024-03-17 12:10:00,14,10,16,23,0,2,65
2024-03-17 12:20:00,12,6,12,21,0,0,51
2024-03-17 12:30:00,15,7,9,21,0,1,53
2024-03-17 12:40:00,7,5,9,24,0,0,45
2024-03-17 12:50:00,5,14,5,22,1,1,48
2024-03-17 13:00:00,8,11,8,21,0,2,50
2024-03-17 13:10:00,9,13,11,19,1,2,55
2024-03-17 13:20:00,13,11,4,22,2,0,52
2024-03-17 13:30:00,8,3,5,15,0,2,33
2024-03-17 13:40:00,5,8,11,23,1,2,50
2024-03-17 13:50:00,10,8,8,22,0,1,49
2024-03-17 14:00:00,5,6,9,25,0,4,49
2024-03-17 14:10:00,10,9,8,21,0,0,48
2024-03-17 14:20:00,6,9,9,17,0,2,43
2024-03-17 14:30:00,6,12,10,20,3,2,53
2024-03-17 14:40:00,11,11,9,23,0,0,54
2024-03-17 14:50:00,12,18,12,20,1,9,72
2024-03-17 15:00:00,2,10,10,27,0,1,50
2024-03-17 15:10:00,7,7,12,18,1,1,46
2024-03-17 15:20:00,5,6,10,20,0,1,42
2024-03-17 15:30:00,5,7,11,21,0,3,47
2024-03-17 15:40:00,7,12,9,25,0,2,55
2024-03-17 15:50:00,7,9,6,24,0,0,46
2024-03-17 16:00:00,3,8,12,25,0,5,53
2024-03-17 16:10:00,7,11,12,25,0,0,55
2024-03-17 16:20:00,7,12,11,23,0,0,53
2024-03-17 16:30:00,8,6,9,28,0,2,53
2024-03-17 16:40:00,9,10,9,19,0,0,47
2024-03-17 16:50:00,8,13,10,19,1,3,54
2024-03-17 17:00:00,5,12,10,16,1,0,44
2024-03-17 17:10:00,11,4,8,21,1,2,47
2024-03-17 17:20:00,7,7,12,24,4,2,56
2024-03-17 17:30:00,6,5,12,20,0,3,46
2024-03-17 17:40:00,8,16,6,18,0,0,48
2024-03-17 17:50:00,5,10,9,19,0,2,45
2024-03-17 18:00:00,8,9,11,24,0,1,53
2024-03-17 18:10:00,9,10,17,26,0,2,64
2024-03-17 18:20:00,12,8,8,22,0,0,50
2024-03-17 18:30:00,5,12,6,16,1,0,40
2024-03-17 18:40:00,11,4,8,20,0,0,43
2024-03-17 18:50:00,11,5,6,14,0,1,37
2024-03-17 19:00:00,5,9,6,20,0,0,40
2024-03-17 19:10:00,10,5,7,18,0,0,40
2024-03-17 19:20:00,4,10,4,20,0,0,38
2024-03-17 19:30:00,7,5,5,22,0,2,41
2024-03-17 19:40:00,8,8,5,17,0,2,40
2024-03-17 19:50:00,7,5,7,21,0,0,40
2024-03-17 20:00:00,2,7,8,16,0,2,35
2024-03-17 20:10:00,6,10,12,25,0,0,53
2024-03-17 20:20:00,4,5,3,18,0,0,30
2024-03-17 20:30:00,2,3,4,19,0,3,31
2024-03-17 20:40:00,5,3,9,11,0,0,28
2024-03-17 20:50:00,2,2,3,20,0,0,27
2024-03-17 21:00:00,8,8,5,76,0,0,97
2024-03-17 21:10:00,5,6,5,23,0,1,40
2024-03-17 21:20:00,5,1,5,17,0,0,28
2024-03-17 21:30:00,4,7,2,14,2,1,30
2024-03-17 21:40:00,5,4,3,12,0,0,24
2024-03-17 21:50:00,4,5,4,15,0,1,29
2024-03-17 22:00:00,12,1,7,9,0,0,29
2024-03-17 22:10:00,3,7,5,15,0,0,30
2024-03-17 22:20:00,1,2,1,10,0,0,14
2024-03-17 22:30:00,6,5,6,20,0,0,37
2024-03-17 22:40:00,2,7,1,15,0,0,25
2024-03-17 22:50:00,3,2,1,9,0,0,15
2024-03-17 23:00:00,4,2,1,12,0,0,19
2024-03-17 23:10:00,2,1,1,12,0,0,16
2024-03-17 23:20:00,1,2,1,8,0,0,12
2024-03-17 23:30:00,0,0,1,13,0,0,14
2024-03-17 23:40:00,4,2,2,5,0,0,13
2024-03-17 23:50:00,1,0,1,6,0,0,8
2024-03-18 00:00:00,0,1,1,6,0,0,8
2024-03-18 00:10:00,3,6,2,9,0,0,20
2024-03-18 00:20:00,0,0,0,3,0,0,3
2024-03-18 00:30:00,2,0,1,6,0,0,9
2024-03-18 00:40:00,0,1,2,5,0,0,8
2024-03-18 00:50:00,1,2,0,3,0,0,6
2024-03-18 01:00:00,0,1,3,3,0,0,7
2024-03-18 01:10:00,0,1,2,3,0,0,6
2024-03-18 01:20:00,1,0,4,2,0,0,7
2024-03-18 01:30:00,0,1,2,3,0,0,6
2024-03-18 01:40:00,1,0,0,2,0,0,3
2024-03-18 01:50:00,0,0,0,2,0,0,2
2024-03-18 02:00:00,1,1,0,5,0,0,7
2024-03-18 02:10:00,0,0,0,2,0,0,2
2024-03-18 02:20:00,0,0,0,0,0,0,0
2024-03-18 02:30:00,0,1,1,4,0,0,6
2024-03-18 02:40:00,0,0,0,2,0,0,2
2024-03-18 02:50:00,0,0,0,5,0,0,5
2024-03-18 03:00:00,0,0,0,1,0,0,1
2024-03-18 03:10:00,1,0,1,2,0,0,4
2024-03-18 03:20:00,0,0,0,3,0,1,4
2024-03-18 03:30:00,0,0,0,3,0,0,3
2024-03-18 03:40:00,0,1,0,3,0,0,4
2024-03-18 03:50:00,2,1,1,2,0,0,6
2024-03-18 04:00:00,1,1,2,5,0,0,9
2024-03-18 04:10:00,0,1,0,3,0,0,4
2024-03-18 04:20:00,1,1,2,3,0,0,7
2024-03-18 04:30:00,2,0,1,6,0,0,9
2024-03-18 04:40:00,0,1,3,4,0,0,8
2024-03-18 04:50:00,0,2,2,6,0,0,10
2024-03-18 05:00:00,1,4,3,7,0,0,15
2024-03-18 05:10:00,3,6,2,10,0,0,21
2024-03-18 05:20:00,2,2,4,20,0,0,28
2024-03-18 05:30:00,5,10,3,20,0,0,38
2024-03-18 05:40:00,5,4,5,18,0,0,32
2024-03-18 05:50:00,5,5,5,17,0,0,32
2024-03-18 06:00:00,4,9,4,16,0,0,33
2024-03-18 06:10:00,7,9,9,17,0,0,42
2024-03-18 06:20:00,3,6,8,25,0,1,43
2024-03-18 06:30:00,7,7,14,20,0,2,50
2024-03-18 06:40:00,5,10,5,18,0,2,40
2024-03-18 06:50:00,12,20,10,11,0,0,53
2024-03-18 07:00:00,9,13,12,19,0,2,55
2024-03-18 07:10:00,11,9,10,16,1,1,48
2024-03-18 07:20:00,8,18,17,15,0,1,59
2024-03-18 07:30:00,5,17,15,18,0,9,64
2024-03-18 07:40:00,13,19,18,7,1,13,71
2024-03-18 07:50:00,11,22,10,16,0,2,61
2024-03-18 08:00:00,13,10,11,16,1,1,52
2024-03-18 08:10:00,15,28,17,20,0,2,82
2024-03-18 08:20:00,15,25,19,14,0,2,75
2024-03-18 08:30:00,7,14,11,6,0,1,39
2024-03-18 08:40:00,13,18,12,8,0,4,55
2024-03-18 08:50:00,9,9,22,22,0,3,65
2024-03-18 09:00:00,13,15,9,15,0,1,53
2024-03-18 09:10:00,15,21,14,17,0,3,70
2024-03-18 09:20:00,9,20,17,14,0,6,66
2024-03-18 09:30:00,12,17,21,11,1,5,67
2024-03-18 09:40:00,16,10,22,6,0,1,55
2024-03-18 09:50:00,14,19,10,10,0,2,55
2024-03-18 10:00:00,17,11,14,6,1,1,50
2024-03-18 10:10:00,17,13,21,0,2,3,56
2024-03-18 10:20:00,11,13,15,12,0,1,52
2024-03-18 10:30:00,13,12,13,15,4,2,59
2024-03-18 10:40:00,19,22,19,11,0,1,72
2024-03-18 10:50:00,4,16,17,15,0,1,53
2024-03-18 11:00:00,9,19,30,12,0,1,71
2024-03-18 11:10:00,16,9,12,11,0,2,50
2024-03-18 11:20:00,18,11,19,13,0,0,61
2024-03-18 11:30:00,15,17,17,21,0,1,71
2024-03-18 11:40:00,11,16,19,12,0,2,60
2024-03-18 11:50:00,10,19,10,19,0,0,58
2024-03-18 12:00:00,14,21,15,17,2,4,73
2024-03-18 12:10:00,10,12,20,9,0,2,53
2024-03-18 12:20:00,11,10,12,16,0,1,50
2024-03-18 12:30:00,11,15,21,17,0,3,67
2024-03-18 12:40:00,59,11,16,13,0,5,104
2024-03-18 12:50:00,11,17,19,15,2,4,68
2024-03-18 13:00:00,16,11,16,16,0,5,64
2024-03-18 13:10:00,49,8,24,14,6,8,109
2024-03-18 13:20:00,11,13,16,5,2,2,49
2024-03-18 13:30:00,14,6,14,17,1,3,55
2024-03-18 13:40:00,7,16,20,19,0,3,65
2024-03-18 13:50:00,9,14,17,11,0,4,55
2024-03-18 14:00:00,7,9,18,16,1,4,55
2024-03-18 14:10:00,9,20,26,19,1,5,80
2024-03-18 14:20:00,8,18,22,14,1,5,68
2024-03-18 14:30:00,11,7,20,17,1,5,61
2024-03-18 14:40:00,13,12,25,11,0,3,64
2024-03-18 14:50:00,12,15,15,21,1,3,67
2024-03-18 15:00:00,9,17,11,18,0,2,57
2024-03-18 15:10:00,9,18,19,11,1,4,62
2024-03-18 15:20:00,9,20,18,1,0,2,50
2024-03-18 15:30:00,20,11,17,8,2,8,66
2024-03-18 15:40:00,12,14,26,7,1,5,65
2024-03-18 15:50:00,6,7,18,17,0,2,50
2024-03-18 16:00:00,10,12,22,9,1,3,57
2024-03-18 16:10:00,8,18,23,14,0,6,69
2024-03-18 16:20:00,8,21,20,18,0,2,69
2024-03-18 16:30:00,12,10,20,15,0,7,64
2024-03-18 16:40:00,10,18,24,10,0,2,64
2024-03-18 16:50:00,19,25,14,23,2,8,91
2024-03-18 17:00:00,13,15,26,15,2,2,73
2024-03-18 17:10:00,15,13,19,13,0,1,61
2024-03-18 17:20:00,16,10,24,24,0,3,77
2024-03-18 17:30:00,14,8,22,25,2,1,72
2024-03-18 17:40:00,12,17,22,23,1,3,78
2024-03-18 17:50:00,10,10,20,17,5,4,66
2024-03-18 18:00:00,17,23,15,17,0,0,72
2024-03-18 18:10:00,12,16,11,15,0,3,57
2024-03-18 18:20:00,6,12,15,23,0,0,56
2024-03-18 18:30:00,11,12,17,18,0,0,58
2024-03-18 18:40:00,26,18,22,12,2,2,82
2024-03-18 18:50:00,11,11,7,25,0,3,57
2024-03-18 19:00:00,12,12,13,23,1,3,64
2024-03-18 19:10:00,9,7,10,17,1,2,46
2024-03-18 19:20:00,7,14,14,15,0,1,51
2024-03-18 19:30:00,12,6,9,20,0,5,52
2024-03-18 19:40:00,14,8,9,16,0,0,47
2024-03-18 19:50:00,4,12,8,21,0,4,49
2024-03-18 20:00:00,3,10,14,20,0,1,48
2024-03-18 20:10:00,3,4,11,16,0,0,34
2024-03-18 20:20:00,7,8,4,18,0,0,37
2024-03-18 20:30:00,9,4,7,16,0,0,36
2024-03-18 20:40:00,5,5,4,17,1,2,34
2024-03-18 20:50:00,2,8,4,16,0,1,31
2024-03-18 21:00:00,9,7,9,14,1,0,40
2024-03-18 21:10:00,4,12,14,15,1,0,46
2024-03-18 21:20:00,3,10,5,13,0,0,31
2024-03-18 21:30:00,10,9,7,11,0,0,37
2024-03-18 21:40:00,9,4,7,15,0,0,35
2024-03-18 21:50:00,7,9,7,15,0,1,39
2024-03-18 22:00:00,8,13,5,13,0,0,39
2024-03-18 22:10:00,1,5,6,16,0,0,28
2024-03-18 22:20:00,2,4,12,18,0,2,38
2024-03-18 22:30:00,6,2,4,17,0,0,29
2024-03-18 22:40:00,4,2,6,16,0,0,28
2024-03-18 22:50:00,4,2,6,11,0,0,23
2024-03-18 23:00:00,4,2,4,12,0,0,22
2024-03-18 23:10:00,3,7,5,13,0,0,28
2024-03-18 23:20:00,2,4,2,9,0,0,17
2024-03-18 23:30:00,2,0,2,9,0,0,13
2024-03-18 23:40:00,7,1,2,13,0,0,23
2024-03-18 23:50:00,2,2,2,7,0,0,13
2024-03-19 00:00:00,0,2,4,8,0,0,14
2024-03-19 00:10:00,5,4,3,5,0,0,17
2024-03-19 00:20:00,0,1,0,7,0,0,8
2024-03-19 00:30:00,0,0,3,5,0,0,8
2024-03-19 00:40:00,0,2,3,4,0,0,9
2024-03-19 00:50:00,0,1,1,5,0,1,8
2024-03-19 01:00:00,0,0,0,6,0,0,6
2024-03-19 01:10:00,1,1,2,4,0,0,8
2024-03-19 01:20:00,0,0,2,6,0,0,8
2024-03-19 01:30:00,1,0,2,4,0,0,7
2024-03-19 01:40:00,0,0,0,5,0,0,5
2024-03-19 01:50:00,1,0,2,4,0,0,7
2024-03-19 02:00:00,0,0,2,1,0,0,3
2024-03-19 02:10:00,0,1,0,3,0,0,4
2024-03-19 02:20:00,1,0,0,6,0,0,7
2024-03-19 02:30:00,3,0,0,3,0,0,6
2024-03-19 02:40:00,0,0,0,2,0,0,2
2024-03-19 02:50:00,0,0,1,4,0,0,5
2024-03-19 03:00:00,0,1,0,6,0,0,7
2024-03-19 03:10:00,0,1,1,5,0,0,7
2024-03-19 03:20:00,0,3,0,2,0,0,5
2024-03-19 03:30:00,0,1,1,6,0,0,8
2024-03-19 03:40:00,0,0,1,2,0,0,3
2024-03-19 03:50:00,0,0,1,4,0,0,5
2024-03-19 04:00:00,2,0,2,4,0,0,8
2024-03-19 04:10:00,0,1,0,2,0,0,3
2024-03-19 04:20:00,1,1,1,6,0,0,9
2024-03-19 04:30:00,0,0,0,3,0,0,3
2024-03-19 04:40:00,2,2,6,6,0,0,16
2024-03-19 04:50:00,0,1,1,6,0,0,8
2024-03-19 05:00:00,0,4,3,6,0,0,13
2024-03-19 05:10:00,3,9,1,9,0,0,22
2024-03-19 05:20:00,3,5,7,16,0,0,31
2024-03-19 05:30:00,1,6,2,18,0,0,27
2024-03-19 05:40:00,4,6,2,12,0,1,25
2024-03-19 05:50:00,9,6,8,22,0,0,45
2024-03-19 06:00:00,5,5,2,20,0,0,32
2024-03-19 06:10:00,3,6,4,19,0,1,33
2024-03-19 06:20:00,2,5,8,17,0,0,32
2024-03-19 06:30:00,5,3,9,18,0,1,36
2024-03-19 06:40:00,6,7,8,23,0,0,44
2024-03-19 06:50:00,7,14,12,19,0,1,53
2024-03-19 07:00:00,5,11,10,34,0,0,60
2024-03-19 07:10:00,12,10,14,20,2,2,60
2024-03-19 07:20:00,8,18,7,12,0,2,47
2024-03-19 07:30:00,14,15,16,24,0,3,72
2024-03-19 07:40:00,11,22,15,20,0,1,69
2024-03-19 07:50:00,13,17,13,6,0,6,55
2024-03-19 08:00:00,14,13,17,18,0,1,63
2024-03-19 08:10:00,19,19,12,11,0,1,62
2024-03-19 08:20:00,7,17,17,14,0,1,56
2024-03-19 08:30:00,13,15,17,16,0,1,62
2024-03-19 08:40:00,16,18,16,10,1,1,62
2024-03-19 08:50:00,9,13,13,10,0,1,46
2024-03-19 09:00:00,11,13,18,17,1,1,61
2024-03-19 09:10:00,14,12,17,16,0,1,60
2024-03-19 09:20:00,16,12,11,14,0,2,55
2024-03-19 09:30:00,11,15,19,25,0,2,72
2024-03-19 09:40:00,12,17,15,12,1,4,61
2024-03-19 09:50:00,12,11,21,19,0,2,65
2024-03-19 10:00:00,10,13,17,12,1,2,55
2024-03-19 10:10:00,9,11,11,9,0,1,41
2024-03-19 10:20:00,7,21,13,18,1,4,64
2024-03-19 10:30:00,7,20,10,9,0,1,47
2024-03-19 10:40:00,16,15,16,19,0,1,67
2024-03-19 10:50:00,10,19,16,13,0,3,61
2024-03-19 11:00:00,6,17,20,16,0,2,61
2024-03-19 11:10:00,10,8,23,9,1,1,52
2024-03-19 11:20:00,12,35,23,8,0,1,79
2024-03-19 11:30:00,12,9,15,17,1,1,55
2024-03-19 11:40:00,12,10,15,19,1,2,59
2024-03-19 11:50:00,7,10,16,8,0,1,42
2024-03-19 12:00:00,18,13,17,20,0,3,71
2024-03-19 12:10:00,10,8,19,18,0,3,58
2024-03-19 12:20:00,10,11,19,16,1,3,60
2024-03-19 12:30:00,14,11,12,21,2,2,62
2024-03-19 12:40:00,9,22,19,20,1,0,71
2024-03-19 12:50:00,13,11,23,19,0,1,67
2024-03-19 13:00:00,11,12,17,14,0,2,56
2024-03-19 13:10:00,13,6,18,26,5,3,71
2024-03-19 13:20:00,10,9,19,17,0,1,56
2024-03-19 13:30:00,37,11,18,18,1,1,86
2024-03-19 13:40:00,11,13,22,12,1,3,62
2024-03-19 13:50:00,12,14,16,20,2,3,67
2024-03-19 14:00:00,12,14,18,25,0,0,69
2024-03-19 14:10:00,9,14,18,9,1,4,55
2024-03-19 14:20:00,14,20,17,15,0,5,71
2024-03-19 14:30:00,13,16,19,10,0,4,62
2024-03-19 14:40:00,16,12,15,17,0,2,62
2024-03-19 14:50:00,11,22,19,10,0,2,64
2024-03-19 15:00:00,10,11,21,15,2,3,62
2024-03-19 15:10:00,15,12,15,1,1,3,47
2024-03-19 15:20:00,13,11,19,6,1,3,53
2024-03-19 15:30:00,16,15,31,25,1,4,92
2024-03-19 15:40:00,9,16,27,14,1,2,69
2024-03-19 15:50:00,8,16,18,12,1,3,58
2024-03-19 16:00:00,10,14,20,21,1,4,70
2024-03-19 16:10:00,11,16,22,14,1,3,67
2024-03-19 16:20:00,17,13,19,22,0,3,74
2024-03-19 16:30:00,10,12,28,14,1,1,66
2024-03-19 16:40:00,4,17,24,14,2,2,63
2024-03-19 16:50:00,12,23,17,21,0,5,78
2024-03-19 17:00:00,11,16,19,19,0,2,67
2024-03-19 17:10:00,11,29,16,12,0,1,69
2024-03-19 17:20:00,13,16,13,18,0,0,60
2024-03-19 17:30:00,13,13,19,26,0,1,72
2024-03-19 17:40:00,14,22,19,25,0,2,82
2024-03-19 17:50:00,8,12,15,5,0,2,42
2024-03-19 18:00:00,11,14,9,8,0,5,47
2024-03-19 18:10:00,15,10,15,6,0,2,48
2024-03-19 18:20:00,9,12,20,21,0,2,64
2024-03-19 18:30:00,11,11,16,31,1,3,73
2024-03-19 18:40:00,10,11,14,18,0,1,54
2024-03-19 18:50:00,15,11,10,26,0,0,62
2024-03-19 19:00:00,8,6,15,19,0,1,49
2024-03-19 19:10:00,10,8,12,19,0,2,51
2024-03-19 19:20:00,6,13,13,19,0,4,55
2024-03-19 19:30:00,13,6,13,19,0,0,51
2024-03-19 19:40:00,12,12,11,19,0,4,58
2024-03-19 19:50:00,9,13,9,23,0,0,54
2024-03-19 20:00:00,14,11,15,14,0,2,56
2024-03-19 20:10:00,6,4,12,19,1,0,42
2024-03-19 20:20:00,5,6,7,21,0,2,41
2024-03-19 20:30:00,9,3,9,20,0,2,43
2024-03-19 20:40:00,7,6,7,17,1,0,38
2024-03-19 20:50:00,5,12,9,21,3,0,50
2024-03-19 21:00:00,5,6,8,21,0,0,40
2024-03-19 21:10:00,5,5,6,16,0,2,34
2024-03-19 21:20:00,1,6,6,18,0,0,31
2024-03-19 21:30:00,10,2,10,22,0,2,46
2024-03-19 21:40:00,8,6,3,25,0,0,42
2024-03-19 21:50:00,2,5,9,7,0,0,23
2024-03-19 22:00:00,7,5,8,18,0,0,38
2024-03-19 22:10:00,15,3,5,15,0,0,38
2024-03-19 22:20:00,5,2,3,15,0,0,25
2024-03-19 22:30:00,1,6,0,17,0,1,25
2024-03-19 22:40:00,4,6,4,12,0,1,27
2024-03-19 22:50:00,4,1,2,10,0,0,17
2024-03-19 23:00:00,4,1,7,11,0,0,23
2024-03-19 23:10:00,4,10,4,8,0,1,27
2024-03-19 23:20:00,0,4,3,6,0,0,13
2024-03-19 23:30:00,3,0,2,9,0,0,14
2024-03-19 23:40:00,6,4,5,12,0,0,27
2024-03-19 23:50:00,3,0,2,7,3,1,16
2024-03-20 00:00:00,1,1,1,9,1,0,13
2024-03-20 00:10:00,3,5,4,6,0,0,18
2024-03-20 00:20:00,2,2,2,4,0,0,10
2024-03-20 00:30:00,0,0,1,3,0,1,5
2024-03-20 00:40:00,0,1,3,13,0,0,17
2024-03-20 00:50:00,0,1,2,4,0,0,7
2024-03-20 01:00:00,0,0,3,1,0,0,4
2024-03-20 01:10:00,0,3,3,6,0,0,12
2024-03-20 01:20:00,1,1,4,6,0,0,12
2024-03-20 01:30:00,0,0,2,3,0,0,5
2024-03-20 01:40:00,0,2,2,4,0,0,8
2024-03-20 01:50:00,1,1,2,5,0,0,9
2024-03-20 02:00:00,0,3,2,3,0,0,8
2024-03-20 02:10:00,0,2,0,3,0,0,5
2024-03-20 02:20:00,0,1,1,2,0,1,5
2024-03-20 02:30:00,0,0,1,3,0,0,4
2024-03-20 02:40:00,0,0,1,3,0,0,4
2024-03-20 02:50:00,0,0,2,5,0,0,7
2024-03-20 03:00:00,0,0,0,6,0,0,6
2024-03-20 03:10:00,0,0,2,2,0,0,4
2024-03-20 03:20:00,0,0,0,3,0,0,3
2024-03-20 03:30:00,0,0,0,4,0,0,4
2024-03-20 03:40:00,0,0,0,3,0,0,3
2024-03-20 03:50:00,0,0,1,4,0,0,5
2024-03-20 04:00:00,0,0,0,5,0,0,5
2024-03-20 04:10:00,0,2,1,4,0,0,7
2024-03-20 04:20:00,2,0,0,1,0,0,3
2024-03-20 04:30:00,0,0,2,5,0,0,7
2024-03-20 04:40:00,0,1,5,4,0,0,10
2024-03-20 04:50:00,2,1,2,9,0,0,14
2024-03-20 05:00:00,0,2,6,6,0,0,14
2024-03-20 05:10:00,4,10,1,11,0,0,26
2024-03-20 05:20:00,3,3,2,14,0,1,23
2024-03-20 05:30:00,1,8,2,21,0,0,32
2024-03-20 05:40:00,3,11,4,12,0,1,31
2024-03-20 05:50:00,10,9,5,20,0,0,44
2024-03-20 06:00:00,3,4,5,16,0,0,28
2024-03-20 06:10:00,3,6,6,23,0,0,38
2024-03-20 06:20:00,3,6,9,19,0,1,38
2024-03-20 06:30:00,3,9,8,20,0,0,40
2024-03-20 06:40:00,4,7,11,23,0,1,46
2024-03-20 06:50:00,7,9,8,22,0,1,47
2024-03-20 07:00:00,6,11,11,16,0,1,45
2024-03-20 07:10:00,12,20,10,21,0,0,63
2024-03-20 07:20:00,19,12,16,17,0,3,67
2024-03-20 07:30:00,17,12,16,25,1,3,74
2024-03-20 07:40:00,16,16,17,14,0,8,71
2024-03-20 07:50:00,17,11,10,19,0,1,58
2024-03-20 08:00:00,8,19,15,25,0,1,68
2024-03-20 08:10:00,13,18,14,19,0,0,64
2024-03-20 08:20:00,10,13,14,18,0,1,56
2024-03-20 08:30:00,12,11,11,23,1,2,60
2024-03-20 08:40:00,12,12,18,15,2,0,59
2024-03-20 08:50:00,15,13,14,18,0,2,62
2024-03-20 09:00:00,11,8,11,19,0,3,52
2024-03-20 09:10:00,8,13,17,19,0,4,61
2024-03-20 09:20:00,15,15,16,14,4,6,70
2024-03-20 09:30:00,10,19,14,11,7,4,65
2024-03-20 09:40:00,16,13,19,17,1,5,71
2024-03-20 09:50:00,12,11,13,9,1,2,48
2024-03-20 10:00:00,18,22,11,2,0,1,54
2024-03-20 10:10:00,14,20,11,15,0,3,63
2024-03-20 10:20:00,13,19,19,22,0,5,78
2024-03-20 10:30:00,16,13,16,16,1,1,63
2024-03-20 10:40:00,31,14,13,17,0,6,81
2024-03-20 10:50:00,13,17,11,17,1,5,64
2024-03-20 11:00:00,13,14,21,20,0,0,68
2024-03-20 11:10:00,14,11,13,1,0,7,46
2024-03-20 11:20:00,10,15,16,9,1,1,52
2024-03-20 11:30:00,12,12,20,20,0,4,68
2024-03-20 11:40:00,14,19,18,19,2,1,73
2024-03-20 11:50:00,10,16,18,29,1,2,76
2024-03-20 12:00:00,15,18,24,17,3,3,80
2024-03-20 12:10:00,16,22,16,24,2,6,86
2024-03-20 12:20:00,22,16,13,20,1,5,77
2024-03-20 12:30:00,17,12,14,16,2,2,63
2024-03-20 12:40:00,12,24,14,10,0,4,64
2024-03-20 12:50:00,11,14,21,28,0,3,77
2024-03-20 13:00:00,8,21,18,22,2,6,77
2024-03-20 13:10:00,16,15,21,28,4,2,86
2024-03-20 13:20:00,9,27,15,22,0,1,74
2024-03-20 13:30:00,13,13,19,25,1,3,74
2024-03-20 13:40:00,7,9,17,14,1,4,52
2024-03-20 13:50:00,10,9,19,10,0,8,56
2024-03-20 14:00:00,12,21,19,19,1,3,75
2024-03-20 14:10:00,10,10,19,21,0,4,64
2024-03-20 14:20:00,16,18,17,18,3,5,77
2024-03-20 14:30:00,16,14,23,17,1,2,73
2024-03-20 14:40:00,15,15,16,10,0,2,58
2024-03-20 14:50:00,11,10,22,16,2,3,64
2024-03-20 15:00:00,14,23,17,11,0,1,66
2024-03-20 15:10:00,13,16,23,18,5,4,79
2024-03-20 15:20:00,9,15,19,19,2,1,65
2024-03-20 15:30:00,11,15,25,20,1,3,75
2024-03-20 15:40:00,10,16,25,23,0,4,78
2024-03-20 15:50:00,9,17,22,15,0,3,66
2024-03-20 16:00:00,15,15,27,12,0,2,71
2024-03-20 16:10:00,19,18,22,22,2,1,84
2024-03-20 16:20:00,15,18,13,22,2,12,82
2024-03-20 16:30:00,12,21,16,14,0,4,67
2024-03-20 16:40:00,11,18,25,8,0,2,64
2024-03-20 16:50:00,11,15,15,14,0,4,59
2024-03-20 17:00:00,11,12,21,24,0,3,71
2024-03-20 17:10:00,8,24,20,9,0,4,65
2024-03-20 17:20:00,17,13,20,10,0,1,61
2024-03-20 17:30:00,9,18,16,18,1,12,74
2024-03-20 17:40:00,19,18,17,9,1,1,65
2024-03-20 17:50:00,13,15,15,11,1,3,58
2024-03-20 18:00:00,10,8,18,17,3,2,58
2024-03-20 18:10:00,10,16,19,28,0,7,80
2024-03-20 18:20:00,6,13,21,21,1,1,63
2024-03-20 18:30:00,9,19,11,20,0,3,62
2024-03-20 18:40:00,15,7,22,15,0,0,59
2024-03-20 18:50:00,7,12,16,17,0,2,54
2024-03-20 19:00:00,7,7,12,26,0,2,54
2024-03-20 19:10:00,7,6,13,22,0,0,48
2024-03-20 19:20:00,12,9,9,16,0,1,47
2024-03-20 19:30:00,14,8,16,20,0,0,58
2024-03-20 19:40:00,9,9,10,22,0,1,51
2024-03-20 19:50:00,7,10,16,23,0,2,58
2024-03-20 20:00:00,11,9,1,19,0,2,42
2024-03-20 20:10:00,7,7,10,26,0,1,51
2024-03-20 20:20:00,5,6,12,21,0,1,45
2024-03-20 20:30:00,7,3,10,11,0,0,31
2024-03-20 20:40:00,5,7,6,12,1,1,32
2024-03-20 20:50:00,2,12,8,17,0,1,40
2024-03-20 21:00:00,8,10,8,20,0,4,50
2024-03-20 21:10:00,6,8,8,11,0,2,35
2024-03-20 21:20:00,8,9,10,18,0,0,45
2024-03-20 21:30:00,7,9,11,24,1,2,54
2024-03-20 21:40:00,8,4,6,19,0,3,40
2024-03-20 21:50:00,6,9,9,17,0,0,41
2024-03-20 22:00:00,5,8,8,16,0,2,39
2024-03-20 22:10:00,4,5,9,20,0,1,39
2024-03-20 22:20:00,2,5,8,14,0,0,29
2024-03-20 22:30:00,4,3,4,14,0,2,27
2024-03-20 22:40:00,5,2,12,16,0,0,35
2024-03-20 22:50:00,12,2,3,14,0,0,31
2024-03-20 23:00:00,4,2,3,16,0,0,25
2024-03-20 23:10:00,4,7,8,18,0,0,37
2024-03-20 23:20:00,0,4,2,7,0,0,13
2024-03-20 23:30:00,7,0,2,8,0,0,17
2024-03-20 23:40:00,2,4,6,8,0,0,20
2024-03-20 23:50:00,1,2,1,12,0,1,17
2024-03-21 00:00:00,0,1,1,4,0,1,7
2024-03-21 00:10:00,4,3,3,13,0,0,23
2024-03-21 00:20:00,0,2,1,5,0,0,8
2024-03-21 00:30:00,1,0,2,6,0,0,9
2024-03-21 00:40:00,1,2,3,13,0,0,19
2024-03-21 00:50:00,1,3,2,7,0,0,13
2024-03-21 01:00:00,1,1,4,2,0,0,8
2024-03-21 01:10:00,0,0,1,4,0,0,5
2024-03-21 01:20:00,1,0,2,7,0,0,10
2024-03-21 01:30:00,0,1,0,6,0,0,7
2024-03-21 01:40:00,1,1,1,5,0,0,8
2024-03-21 01:50:00,0,2,0,4,0,0,6
2024-03-21 02:00:00,0,0,0,1,0,0,1
2024-03-21 02:10:00,0,1,1,1,0,0,3
2024-03-21 02:20:00,0,2,0,3,0,0,5
2024-03-21 02:30:00,0,1,1,2,0,0,4
2024-03-21 02:40:00,1,1,1,3,0,0,6
2024-03-21 02:50:00,0,1,1,6,0,0,8
2024-03-21 03:00:00,0,1,0,3,0,0,4
2024-03-21 03:10:00,1,0,2,2,0,0,5
2024-03-21 03:20:00,0,0,0,3,0,0,3
2024-03-21 03:30:00,0,0,2,5,0,0,7
2024-03-21 03:40:00,0,1,0,5,0,0,6
2024-03-21 03:50:00,2,0,1,1,0,0,4
2024-03-21 04:00:00,0,1,1,8,0,0,10
2024-03-21 04:10:00,3,1,2,3,0,0,9
2024-03-21 04:20:00,1,2,2,2,0,0,7
2024-03-21 04:30:00,1,2,1,4,0,0,8
2024-03-21 04:40:00,0,1,3,7,0,0,11
2024-03-21 04:50:00,0,1,1,8,0,0,10
2024-03-21 05:00:00,0,3,1,10,0,0,14
2024-03-21 05:10:00,3,8,1,8,0,0,20
2024-03-21 05:20:00,1,6,1,15,0,0,23
2024-03-21 05:30:00,2,5,3,38,0,0,48
2024-03-21 05:40:00,5,8,5,12,0,0,30
2024-03-21 05:50:00,5,6,3,19,0,0,33
2024-03-21 06:00:00,3,2,4,18,0,0,27
2024-03-21 06:10:00,3,6,3,18,0,0,30
2024-03-21 06:20:00,3,7,6,19,0,0,35
2024-03-21 06:30:00,6,7,10,16,0,1,40
2024-03-21 06:40:00,5,7,6,17,0,1,36
2024-03-21 06:50:00,6,6,11,26,0,1,50
2024-03-21 07:00:00,8,10,11,25,0,2,56
2024-03-21 07:10:00,16,14,13,25,0,2,70
2024-03-21 07:20:00,8,7,13,20,0,3,51
2024-03-21 07:30:00,15,15,20,17,1,2,70
2024-03-21 07:40:00,9,18,23,12,3,10,75
2024-03-21 07:50:00,6,10,12,12,0,3,43
2024-03-21 08:00:00,12,14,10,19,1,2,58
2024-03-21 08:10:00,11,19,8,21,1,3,63
2024-03-21 08:20:00,8,13,10,22,0,2,55
2024-03-21 08:30:00,13,7,15,14,0,6,55
2024-03-21 08:40:00,8,11,17,7,0,2,45
2024-03-21 08:50:00,8,15,13,25,0,2,63
2024-03-21 09:00:00,18,14,17,14,1,1,65
2024-03-21 09:10:00,19,9,16,18,3,5,70
2024-03-21 09:20:00,13,0,14,24,0,1,52
2024-03-21 09:30:00,15,12,16,22,0,4,69
2024-03-21 09:40:00,19,9,11,22,2,4,67
2024-03-21 09:50:00,14,11,23,28,0,0,76
2024-03-21 10:00:00,13,15,21,20,0,2,71
2024-03-21 10:10:00,13,10,18,6,0,3,50
2024-03-21 10:20:00,7,14,14,10,1,2,48
2024-03-21 10:30:00,17,13,19,15,0,5,69
2024-03-21 10:40:00,15,17,20,21,3,5,81
2024-03-21 10:50:00,15,21,19,21,0,1,77
2024-03-21 11:00:00,10,12,13,20,0,2,57
2024-03-21 11:10:00,14,17,16,15,1,4,67
2024-03-21 11:20:00,16,17,13,16,0,5,67
2024-03-21 11:30:00,13,15,12,24,1,4,69
2024-03-21 11:40:00,16,15,23,18,0,0,72
2024-03-21 11:50:00,10,14,14,17,0,5,60
2024-03-21 12:00:00,15,7,23,10,0,3,58
2024-03-21 12:10:00,11,18,18,17,0,5,69
2024-03-21 12:20:00,6,10,23,23,1,0,63
2024-03-21 12:30:00,14,14,26,20,0,1,75
2024-03-21 12:40:00,15,13,16,13,0,5,62
2024-03-21 12:50:00,17,25,22,8,0,1,73
2024-03-21 13:00:00,12,15,19,12,2,2,62
2024-03-21 13:10:00,23,16,23,3,1,7,73
2024-03-21 13:20:00,12,12,18,15,0,3,60
2024-03-21 13:30:00,12,18,12,19,1,3,65
2024-03-21 13:40:00,19,8,15,28,1,1,72
2024-03-21 13:50:00,10,13,22,14,1,5,65
2024-03-21 14:00:00,8,18,22,20,0,3,71
2024-03-21 14:10:00,13,9,20,15,0,1,58
2024-03-21 14:20:00,15,9,16,14,1,1,56
2024-03-21 14:30:00,8,11,22,13,0,1,55
2024-03-21 14:40:00,12,20,13,16,1,3,65
2024-03-21 14:50:00,17,14,21,9,3,1,65
2024-03-21 15:00:00,12,24,19,22,2,4,83
2024-03-21 15:10:00,14,22,20,20,0,3,79
2024-03-21 15:20:00,10,19,20,20,0,2,71
2024-03-21 15:30:00,12,15,17,12,0,5,61
2024-03-21 15:40:00,14,15,25,15,0,4,73
2024-03-21 15:50:00,10,16,23,10,2,5,66
2024-03-21 16:00:00,11,16,19,17,0,2,65
2024-03-21 16:10:00,11,15,14,14,0,7,61
2024-03-21 16:20:00,13,16,18,8,0,4,59
2024-03-21 16:30:00,14,19,27,24,0,5,89
2024-03-21 16:40:00,13,8,25,21,0,3,70
2024-03-21 16:50:00,11,12,21,9,1,2,56
2024-03-21 17:00:00,6,8,19,23,1,2,59
2024-03-21 17:10:00,11,15,20,22,0,2,70
2024-03-21 17:20:00,11,17,17,17,1,2,65
2024-03-21 17:30:00,8,17,17,24,0,3,69
2024-03-21 17:40:00,13,15,16,13,0,1,58
2024-03-21 17:50:00,10,18,19,15,0,10,72
2024-03-21 18:00:00,11,9,15,23,0,5,63
2024-03-21 18:10:00,13,18,19,19,0,3,72
2024-03-21 18:20:00,9,18,20,23,0,4,74
2024-03-21 18:30:00,14,8,13,17,2,4,58
2024-03-21 18:40:00,11,15,16,18,0,1,61
2024-03-21 18:50:00,14,15,12,20,0,3,64
2024-03-21 19:00:00,12,7,12,19,1,2,53
2024-03-21 19:10:00,14,9,17,17,0,0,57
2024-03-21 19:20:00,6,15,13,20,1,1,56
2024-03-21 19:30:00,12,8,11,24,0,0,55
2024-03-21 19:40:00,10,10,8,18,0,1,47
2024-03-21 19:50:00,5,8,12,19,0,0,44
2024-03-21 20:00:00,9,12,12,20,0,0,53
2024-03-21 20:10:00,9,5,9,21,0,2,46
2024-03-21 20:20:00,8,13,8,20,0,2,51
2024-03-21 20:30:00,7,5,5,18,2,1,38
2024-03-21 20:40:00,6,7,5,21,0,4,43
2024-03-21 20:50:00,7,7,7,19,0,0,40
2024-03-21 21:00:00,2,6,4,15,0,1,28
2024-03-21 21:10:00,8,7,8,12,0,0,35
2024-03-21 21:20:00,3,7,6,18,0,0,34
2024-03-21 21:30:00,10,6,4,26,0,2,48
2024-03-21 21:40:00,7,6,4,21,1,0,39
2024-03-21 21:50:00,1,7,7,15,0,2,32
2024-03-21 22:00:00,3,8,5,20,0,0,36
2024-03-21 22:10:00,3,7,8,20,0,0,38
2024-03-21 22:20:00,7,7,3,16,0,0,33
2024-03-21 22:30:00,7,3,8,14,2,1,35
2024-03-21 22:40:00,4,5,3,14,0,1,27
2024-03-21 22:50:00,5,10,2,14,0,0,31
2024-03-21 23:00:00,2,6,1,8,0,1,18
2024-03-21 23:10:00,2,4,4,9,0,0,19
2024-03-21 23:20:00,6,5,4,11,0,0,26
2024-03-21 23:30:00,5,1,5,11,0,1,23
2024-03-21 23:40:00,6,3,3,11,0,0,23
2024-03-21 23:50:00,0,3,1,8,0,0,12
2024-03-22 00:00:00,3,2,3,7,0,0,15
2024-03-22 00:10:00,3,6,3,9,0,0,21
2024-03-22 00:20:00,2,0,3,8,0,0,13
2024-03-22 00:30:00,0,1,1,10,0,1,13
2024-03-22 00:40:00,3,3,2,9,0,0,17
2024-03-22 00:50:00,1,1,1,7,0,1,11
2024-03-22 01:00:00,0,1,1,4,0,0,6
2024-03-22 01:10:00,1,2,1,6,0,0,10
2024-03-22 01:20:00,0,0,1,4,0,1,6
2024-03-22 01:30:00,1,2,2,2,0,0,7
2024-03-22 01:40:00,0,0,0,3,0,0,3
2024-03-22 01:50:00,1,0,1,6,0,0,8
2024-03-22 02:00:00,0,0,1,3,0,0,4
2024-03-22 02:10:00,0,2,0,5,0,0,7
2024-03-22 02:20:00,0,2,3,4,0,0,9
2024-03-22 02:30:00,2,0,2,5,0,1,10
2024-03-22 02:40:00,2,0,1,4,0,0,7
2024-03-22 02:50:00,0,0,0,5,0,0,5
2024-03-22 03:00:00,0,0,0,1,0,0,1
2024-03-22 03:10:00,0,0,1,2,0,0,3
2024-03-22 03:20:00,0,0,1,3,0,0,4
2024-03-22 03:30:00,1,0,1,3,0,0,5
2024-03-22 03:40:00,0,0,0,4,0,0,4
2024-03-22 03:50:00,1,0,0,1,0,0,2
2024-03-22 04:00:00,1,1,0,4,0,0,6
2024-03-22 04:10:00,0,2,2,4,0,0,8
2024-03-22 04:20:00,1,0,1,3,0,0,5
2024-03-22 04:30:00,0,1,1,5,0,0,7
2024-03-22 04:40:00,1,2,5,1,0,0,9
2024-03-22 04:50:00,1,1,1,6,0,0,9
2024-03-22 05:00:00,0,2,1,8,0,0,11
2024-03-22 05:10:00,1,7,1,13,0,0,22
2024-03-22 05:20:00,4,4,1,11,0,0,20
2024-03-22 05:30:00,3,7,2,20,0,0,32
2024-03-22 05:40:00,5,6,5,24,0,1,41
2024-03-22 05:50:00,4,9,4,14,0,0,31
2024-03-22 06:00:00,4,3,2,15,0,0,24
2024-03-22 06:10:00,2,6,4,21,0,0,33
2024-03-22 06:20:00,2,11,4,20,0,1,38
2024-03-22 06:30:00,5,9,11,18,0,2,45
2024-03-22 06:40:00,6,7,7,23,0,1,44
2024-03-22 06:50:00,4,12,9,22,0,1,48
2024-03-22 07:00:00,8,10,10,21,0,1,50
2024-03-22 07:10:00,6,10,12,25,1,3,57
2024-03-22 07:20:00,11,7,16,24,2,2,62
2024-03-22 07:30:00,15,9,13,19,1,1,58
2024-03-22 07:40:00,14,20,11,16,2,3,66
2024-03-22 07:50:00,14,7,10,29,1,1,62
2024-03-22 08:00:00,11,11,11,32,1,2,68
2024-03-22 08:10:00,15,15,10,12,0,2,54
2024-03-22 08:20:00,11,15,12,18,3,3,62
2024-03-22 08:30:00,14,12,13,13,0,4,56
2024-03-22 08:40:00,10,20,12,19,0,1,62
2024-03-22 08:50:00,8,12,15,21,1,5,62
2024-03-22 09:00:00,14,10,22,10,0,7,63
2024-03-22 09:10:00,12,12,17,23,0,1,65
2024-03-22 09:20:00,7,18,9,23,0,1,58
2024-03-22 09:30:00,12,21,19,12,0,2,66
2024-03-22 09:40:00,12,16,17,20,0,9,74
2024-03-22 09:50:00,13,17,14,18,0,2,64
2024-03-22 10:00:00,9,20,12,11,0,1,53
2024-03-22 10:10:00,10,12,15,21,0,3,61
2024-03-22 10:20:00,11,12,21,12,1,4,61
2024-03-22 10:30:00,27,10,25,13,2,3,80
2024-03-22 10:40:00,13,15,14,13,1,4,60
2024-03-22 10:50:00,12,16,17,2,1,2,50
2024-03-22 11:00:00,16,16,26,21,0,2,81
2024-03-22 11:10:00,17,10,14,15,0,2,58
2024-03-22 11:20:00,15,17,21,12,1,2,68
2024-03-22 11:30:00,13,16,21,10,0,3,63
2024-03-22 11:40:00,17,8,17,19,0,0,61
2024-03-22 11:50:00,10,13,17,21,0,7,68
2024-03-22 12:00:00,9,15,26,24,0,2,76
2024-03-22 12:10:00,13,15,21,26,0,9,84
2024-03-22 12:20:00,12,14,20,14,0,2,62
2024-03-22 12:30:00,10,16,19,20,1,10,76
2024-03-22 12:40:00,14,10,28,18,0,4,74
2024-03-22 12:50:00,10,15,20,27,0,7,79
2024-03-22 13:00:00,9,13,36,17,1,3,79
2024-03-22 13:10:00,12,17,18,12,0,2,61
2024-03-22 13:20:00,13,18,17,14,0,2,64
2024-03-22 13:30:00,9,15,20,22,1,2,69
2024-03-22 13:40:00,8,9,23,24,0,2,66
2024-03-22 13:50:00,11,15,14,15,0,3,58
2024-03-22 14:00:00,9,16,18,19,0,2,64
2024-03-22 14:10:00,9,11,23,21,0,5,69
2024-03-22 14:20:00,11,15,18,22,0,4,70
2024-03-22 14:30:00,15,11,15,21,1,2,65
2024-03-22 14:40:00,14,19,28,21,1,1,84
2024-03-22 14:50:00,10,14,17,16,0,0,57
2024-03-22 15:00:00,11,13,26,19,2,0,71
2024-03-22 15:10:00,16,15,20,28,0,2,81
2024-03-22 15:20:00,25,15,16,20,0,4,80
2024-03-22 15:30:00,13,16,20,32,0,2,83
2024-03-22 15:40:00,12,10,20,11,1,7,61
2024-03-22 15:50:00,14,13,18,14,0,3,62
2024-03-22 16:00:00,10,20,18,21,1,2,72
2024-03-22 16:10:00,9,9,20,19,1,4,62
2024-03-22 16:20:00,15,14,13,25,0,3,70
2024-03-22 16:30:00,13,12,13,28,0,5,71
2024-03-22 16:40:00,11,8,13,20,0,10,62
2024-03-22 16:50:00,9,10,13,21,0,2,55
2024-03-22 17:00:00,11,16,14,22,0,3,66
2024-03-22 17:10:00,13,18,16,20,0,1,68
2024-03-22 17:20:00,14,20,12,25,0,4,75
2024-03-22 17:30:00,10,13,23,23,1,1,71
2024-03-22 17:40:00,9,17,11,22,0,2,61
2024-03-22 17:50:00,13,10,14,26,1,0,64
2024-03-22 18:00:00,10,14,15,24,2,4,69
2024-03-22 18:10:00,11,12,21,23,0,2,69
2024-03-22 18:20:00,11,30,15,24,3,2,85
2024-03-22 18:30:00,7,3,7,14,0,1,32
2024-03-22 18:40:00,4,1,3,6,0,0,14
2024-03-22 18:50:00,10,7,4,13,0,1,35
2024-03-22 19:00:00,10,6,14,15,0,1,46
2024-03-22 19:10:00,8,10,9,21,0,4,52
2024-03-22 19:20:00,8,11,6,27,0,4,56
2024-03-22 19:30:00,6,4,11,14,0,4,39
2024-03-22 19:40:00,12,8,10,21,0,5,56
2024-03-22 19:50:00,9,8,11,19,0,1,48
2024-03-22 20:00:00,11,10,8,23,0,4,56
2024-03-22 20:10:00,5,5,9,24,1,3,47
2024-03-22 20:20:00,5,10,6,24,0,0,45
2024-03-22 20:30:00,11,7,5,17,1,3,44
2024-03-22 20:40:00,6,5,5,17,0,1,34
2024-03-22 20:50:00,3,7,5,17,1,2,35
2024-03-22 21:00:00,5,8,5,18,0,0,36
2024-03-22 21:10:00,4,9,12,29,1,0,55
2024-03-22 21:20:00,5,10,5,16,0,2,38
2024-03-22 21:30:00,5,4,1,19,0,0,29
2024-03-22 21:40:00,15,6,6,24,0,0,51
2024-03-22 21:50:00,3,17,6,17,0,0,43
2024-03-22 22:00:00,4,4,3,13,0,1,25
2024-03-22 22:10:00,5,4,13,12,0,0,34
2024-03-22 22:20:00,1,4,10,19,0,0,34
2024-03-22 22:30:00,4,6,8,16,0,0,34
2024-03-22 22:40:00,3,7,11,15,0,0,36
2024-03-22 22:50:00,5,1,4,14,0,1,25
2024-03-22 23:00:00,5,2,4,19,0,1,31
2024-03-22 23:10:00,2,3,2,19,0,0,26
2024-03-22 23:20:00,3,4,3,13,0,0,23
2024-03-22 23:30:00,2,0,5,11,0,0,18
2024-03-22 23:40:00,2,4,2,11,0,0,19
2024-03-22 23:50:00,1,4,3,19,0,0,27
2024-03-23 00:00:00,3,7,7,12,0,0,29
2024-03-23 00:10:00,2,2,8,13,0,0,25
2024-03-23 00:20:00,2,4,2,11,0,0,19
2024-03-23 00:30:00,1,4,5,15,0,0,25
2024-03-23 00:40:00,0,1,5,11,0,2,19
2024-03-23 00:50:00,1,4,3,12,0,0,20
2024-03-23 01:00:00,1,8,1,18,0,0,28
2024-03-23 01:10:00,1,5,4,12,0,0,22
2024-03-23 01:20:00,2,2,2,8,0,0,14
2024-03-23 01:30:00,1,1,3,7,0,0,12
2024-03-23 01:40:00,2,2,0,10,0,0,14
2024-03-23 01:50:00,1,1,2,9,0,0,13
2024-03-23 02:00:00,2,1,5,11,0,0,19
2024-03-23 02:10:00,0,1,4,12,0,0,17
2024-03-23 02:20:00,1,1,2,6,0,0,10
2024-03-23 02:30:00,0,3,2,9,0,0,14
2024-03-23 02:40:00,0,1,0,9,0,0,10
2024-03-23 02:50:00,1,0,1,8,0,0,10
2024-03-23 03:00:00,0,2,2,6,0,0,10
2024-03-23 03:10:00,0,2,3,8,0,0,13
2024-03-23 03:20:00,0,1,0,4,0,0,5
2024-03-23 03:30:00,1,0,1,9,0,0,11
2024-03-23 03:40:00,0,0,0,5,0,0,5
2024-03-23 03:50:00,1,1,1,8,0,0,11
2024-03-23 04:00:00,0,3,0,2,0,0,5
2024-03-23 04:10:00,0,0,0,4,0,0,4
2024-03-23 04:20:00,0,5,2,5,0,0,12
2024-03-23 04:30:00,3,2,2,5,0,0,12
2024-03-23 04:40:00,0,0,0,4,0,0,4
2024-03-23 04:50:00,2,0,1,2,0,0,5
2024-03-23 05:00:00,2,3,4,5,0,0,14
2024-03-23 05:10:00,1,4,3,8,0,0,16
2024-03-23 05:20:00,1,6,2,16,0,0,25
2024-03-23 05:30:00,5,6,1,21,0,1,34
2024-03-23 05:40:00,5,6,4,13,0,0,28
2024-03-23 05:50:00,1,5,2,16,0,0,24
2024-03-23 06:00:00,0,4,0,3,0,0,7
2024-03-23 06:10:00,2,1,1,11,0,0,15
2024-03-23 06:20:00,3,3,4,15,0,1,26
2024-03-23 06:30:00,3,5,6,11,0,0,25
2024-03-23 06:40:00,2,2,4,20,0,0,28
2024-03-23 06:50:00,4,4,1,15,0,1,25
2024-03-23 07:00:00,4,3,2,17,0,1,27
2024-03-23 07:10:00,4,4,4,15,0,0,27
2024-03-23 07:20:00,0,3,1,12,0,0,16
2024-03-23 07:30:00,1,4,7,11,0,0,23
2024-03-23 07:40:00,2,5,3,13,0,0,23
2024-03-23 07:50:00,6,4,4,15,0,0,29
2024-03-23 08:00:00,3,4,6,13,0,0,26
2024-03-23 08:10:00,2,7,6,18,0,0,33
2024-03-23 08:20:00,0,3,0,14,1,1,19
2024-03-23 08:30:00,10,4,8,15,0,0,37
2024-03-23 08:40:00,5,6,5,18,0,0,34
2024-03-23 08:50:00,4,4,5,22,0,1,36
2024-03-23 09:00:00,1,2,4,17,0,3,27
2024-03-23 09:10:00,5,8,5,13,0,3,34
2024-03-23 09:20:00,7,4,6,28,0,1,46
2024-03-23 09:30:00,16,5,5,24,0,0,50
2024-03-23 09:40:00,6,8,8,23,0,1,46
2024-03-23 09:50:00,22,14,9,25,0,2,72
2024-03-23 10:00:00,9,6,6,22,0,1,44
2024-03-23 10:10:00,2,8,12,23,0,1,46
2024-03-23 10:20:00,9,7,4,25,0,1,46
2024-03-23 10:30:00,8,10,5,22,1,2,48
2024-03-23 10:40:00,12,5,19,23,1,0,60
2024-03-23 10:50:00,8,4,6,22,0,3,43
2024-03-23 11:00:00,9,9,11,23,0,3,55
2024-03-23 11:10:00,9,7,15,26,0,3,60
2024-03-23 11:20:00,7,15,11,23,1,0,57
2024-03-23 11:30:00,11,11,10,18,1,2,53
2024-03-23 11:40:00,12,9,8,24,0,3,56
2024-03-23 11:50:00,14,14,9,26,0,3,66
2024-03-23 12:00:00,15,13,12,24,0,2,66
2024-03-23 12:10:00,9,8,10,25,0,4,56
2024-03-23 12:20:00,4,12,13,24,0,1,54
2024-03-23 12:30:00,10,9,15,15,0,1,50
2024-03-23 12:40:00,17,10,8,24,0,2,61
2024-03-23 12:50:00,10,8,14,27,2,1,62
2024-03-23 13:00:00,6,13,10,20,0,3,52
2024-03-23 13:10:00,2,13,11,23,0,4,53
2024-03-23 13:20:00,10,20,12,24,0,1,67
2024-03-23 13:30:00,10,9,14,17,1,4,55
2024-03-23 13:40:00,9,8,16,26,0,1,60
2024-03-23 13:50:00,10,9,14,18,0,2,53
2024-03-23 14:00:00,8,9,14,26,0,2,59
2024-03-23 14:10:00,9,8,9,18,0,5,49
2024-03-23 14:20:00,14,4,7,20,0,1,46
2024-03-23 14:30:00,8,13,13,17,0,0,51
2024-03-23 14:40:00,10,11,7,19,0,0,47
2024-03-23 14:50:00,9,6,12,22,1,1,51
2024-03-23 15:00:00,9,8,14,18,0,0,49
2024-03-23 15:10:00,7,16,7,27,0,2,59
2024-03-23 15:20:00,11,14,14,33,0,3,75
2024-03-23 15:30:00,8,8,9,19,0,0,44
2024-03-23 15:40:00,9,6,15,25,0,0,55
2024-03-23 15:50:00,9,6,16,22,1,2,56
2024-03-23 16:00:00,12,6,8,28,0,5,59
2024-03-23 16:10:00,6,8,10,24,0,3,51
2024-03-23 16:20:00,40,7,13,22,0,3,85
2024-03-23 16:30:00,7,5,12,24,1,1,50
2024-03-23 16:40:00,10,15,14,24,0,2,65
2024-03-23 16:50:00,14,9,11,17,0,0,51
2024-03-23 17:00:00,10,10,16,28,0,2,66
2024-03-23 17:10:00,7,9,9,29,0,2,56
2024-03-23 17:20:00,5,11,10,20,0,1,47
2024-03-23 17:30:00,10,7,14,24,0,2,57
2024-03-23 17:40:00,15,5,9,18,0,4,51
2024-03-23 17:50:00,10,10,10,20,0,0,50
2024-03-23 18:00:00,12,9,10,27,0,0,58
2024-03-23 18:10:00,10,3,11,17,0,3,44
2024-03-23 18:20:00,4,14,11,27,0,0,56
2024-03-23 18:30:00,8,8,11,28,0,0,55
2024-03-23 18:40:00,12,7,9,24,0,0,52
2024-03-23 18:50:00,8,8,4,24,0,3,47
2024-03-23 19:00:00,4,3,7,15,0,1,30
2024-03-23 19:10:00,10,7,8,22,0,0,47
2024-03-23 19:20:00,5,8,5,21,4,2,45
2024-03-23 19:30:00,11,4,7,22,0,1,45
2024-03-23 19:40:00,8,6,11,19,1,3,48
2024-03-23 19:50:00,5,6,6,15,0,2,34
2024-03-23 20:00:00,11,16,15,16,1,0,59
2024-03-23 20:10:00,7,12,5,22,0,2,48
2024-03-23 20:20:00,4,6,8,26,0,0,44
2024-03-23 20:30:00,10,9,9,22,0,2,52
2024-03-23 20:40:00,6,10,5,25,0,0,46
2024-03-23 20:50:00,3,5,7,12,0,2,29
2024-03-23 21:00:00,5,8,6,26,0,0,45
2024-03-23 21:10:00,4,6,7,17,1,1,36
2024-03-23 21:20:00,5,4,7,16,0,0,32
2024-03-23 21:30:00,1,8,2,14,0,0,25
2024-03-23 21:40:00,5,7,4,20,0,0,36
2024-03-23 21:50:00,2,3,4,23,0,0,32
2024-03-23 22:00:00,3,7,4,15,0,0,29
2024-03-23 22:10:00,8,6,5,12,0,0,31
2024-03-23 22:20:00,2,3,8,9,0,0,22
2024-03-23 22:30:00,6,2,4,17,0,0,29
2024-03-23 22:40:00,6,1,6,18,0,2,33
2024-03-23 22:50:00,3,4,4,18,2,0,31
2024-03-23 23:00:00,2,4,6,15,0,1,28
2024-03-23 23:10:00,4,7,5,14,0,0,30
2024-03-23 23:20:00,2,12,3,18,0,0,35
2024-03-23 23:30:00,3,2,6,12,0,1,24
2024-03-23 23:40:00,5,0,4,14,0,1,24
2024-03-23 23:50:00,4,3,2,10,0,2,21
2024-03-24 00:00:00,1,7,2,12,0,0,22
2024-03-24 00:10:00,6,7,6,9,0,0,28
2024-03-24 00:20:00,6,3,2,10,0,0,21
2024-03-24 00:30:00,2,4,3,14,0,0,23
2024-03-24 00:40:00,3,2,1,10,0,0,16
2024-03-24 00:50:00,4,3,4,10,0,0,21
2024-03-24 01:00:00,4,7,2,11,0,0,24
2024-03-24 01:10:00,1,1,3,11,0,0,16
2024-03-24 01:20:00,1,1,4,14,0,0,20
2024-03-24 01:30:00,4,2,3,15,0,0,24
2024-03-24 01:40:00,1,1,0,14,0,0,16
2024-03-24 01:50:00,1,0,2,14,0,0,17
2024-03-24 02:00:00,1,2,6,8,0,0,17
2024-03-24 02:10:00,1,2,2,6,0,0,11
2024-03-24 02:20:00,1,1,3,6,0,0,11
2024-03-24 02:30:00,1,1,2,7,0,0,11
2024-03-24 02:40:00,0,0,1,12,0,0,13
2024-03-24 02:50:00,1,1,2,5,1,0,10
2024-03-24 03:00:00,0,0,1,6,0,0,7
2024-03-24 03:10:00,0,1,1,8,0,0,10
2024-03-24 03:20:00,0,0,0,5,0,0,5
2024-03-24 03:30:00,0,0,2,5,0,0,7
2024-03-24 03:40:00,1,0,0,5,0,0,6
2024-03-24 03:50:00,0,0,0,4,0,0,4
2024-03-24 04:00:00,0,5,0,2,0,0,7
2024-03-24 04:10:00,0,0,0,5,0,0,5
2024-03-24 04:20:00,0,1,0,4,0,0,5
2024-03-24 04:30:00,0,2,1,5,0,0,8
2024-03-24 04:40:00,3,0,0,7,0,0,10
2024-03-24 04:50:00,0,0,1,5,0,0,6
2024-03-24 05:00:00,1,1,0,6,0,0,8
2024-03-24 05:10:00,2,0,3,9,0,0,14
2024-03-24 05:20:00,1,1,1,15,1,0,19
2024-03-24 05:30:00,2,2,0,12,0,0,16
2024-03-24 05:40:00,2,0,1,13,0,0,16
2024-03-24 05:50:00,0,2,0,7,0,0,9
2024-03-24 06:00:00,1,1,1,6,0,0,9
2024-03-24 06:10:00,2,2,7,14,0,0,25
2024-03-24 06:20:00,0,2,2,11,0,0,15
2024-03-24 06:30:00,0,1,1,12,0,0,14
2024-03-24 06:40:00,2,2,4,8,0,3,19
2024-03-24 06:50:00,2,1,2,7,0,0,12
2024-03-24 07:00:00,0,2,1,7,0,0,10
2024-03-24 07:10:00,2,2,0,4,0,0,8
2024-03-24 07:20:00,2,1,0,13,0,0,16
2024-03-24 07:30:00,1,4,1,5,0,0,11
2024-03-24 07:40:00,5,2,4,9,0,0,20
2024-03-24 07:50:00,2,2,1,4,0,0,9
2024-03-24 08:00:00,1,1,2,8,0,0,12
2024-03-24 08:10:00,2,2,3,7,0,0,14
2024-03-24 08:20:00,2,0,2,11,0,0,15
2024-03-24 08:30:00,0,8,1,9,0,0,18
2024-03-24 08:40:00,5,1,5,12,0,0,23
2024-03-24 08:50:00,3,5,7,11,0,1,27
2024-03-24 09:00:00,5,7,1,9,0,1,23
2024-03-24 09:10:00,3,4,5,12,0,0,24
2024-03-24 09:20:00,1,9,2,10,0,0,22
2024-03-24 09:30:00,7,1,6,17,0,2,33
2024-03-24 09:40:00,6,5,6,13,0,0,30
2024-03-24 09:50:00,4,8,6,16,0,0,34
2024-03-24 10:00:00,8,5,3,19,0,0,35
2024-03-24 10:10:00,5,8,3,18,0,1,35
2024-03-24 10:20:00,8,2,5,17,0,1,33
2024-03-24 10:30:00,3,5,5,13,0,1,27
2024-03-24 10:40:00,8,4,5,25,0,0,42
2024-03-24 10:50:00,6,9,5,17,0,2,39
2024-03-24 11:00:00,9,6,2,19,0,0,36
2024-03-24 11:10:00,9,7,4,15,1,0,36
2024-03-24 11:20:00,4,7,4,23,0,1,39
2024-03-24 11:30:00,3,2,6,17,1,0,29
2024-03-24 11:40:00,9,5,13,29,0,0,56
2024-03-24 11:50:00,5,10,6,19,0,2,42
2024-03-24 12:00:00,10,5,4,17,1,0,37
2024-03-24 12:10:00,8,15,6,20,0,0,49
2024-03-24 12:20:00,10,8,10,27,0,1,56
2024-03-24 12:30:00,7,8,5,23,0,1,44
2024-03-24 12:40:00,9,9,9,26,0,0,53
2024-03-24 12:50:00,4,7,9,22,0,0,42
2024-03-24 13:00:00,8,11,4,19,0,1,43
2024-03-24 13:10:00,9,5,8,18,0,1,41
2024-03-24 13:20:00,7,7,6,25,1,0,46
2024-03-24 13:30:00,5,5,9,20,0,1,40
2024-03-24 13:40:00,6,39,5,22,0,1,73
2024-03-24 13:50:00,7,9,14,25,0,1,56
2024-03-24 14:00:00,7,5,5,41,0,0,58
2024-03-24 14:10:00,10,6,9,25,0,1,51
2024-03-24 14:20:00,12,10,7,24,0,1,54
2024-03-24 14:30:00,6,9,8,22,0,0,45
2024-03-24 14:40:00,9,7,10,20,0,0,46
2024-03-24 14:50:00,6,6,5,23,0,0,40
2024-03-24 15:00:00,13,14,9,19,0,0,55
2024-03-24 15:10:00,8,5,10,23,0,1,47
2024-03-24 15:20:00,8,13,9,21,0,1,52
2024-03-24 15:30:00,7,4,5,24,0,0,40
2024-03-24 15:40:00,7,9,9,25,0,2,52
2024-03-24 15:50:00,5,5,9,20,0,2,41
2024-03-24 16:00:00,11,6,10,25,2,0,54
2024-03-24 16:10:00,6,6,8,21,0,1,42
2024-03-24 16:20:00,0,9,6,23,0,0,38
2024-03-24 16:30:00,7,6,11,23,1,1,49
2024-03-24 16:40:00,7,7,16,15,0,1,46
2024-03-24 16:50:00,7,8,7,18,0,2,42
2024-03-24 17:00:00,8,6,8,26,0,2,50
2024-03-24 17:10:00,11,6,14,18,0,1,50
2024-03-24 17:20:00,10,4,13,28,2,0,57
2024-03-24 17:30:00,9,10,9,21,0,1,50
2024-03-24 17:40:00,12,12,6,31,0,0,61
2024-03-24 17:50:00,12,7,10,20,0,3,52
2024-03-24 18:00:00,9,8,6,21,0,0,44
2024-03-24 18:10:00,6,10,7,30,0,2,55
2024-03-24 18:20:00,9,5,6,22,0,0,42
2024-03-24 18:30:00,4,8,7,22,0,0,41
2024-03-24 18:40:00,18,8,7,19,0,0,52
2024-03-24 18:50:00,8,5,5,17,0,2,37
2024-03-24 19:00:00,5,8,9,15,0,1,38
2024-03-24 19:10:00,5,3,11,47,0,1,67
2024-03-24 19:20:00,5,6,7,18,0,0,36
2024-03-24 19:30:00,6,5,6,23,0,0,40
2024-03-24 19:40:00,10,5,9,21,1,1,47
2024-03-24 19:50:00,3,7,16,17,0,0,43
2024-03-24 20:00:00,12,1,5,15,0,0,33
2024-03-24 20:10:00,5,6,5,15,0,1,32
2024-03-24 20:20:00,4,6,8,24,0,1,43
2024-03-24 20:30:00,6,6,7,16,0,0,35
2024-03-24 20:40:00,3,8,6,28,0,1,46
2024-03-24 20:50:00,4,4,5,25,0,0,38
2024-03-24 21:00:00,6,7,5,14,0,0,32
2024-03-24 21:10:00,4,2,5,24,0,0,35
2024-03-24 21:20:00,2,0,4,21,0,0,27
2024-03-24 21:30:00,10,7,5,19,0,0,41
2024-03-24 21:40:00,7,4,3,17,0,0,31
2024-03-24 21:50:00,1,5,5,16,0,0,27
2024-03-24 22:00:00,5,2,5,13,0,0,25
2024-03-24 22:10:00,5,7,8,15,0,0,35
2024-03-24 22:20:00,3,4,1,14,0,0,22
2024-03-24 22:30:00,1,3,2,13,0,0,19
2024-03-24 22:40:00,7,2,3,17,0,0,29
2024-03-24 22:50:00,2,3,1,12,0,0,18
2024-03-24 23:00:00,0,6,4,8,0,0,18
2024-03-24 23:10:00,4,3,5,8,0,0,20
2024-03-24 23:20:00,0,5,2,10,0,0,17
2024-03-24 23:30:00,1,2,2,14,0,0,19
2024-03-24 23:40:00,2,2,1,11,0,0,16
2024-03-24 23:50:00,3,1,3,7,0,0,14
2024-03-25 00:00:00,2,3,1,9,0,0,15
2024-03-25 00:10:00,2,4,2,12,0,0,20
2024-03-25 00:20:00,1,0,3,9,0,0,13
2024-03-25 00:30:00,0,1,2,9,0,0,12
2024-03-25 00:40:00,0,1,0,8,0,0,9
2024-03-25 00:50:00,0,0,3,7,0,0,10
2024-03-25 01:00:00,0,0,3,5,0,0,8
2024-03-25 01:10:00,2,1,0,10,0,0,13
2024-03-25 01:20:00,1,0,1,0,0,0,2
2024-03-25 01:30:00,0,0,0,5,0,0,5
2024-03-25 01:40:00,0,0,1,2,0,0,3
2024-03-25 01:50:00,0,1,0,1,0,0,2
2024-03-25 02:00:00,0,0,2,1,0,0,3
2024-03-25 02:10:00,2,0,1,6,0,0,9
2024-03-25 02:20:00,0,0,0,2,0,0,2
2024-03-25 02:30:00,0,0,0,1,0,0,1
2024-03-25 02:40:00,0,0,0,0,0,0,0
2024-03-25 02:50:00,0,0,0,4,0,0,4
2024-03-25 03:00:00,0,0,0,1,0,0,1
2024-03-25 03:10:00,0,0,0,2,0,0,2
2024-03-25 03:20:00,0,3,0,2,0,0,5
2024-03-25 03:30:00,1,0,1,5,0,0,7
2024-03-25 03:40:00,0,0,0,5,0,0,5
2024-03-25 03:50:00,0,0,0,3,0,0,3
2024-03-25 04:00:00,1,1,1,5,0,0,8
2024-03-25 04:10:00,2,0,1,4,0,0,7
2024-03-25 04:20:00,1,1,3,9,0,0,14
2024-03-25 04:30:00,0,2,1,3,0,0,6
2024-03-25 04:40:00,1,1,2,3,0,0,7
2024-03-25 04:50:00,2,1,1,4,0,0,8
2024-03-25 05:00:00,0,4,0,9,0,0,13
2024-03-25 05:10:00,5,4,3,14,0,0,26
2024-03-25 05:20:00,3,1,2,11,0,0,17
2024-03-25 05:30:00,4,6,3,14,0,1,28
2024-03-25 05:40:00,5,7,1,18,0,2,33
2024-03-25 05:50:00,4,2,6,16,0,0,28
2024-03-25 06:00:00,2,3,1,15,0,0,21
2024-03-25 06:10:00,1,6,5,19,0,0,31
2024-03-25 06:20:00,2,6,10,16,0,1,35
2024-03-25 06:30:00,5,4,5,19,0,1,34
2024-03-25 06:40:00,6,5,9,22,1,0,43
2024-03-25 06:50:00,2,16,5,23,0,1,47
2024-03-25 07:00:00,3,10,6,23,0,3,45
2024-03-25 07:10:00,7,12,4,22,0,3,48
2024-03-25 07:20:00,5,3,9,25,0,2,44
2024-03-25 07:30:00,8,13,4,18,0,0,43
2024-03-25 07:40:00,17,14,9,22,0,2,64
2024-03-25 07:50:00,11,13,13,28,0,1,66
2024-03-25 08:00:00,9,5,14,25,0,3,56
2024-03-25 08:10:00,14,8,6,27,0,3,58
2024-03-25 08:20:00,12,16,14,28,0,5,75
2024-03-25 08:30:00,10,16,12,29,0,2,69
2024-03-25 08:40:00,12,10,10,18,0,1,51
2024-03-25 08:50:00,14,15,14,22,0,2,67
2024-03-25 09:00:00,11,13,12,12,1,2,51
2024-03-25 09:10:00,3,12,13,31,0,1,60
2024-03-25 09:20:00,1,9,10,20,0,4,44
2024-03-25 09:30:00,9,15,16,20,1,2,63
2024-03-25 09:40:00,19,14,12,15,1,1,62
2024-03-25 09:50:00,8,17,14,24,0,1,64
2024-03-25 10:00:00,10,13,19,28,1,2,73
2024-03-25 10:10:00,14,18,17,7,1,1,58
2024-03-25 10:20:00,17,11,10,22,0,1,61
2024-03-25 10:30:00,15,10,17,10,0,5,57
2024-03-25 10:40:00,6,13,23,18,1,2,63
2024-03-25 10:50:00,10,14,17,29,2,5,77
2024-03-25 11:00:00,17,13,19,13,0,1,63
2024-03-25 11:10:00,7,17,13,32,0,3,72
2024-03-25 11:20:00,9,19,17,23,0,3,71
2024-03-25 11:30:00,17,17,16,18,0,3,71
2024-03-25 11:40:00,13,18,17,15,0,4,67
2024-03-25 11:50:00,11,12,9,27,0,5,64
2024-03-25 12:00:00,7,12,20,16,3,0,58
2024-03-25 12:10:00,4,16,25,20,0,2,67
2024-03-25 12:20:00,9,21,21,25,1,0,77
2024-03-25 12:30:00,9,14,18,25,1,5,72
2024-03-25 12:40:00,9,11,19,16,1,0,56
2024-03-25 12:50:00,12,10,17,20,0,6,65
2024-03-25 13:00:00,10,15,19,20,1,4,69
2024-03-25 13:10:00,3,21,16,29,1,1,71
2024-03-25 13:20:00,14,18,16,22,0,2,72
2024-03-25 13:30:00,11,19,15,16,1,3,65
2024-03-25 13:40:00,9,15,20,22,1,2,69
2024-03-25 13:50:00,11,8,20,16,0,2,57
2024-03-25 14:00:00,16,15,18,19,2,7,77
2024-03-25 14:10:00,10,11,10,25,0,5,61
2024-03-25 14:20:00,12,24,15,15,0,7,73
2024-03-25 14:30:00,14,14,24,19,1,3,75
2024-03-25 14:40:00,11,17,21,2,2,3,56
2024-03-25 14:50:00,16,21,21,42,0,3,103
2024-03-25 15:00:00,12,7,19,16,1,3,58
2024-03-25 15:10:00,11,17,13,18,0,7,66
2024-03-25 15:20:00,8,11,16,13,0,1,49
2024-03-25 15:30:00,7,14,23,13,0,1,58
2024-03-25 15:40:00,11,20,18,7,0,6,62
2024-03-25 15:50:00,7,18,18,15,1,0,59
2024-03-25 16:00:00,14,19,24,8,2,4,71
2024-03-25 16:10:00,79,10,15,13,1,2,120
2024-03-25 16:20:00,13,21,29,16,0,2,81
2024-03-25 16:30:00,14,39,15,13,2,4,87
2024-03-25 16:40:00,7,6,22,4,1,3,43
2024-03-25 16:50:00,11,26,17,19,0,2,75
2024-03-25 17:00:00,9,17,15,16,1,1,59
2024-03-25 17:10:00,9,18,20,14,0,12,73
2024-03-25 17:20:00,10,18,19,21,1,3,72
2024-03-25 17:30:00,9,12,10,31,2,2,66
2024-03-25 17:40:00,13,13,19,49,0,3,97
2024-03-25 17:50:00,11,17,18,2,4,4,56
2024-03-25 18:00:00,9,13,15,21,1,6,65
2024-03-25 18:10:00,8,12,17,27,0,2,66
2024-03-25 18:20:00,7,15,12,22,0,4,60
2024-03-25 18:30:00,6,13,21,18,0,0,58
2024-03-25 18:40:00,8,7,17,31,0,2,65
2024-03-25 18:50:00,6,12,14,22,0,3,57
2024-03-25 19:00:00,13,12,16,17,0,1,59
2024-03-25 19:10:00,6,9,9,31,1,1,57
2024-03-25 19:20:00,9,6,8,16,0,1,40
2024-03-25 19:30:00,11,7,11,24,0,0,53
2024-03-25 19:40:00,21,4,7,23,0,0,55
2024-03-25 19:50:00,5,9,9,22,0,0,45
2024-03-25 20:00:00,12,9,4,21,1,1,48
2024-03-25 20:10:00,6,5,11,27,0,1,50
2024-03-25 20:20:00,9,11,5,26,0,1,52
2024-03-25 20:30:00,14,4,2,16,0,0,36
2024-03-25 20:40:00,8,6,6,23,0,0,43
2024-03-25 20:50:00,2,5,6,17,0,0,30
2024-03-25 21:00:00,11,3,7,19,0,1,41
2024-03-25 21:10:00,6,12,6,12,0,1,37
2024-03-25 21:20:00,6,9,7,16,0,0,38
2024-03-25 21:30:00,1,6,5,19,0,1,32
2024-03-25 21:40:00,8,3,3,15,2,0,31
2024-03-25 21:50:00,10,18,6,15,0,1,50
2024-03-25 22:00:00,6,5,7,15,0,0,33
2024-03-25 22:10:00,4,3,5,15,0,2,29
2024-03-25 22:20:00,2,5,8,14,0,0,29
2024-03-25 22:30:00,1,6,2,9,0,0,18
2024-03-25 22:40:00,4,4,8,15,0,2,33
2024-03-25 22:50:00,4,3,2,14,0,0,23
2024-03-25 23:00:00,0,6,6,12,0,0,24
2024-03-25 23:10:00,4,2,1,7,0,0,14
2024-03-25 23:20:00,2,5,3,9,0,0,19
2024-03-25 23:30:00,2,1,3,11,0,0,17
2024-03-25 23:40:00,2,3,2,8,0,0,15
2024-03-25 23:50:00,1,3,3,9,0,0,16
2024-03-26 00:00:00,1,2,3,6,0,0,12
2024-03-26 00:10:00,5,5,3,11,0,0,24
2024-03-26 00:20:00,1,0,3,8,0,0,12
2024-03-26 00:30:00,0,3,1,8,0,0,12
2024-03-26 00:40:00,1,2,2,7,0,0,12
2024-03-26 00:50:00,0,0,1,7,0,0,8
2024-03-26 01:00:00,0,0,5,6,0,0,11
2024-03-26 01:10:00,0,1,2,7,0,0,10
2024-03-26 01:20:00,1,1,3,1,0,0,6
2024-03-26 01:30:00,0,1,1,5,0,0,7
2024-03-26 01:40:00,1,0,0,5,0,0,6
2024-03-26 01:50:00,0,0,3,5,0,0,8
2024-03-26 02:00:00,0,0,1,2,0,0,3
2024-03-26 02:10:00,0,0,3,3,0,0,6
2024-03-26 02:20:00,0,0,1,3,0,0,4
2024-03-26 02:30:00,0,0,2,1,0,0,3
2024-03-26 02:40:00,0,0,0,1,0,0,1
2024-03-26 02:50:00,0,2,0,4,0,0,6
2024-03-26 03:00:00,0,0,2,2,0,0,4
2024-03-26 03:10:00,0,1,0,2,0,0,3
2024-03-26 03:20:00,0,1,0,2,0,0,3
2024-03-26 03:30:00,0,0,0,4,0,0,4
2024-03-26 03:40:00,0,0,0,2,0,0,2
2024-03-26 03:50:00,3,0,0,1,0,0,4
2024-03-26 04:00:00,0,1,0,4,0,0,5
2024-03-26 04:10:00,0,1,1,5,0,0,7
2024-03-26 04:20:00,1,0,1,6,0,0,8
2024-03-26 04:30:00,0,1,1,2,0,0,4
2024-03-26 04:40:00,0,1,0,5,0,0,6
2024-03-26 04:50:00,0,2,2,6,0,0,10
2024-03-26 05:00:00,2,4,2,11,0,0,19
2024-03-26 05:10:00,7,7,3,13,0,0,30
2024-03-26 05:20:00,3,6,2,13,0,0,24
2024-03-26 05:30:00,1,7,2,12,0,1,23
2024-03-26 05:40:00,2,7,5,18,0,1,33
2024-03-26 05:50:00,5,6,5,17,0,0,33
2024-03-26 06:00:00,6,3,3,16,0,5,33
2024-03-26 06:10:00,2,3,5,17,0,0,27
2024-03-26 06:20:00,1,4,4,17,0,0,26
2024-03-26 06:30:00,4,3,9,21,0,0,37
2024-03-26 06:40:00,5,11,6,23,0,1,46
2024-03-26 06:50:00,3,11,10,22,0,0,46
2024-03-26 07:00:00,9,10,8,21,0,0,48
2024-03-26 07:10:00,10,21,9,11,0,2,53
2024-03-26 07:20:00,7,13,8,23,0,1,52
2024-03-26 07:30:00,7,8,9,23,0,0,47
2024-03-26 07:40:00,11,14,10,10,0,1,46
2024-03-26 07:50:00,13,14,11,22,0,2,62
2024-03-26 08:00:00,7,9,8,21,0,4,49
2024-03-26 08:10:00,15,10,16,23,0,0,64
2024-03-26 08:20:00,17,12,11,11,0,0,51
2024-03-26 08:30:00,12,13,12,16,0,3,56
2024-03-26 08:40:00,10,16,12,22,0,2,62
2024-03-26 08:50:00,4,19,15,21,0,0,59
2024-03-26 09:00:00,8,24,15,19,1,1,68
2024-03-26 09:10:00,10,13,9,25,0,2,59
2024-03-26 09:20:00,11,16,10,16,1,4,58
2024-03-26 09:30:00,6,8,6,21,0,1,42
2024-03-26 09:40:00,10,19,10,13,0,2,54
2024-03-26 09:50:00,13,11,18,12,3,0,57
2024-03-26 10:00:00,8,11,16,18,1,1,55
2024-03-26 10:10:00,9,8,10,19,0,0,46
2024-03-26 10:20:00,9,13,15,17,0,2,56
2024-03-26 10:30:00,12,17,13,23,0,6,71
2024-03-26 10:40:00,7,11,13,16,1,1,49
2024-03-26 10:50:00,10,11,18,17,0,1,57
2024-03-26 11:00:00,5,9,17,13,0,0,44
2024-03-26 11:10:00,9,10,16,11,0,9,55
2024-03-26 11:20:00,8,8,19,12,0,2,49
2024-03-26 11:30:00,10,13,16,12,1,0,52
2024-03-26 11:40:00,11,19,12,11,0,2,55
2024-03-26 11:50:00,10,10,17,17,1,3,58
2024-03-26 12:00:00,16,10,17,16,0,1,60
2024-03-26 12:10:00,6,13,20,13,0,1,53
2024-03-26 12:20:00,13,9,12,23,2,1,60
2024-03-26 12:30:00,8,4,17,9,0,4,42
2024-03-26 12:40:00,20,15,14,19,0,9,77
2024-03-26 12:50:00,9,16,10,18,1,6,60
2024-03-26 13:00:00,10,14,14,23,0,8,69
2024-03-26 13:10:00,13,11,10,9,0,2,45
2024-03-26 13:20:00,9,18,19,21,1,3,71
2024-03-26 13:30:00,12,12,16,22,0,2,64
2024-03-26 13:40:00,10,13,15,30,2,2,72
2024-03-26 13:50:00,13,14,15,20,0,3,65
2024-03-26 14:00:00,10,11,12,25,1,3,62
2024-03-26 14:10:00,10,15,17,14,0,0,56
2024-03-26 14:20:00,9,14,20,14,0,5,62
2024-03-26 14:30:00,10,17,17,20,2,3,69
2024-03-26 14:40:00,15,19,11,17,1,2,65
2024-03-26 14:50:00,7,17,19,18,0,3,64
2024-03-26 15:00:00,10,19,15,14,1,1,60
2024-03-26 15:10:00,14,10,16,20,2,3,65
2024-03-26 15:20:00,14,11,19,21,0,4,69
2024-03-26 15:30:00,11,10,29,20,4,1,75
2024-03-26 15:40:00,12,16,17,26,2,7,80
2024-03-26 15:50:00,21,23,12,14,0,1,71
2024-03-26 16:00:00,12,15,23,18,2,9,79
2024-03-26 16:10:00,13,14,25,16,0,2,70
2024-03-26 16:20:00,5,14,17,6,1,2,45
2024-03-26 16:30:00,10,15,21,20,1,1,68
2024-03-26 16:40:00,7,11,27,13,0,2,60
2024-03-26 16:50:00,13,24,16,15,1,2,71
2024-03-26 17:00:00,12,23,20,21,1,1,78
2024-03-26 17:10:00,16,19,26,21,0,4,86
2024-03-26 17:20:00,9,12,19,23,1,3,67
2024-03-26 17:30:00,9,18,16,22,0,1,66
2024-03-26 17:40:00,11,15,13,24,0,2,65
2024-03-26 17:50:00,12,12,19,16,0,1,60
2024-03-26 18:00:00,13,18,17,17,0,1,66
2024-03-26 18:10:00,13,13,22,25,1,5,79
2024-03-26 18:20:00,8,10,8,17,1,7,51
2024-03-26 18:30:00,13,13,24,17,0,2,69
2024-03-26 18:40:00,24,10,19,18,0,2,73
2024-03-26 18:50:00,12,16,16,23,1,4,72
2024-03-26 19:00:00,12,8,12,21,0,2,55
2024-03-26 19:10:00,10,10,11,15,0,1,47
2024-03-26 19:20:00,12,10,16,7,1,0,46
2024-03-26 19:30:00,8,9,12,16,0,4,49
2024-03-26 19:40:00,8,10,11,23,0,2,54
2024-03-26 19:50:00,9,11,14,19,1,0,54
2024-03-26 20:00:00,10,8,10,19,0,2,49
2024-03-26 20:10:00,7,8,7,18,0,1,41
2024-03-26 20:20:00,1,7,5,23,0,0,36
2024-03-26 20:30:00,5,6,6,21,0,0,38
2024-03-26 20:40:00,3,8,8,16,0,1,36
2024-03-26 20:50:00,7,12,8,17,0,1,45
2024-03-26 21:00:00,3,3,5,17,0,0,28
2024-03-26 21:10:00,5,7,4,25,0,0,41
2024-03-26 21:20:00,3,7,5,13,0,0,28
2024-03-26 21:30:00,6,5,8,18,0,1,38
2024-03-26 21:40:00,4,1,3,18,0,1,27
2024-03-26 21:50:00,5,14,5,18,0,0,42
2024-03-26 22:00:00,4,7,10,12,0,0,33
2024-03-26 22:10:00,3,2,7,8,0,0,20
2024-03-26 22:20:00,2,3,6,15,0,1,27
2024-03-26 22:30:00,3,4,8,15,0,0,30
2024-03-26 22:40:00,4,3,4,16,0,0,27
2024-03-26 22:50:00,2,7,3,13,0,0,25
2024-03-26 23:00:00,4,3,2,14,0,2,25
2024-03-26 23:10:00,3,3,2,10,0,0,18
2024-03-26 23:20:00,2,3,7,28,0,0,40
2024-03-26 23:30:00,1,2,4,7,0,0,14
2024-03-26 23:40:00,4,6,3,7,0,0,20
2024-03-26 23:50:00,0,0,4,13,0,0,17
2024-03-27 00:00:00,4,5,0,8,0,0,17
2024-03-27 00:10:00,2,2,10,10,0,0,24
2024-03-27 00:20:00,0,2,1,11,0,0,14
2024-03-27 00:30:00,0,1,2,11,0,0,14
2024-03-27 00:40:00,1,0,6,9,0,0,16
2024-03-27 00:50:00,3,0,1,11,0,0,15
2024-03-27 01:00:00,1,2,0,8,0,0,11
2024-03-27 01:10:00,1,2,2,7,0,1,13
2024-03-27 01:20:00,0,0,1,3,0,0,4
2024-03-27 01:30:00,1,1,0,3,0,0,5
2024-03-27 01:40:00,0,1,2,2,0,0,5
2024-03-27 01:50:00,1,0,0,4,0,0,5
2024-03-27 02:00:00,0,1,2,4,0,0,7
2024-03-27 02:10:00,0,0,3,6,0,0,9
2024-03-27 02:20:00,2,1,3,7,0,0,13
2024-03-27 02:30:00,0,1,0,2,0,0,3
2024-03-27 02:40:00,0,0,1,2,0,0,3
2024-03-27 02:50:00,0,0,0,4,0,0,4
2024-03-27 03:00:00,0,2,0,3,0,0,5
2024-03-27 03:10:00,1,0,0,1,0,0,2
2024-03-27 03:20:00,1,1,1,1,0,0,4
2024-03-27 03:30:00,0,0,0,3,0,0,3
2024-03-27 03:40:00,0,1,0,4,0,0,5
2024-03-27 03:50:00,1,0,0,10,0,0,11
2024-03-27 04:00:00,0,1,0,5,0,0,6
2024-03-27 04:10:00,0,0,0,3,0,0,3
2024-03-27 04:20:00,1,1,3,7,0,0,12
2024-03-27 04:30:00,0,2,1,3,0,0,6
2024-03-27 04:40:00,1,0,1,5,0,0,7
2024-03-27 04:50:00,0,2,6,6,0,0,14
2024-03-27 05:00:00,0,4,1,7,0,0,12
2024-03-27 05:10:00,6,2,4,10,0,0,22
2024-03-27 05:20:00,3,3,6,15,0,0,27
2024-03-27 05:30:00,0,8,1,18,0,0,27
2024-03-27 05:40:00,2,6,3,20,1,0,32
2024-03-27 05:50:00,4,4,2,19,0,0,29
2024-03-27 06:00:00,11,4,3,13,0,0,31
2024-03-27 06:10:00,1,8,9,12,1,0,31
2024-03-27 06:20:00,1,5,5,20,0,3,34
2024-03-27 06:30:00,5,6,3,16,0,2,32
2024-03-27 06:40:00,4,11,5,18,0,0,38
2024-03-27 06:50:00,6,19,13,22,0,1,61
2024-03-27 07:00:00,8,12,6,15,0,0,41
2024-03-27 07:10:00,11,13,4,26,0,1,55
2024-03-27 07:20:00,5,15,6,18,0,0,44
2024-03-27 07:30:00,7,15,9,28,0,0,59
2024-03-27 07:40:00,14,18,9,17,0,2,60
2024-03-27 07:50:00,19,12,10,28,0,0,69
2024-03-27 08:00:00,10,8,14,19,0,2,53
2024-03-27 08:10:00,9,13,11,18,0,0,51
2024-03-27 08:20:00,11,22,7,14,0,3,57
2024-03-27 08:30:00,9,7,9,33,1,3,62
2024-03-27 08:40:00,7,21,17,18,1,1,65
2024-03-27 08:50:00,18,7,12,26,0,1,64
2024-03-27 09:00:00,15,12,10,27,0,4,68
2024-03-27 09:10:00,10,13,8,21,0,0,52
2024-03-27 09:20:00,11,11,12,8,0,4,46
2024-03-27 09:30:00,14,11,22,18,2,2,69
2024-03-27 09:40:00,8,13,12,12,0,2,47
2024-03-27 09:50:00,6,12,18,26,3,3,68
2024-03-27 10:00:00,8,10,17,14,0,2,51
2024-03-27 10:10:00,13,13,12,15,0,4,57
2024-03-27 10:20:00,6,13,13,15,1,1,49
2024-03-27 10:30:00,11,19,13,10,0,0,53
2024-03-27 10:40:00,13,15,15,18,2,0,63
2024-03-27 10:50:00,9,14,14,17,1,2,57
2024-03-27 11:00:00,11,11,14,22,0,1,59
2024-03-27 11:10:00,6,12,14,17,1,3,53
2024-03-27 11:20:00,7,19,18,26,0,7,77
2024-03-27 11:30:00,14,8,13,29,1,1,66
2024-03-27 11:40:00,5,10,14,17,1,3,50
2024-03-27 11:50:00,11,18,14,17,2,5,67
2024-03-27 12:00:00,10,15,21,22,0,2,70
2024-03-27 12:10:00,9,15,21,19,0,0,64
2024-03-27 12:20:00,8,13,17,20,1,6,65
2024-03-27 12:30:00,10,16,18,20,1,3,68
2024-03-27 12:40:00,11,8,21,12,0,3,55
2024-03-27 12:50:00,9,23,13,19,0,0,64
2024-03-27 13:00:00,7,16,16,28,1,1,69
2024-03-27 13:10:00,11,14,14,12,1,3,55
2024-03-27 13:20:00,16,12,23,21,0,1,73
2024-03-27 13:30:00,8,21,12,10,1,0,52
2024-03-27 13:40:00,12,14,26,18,0,1,71
2024-03-27 13:50:00,16,19,14,23,0,2,74
2024-03-27 14:00:00,6,6,23,18,3,3,59
2024-03-27 14:10:00,9,13,21,13,0,3,59
2024-03-27 14:20:00,9,15,21,12,1,1,59
2024-03-27 14:30:00,16,8,15,12,1,2,54
2024-03-27 14:40:00,12,21,16,11,0,3,63
2024-03-27 14:50:00,12,12,23,22,0,2,71
2024-03-27 15:00:00,14,15,19,21,0,1,70
2024-03-27 15:10:00,8,17,15,12,0,5,57
2024-03-27 15:20:00,4,19,17,23,0,2,65
2024-03-27 15:30:00,7,13,25,17,0,2,64
2024-03-27 15:40:00,14,10,16,13,0,2,55
2024-03-27 15:50:00,6,7,16,13,0,5,47
2024-03-27 16:00:00,15,20,28,14,0,1,78
2024-03-27 16:10:00,13,17,20,15,0,3,68
2024-03-27 16:20:00,11,20,21,17,1,5,75
2024-03-27 16:30:00,13,13,22,16,0,3,67
2024-03-27 16:40:00,10,12,19,15,0,1,57
2024-03-27 16:50:00,13,10,19,18,0,0,60
2024-03-27 17:00:00,16,13,17,6,1,2,55
2024-03-27 17:10:00,13,12,22,14,0,0,61
2024-03-27 17:20:00,9,17,15,21,0,1,63
2024-03-27 17:30:00,14,14,17,12,2,1,60
2024-03-27 17:40:00,7,9,16,14,0,2,48
2024-03-27 17:50:00,20,12,12,25,0,1,70
2024-03-27 18:00:00,10,16,10,16,0,1,53
2024-03-27 18:10:00,13,8,16,20,0,2,59
2024-03-27 18:20:00,16,7,19,19,0,2,63
2024-03-27 18:30:00,13,8,7,16,0,1,45
2024-03-27 18:40:00,9,7,23,23,1,1,64
2024-03-27 18:50:00,8,11,7,19,0,3,48
2024-03-27 19:00:00,17,9,10,18,0,4,58
2024-03-27 19:10:00,20,13,5,24,0,0,62
2024-03-27 19:20:00,7,9,7,23,0,2,48
2024-03-27 19:30:00,11,7,11,23,0,1,53
2024-03-27 19:40:00,14,6,3,16,0,2,41
2024-03-27 19:50:00,9,7,6,16,0,2,40
2024-03-27 20:00:00,13,11,6,17,0,1,48
2024-03-27 20:10:00,3,9,9,25,0,4,50
2024-03-27 20:20:00,6,12,7,16,0,0,41
2024-03-27 20:30:00,15,7,4,19,0,0,45
2024-03-27 20:40:00,8,2,4,18,0,2,34
2024-03-27 20:50:00,9,8,9,15,0,1,42
2024-03-27 21:00:00,9,13,4,14,0,1,41
2024-03-27 21:10:00,9,5,4,25,0,3,46
2024-03-27 21:20:00,3,3,7,16,0,1,30
2024-03-27 21:30:00,4,7,3,15,0,1,30
2024-03-27 21:40:00,7,2,4,15,0,0,28
2024-03-27 21:50:00,5,4,4,18,0,0,31
2024-03-27 22:00:00,7,8,4,20,0,0,39
2024-03-27 22:10:00,3,3,5,18,0,0,29
2024-03-27 22:20:00,5,13,5,8,0,1,32
2024-03-27 22:30:00,1,4,3,13,0,0,21
2024-03-27 22:40:00,5,2,3,12,0,3,25
2024-03-27 22:50:00,3,1,5,15,0,0,24
2024-03-27 23:00:00,1,3,4,12,0,1,21
2024-03-27 23:10:00,2,1,3,13,0,1,20
2024-03-27 23:20:00,2,3,2,11,0,0,18
2024-03-27 23:30:00,2,2,1,7,0,0,12
2024-03-27 23:40:00,3,3,4,12,0,0,22
2024-03-27 23:50:00,1,2,2,10,0,0,15
2024-03-28 00:00:00,1,2,2,5,0,0,10
2024-03-28 00:10:00,2,2,3,8,0,0,15
2024-03-28 00:20:00,1,1,3,9,0,0,14
2024-03-28 00:30:00,1,2,2,12,0,0,17
2024-03-28 00:40:00,0,0,1,4,0,0,5
2024-03-28 00:50:00,1,0,3,10,0,0,14
2024-03-28 01:00:00,0,0,0,8,0,0,8
2024-03-28 01:10:00,1,3,0,7,0,0,11
2024-03-28 01:20:00,0,1,2,1,0,0,4
2024-03-28 01:30:00,1,1,2,4,0,0,8
2024-03-28 01:40:00,0,1,0,1,0,0,2
2024-03-28 01:50:00,0,0,2,1,0,0,3
2024-03-28 02:00:00,1,0,2,2,0,0,5
2024-03-28 02:10:00,0,0,2,5,0,0,7
2024-03-28 02:20:00,1,2,3,1,0,0,7
2024-03-28 02:30:00,0,0,2,3,0,0,5
2024-03-28 02:40:00,0,2,2,2,0,0,6
2024-03-28 02:50:00,0,0,4,4,0,0,8
2024-03-28 03:00:00,0,0,2,2,0,0,4
2024-03-28 03:10:00,1,0,0,2,0,0,3
2024-03-28 03:20:00,0,0,0,3,0,0,3
2024-03-28 03:30:00,0,1,2,5,0,0,8
2024-03-28 03:40:00,0,0,1,7,0,0,8
2024-03-28 03:50:00,0,1,1,1,0,0,3
2024-03-28 04:00:00,1,2,0,6,0,0,9
2024-03-28 04:10:00,1,0,0,6,0,0,7
2024-03-28 04:20:00,1,2,3,5,0,0,11
2024-03-28 04:30:00,0,2,3,4,0,0,9
2024-03-28 04:40:00,1,0,3,6,0,0,10
2024-03-28 04:50:00,0,2,1,8,0,0,11
2024-03-28 05:00:00,0,4,5,9,0,0,18
2024-03-28 05:10:00,3,5,1,10,0,0,19
2024-03-28 05:20:00,2,1,1,18,0,1,23
2024-03-28 05:30:00,1,11,4,22,0,0,38
2024-03-28 05:40:00,4,9,2,14,0,0,29
2024-03-28 05:50:00,3,2,4,15,0,0,24
2024-03-28 06:00:00,4,4,4,13,0,0,25
2024-03-28 06:10:00,2,5,1,13,0,0,21
2024-03-28 06:20:00,2,5,7,22,0,0,36
2024-03-28 06:30:00,1,4,6,26,0,0,37
2024-03-28 06:40:00,8,6,6,16,0,0,36
2024-03-28 06:50:00,6,8,8,25,0,0,47
2024-03-28 07:00:00,4,6,12,19,0,0,41
2024-03-28 07:10:00,7,11,5,17,0,5,45
2024-03-28 07:20:00,11,5,6,22,0,1,45
2024-03-28 07:30:00,9,5,10,26,0,0,50
2024-03-28 07:40:00,12,13,10,17,0,0,52
2024-03-28 07:50:00,10,16,9,23,0,1,59
2024-03-28 08:00:00,7,17,11,23,0,2,60
2024-03-28 08:10:00,13,20,13,25,0,2,73
2024-03-28 08:20:00,10,11,6,22,0,1,50
2024-03-28 08:30:00,6,24,12,13,0,2,57
2024-03-28 08:40:00,12,32,14,14,0,3,75
2024-03-28 08:50:00,11,26,8,19,0,2,66
2024-03-28 09:00:00,15,9,14,13,1,2,54
2024-03-28 09:10:00,8,17,17,15,0,1,58
2024-03-28 09:20:00,8,10,9,14,0,3,44
2024-03-28 09:30:00,10,10,17,17,0,1,55
2024-03-28 09:40:00,10,17,14,5,0,2,48
2024-03-28 09:50:00,14,16,16,6,0,2,54
2024-03-28 10:00:00,7,10,17,13,1,0,48
2024-03-28 10:10:00,11,16,13,17,0,0,57
2024-03-28 10:20:00,7,11,18,17,0,0,53
2024-03-28 10:30:00,8,9,14,14,0,1,46
2024-03-28 10:40:00,14,23,15,20,1,1,74
2024-03-28 10:50:00,12,17,13,12,1,1,56
2024-03-28 11:00:00,12,14,16,9,0,4,55
2024-03-28 11:10:00,16,16,10,14,0,0,56
2024-03-28 11:20:00,11,17,11,25,0,1,65
2024-03-28 11:30:00,19,9,20,17,1,1,67
2024-03-28 11:40:00,21,16,16,8,0,0,61
2024-03-28 11:50:00,59,19,19,25,2,0,124
2024-03-28 12:00:00,69,26,17,19,0,4,135
2024-03-28 12:10:00,19,12,18,18,1,4,72
2024-03-28 12:20:00,28,14,21,13,1,1,78
2024-03-28 12:30:00,9,7,15,7,0,2,40
2024-03-28 12:40:00,10,9,18,20,0,1,58
2024-03-28 12:50:00,11,14,19,17,0,1,62
2024-03-28 13:00:00,70,7,23,17,0,1,118
2024-03-28 13:10:00,8,12,16,24,0,3,63
2024-03-28 13:20:00,13,16,15,23,0,0,67
2024-03-28 13:30:00,18,15,17,30,0,1,81
2024-03-28 13:40:00,19,9,28,9,1,0,66
2024-03-28 13:50:00,19,13,29,16,0,1,78
2024-03-28 14:00:00,51,21,21,9,0,2,104
2024-03-28 14:10:00,69,13,23,17,0,3,125
2024-03-28 14:20:00,56,10,22,26,1,4,119
2024-03-28 14:30:00,9,14,21,9,1,3,57
2024-03-28 14:40:00,11,18,26,12,1,2,70
2024-03-28 14:50:00,8,10,22,17,1,4,62
2024-03-28 15:00:00,10,8,14,14,0,2,48
2024-03-28 15:10:00,11,13,21,18,1,3,67
2024-03-28 15:20:00,18,15,20,16,0,3,72
2024-03-28 15:30:00,30,12,16,14,1,9,82
2024-03-28 15:40:00,12,19,24,8,2,6,71
2024-03-28 15:50:00,7,14,20,21,1,0,63
2024-03-28 16:00:00,7,11,22,12,2,1,55
2024-03-28 16:10:00,28,16,19,13,0,1,77
2024-03-28 16:20:00,10,10,13,23,0,4,60
2024-03-28 16:30:00,20,16,22,18,1,5,82
2024-03-28 16:40:00,11,13,20,19,0,6,69
2024-03-28 16:50:00,14,14,16,26,0,2,72
2024-03-28 17:00:00,12,7,24,24,3,5,75
2024-03-28 17:10:00,14,16,22,13,0,4,69
2024-03-28 17:20:00,14,19,16,13,1,0,63
2024-03-28 17:30:00,11,10,15,10,1,4,51
2024-03-28 17:40:00,11,12,15,14,0,4,56
2024-03-28 17:50:00,6,18,15,20,0,5,64
2024-03-28 18:00:00,15,10,20,30,0,14,89
2024-03-28 18:10:00,9,16,19,22,0,2,68
2024-03-28 18:20:00,12,18,14,16,1,3,64
2024-03-28 18:30:00,14,6,11,28,0,2,61
2024-03-28 18:40:00,9,10,10,11,0,0,40
2024-03-28 18:50:00,8,13,18,28,0,1,68
2024-03-28 19:00:00,15,6,10,17,0,2,50
2024-03-28 19:10:00,19,9,12,21,0,0,61
2024-03-28 19:20:00,11,11,6,20,0,2,50
2024-03-28 19:30:00,10,5,9,19,1,3,47
2024-03-28 19:40:00,10,11,6,17,0,4,48
2024-03-28 19:50:00,12,9,9,22,0,0,52
2024-03-28 20:00:00,10,12,11,21,0,0,54
2024-03-28 20:10:00,6,11,11,28,0,2,58
2024-03-28 20:20:00,5,12,5,24,1,2,49
2024-03-28 20:30:00,5,6,8,17,0,0,36
2024-03-28 20:40:00,4,6,7,21,0,1,39
2024-03-28 20:50:00,3,9,9,21,0,3,45
2024-03-28 21:00:00,5,13,5,25,0,0,48
2024-03-28 21:10:00,4,7,12,16,0,0,39
2024-03-28 21:20:00,3,3,8,18,0,1,33
2024-03-28 21:30:00,6,4,6,25,1,0,42
2024-03-28 21:40:00,3,3,5,16,0,1,28
2024-03-28 21:50:00,9,8,6,16,0,1,40
2024-03-28 22:00:00,7,13,3,19,0,0,42
2024-03-28 22:10:00,9,4,4,19,0,2,38
2024-03-28 22:20:00,6,5,5,16,0,0,32
2024-03-28 22:30:00,3,9,5,21,0,1,39
2024-03-28 22:40:00,4,3,9,19,0,0,35
2024-03-28 22:50:00,5,4,6,22,0,0,37
2024-03-28 23:00:00,1,5,3,13,0,1,23
2024-03-28 23:10:00,5,2,9,13,0,0,29
2024-03-28 23:20:00,3,11,0,14,0,0,28
2024-03-28 23:30:00,3,1,6,12,0,0,22
2024-03-28 23:40:00,2,3,5,13,0,0,23
2024-03-28 23:50:00,2,4,5,6,0,0,17
2024-03-29 00:00:00,2,5,3,11,0,1,22
2024-03-29 00:10:00,6,6,3,11,0,0,26
2024-03-29 00:20:00,1,1,4,12,0,0,18
2024-03-29 00:30:00,2,4,2,14,0,0,22
2024-03-29 00:40:00,0,0,3,15,0,0,18
2024-03-29 00:50:00,3,4,3,14,0,0,24
2024-03-29 01:00:00,2,4,1,15,0,1,23
2024-03-29 01:10:00,3,0,3,10,0,0,16
2024-03-29 01:20:00,0,4,5,7,0,0,16
2024-03-29 01:30:00,0,2,2,11,0,0,15
2024-03-29 01:40:00,2,0,2,8,0,1,13
2024-03-29 01:50:00,2,0,2,8,0,0,12
2024-03-29 02:00:00,3,2,1,5,0,0,11
2024-03-29 02:10:00,0,0,2,9,0,0,11
2024-03-29 02:20:00,3,1,1,4,0,0,9
2024-03-29 02:30:00,2,1,2,4,0,0,9
2024-03-29 02:40:00,0,0,3,4,0,0,7
2024-03-29 02:50:00,0,1,1,6,0,0,8
2024-03-29 03:00:00,0,3,1,2,0,0,6
2024-03-29 03:10:00,1,1,0,4,0,0,6
2024-03-29 03:20:00,0,1,1,7,0,0,9
2024-03-29 03:30:00,0,2,0,5,0,0,7
2024-03-29 03:40:00,0,0,1,3,0,0,4
2024-03-29 03:50:00,0,0,0,5,0,0,5
2024-03-29 04:00:00,1,1,1,4,0,0,7
2024-03-29 04:10:00,0,1,1,11,0,0,13
2024-03-29 04:20:00,0,1,3,6,0,0,10
2024-03-29 04:30:00,0,1,0,6,0,0,7
2024-03-29 04:40:00,1,0,3,5,0,0,9
2024-03-29 04:50:00,0,0,1,5,0,0,6
2024-03-29 05:00:00,1,1,1,8,0,0,11
2024-03-29 05:10:00,1,0,0,2,0,1,4
2024-03-29 05:20:00,2,0,1,11,0,0,14
2024-03-29 05:30:00,0,3,1,17,0,0,21
2024-03-29 05:40:00,5,1,0,19,0,0,25
2024-03-29 05:50:00,2,3,1,12,0,0,18
2024-03-29 06:00:00,2,2,0,4,0,0,8
2024-03-29 06:10:00,1,2,2,5,0,0,10
2024-03-29 06:20:00,0,5,5,9,0,0,19
2024-03-29 06:30:00,1,1,1,9,0,0,12
2024-03-29 06:40:00,1,4,4,5,0,0,14
2024-03-29 06:50:00,1,2,1,10,0,0,14
2024-03-29 07:00:00,1,2,2,10,0,0,15
2024-03-29 07:10:00,1,3,1,14,0,0,19
2024-03-29 07:20:00,2,10,3,7,0,1,23
2024-03-29 07:30:00,3,3,3,12,0,0,21
2024-03-29 07:40:00,5,1,4,7,0,0,17
2024-03-29 07:50:00,3,3,2,11,0,0,19
2024-03-29 08:00:00,2,7,1,11,0,1,22
2024-03-29 08:10:00,4,4,4,18,0,0,30
2024-03-29 08:20:00,3,10,1,7,0,0,21
2024-03-29 08:30:00,5,6,4,10,0,0,25
2024-03-29 08:40:00,1,3,3,11,0,0,18
2024-03-29 08:50:00,2,4,3,12,0,3,24
2024-03-29 09:00:00,5,6,5,13,0,0,29
2024-03-29 09:10:00,9,2,4,14,0,2,31
2024-03-29 09:20:00,4,2,9,17,0,1,33
2024-03-29 09:30:00,5,11,3,14,0,1,34
2024-03-29 09:40:00,5,4,1,16,0,0,26
2024-03-29 09:50:00,6,3,3,19,0,0,31
2024-03-29 10:00:00,10,1,3,17,0,0,31
2024-03-29 10:10:00,8,6,3,17,0,1,35
2024-03-29 10:20:00,6,4,4,20,2,0,36
2024-03-29 10:30:00,8,5,10,18,0,0,41
2024-03-29 10:40:00,10,4,8,15,0,0,37
2024-03-29 10:50:00,7,7,4,17,0,0,35
2024-03-29 11:00:00,4,8,7,14,0,0,33
2024-03-29 11:10:00,10,8,7,21,0,0,46
2024-03-29 11:20:00,5,11,3,23,0,0,42
2024-03-29 11:30:00,5,3,4,22,0,0,34
2024-03-29 11:40:00,3,8,5,17,0,0,33
2024-03-29 11:50:00,2,4,3,25,0,1,35
2024-03-29 12:00:00,9,13,7,24,0,1,54
2024-03-29 12:10:00,8,10,9,22,0,0,49
2024-03-29 12:20:00,11,8,16,23,0,0,58
2024-03-29 12:30:00,10,5,6,17,0,3,41
2024-03-29 12:40:00,9,7,8,19,0,0,43
2024-03-29 12:50:00,6,8,7,20,0,0,41
2024-03-29 13:00:00,7,3,5,26,0,6,47
2024-03-29 13:10:00,8,7,13,22,0,0,50
2024-03-29 13:20:00,11,10,3,29,0,1,54
2024-03-29 13:30:00,7,14,3,25,1,2,52
2024-03-29 13:40:00,12,7,8,24,0,3,54
2024-03-29 13:50:00,11,6,5,19,0,0,41
2024-03-29 14:00:00,2,9,8,27,0,1,47
2024-03-29 14:10:00,9,8,8,25,1,2,53
2024-03-29 14:20:00,9,2,6,24,1,3,45
2024-03-29 14:30:00,7,6,11,16,0,1,41
2024-03-29 14:40:00,4,6,9,20,0,0,39
2024-03-29 14:50:00,7,17,5,24,0,0,53
2024-03-29 15:00:00,7,12,9,23,0,1,52
2024-03-29 15:10:00,5,15,15,20,1,0,56
2024-03-29 15:20:00,6,9,5,20,1,0,41
2024-03-29 15:30:00,7,5,8,24,0,0,44
2024-03-29 15:40:00,7,11,9,23,0,3,53
2024-03-29 15:50:00,7,8,12,22,0,2,51
2024-03-29 16:00:00,9,11,7,23,1,0,51
2024-03-29 16:10:00,7,7,8,17,0,2,41
2024-03-29 16:20:00,7,6,8,21,0,0,42
2024-03-29 16:30:00,9,8,10,23,0,2,52
2024-03-29 16:40:00,7,5,10,21,0,0,43
2024-03-29 16:50:00,6,14,6,24,0,1,51
2024-03-29 17:00:00,8,3,7,19,0,1,38
2024-03-29 17:10:00,5,10,4,19,0,0,38
2024-03-29 17:20:00,9,12,13,25,0,1,60
2024-03-29 17:30:00,5,11,8,36,0,0,60
2024-03-29 17:40:00,7,6,5,23,0,1,42
2024-03-29 17:50:00,8,5,7,29,1,0,50
2024-03-29 18:00:00,12,10,5,23,0,1,51
2024-03-29 18:10:00,9,11,12,26,0,2,60
2024-03-29 18:20:00,6,6,8,24,0,2,46
2024-03-29 18:30:00,12,6,8,16,0,1,43
2024-03-29 18:40:00,6,6,5,15,0,0,32
2024-03-29 18:50:00,7,10,10,19,0,0,46
2024-03-29 19:00:00,4,9,7,16,0,0,36
2024-03-29 19:10:00,8,4,6,22,0,0,40
2024-03-29 19:20:00,12,5,10,14,0,1,42
2024-03-29 19:30:00,7,5,8,18,0,0,38
2024-03-29 19:40:00,4,7,6,17,0,0,34
2024-03-29 19:50:00,5,10,0,17,0,0,32
2024-03-29 20:00:00,3,6,9,13,0,2,33
2024-03-29 20:10:00,6,9,9,17,0,0,41
2024-03-29 20:20:00,4,1,5,25,0,0,35
2024-03-29 20:30:00,7,7,3,24,0,0,41
2024-03-29 20:40:00,5,14,3,15,0,1,38
2024-03-29 20:50:00,5,3,8,15,0,2,33
2024-03-29 21:00:00,4,7,9,17,0,1,38
2024-03-29 21:10:00,4,4,5,16,0,0,29
2024-03-29 21:20:00,1,3,6,18,0,0,28
2024-03-29 21:30:00,4,4,9,11,0,0,28
2024-03-29 21:40:00,10,6,2,14,0,0,32
2024-03-29 21:50:00,2,3,3,21,0,0,29
2024-03-29 22:00:00,5,4,12,17,0,0,38
2024-03-29 22:10:00,4,7,5,18,0,2,36
2024-03-29 22:20:00,5,3,5,22,0,1,36
2024-03-29 22:30:00,1,2,2,12,0,0,17
2024-03-29 22:40:00,5,3,4,14,0,0,26
2024-03-29 22:50:00,1,3,5,13,0,1,23
2024-03-29 23:00:00,2,5,7,16,0,0,30
2024-03-29 23:10:00,5,1,4,14,0,0,24
2024-03-29 23:20:00,6,3,6,10,0,0,25
2024-03-29 23:30:00,3,4,2,15,0,0,24
2024-03-29 23:40:00,7,2,4,10,0,1,24
2024-03-29 23:50:00,1,3,2,10,1,0,17
2024-03-30 00:00:00,1,4,2,15,0,0,22
2024-03-30 00:10:00,5,3,1,7,0,0,16
2024-03-30 00:20:00,0,1,4,12,0,0,17
2024-03-30 00:30:00,2,1,3,13,0,0,19
2024-03-30 00:40:00,2,2,4,10,0,0,18
2024-03-30 00:50:00,1,4,2,8,0,0,15
2024-03-30 01:00:00,2,3,2,8,0,0,15
2024-03-30 01:10:00,0,2,5,9,0,0,16
2024-03-30 01:20:00,5,0,4,8,0,0,17
2024-03-30 01:30:00,0,2,3,8,0,0,13
2024-03-30 01:40:00,0,3,2,14,0,0,19
2024-03-30 01:50:00,0,0,2,4,0,0,6
2024-03-30 02:00:00,1,2,2,8,0,0,13
2024-03-30 02:10:00,0,1,3,8,0,0,12
2024-03-30 02:20:00,2,1,3,8,0,0,14
2024-03-30 02:30:00,0,2,1,3,0,0,6
2024-03-30 02:40:00,2,0,1,5,0,0,8
2024-03-30 02:50:00,0,2,3,3,0,0,8
2024-03-30 03:00:00,0,1,0,3,0,0,4
2024-03-30 03:10:00,0,2,0,4,0,0,6
2024-03-30 03:20:00,2,0,2,10,0,0,14
2024-03-30 03:30:00,1,0,1,7,0,0,9
2024-03-30 03:40:00,0,4,1,6,0,0,11
2024-03-30 03:50:00,0,1,1,2,0,0,4
2024-03-30 04:00:00,0,1,0,3,0,0,4
2024-03-30 04:10:00,0,0,2,4,0,0,6
2024-03-30 04:20:00,0,4,2,5,0,0,11
2024-03-30 04:30:00,1,1,1,4,0,0,7
2024-03-30 04:40:00,0,0,1,10,0,0,11
2024-03-30 04:50:00,0,2,1,7,0,0,10
2024-03-30 05:00:00,1,2,1,9,0,0,13
2024-03-30 05:10:00,2,7,2,9,0,0,20
2024-03-30 05:20:00,0,2,0,11,0,0,13
2024-03-30 05:30:00,5,3,4,22,0,0,34
2024-03-30 05:40:00,2,3,1,16,0,0,22
2024-03-30 05:50:00,1,4,2,9,0,0,16
2024-03-30 06:00:00,1,5,0,7,0,0,13
2024-03-30 06:10:00,1,4,2,8,0,0,15
2024-03-30 06:20:00,1,1,1,7,0,0,10
2024-03-30 06:30:00,2,2,1,16,0,0,21
2024-03-30 06:40:00,2,5,4,9,0,0,20
2024-03-30 06:50:00,2,2,0,14,0,0,18
2024-03-30 07:00:00,1,3,5,10,0,0,19
2024-03-30 07:10:00,1,4,4,13,0,0,22
2024-03-30 07:20:00,2,4,3,12,0,2,23
2024-03-30 07:30:00,0,2,3,14,0,0,19
2024-03-30 07:40:00,4,5,2,7,0,0,18
2024-03-30 07:50:00,3,2,4,18,0,0,27
2024-03-30 08:00:00,4,4,2,19,0,0,29
2024-03-30 08:10:00,2,3,3,11,0,1,20
2024-03-30 08:20:00,3,4,6,22,0,0,35
2024-03-30 08:30:00,7,7,5,20,0,0,39
2024-03-30 08:40:00,6,5,5,17,0,0,33
2024-03-30 08:50:00,7,4,5,19,0,1,36
2024-03-30 09:00:00,7,7,7,21,0,0,42
2024-03-30 09:10:00,7,4,4,16,0,1,32
2024-03-30 09:20:00,11,5,7,22,0,2,47
2024-03-30 09:30:00,8,8,4,18,0,1,39
2024-03-30 09:40:00,8,6,6,23,1,1,45
2024-03-30 09:50:00,8,10,6,21,0,2,47
2024-03-30 10:00:00,8,4,4,22,0,2,40
2024-03-30 10:10:00,7,9,7,23,0,4,50
2024-03-30 10:20:00,12,12,4,22,1,2,53
2024-03-30 10:30:00,6,15,7,25,0,2,55
2024-03-30 10:40:00,11,11,14,22,0,4,62
2024-03-30 10:50:00,9,8,8,22,0,1,48
2024-03-30 11:00:00,7,15,12,25,0,1,60
2024-03-30 11:10:00,14,11,10,22,0,1,58
2024-03-30 11:20:00,11,7,13,28,0,0,59
2024-03-30 11:30:00,4,12,6,18,1,3,44
2024-03-30 11:40:00,11,8,14,29,0,4,66
2024-03-30 11:50:00,7,9,10,17,0,1,44
2024-03-30 12:00:00,8,12,8,27,0,2,57
2024-03-30 12:10:00,9,11,15,21,0,2,58
2024-03-30 12:20:00,6,12,15,23,1,4,61
2024-03-30 12:30:00,12,11,10,22,0,0,55
2024-03-30 12:40:00,9,11,13,21,1,5,60
2024-03-30 12:50:00,16,7,7,16,0,3,49
2024-03-30 13:00:00,7,4,16,26,0,7,60
2024-03-30 13:10:00,7,12,15,21,0,1,56
2024-03-30 13:20:00,9,14,13,24,0,2,62
2024-03-30 13:30:00,8,10,17,20,0,2,57
2024-03-30 13:40:00,9,10,11,11,0,5,46
2024-03-30 13:50:00,13,8,15,20,0,2,58
2024-03-30 14:00:00,17,12,12,21,2,0,64
2024-03-30 14:10:00,10,12,15,30,0,11,78
2024-03-30 14:20:00,14,14,15,18,0,2,63
2024-03-30 14:30:00,10,11,13,15,0,2,51
2024-03-30 14:40:00,12,9,17,21,0,3,62
2024-03-30 14:50:00,5,6,11,16,0,4,42
2024-03-30 15:00:00,7,10,12,30,0,3,62
2024-03-30 15:10:00,7,5,19,21,0,2,54
2024-03-30 15:20:00,12,6,19,20,0,4,61
2024-03-30 15:30:00,8,7,13,26,0,1,55
2024-03-30 15:40:00,8,17,8,30,0,2,65
2024-03-30 15:50:00,5,8,16,18,0,1,48
2024-03-30 16:00:00,11,9,14,20,1,3,58
2024-03-30 16:10:00,12,11,16,22,0,2,63
2024-03-30 16:20:00,7,8,10,20,0,2,47
2024-03-30 16:30:00,7,8,14,18,1,2,50
2024-03-30 16:40:00,5,18,17,30,0,2,72
2024-03-30 16:50:00,9,8,14,25,0,1,57
2024-03-30 17:00:00,11,10,11,23,1,2,58
2024-03-30 17:10:00,8,7,13,23,1,5,57
2024-03-30 17:20:00,8,12,8,23,0,1,52
2024-03-30 17:30:00,9,10,9,19,0,2,49
2024-03-30 17:40:00,8,7,14,18,0,1,48
2024-03-30 17:50:00,9,6,10,26,3,2,56
2024-03-30 18:00:00,12,8,11,22,0,1,54
2024-03-30 18:10:00,10,6,11,23,0,2,52
2024-03-30 18:20:00,8,4,18,19,0,5,54
2024-03-30 18:30:00,4,9,14,20,0,1,48
2024-03-30 18:40:00,6,14,7,23,0,1,51
2024-03-30 18:50:00,5,7,7,17,1,0,37
2024-03-30 19:00:00,3,7,12,19,0,1,42
2024-03-30 19:10:00,5,9,7,18,0,3,42
2024-03-30 19:20:00,4,5,5,24,0,1,39
2024-03-30 19:30:00,5,8,11,18,0,3,45
2024-03-30 19:40:00,4,4,6,23,0,0,37
2024-03-30 19:50:00,9,5,7,21,0,0,42
2024-03-30 20:00:00,4,8,4,16,1,1,34
2024-03-30 20:10:00,3,7,15,32,0,0,57
2024-03-30 20:20:00,5,6,10,29,0,1,51
2024-03-30 20:30:00,5,6,6,17,0,0,34
2024-03-30 20:40:00,4,3,7,17,0,1,32
2024-03-30 20:50:00,3,4,3,26,0,0,36
2024-03-30 21:00:00,7,3,8,19,1,1,39
2024-03-30 21:10:00,5,7,6,17,0,0,35
2024-03-30 21:20:00,5,4,0,16,0,0,25
2024-03-30 21:30:00,3,4,3,17,0,1,28
2024-03-30 21:40:00,5,4,4,15,0,0,28
2024-03-30 21:50:00,3,9,2,21,0,1,36
2024-03-30 22:00:00,15,4,2,24,0,0,45
2024-03-30 22:10:00,4,5,8,13,0,2,32
2024-03-30 22:20:00,1,4,3,14,0,0,22
2024-03-30 22:30:00,4,5,4,19,0,1,33
2024-03-30 22:40:00,4,2,6,19,0,0,31
2024-03-30 22:50:00,2,5,2,36,2,1,48
2024-03-30 23:00:00,4,4,5,13,0,1,27
2024-03-30 23:10:00,6,6,2,13,0,1,28
2024-03-30 23:20:00,2,5,7,19,0,0,33
2024-03-30 23:30:00,1,2,2,17,0,0,22
2024-03-30 23:40:00,9,4,5,12,0,0,30
2024-03-30 23:50:00,1,0,3,14,0,0,18
2024-03-31 00:00:00,2,3,2,12,0,0,19
2024-03-31 00:10:00,2,2,3,17,0,0,24
2024-03-31 00:20:00,2,7,2,17,0,0,28
2024-03-31 00:30:00,2,3,5,10,0,0,20
2024-03-31 00:40:00,0,1,0,12,0,0,13
2024-03-31 00:50:00,1,1,1,13,0,0,16
2024-03-31 01:00:00,1,3,1,7,0,0,12
2024-03-31 01:10:00,1,0,3,14,0,0,18
2024-03-31 01:20:00,2,0,1,11,0,0,14
2024-03-31 01:30:00,0,2,3,12,0,0,17
2024-03-31 01:40:00,3,1,2,9,0,0,15
2024-03-31 01:50:00,3,0,5,10,0,0,18
2024-03-31 02:00:00,0,0,0,0,0,0,0
2024-03-31 02:10:00,0,0,0,0,0,0,0
2024-03-31 02:20:00,0,0,0,0,0,0,0
2024-03-31 02:30:00,0,0,0,0,0,0,0
2024-03-31 02:40:00,0,0,0,0,0,0,0
2024-03-31 02:50:00,0,0,0,0,0,0,0
2024-03-31 03:00:00,0,0,0,0,0,0,0
2024-03-31 03:10:00,0,0,0,0,0,0,0
2024-03-31 03:20:00,0,0,0,0,0,0,0
2024-03-31 03:30:00,0,0,0,0,0,0,0
2024-03-31 03:40:00,0,0,0,0,0,0,0
2024-03-31 03:50:00,0,0,0,0,0,0,0
2024-03-31 04:00:00,1,1,3,8,0,0,13
2024-03-31 04:10:00,2,0,4,5,0,0,11
2024-03-31 04:20:00,0,4,4,7,0,1,16
2024-03-31 04:30:00,0,4,2,6,0,0,12
2024-03-31 04:40:00,1,1,0,4,0,0,6
2024-03-31 04:50:00,1,0,0,8,0,0,9
2024-03-31 05:00:00,1,3,1,7,0,0,12
2024-03-31 05:10:00,0,2,2,7,0,0,11
2024-03-31 05:20:00,1,1,3,12,0,0,17
2024-03-31 05:30:00,1,4,1,13,0,0,19
2024-03-31 05:40:00,1,1,5,18,0,0,25
2024-03-31 05:50:00,0,2,3,8,0,0,13
2024-03-31 06:00:00,2,2,4,7,0,0,15
2024-03-31 06:10:00,3,1,1,10,0,0,15
2024-03-31 06:20:00,0,1,1,6,0,0,8
2024-03-31 06:30:00,0,2,4,15,0,0,21
2024-03-31 06:40:00,4,4,4,5,0,0,17
2024-03-31 06:50:00,1,0,1,9,0,1,12
2024-03-31 07:00:00,0,1,0,8,0,0,9
2024-03-31 07:10:00,1,0,0,9,0,0,10
2024-03-31 07:20:00,5,2,1,6,0,0,14
2024-03-31 07:30:00,3,2,0,6,0,0,11
2024-03-31 07:40:00,4,1,2,10,0,0,17
2024-03-31 07:50:00,2,4,3,16,0,0,25
2024-03-31 08:00:00,1,3,3,7,0,0,14
2024-03-31 08:10:00,5,3,3,10,0,0,21
2024-03-31 08:20:00,4,7,1,17,0,0,29
2024-03-31 08:30:00,2,2,2,11,0,1,18
2024-03-31 08:40:00,1,0,4,12,0,0,17
2024-03-31 08:50:00,0,3,2,13,0,0,18
2024-03-31 09:00:00,0,3,4,14,0,0,21
2024-03-31 09:10:00,6,5,0,9,0,0,20
2024-03-31 09:20:00,3,3,5,16,0,0,27
2024-03-31 09:30:00,5,5,5,14,0,0,29
2024-03-31 09:40:00,6,6,3,15,0,0,30
2024-03-31 09:50:00,9,6,3,14,0,0,32
2024-03-31 10:00:00,3,2,5,18,0,1,29
2024-03-31 10:10:00,17,9,8,26,0,1,61
2024-03-31 10:20:00,18,2,3,20,0,0,43
2024-03-31 10:30:00,9,8,4,21,0,0,42
2024-03-31 10:40:00,9,7,5,22,0,0,43
2024-03-31 10:50:00,8,3,6,26,0,0,43
2024-03-31 11:00:00,7,18,5,14,0,0,44
2024-03-31 11:10:00,5,11,5,22,3,1,47
2024-03-31 11:20:00,6,6,5,17,0,0,34
2024-03-31 11:30:00,10,5,10,26,0,0,51
2024-03-31 11:40:00,10,9,8,18,1,0,46
2024-03-31 11:50:00,4,7,6,25,0,2,44
2024-03-31 12:00:00,7,8,9,19,0,0,43
2024-03-31 12:10:00,14,7,6,21,0,1,49
2024-03-31 12:20:00,3,8,7,24,2,0,44
2024-03-31 12:30:00,4,9,6,36,0,0,55
2024-03-31 12:40:00,8,6,9,21,0,0,44
2024-03-31 12:50:00,7,5,3,20,0,2,37
2024-03-31 13:00:00,7,8,12,23,0,0,50
2024-03-31 13:10:00,7,7,6,28,0,1,49
2024-03-31 13:20:00,6,10,10,19,0,0,45
2024-03-31 13:30:00,3,7,7,30,1,0,48
2024-03-31 13:40:00,3,5,14,26,0,0,48
2024-03-31 13:50:00,2,9,5,25,0,1,42
2024-03-31 14:00:00,5,16,9,19,0,1,50
2024-03-31 14:10:00,3,12,11,20,1,1,48
2024-03-31 14:20:00,4,4,5,24,0,0,37
2024-03-31 14:30:00,10,5,2,21,0,1,39
2024-03-31 14:40:00,13,5,7,28,0,0,53
2024-03-31 14:50:00,4,14,8,17,0,0,43
2024-03-31 15:00:00,9,11,10,22,0,0,52
2024-03-31 15:10:00,6,9,7,26,0,1,49
2024-03-31 15:20:00,3,9,6,18,0,3,39
2024-03-31 15:30:00,7,10,11,23,1,3,55
2024-03-31 15:40:00,8,5,12,18,0,1,44
2024-03-31 15:50:00,4,4,10,18,0,0,36
2024-03-31 16:00:00,6,9,6,17,0,1,39
2024-03-31 16:10:00,6,9,7,23,0,2,47
2024-03-31 16:20:00,5,5,10,22,2,1,45
2024-03-31 16:30:00,6,10,11,21,0,0,48
2024-03-31 16:40:00,4,4,8,22,1,0,39
2024-03-31 16:50:00,4,10,12,16,2,2,46
2024-03-31 17:00:00,5,5,10,22,0,7,49
2024-03-31 17:10:00,5,4,7,24,0,1,41
2024-03-31 17:20:00,6,14,10,21,0,1,52
2024-03-31 17:30:00,2,8,6,20,0,0,36
2024-03-31 17:40:00,10,6,13,18,0,1,48
2024-03-31 17:50:00,8,11,4,23,0,1,47
2024-03-31 18:00:00,8,6,6,15,0,3,38
2024-03-31 18:10:00,7,5,7,18,0,0,37
2024-03-31 18:20:00,6,4,11,26,0,0,47
2024-03-31 18:30:00,3,8,11,14,0,1,37
2024-03-31 18:40:00,5,11,10,17,0,0,43
2024-03-31 18:50:00,7,9,3,25,0,0,44
2024-03-31 19:00:00,5,5,10,22,1,0,43
2024-03-31 19:10:00,3,5,7,14,0,1,30
2024-03-31 19:20:00,8,9,11,19,0,0,47
2024-03-31 19:30:00,3,12,6,18,0,0,39
2024-03-31 19:40:00,7,7,5,21,0,0,40
2024-03-31 19:50:00,1,8,3,19,0,2,33
2024-03-31 20:00:00,6,5,4,17,0,2,34
2024-03-31 20:10:00,8,4,7,16,0,1,36
2024-03-31 20:20:00,5,4,6,13,0,0,28
2024-03-31 20:30:00,4,5,3,20,0,0,32
2024-03-31 20:40:00,2,3,3,20,0,1,29
2024-03-31 20:50:00,2,4,6,19,0,0,31
2024-03-31 21:00:00,4,5,3,20,0,0,32
2024-03-31 21:10:00,8,6,9,18,0,0,41
2024-03-31 21:20:00,7,1,9,18,1,1,37
2024-03-31 21:30:00,4,6,2,14,0,0,26
2024-03-31 21:40:00,1,4,1,22,0,2,30
2024-03-31 21:50:00,3,3,2,19,0,1,28
2024-03-31 22:00:00,4,5,8,13,0,1,31
2024-03-31 22:10:00,2,6,5,14,0,0,27
2024-03-31 22:20:00,3,5,2,19,0,0,29
2024-03-31 22:30:00,7,3,5,17,0,0,32
2024-03-31 22:40:00,2,2,6,18,0,1,29
2024-03-31 22:50:00,1,1,4,15,0,0,21
2024-03-31 23:00:00,6,3,8,15,0,0,32
2024-03-31 23:10:00,2,4,1,15,0,0,22
2024-03-31 23:20:00,5,4,2,8,0,0,19
2024-03-31 23:30:00,3,4,4,18,0,0,29
2024-03-31 23:40:00,3,8,1,15,0,1,28
2024-03-31 23:50:00,1,0,4,8,0,0,13
2024-04-01 00:00:00,1,7,4,10,0,1,23
2024-04-01 00:10:00,4,2,1,11,0,0,18
2024-04-01 00:20:00,2,0,4,16,0,0,22
2024-04-01 00:30:00,3,5,1,10,0,0,19
2024-04-01 00:40:00,1,1,2,11,0,1,16
2024-04-01 00:50:00,0,0,3,14,0,0,17
2024-04-01 01:00:00,2,5,6,6,0,0,19
2024-04-01 01:10:00,2,0,1,10,0,0,13
2024-04-01 01:20:00,2,1,2,9,0,0,14
2024-04-01 01:30:00,0,0,6,8,0,0,14
2024-04-01 01:40:00,1,2,0,11,0,0,14
2024-04-01 01:50:00,2,0,1,6,0,0,9
2024-04-01 02:00:00,0,1,1,6,0,2,10
2024-04-01 02:10:00,1,1,0,10,0,0,12
2024-04-01 02:20:00,3,0,0,1,0,0,4
2024-04-01 02:30:00,2,3,0,7,0,0,12
2024-04-01 02:40:00,0,1,1,6,0,0,8
2024-04-01 02:50:00,0,1,3,4,0,0,8
2024-04-01 03:00:00,0,0,1,7,0,0,8
2024-04-01 03:10:00,0,4,3,4,0,0,11
2024-04-01 03:20:00,0,1,0,5,0,0,6
2024-04-01 03:30:00,0,0,0,0,0,0,0
2024-04-01 03:40:00,0,1,3,8,0,0,12
2024-04-01 03:50:00,0,1,1,4,0,0,6
2024-04-01 04:00:00,0,2,1,3,0,0,6
2024-04-01 04:10:00,0,1,3,6,0,0,10
2024-04-01 04:20:00,0,1,0,8,0,0,9
2024-04-01 04:30:00,1,2,0,2,0,0,5
2024-04-01 04:40:00,4,0,1,7,0,0,12
2024-04-01 04:50:00,0,0,0,3,0,0,3
2024-04-01 05:00:00,0,1,0,3,0,0,4
2024-04-01 05:10:00,1,0,3,5,0,0,9
2024-04-01 05:20:00,1,1,2,7,0,0,11
2024-04-01 05:30:00,0,4,5,13,0,0,22
2024-04-01 05:40:00,4,2,0,13,0,0,19
2024-04-01 05:50:00,0,1,0,7,0,0,8
2024-04-01 06:00:00,1,2,1,9,0,0,13
2024-04-01 06:10:00,2,3,2,12,0,0,19
2024-04-01 06:20:00,5,1,2,12,0,0,20
2024-04-01 06:30:00,1,5,4,8,0,0,18
2024-04-01 06:40:00,3,3,3,6,0,0,15
2024-04-01 06:50:00,2,2,0,7,0,0,11
2024-04-01 07:00:00,2,2,1,10,0,0,15
2024-04-01 07:10:00,2,2,3,10,0,0,17
2024-04-01 07:20:00,0,3,2,6,0,1,12
2024-04-01 07:30:00,1,3,1,9,0,0,14
2024-04-01 07:40:00,2,3,1,7,0,0,13
2024-04-01 07:50:00,0,2,2,13,0,0,17
2024-04-01 08:00:00,2,1,1,10,0,0,14
2024-04-01 08:10:00,5,1,2,8,0,0,16
2024-04-01 08:20:00,1,3,2,13,0,0,19
2024-04-01 08:30:00,2,1,0,12,0,1,16
2024-04-01 08:40:00,2,1,3,7,0,0,13
2024-04-01 08:50:00,2,6,2,9,0,0,19
2024-04-01 09:00:00,1,4,0,6,1,0,12
2024-04-01 09:10:00,3,2,4,14,0,0,23
2024-04-01 09:20:00,1,5,1,14,0,0,21
2024-04-01 09:30:00,2,1,2,17,0,0,22
2024-04-01 09:40:00,6,5,2,12,0,0,25
2024-04-01 09:50:00,6,2,6,20,0,0,34
2024-04-01 10:00:00,3,4,4,14,0,0,25
2024-04-01 10:10:00,2,5,2,21,0,0,30
2024-04-01 10:20:00,0,5,3,20,0,0,28
2024-04-01 10:30:00,4,6,5,14,0,0,29
2024-04-01 10:40:00,10,5,5,18,0,0,38
2024-04-01 10:50:00,7,5,4,21,0,0,37
2024-04-01 11:00:00,8,9,2,14,0,1,34
2024-04-01 11:10:00,6,6,3,15,0,0,30
2024-04-01 11:20:00,8,7,2,18,0,0,35
2024-04-01 11:30:00,9,9,5,21,0,0,44
2024-04-01 11:40:00,9,6,7,15,0,0,37
2024-04-01 11:50:00,2,6,4,17,0,0,29
2024-04-01 12:00:00,6,9,3,22,0,1,41
2024-04-01 12:10:00,6,7,9,23,0,0,45
2024-04-01 12:20:00,7,7,7,18,0,0,39
2024-04-01 12:30:00,8,6,6,25,0,0,45
2024-04-01 12:40:00,7,4,6,23,0,0,40
2024-04-01 12:50:00,10,6,6,21,0,0,43
2024-04-01 13:00:00,7,6,5,28,0,1,47
2024-04-01 13:10:00,7,6,9,18,0,2,42
2024-04-01 13:20:00,6,7,6,19,0,1,39
2024-04-01 13:30:00,13,10,2,21,0,0,46
2024-04-01 13:40:00,8,9,6,20,0,1,44
2024-04-01 13:50:00,7,10,5,25,0,0,47
2024-04-01 14:00:00,4,13,6,20,0,0,43
2024-04-01 14:10:00,7,9,8,24,0,1,49
2024-04-01 14:20:00,7,9,10,22,0,0,48
2024-04-01 14:30:00,10,9,4,18,0,3,44
2024-04-01 14:40:00,10,7,8,18,1,0,44
2024-04-01 14:50:00,6,8,7,21,0,0,42
2024-04-01 15:00:00,9,9,8,23,0,0,49
2024-04-01 15:10:00,9,9,11,21,0,2,52
2024-04-01 15:20:00,5,10,6,25,0,1,47
2024-04-01 15:30:00,7,5,5,24,0,0,41
2024-04-01 15:40:00,8,8,7,32,0,0,55
2024-04-01 15:50:00,5,7,7,23,0,2,44
2024-04-01 16:00:00,8,11,8,23,0,1,51
2024-04-01 16:10:00,2,7,3,25,0,0,37
2024-04-01 16:20:00,13,7,10,13,0,1,44
2024-04-01 16:30:00,10,7,12,20,0,1,50
2024-04-01 16:40:00,7,3,15,22,0,0,47
2024-04-01 16:50:00,8,10,7,21,0,2,48
2024-04-01 17:00:00,6,8,11,18,0,0,43
2024-04-01 17:10:00,3,9,10,22,1,3,48
2024-04-01 17:20:00,5,10,11,23,0,1,50
2024-04-01 17:30:00,11,5,10,25,0,3,54
2024-04-01 17:40:00,3,8,15,28,1,1,56
2024-04-01 17:50:00,6,9,15,27,0,0,57
2024-04-01 18:00:00,7,6,7,22,0,0,42
2024-04-01 18:10:00,3,4,9,26,0,1,43
2024-04-01 18:20:00,7,4,8,21,0,2,42
2024-04-01 18:30:00,5,6,10,18,0,2,41
2024-04-01 18:40:00,8,4,12,18,0,0,42
2024-04-01 18:50:00,5,6,6,20,0,1,38
2024-04-01 19:00:00,5,7,7,24,0,0,43
2024-04-01 19:10:00,7,7,7,23,0,1,45
2024-04-01 19:20:00,4,8,6,22,0,0,40
2024-04-01 19:30:00,11,2,17,20,1,0,51
2024-04-01 19:40:00,10,5,11,18,0,0,44
2024-04-01 19:50:00,2,8,3,18,0,0,31
2024-04-01 20:00:00,5,6,8,19,0,0,38
2024-04-01 20:10:00,8,3,9,14,0,1,35
2024-04-01 20:20:00,3,6,8,19,0,0,36
2024-04-01 20:30:00,7,3,5,19,0,0,34
2024-04-01 20:40:00,7,7,3,15,0,2,34
2024-04-01 20:50:00,6,6,7,21,0,2,42
2024-04-01 21:00:00,8,4,5,19,0,0,36
2024-04-01 21:10:00,5,7,9,19,0,0,40
2024-04-01 21:20:00,4,2,7,24,0,0,37
2024-04-01 21:30:00,3,8,6,16,0,1,34
2024-04-01 21:40:00,5,7,7,19,0,1,39
2024-04-01 21:50:00,5,10,4,16,0,0,35
2024-04-01 22:00:00,2,3,3,13,0,1,22
2024-04-01 22:10:00,3,5,2,8,0,0,18
2024-04-01 22:20:00,3,3,4,17,0,0,27
2024-04-01 22:30:00,5,2,2,15,1,0,25
2024-04-01 22:40:00,7,7,2,48,0,2,66
2024-04-01 22:50:00,5,1,6,13,0,0,25
2024-04-01 23:00:00,1,7,3,17,0,0,28
2024-04-01 23:10:00,5,4,2,7,0,1,19
2024-04-01 23:20:00,3,4,6,10,0,0,23
2024-04-01 23:30:00,0,2,2,10,0,0,14
2024-04-01 23:40:00,1,2,2,11,0,0,16
2024-04-01 23:50:00,0,1,3,10,0,0,14
2024-04-02 00:00:00,0,4,2,7,0,0,13
2024-04-02 00:10:00,2,5,3,12,0,0,22
2024-04-02 00:20:00,0,1,2,8,0,0,11
2024-04-02 00:30:00,0,2,2,7,0,0,11
2024-04-02 00:40:00,1,1,0,6,0,0,8
2024-04-02 00:50:00,0,0,0,5,0,0,5
2024-04-02 01:00:00,1,1,0,5,0,0,7
2024-04-02 01:10:00,1,0,3,7,0,0,11
2024-04-02 01:20:00,1,0,0,3,0,0,4
2024-04-02 01:30:00,1,0,1,5,0,0,7
2024-04-02 01:40:00,0,0,1,5,0,0,6
2024-04-02 01:50:00,2,1,0,1,0,0,4
2024-04-02 02:00:00,0,0,1,1,0,0,2
2024-04-02 02:10:00,0,2,0,6,0,0,8
2024-04-02 02:20:00,0,0,2,3,0,0,5
2024-04-02 02:30:00,1,0,0,7,0,0,8
2024-04-02 02:40:00,0,1,0,1,0,0,2
2024-04-02 02:50:00,0,0,0,3,0,0,3
2024-04-02 03:00:00,0,1,2,0,0,0,3
2024-04-02 03:10:00,0,0,0,3,0,0,3
2024-04-02 03:20:00,0,1,0,6,0,0,7
2024-04-02 03:30:00,0,1,0,1,0,0,2
2024-04-02 03:40:00,0,0,1,6,0,0,7
2024-04-02 03:50:00,0,0,0,3,0,0,3
2024-04-02 04:00:00,0,1,4,0,0,0,5
2024-04-02 04:10:00,1,0,0,6,0,0,7
2024-04-02 04:20:00,0,2,2,4,0,0,8
2024-04-02 04:30:00,0,1,0,4,0,0,5
2024-04-02 04:40:00,0,2,2,3,0,0,7
2024-04-02 04:50:00,0,2,1,11,0,0,14
2024-04-02 05:00:00,0,6,0,7,0,0,13
2024-04-02 05:10:00,3,5,4,15,0,0,27
2024-04-02 05:20:00,3,1,3,19,0,0,26
2024-04-02 05:30:00,1,10,3,17,0,0,31
2024-04-02 05:40:00,4,8,1,19,0,1,33
2024-04-02 05:50:00,3,4,5,19,0,0,31
2024-04-02 06:00:00,10,8,1,19,0,0,38
2024-04-02 06:10:00,3,6,12,27,0,0,48
2024-04-02 06:20:00,9,11,6,17,0,1,44
2024-04-02 06:30:00,7,8,8,15,0,1,39
2024-04-02 06:40:00,8,7,4,28,0,1,48
2024-04-02 06:50:00,3,8,5,15,0,1,32
2024-04-02 07:00:00,3,8,8,21,0,1,41
2024-04-02 07:10:00,10,18,4,16,0,2,50
2024-04-02 07:20:00,8,10,7,16,0,0,41
2024-04-02 07:30:00,10,18,12,14,0,1,55
2024-04-02 07:40:00,10,22,11,23,0,2,68
2024-04-02 07:50:00,7,16,10,16,0,0,49
2024-04-02 08:00:00,8,20,17,18,0,1,64
2024-04-02 08:10:00,8,12,12,17,0,3,52
2024-04-02 08:20:00,12,14,14,21,0,3,64
2024-04-02 08:30:00,6,14,15,20,0,2,57
2024-04-02 08:40:00,8,15,12,21,0,3,59
2024-04-02 08:50:00,10,14,17,16,0,8,65
2024-04-02 09:00:00,9,16,13,18,0,1,57
2024-04-02 09:10:00,9,13,18,18,1,1,60
2024-04-02 09:20:00,6,8,18,15,0,4,51
2024-04-02 09:30:00,13,11,17,27,0,2,70
2024-04-02 09:40:00,6,9,19,16,1,3,54
2024-04-02 09:50:00,6,14,14,24,2,2,62
2024-04-02 10:00:00,10,8,13,23,1,2,57
2024-04-02 10:10:00,12,10,11,26,1,1,61
2024-04-02 10:20:00,6,17,15,23,0,4,65
2024-04-02 10:30:00,9,9,14,20,1,1,54
2024-04-02 10:40:00,7,10,11,19,1,0,48
2024-04-02 10:50:00,9,13,9,24,0,3,58
2024-04-02 11:00:00,9,12,19,21,0,3,64
2024-04-02 11:10:00,16,15,9,17,0,1,58
2024-04-02 11:20:00,10,13,16,17,2,2,60
2024-04-02 11:30:00,9,8,19,30,0,2,68
2024-04-02 11:40:00,8,10,12,17,0,1,48
2024-04-02 11:50:00,10,12,17,16,0,1,56
2024-04-02 12:00:00,13,11,15,18,0,0,57
2024-04-02 12:10:00,31,12,20,20,0,5,88
2024-04-02 12:20:00,8,12,11,24,1,1,57
2024-04-02 12:30:00,14,12,17,15,0,0,58
2024-04-02 12:40:00,13,11,20,25,1,1,71
2024-04-02 12:50:00,5,15,14,21,2,1,58
2024-04-02 13:00:00,10,12,14,15,0,3,54
2024-04-02 13:10:00,26,12,14,22,0,3,77
2024-04-02 13:20:00,11,16,15,23,1,0,66
2024-04-02 13:30:00,12,17,9,23,0,1,62
2024-04-02 13:40:00,7,14,15,19,0,1,56
2024-04-02 13:50:00,9,9,19,22,0,0,59
2024-04-02 14:00:00,8,18,22,19,0,3,70
2024-04-02 14:10:00,12,14,16,25,0,2,69
2024-04-02 14:20:00,8,14,14,16,4,2,58
2024-04-02 14:30:00,11,12,19,19,2,1,64
2024-04-02 14:40:00,21,18,14,10,0,2,65
2024-04-02 14:50:00,12,12,10,15,0,2,51
2024-04-02 15:00:00,8,18,22,10,2,2,62
2024-04-02 15:10:00,11,18,24,17,0,2,72
2024-04-02 15:20:00,14,13,16,21,1,1,66
2024-04-02 15:30:00,12,12,21,22,0,1,68
2024-04-02 15:40:00,10,11,15,25,2,3,66
2024-04-02 15:50:00,7,16,18,20,0,2,63
2024-04-02 16:00:00,11,13,21,19,3,3,70
2024-04-02 16:10:00,15,16,22,19,1,1,74
2024-04-02 16:20:00,10,16,16,16,1,9,68
2024-04-02 16:30:00,16,13,18,22,0,4,73
2024-04-02 16:40:00,13,12,21,19,1,3,69
2024-04-02 16:50:00,12,10,16,13,2,2,55
2024-04-02 17:00:00,8,12,17,23,0,3,63
2024-04-02 17:10:00,9,10,21,20,0,2,62
2024-04-02 17:20:00,13,16,18,25,0,2,74
2024-04-02 17:30:00,11,12,17,24,1,2,67
2024-04-02 17:40:00,12,15,15,19,0,4,65
2024-04-02 17:50:00,8,15,17,24,0,2,66
2024-04-02 18:00:00,23,18,18,29,0,3,91
2024-04-02 18:10:00,12,17,22,24,0,6,81
2024-04-02 18:20:00,10,17,20,26,3,3,79
2024-04-02 18:30:00,11,13,17,25,0,0,66
2024-04-02 18:40:00,6,7,13,17,0,3,46
2024-04-02 18:50:00,9,9,11,16,0,2,47
2024-04-02 19:00:00,6,9,16,23,0,3,57
2024-04-02 19:10:00,9,6,20,25,2,2,64
2024-04-02 19:20:00,15,6,11,24,0,2,58
2024-04-02 19:30:00,7,5,10,22,0,1,45
2024-04-02 19:40:00,5,9,12,22,0,0,48
2024-04-02 19:50:00,6,7,7,17,0,2,39
2024-04-02 20:00:00,5,7,12,25,2,3,54
2024-04-02 20:10:00,7,11,8,20,0,0,46
2024-04-02 20:20:00,5,5,4,22,0,1,37
2024-04-02 20:30:00,5,8,4,18,0,0,35
2024-04-02 20:40:00,3,4,4,23,0,1,35
2024-04-02 20:50:00,6,7,4,19,0,4,40
2024-04-02 21:00:00,3,7,3,20,0,0,33
2024-04-02 21:10:00,5,7,13,21,0,0,46
2024-04-02 21:20:00,1,10,9,19,0,4,43
2024-04-02 21:30:00,5,4,7,13,0,0,29
2024-04-02 21:40:00,4,4,4,18,0,1,31
2024-04-02 21:50:00,1,7,5,18,0,4,35
2024-04-02 22:00:00,2,6,3,20,0,0,31
2024-04-02 22:10:00,4,5,5,20,0,0,34
2024-04-02 22:20:00,4,4,6,11,0,0,25
2024-04-02 22:30:00,4,5,2,11,0,0,22
2024-04-02 22:40:00,6,2,4,15,0,0,27
2024-04-02 22:50:00,7,5,6,13,0,0,31
2024-04-02 23:00:00,2,6,7,20,0,0,35
2024-04-02 23:10:00,3,3,6,12,0,1,25
2024-04-02 23:20:00,1,8,1,7,0,0,17
2024-04-02 23:30:00,0,3,2,12,0,1,18
2024-04-02 23:40:00,2,1,4,8,0,0,15
2024-04-02 23:50:00,2,6,1,10,0,0,19
2024-04-03 00:00:00,1,3,1,6,0,0,11
2024-04-03 00:10:00,5,6,3,11,0,0,25
2024-04-03 00:20:00,0,2,4,11,0,0,17
2024-04-03 00:30:00,0,3,3,6,0,0,12
2024-04-03 00:40:00,1,2,3,10,0,0,16
2024-04-03 00:50:00,0,0,3,10,0,0,13
2024-04-03 01:00:00,0,0,1,9,0,0,10
2024-04-03 01:10:00,0,2,1,9,0,0,12
2024-04-03 01:20:00,3,0,1,4,0,0,8
2024-04-03 01:30:00,0,2,6,5,0,0,13
2024-04-03 01:40:00,0,0,1,4,0,0,5
2024-04-03 01:50:00,1,1,0,5,0,0,7
2024-04-03 02:00:00,0,0,0,8,0,0,8
2024-04-03 02:10:00,0,1,0,6,0,0,7
2024-04-03 02:20:00,0,0,0,2,0,0,2
2024-04-03 02:30:00,0,0,0,2,0,0,2
2024-04-03 02:40:00,0,1,2,3,0,0,6
2024-04-03 02:50:00,0,0,0,4,0,0,4
2024-04-03 03:00:00,0,0,1,2,0,0,3
2024-04-03 03:10:00,0,0,1,3,0,0,4
2024-04-03 03:20:00,0,0,1,3,0,0,4
2024-04-03 03:30:00,0,5,0,0,0,0,5
2024-04-03 03:40:00,0,0,0,2,0,0,2
2024-04-03 03:50:00,0,0,2,5,0,0,7
2024-04-03 04:00:00,0,1,0,2,0,0,3
2024-04-03 04:10:00,0,1,1,6,0,0,8
2024-04-03 04:20:00,0,0,0,4,0,0,4
2024-04-03 04:30:00,3,2,1,3,0,0,9
2024-04-03 04:40:00,1,0,3,3,0,0,7
2024-04-03 04:50:00,1,2,1,9,0,0,13
2024-04-03 05:00:00,0,2,0,8,0,0,10
2024-04-03 05:10:00,3,5,5,11,0,0,24
2024-04-03 05:20:00,2,4,4,13,0,1,24
2024-04-03 05:30:00,2,12,2,15,0,0,31
2024-04-03 05:40:00,3,5,4,23,0,0,35
2024-04-03 05:50:00,5,7,3,16,0,0,31
2024-04-03 06:00:00,4,4,4,17,0,0,29
2024-04-03 06:10:00,3,10,11,20,0,0,44
2024-04-03 06:20:00,4,8,3,28,0,1,44
2024-04-03 06:30:00,4,9,9,22,0,0,44
2024-04-03 06:40:00,4,9,6,27,0,0,46
2024-04-03 06:50:00,9,8,5,13,0,0,35
2024-04-03 07:00:00,8,9,9,21,0,0,47
2024-04-03 07:10:00,6,12,7,19,0,1,45
2024-04-03 07:20:00,11,10,6,22,0,5,54
2024-04-03 07:30:00,6,6,7,21,0,0,40
2024-04-03 07:40:00,7,13,13,24,0,3,60
2024-04-03 07:50:00,7,9,10,16,0,2,44
2024-04-03 08:00:00,4,11,14,26,0,1,56
2024-04-03 08:10:00,11,16,16,32,1,1,77
2024-04-03 08:20:00,12,19,13,19,0,2,65
2024-04-03 08:30:00,7,10,14,20,0,2,53
2024-04-03 08:40:00,10,17,12,21,0,3,63
2024-04-03 08:50:00,8,11,15,21,0,1,56
2024-04-03 09:00:00,14,9,23,20,0,3,69
2024-04-03 09:10:00,8,25,12,19,0,1,65
2024-04-03 09:20:00,9,20,10,16,1,1,57
2024-04-03 09:30:00,13,13,12,22,0,1,61
2024-04-03 09:40:00,14,12,16,14,0,3,59
2024-04-03 09:50:00,19,14,12,16,1,1,63
2024-04-03 10:00:00,11,12,10,18,0,5,56
2024-04-03 10:10:00,7,14,18,11,1,0,51
2024-04-03 10:20:00,7,12,9,21,0,0,49
2024-04-03 10:30:00,8,12,14,15,0,2,51
2024-04-03 10:40:00,15,7,11,12,0,1,46
2024-04-03 10:50:00,9,19,12,17,0,0,57
2024-04-03 11:00:00,8,13,14,19,0,0,54
2024-04-03 11:10:00,12,9,22,15,0,3,61
2024-04-03 11:20:00,11,13,15,27,0,3,69
2024-04-03 11:30:00,8,12,14,17,0,4,55
2024-04-03 11:40:00,14,12,18,3,0,3,50
2024-04-03 11:50:00,8,21,15,25,0,2,71
2024-04-03 12:00:00,6,11,16,16,0,6,55
2024-04-03 12:10:00,11,13,14,17,1,1,57
2024-04-03 12:20:00,11,4,15,23,0,3,56
2024-04-03 12:30:00,7,14,22,20,2,1,66
2024-04-03 12:40:00,8,10,16,20,0,2,56
2024-04-03 12:50:00,6,15,10,24,1,1,57
2024-04-03 13:00:00,12,12,13,16,0,1,54
2024-04-03 13:10:00,11,14,13,19,0,0,57
2024-04-03 13:20:00,13,12,22,20,0,2,69
2024-04-03 13:30:00,5,15,21,12,0,1,54
2024-04-03 13:40:00,7,17,13,19,0,1,57
2024-04-03 13:50:00,7,20,18,24,0,1,70
2024-04-03 14:00:00,12,7,21,22,1,1,64
2024-04-03 14:10:00,8,14,11,6,0,1,40
2024-04-03 14:20:00,13,12,18,17,0,1,61
2024-04-03 14:30:00,8,11,26,20,0,1,66
2024-04-03 14:40:00,12,13,18,11,0,3,57
2024-04-03 14:50:00,7,13,15,17,0,2,54
2024-04-03 15:00:00,7,7,12,19,0,0,45
2024-04-03 15:10:00,8,15,18,15,0,1,57
2024-04-03 15:20:00,10,23,10,18,1,1,63
2024-04-03 15:30:00,8,12,28,13,1,2,64
2024-04-03 15:40:00,13,13,16,15,0,0,57
2024-04-03 15:50:00,5,8,28,18,0,2,61
2024-04-03 16:00:00,13,10,15,19,1,7,65
2024-04-03 16:10:00,10,10,17,17,1,1,56
2024-04-03 16:20:00,12,13,23,18,0,2,68
2024-04-03 16:30:00,12,18,24,12,0,6,72
2024-04-03 16:40:00,11,14,23,17,0,3,68
2024-04-03 16:50:00,13,12,24,18,0,2,69
2024-04-03 17:00:00,17,10,23,24,1,4,79
2024-04-03 17:10:00,12,15,15,16,0,0,58
2024-04-03 17:20:00,11,9,25,10,0,1,56
2024-04-03 17:30:00,11,12,14,21,1,2,61
2024-04-03 17:40:00,11,13,18,10,0,2,54
2024-04-03 17:50:00,8,15,17,19,0,0,59
2024-04-03 18:00:00,13,16,15,13,0,0,57
2024-04-03 18:10:00,7,11,19,19,0,1,57
2024-04-03 18:20:00,7,12,13,24,0,1,57
2024-04-03 18:30:00,7,11,14,25,1,1,59
2024-04-03 18:40:00,12,8,10,14,0,0,44
2024-04-03 18:50:00,6,10,14,29,1,0,60
2024-04-03 19:00:00,4,13,10,22,0,3,52
2024-04-03 19:10:00,8,11,13,22,0,1,55
2024-04-03 19:20:00,8,11,15,27,0,1,62
2024-04-03 19:30:00,10,7,8,23,1,2,51
2024-04-03 19:40:00,7,10,11,21,0,1,50
2024-04-03 19:50:00,3,8,14,21,0,3,49
2024-04-03 20:00:00,5,9,9,22,0,1,46
2024-04-03 20:10:00,2,5,8,19,1,1,36
2024-04-03 20:20:00,6,7,9,22,0,0,44
2024-04-03 20:30:00,4,8,6,18,2,0,38
2024-04-03 20:40:00,7,6,5,23,0,0,41
2024-04-03 20:50:00,3,7,5,18,0,0,33
2024-04-03 21:00:00,5,13,10,19,1,0,48
2024-04-03 21:10:00,5,4,9,15,0,0,33
2024-04-03 21:20:00,7,4,5,23,0,0,39
2024-04-03 21:30:00,9,6,7,13,0,0,35
2024-04-03 21:40:00,4,1,7,11,0,0,23
2024-04-03 21:50:00,1,7,7,20,0,1,36
2024-04-03 22:00:00,6,5,3,19,0,1,34
2024-04-03 22:10:00,2,3,3,17,0,1,26
2024-04-03 22:20:00,6,3,3,15,0,0,27
2024-04-03 22:30:00,12,5,9,21,0,0,47
2024-04-03 22:40:00,5,6,5,22,0,1,39
2024-04-03 22:50:00,8,4,2,19,0,0,33
2024-04-03 23:00:00,4,6,7,13,0,1,31
2024-04-03 23:10:00,6,1,3,11,0,0,21
2024-04-03 23:20:00,8,3,5,10,1,0,27
2024-04-03 23:30:00,4,4,7,15,1,0,31
2024-04-03 23:40:00,1,4,3,7,0,0,15
2024-04-03 23:50:00,6,3,3,15,0,0,27
2024-04-04 00:00:00,0,5,3,7,0,0,15
2024-04-04 00:10:00,6,4,4,7,0,0,21
2024-04-04 00:20:00,0,2,1,12,0,0,15
2024-04-04 00:30:00,1,1,0,7,0,1,10
2024-04-04 00:40:00,3,1,1,9,0,0,14
2024-04-04 00:50:00,0,1,1,7,0,0,9
2024-04-04 01:00:00,3,2,2,5,0,0,12
2024-04-04 01:10:00,2,1,2,5,0,0,10
2024-04-04 01:20:00,0,1,1,2,0,0,4
2024-04-04 01:30:00,0,1,3,4,0,0,8
2024-04-04 01:40:00,1,0,4,3,0,0,8
2024-04-04 01:50:00,0,3,1,2,0,0,6
2024-04-04 02:00:00,2,0,2,5,0,0,9
2024-04-04 02:10:00,0,2,0,3,0,0,5
2024-04-04 02:20:00,1,1,0,3,0,0,5
2024-04-04 02:30:00,0,0,0,1,0,0,1
2024-04-04 02:40:00,0,1,0,5,0,0,6
2024-04-04 02:50:00,0,0,0,3,0,0,3
2024-04-04 03:00:00,0,0,0,0,0,0,0
2024-04-04 03:10:00,0,0,1,1,0,0,2
2024-04-04 03:20:00,0,0,3,3,0,0,6
2024-04-04 03:30:00,2,1,1,3,0,0,7
2024-04-04 03:40:00,0,0,2,3,0,0,5
2024-04-04 03:50:00,1,0,0,4,0,0,5
2024-04-04 04:00:00,0,2,2,1,0,0,5
2024-04-04 04:10:00,0,0,0,5,0,0,5
2024-04-04 04:20:00,0,2,1,4,0,0,7
2024-04-04 04:30:00,0,1,4,2,0,0,7
2024-04-04 04:40:00,1,0,0,2,0,0,3
2024-04-04 04:50:00,0,3,4,5,0,0,12
2024-04-04 05:00:00,0,3,3,14,0,0,20
2024-04-04 05:10:00,2,7,4,9,0,0,22
2024-04-04 05:20:00,3,1,4,11,0,0,19
2024-04-04 05:30:00,2,7,3,18,0,1,31
2024-04-04 05:40:00,6,5,4,18,0,0,33
2024-04-04 05:50:00,3,5,3,16,0,1,28
2024-04-04 06:00:00,6,5,3,18,0,0,32
2024-04-04 06:10:00,9,4,6,16,0,1,36
2024-04-04 06:20:00,6,6,6,21,0,0,39
2024-04-04 06:30:00,5,4,7,18,0,0,34
2024-04-04 06:40:00,5,10,4,26,0,1,46
2024-04-04 06:50:00,2,8,12,14,0,1,37
2024-04-04 07:00:00,5,5,9,14,0,1,34
2024-04-04 07:10:00,6,23,4,21,0,2,56
2024-04-04 07:20:00,4,18,7,20,0,1,50
2024-04-04 07:30:00,9,12,13,17,0,0,51
2024-04-04 07:40:00,6,15,8,27,0,2,58
2024-04-04 07:50:00,9,15,15,18,1,1,59
2024-04-04 08:00:00,7,12,12,22,0,3,56
2024-04-04 08:10:00,8,10,15,26,0,2,61
2024-04-04 08:20:00,18,9,5,25,0,2,59
2024-04-04 08:30:00,12,13,9,21,1,1,57
2024-04-04 08:40:00,8,17,11,18,0,1,55
2024-04-04 08:50:00,10,16,15,14,0,2,57
2024-04-04 09:00:00,5,16,15,17,1,4,58
2024-04-04 09:10:00,9,12,16,23,0,4,64
2024-04-04 09:20:00,4,9,14,25,1,2,55
2024-04-04 09:30:00,18,9,15,18,3,1,64
2024-04-04 09:40:00,8,8,9,23,1,1,50
2024-04-04 09:50:00,9,15,18,23,0,2,67
2024-04-04 10:00:00,11,8,14,15,0,4,52
2024-04-04 10:10:00,11,9,17,22,1,1,61
2024-04-04 10:20:00,10,13,15,22,0,6,66
2024-04-04 10:30:00,15,15,17,11,0,2,60
2024-04-04 10:40:00,10,19,15,13,0,4,61
2024-04-04 10:50:00,13,11,16,20,1,1,62
2024-04-04 11:00:00,16,16,18,21,1,0,72
2024-04-04 11:10:00,11,18,15,16,0,2,62
2024-04-04 11:20:00,8,16,19,13,1,3,60
2024-04-04 11:30:00,5,17,19,16,0,1,58
2024-04-04 11:40:00,10,10,23,16,0,1,60
2024-04-04 11:50:00,8,13,19,19,0,5,64
2024-04-04 12:00:00,12,5,16,16,0,1,50
2024-04-04 12:10:00,17,18,13,14,0,6,68
2024-04-04 12:20:00,7,7,10,14,0,0,38
2024-04-04 12:30:00,10,7,17,24,0,2,60
2024-04-04 12:40:00,11,8,22,15,0,2,58
2024-04-04 12:50:00,13,12,15,21,0,1,62
2024-04-04 13:00:00,11,8,15,13,0,1,48
2024-04-04 13:10:00,12,10,15,8,0,2,47
2024-04-04 13:20:00,8,8,17,19,0,0,52
2024-04-04 13:30:00,11,11,19,27,0,1,69
2024-04-04 13:40:00,14,17,20,13,0,0,64
2024-04-04 13:50:00,6,14,12,16,0,0,48
2024-04-04 14:00:00,5,7,17,13,0,1,43
2024-04-04 14:10:00,9,13,22,15,0,1,60
2024-04-04 14:20:00,13,13,15,17,1,1,60
2024-04-04 14:30:00,9,23,16,14,0,2,64
2024-04-04 14:40:00,9,13,10,1,1,3,37
2024-04-04 14:50:00,15,12,17,8,0,2,54
2024-04-04 15:00:00,13,8,15,16,0,1,53
2024-04-04 15:10:00,6,14,14,14,0,1,49
2024-04-04 15:20:00,9,16,15,16,1,1,58
2024-04-04 15:30:00,13,13,14,14,0,1,55
2024-04-04 15:40:00,13,10,17,13,0,2,55
2024-04-04 15:50:00,11,13,14,16,0,2,56
2024-04-04 16:00:00,14,14,16,20,0,5,69
2024-04-04 16:10:00,11,17,15,15,1,0,59
2024-04-04 16:20:00,13,31,19,18,0,0,81
2024-04-04 16:30:00,10,18,20,23,0,2,73
2024-04-04 16:40:00,17,20,19,10,0,3,69
2024-04-04 16:50:00,14,14,26,15,0,3,72
2024-04-04 17:00:00,14,9,18,20,0,5,66
2024-04-04 17:10:00,16,19,16,21,1,2,75
2024-04-04 17:20:00,11,12,27,12,0,2,64
2024-04-04 17:30:00,13,15,20,23,1,2,74
2024-04-04 17:40:00,5,15,16,19,1,5,61
2024-04-04 17:50:00,15,20,16,16,1,2,70
2024-04-04 18:00:00,14,14,25,18,1,2,74
2024-04-04 18:10:00,7,9,19,21,0,4,60
2024-04-04 18:20:00,6,11,17,19,2,2,57
2024-04-04 18:30:00,8,11,17,25,0,3,64
2024-04-04 18:40:00,11,10,18,18,0,2,59
2024-04-04 18:50:00,12,13,7,21,0,1,54
2024-04-04 19:00:00,12,11,19,22,0,0,64
2024-04-04 19:10:00,9,11,16,19,0,0,55
2024-04-04 19:20:00,9,12,11,27,0,1,60
2024-04-04 19:30:00,11,11,11,17,0,3,53
2024-04-04 19:40:00,8,11,12,22,0,3,56
2024-04-04 19:50:00,7,7,8,22,0,2,46
2024-04-04 20:00:00,11,9,4,17,1,2,44
2024-04-04 20:10:00,12,9,13,14,0,2,50
2024-04-04 20:20:00,12,13,5,17,0,0,47
2024-04-04 20:30:00,10,6,5,17,0,0,38
2024-04-04 20:40:00,8,6,5,25,0,3,47
2024-04-04 20:50:00,5,7,4,18,0,1,35
2024-04-04 21:00:00,7,9,5,12,0,1,34
2024-04-04 21:10:00,12,5,6,13,0,0,36
2024-04-04 21:20:00,3,12,6,22,0,1,44
2024-04-04 21:30:00,6,13,8,15,0,0,42
2024-04-04 21:40:00,5,6,5,20,0,1,37
2024-04-04 21:50:00,4,6,6,15,0,0,31
2024-04-04 22:00:00,6,7,7,10,0,1,31
2024-04-04 22:10:00,4,3,10,32,0,1,50
2024-04-04 22:20:00,7,5,6,15,0,1,34
2024-04-04 22:30:00,7,3,10,16,0,1,37
2024-04-04 22:40:00,6,4,5,16,0,0,31
2024-04-04 22:50:00,6,7,7,12,1,0,33
2024-04-04 23:00:00,6,6,5,17,0,0,34
2024-04-04 23:10:00,3,5,4,13,0,0,25
2024-04-04 23:20:00,7,1,8,9,0,0,25
2024-04-04 23:30:00,2,5,1,13,0,0,21
2024-04-04 23:40:00,5,1,4,11,0,0,21
2024-04-04 23:50:00,1,1,2,8,0,0,12
2024-04-05 00:00:00,3,3,2,13,0,0,21
2024-04-05 00:10:00,2,2,2,14,0,0,20
2024-04-05 00:20:00,1,4,1,15,0,0,21
2024-04-05 00:30:00,3,3,3,8,0,0,17
2024-04-05 00:40:00,3,0,4,9,0,0,16
2024-04-05 00:50:00,1,0,1,9,0,0,11
2024-04-05 01:00:00,0,1,2,4,0,0,7
2024-04-05 01:10:00,0,0,3,6,1,0,10
2024-04-05 01:20:00,1,0,1,6,0,0,8
2024-04-05 01:30:00,2,0,3,4,0,0,9
2024-04-05 01:40:00,0,0,1,7,0,0,8
2024-04-05 01:50:00,0,0,0,3,0,0,3
2024-04-05 02:00:00,0,1,0,0,0,0,1
