datetime,V21Z,V22Z,V52Z,V81Z,V82Z,V112Z,Total
2024-03-01 01:00:00,2,2,0,4,4,0,12
2024-03-01 01:10:00,3,4,1,3,2,0,13
2024-03-01 01:20:00,1,0,1,1,0,0,3
2024-03-01 01:30:00,4,3,0,5,3,0,15
2024-03-01 01:40:00,2,2,0,2,2,0,8
2024-03-01 01:50:00,1,1,0,2,2,0,6
2024-03-01 02:00:00,2,2,0,4,3,0,11
2024-03-01 02:10:00,2,2,1,0,0,0,5
2024-03-01 02:20:00,1,1,0,0,0,0,2
2024-03-01 02:30:00,1,1,0,0,0,0,2
2024-03-01 02:40:00,0,0,0,3,3,0,6
2024-03-01 02:50:00,1,1,0,4,3,0,9
2024-03-01 03:00:00,0,0,2,2,1,0,5
2024-03-01 03:10:00,1,1,1,2,2,0,7
2024-03-01 03:20:00,1,1,3,2,1,2,10
2024-03-01 03:30:00,0,0,0,2,1,2,5
2024-03-01 03:40:00,0,0,1,4,3,0,8
2024-03-01 03:50:00,0,2,1,0,0,0,3
2024-03-01 04:00:00,3,3,0,0,0,0,6
2024-03-01 04:10:00,0,2,0,3,6,0,11
2024-03-01 04:20:00,1,3,1,2,4,0,11
2024-03-01 04:30:00,2,3,0,2,4,2,13
2024-03-01 04:40:00,2,3,1,2,3,0,11
2024-03-01 04:50:00,3,3,5,0,0,0,11
2024-03-01 05:00:00,8,8,1,2,4,0,23
2024-03-01 05:10:00,9,8,2,4,5,0,28
2024-03-01 05:20:00,4,3,4,5,5,3,24
2024-03-01 05:30:00,6,8,11,5,2,0,32
2024-03-01 05:40:00,10,12,5,8,6,0,41
2024-03-01 05:50:00,7,7,2,7,6,2,31
2024-03-01 06:00:00,11,11,10,7,8,1,48
2024-03-01 06:10:00,12,12,3,11,9,0,47
2024-03-01 06:20:00,10,12,7,12,8,3,52
2024-03-01 06:30:00,15,14,13,16,18,1,77
2024-03-01 06:40:00,16,11,6,13,12,2,60
2024-03-01 06:50:00,23,19,7,23,16,3,91
2024-03-01 07:00:00,19,21,9,23,17,1,90
2024-03-01 07:10:00,34,24,12,21,21,7,119
2024-03-01 07:20:00,30,28,15,25,18,6,122
2024-03-01 07:30:00,54,40,25,28,15,9,171
2024-03-01 07:40:00,39,23,18,32,20,8,140
2024-03-01 07:50:00,39,24,20,52,33,7,175
2024-03-01 08:00:00,34,28,19,28,20,8,137
2024-03-01 08:10:00,43,42,17,27,24,9,162
2024-03-01 08:20:00,31,31,27,28,19,13,149
2024-03-01 08:30:00,33,29,20,21,11,6,120
2024-03-01 08:40:00,37,24,19,28,23,12,143
2024-03-01 08:50:00,36,32,25,33,21,5,152
2024-03-01 09:00:00,53,33,26,30,24,11,177
2024-03-01 09:10:00,46,31,18,36,20,11,162
2024-03-01 09:20:00,27,22,21,34,22,5,131
2024-03-01 09:30:00,38,27,21,23,15,7,131
2024-03-01 09:40:00,34,29,29,43,19,2,156
2024-03-01 09:50:00,38,30,21,24,19,9,141
2024-03-01 10:00:00,45,25,21,33,20,6,150
2024-03-01 10:10:00,40,35,19,42,29,10,175
2024-03-01 10:20:00,33,25,22,41,23,6,150
2024-03-01 10:30:00,44,29,18,28,15,14,148
2024-03-01 10:40:00,45,20,30,36,18,6,155
2024-03-01 10:50:00,40,24,26,28,15,11,144
2024-03-01 11:00:00,36,28,20,38,15,14,151
2024-03-01 11:10:00,43,38,23,42,21,19,186
2024-03-01 11:20:00,41,32,19,42,30,18,182
2024-03-01 11:30:00,39,28,25,42,26,11,171
2024-03-01 11:40:00,35,30,18,47,25,9,164
2024-03-01 11:50:00,38,26,17,28,22,6,137
2024-03-01 12:00:00,37,34,14,41,21,11,158
2024-03-01 12:10:00,36,25,18,40,24,14,157
2024-03-01 12:20:00,28,23,23,30,25,14,143
2024-03-01 12:30:00,40,27,19,37,27,8,158
2024-03-01 12:40:00,37,36,23,42,27,10,175
2024-03-01 12:50:00,57,45,13,36,26,5,182
2024-03-01 13:00:00,37,30,23,38,28,6,162
2024-03-01 13:10:00,18,14,14,32,14,4,96
2024-03-01 13:20:00,41,37,20,32,17,12,159
2024-03-01 13:30:00,38,28,4,44,31,13,158
2024-03-01 13:40:00,44,32,20,36,24,6,162
2024-03-01 13:50:00,51,44,22,33,19,7,176
2024-03-01 14:00:00,30,23,22,39,20,7,141
2024-03-01 14:10:00,48,28,13,44,25,6,164
2024-03-01 14:20:00,50,41,16,44,28,4,183
2024-03-01 14:30:00,35,20,22,43,28,7,155
2024-03-01 14:40:00,49,44,16,49,29,11,198
2024-03-01 14:50:00,49,36,24,44,27,10,190
2024-03-01 15:00:00,42,34,16,29,22,10,153
2024-03-01 15:10:00,58,36,19,43,22,12,190
2024-03-01 15:20:00,41,27,24,51,24,8,175
2024-03-01 15:30:00,29,23,27,56,23,4,162
2024-03-01 15:40:00,49,25,18,44,33,14,183
2024-03-01 15:50:00,31,24,15,21,15,14,120
2024-03-01 16:00:00,38,20,15,50,12,9,144
2024-03-01 16:10:00,38,30,20,53,36,10,187
2024-03-01 16:20:00,43,23,28,43,16,6,159
2024-03-01 16:30:00,52,35,16,51,20,11,185
2024-03-01 16:40:00,32,20,22,49,27,5,155
2024-03-01 16:50:00,46,33,26,45,25,9,184
2024-03-01 17:00:00,48,29,26,27,17,9,156
2024-03-01 17:10:00,44,32,25,41,27,4,173
2024-03-01 17:20:00,43,27,13,37,22,8,150
2024-03-01 17:30:00,41,29,7,50,11,9,147
2024-03-01 17:40:00,44,25,8,39,17,10,143
2024-03-01 17:50:00,42,25,17,50,22,7,163
2024-03-01 18:00:00,42,28,15,33,22,9,149
2024-03-01 18:10:00,48,25,22,43,21,4,163
2024-03-01 18:20:00,50,36,27,33,22,10,178
2024-03-01 18:30:00,38,24,15,41,24,11,153
2024-03-01 18:40:00,33,26,20,35,20,15,149
2024-03-01 18:50:00,34,19,29,22,18,4,126
2024-03-01 19:00:00,30,17,21,32,23,9,132
2024-03-01 19:10:00,32,26,25,38,23,11,155
2024-03-01 19:20:00,27,15,13,22,13,11,101
2024-03-01 19:30:00,21,19,10,27,20,3,100
2024-03-01 19:40:00,25,24,18,22,20,8,117
2024-03-01 19:50:00,24,17,22,15,13,4,95
2024-03-01 20:00:00,22,18,7,18,14,1,80
2024-03-01 20:10:00,19,13,9,27,20,5,93
2024-03-01 20:20:00,29,19,18,31,19,0,116
2024-03-01 20:30:00,15,9,5,16,15,2,62
2024-03-01 20:40:00,18,17,7,15,12,2,71
2024-03-01 20:50:00,14,11,12,16,16,3,72
2024-03-01 21:00:00,16,9,18,24,14,4,85
2024-03-01 21:10:00,11,11,10,18,16,1,67
2024-03-01 21:20:00,11,13,11,14,14,1,64
2024-03-01 21:30:00,16,16,6,23,12,2,75
2024-03-01 21:40:00,12,11,10,14,8,2,57
2024-03-01 21:50:00,11,12,4,9,9,3,48
2024-03-01 22:00:00,16,16,5,25,18,0,80
2024-03-01 22:10:00,19,14,9,20,11,2,75
2024-03-01 22:20:00,13,11,7,11,12,0,54
2024-03-01 22:30:00,12,7,6,17,16,1,59
2024-03-01 22:40:00,15,10,4,15,7,3,54
2024-03-01 22:50:00,6,6,3,7,6,0,28
2024-03-01 23:00:00,16,13,8,12,8,0,57
2024-03-01 23:10:00,8,4,2,16,12,1,43
2024-03-01 23:20:00,8,7,0,13,8,0,36
2024-03-01 23:30:00,11,9,3,14,8,0,45
2024-03-01 23:40:00,5,4,6,8,5,4,32
2024-03-01 23:50:00,5,5,3,7,6,0,26
2024-03-02 00:00:00,9,8,2,11,8,0,38
2024-03-02 00:10:00,8,10,3,7,7,5,40
2024-03-02 00:20:00,7,8,3,5,2,0,25
2024-03-02 00:30:00,2,2,0,9,2,0,15
2024-03-02 00:40:00,8,8,1,6,4,0,27
2024-03-02 00:50:00,3,3,0,3,3,1,13
2024-03-02 01:00:00,6,4,1,11,6,1,29
2024-03-02 01:10:00,1,1,0,2,0,0,4
2024-03-02 01:20:00,3,3,0,4,3,0,13
2024-03-02 01:30:00,2,2,1,4,4,0,13
2024-03-02 01:40:00,5,5,0,4,7,1,22
2024-03-02 01:50:00,4,4,3,4,4,0,19
2024-03-02 02:00:00,5,5,2,3,5,0,20
2024-03-02 02:10:00,2,2,0,6,2,1,13
2024-03-02 02:20:00,6,4,1,4,3,0,18
2024-03-02 02:30:00,4,4,0,3,2,0,13
2024-03-02 02:40:00,1,1,0,1,1,0,4
2024-03-02 02:50:00,1,1,0,4,5,0,11
2024-03-02 03:00:00,4,4,1,5,2,0,16
2024-03-02 03:10:00,3,3,1,3,4,0,14
2024-03-02 03:20:00,3,3,0,2,2,0,10
2024-03-02 03:30:00,6,5,2,4,3,0,20
2024-03-02 03:40:00,1,1,0,2,2,1,7
2024-03-02 03:50:00,4,4,0,3,2,1,14
2024-03-02 04:00:00,4,4,1,5,5,0,19
2024-03-02 04:10:00,1,1,1,3,3,0,9
2024-03-02 04:20:00,2,2,2,3,3,1,13
2024-03-02 04:30:00,4,5,0,3,2,2,16
2024-03-02 04:40:00,4,3,1,1,1,0,10
2024-03-02 04:50:00,6,6,0,3,2,0,17
2024-03-02 05:00:00,4,4,3,2,2,0,15
2024-03-02 05:10:00,6,5,2,3,4,0,20
2024-03-02 05:20:00,1,1,0,4,4,0,10
2024-03-02 05:30:00,4,5,1,7,6,0,23
2024-03-02 05:40:00,2,2,2,1,3,0,10
2024-03-02 05:50:00,1,7,2,2,2,2,16
2024-03-02 06:00:00,4,3,3,5,6,0,21
2024-03-02 06:10:00,6,6,5,7,6,1,31
2024-03-02 06:20:00,5,6,2,7,6,0,26
2024-03-02 06:30:00,11,13,7,7,5,0,43
2024-03-02 06:40:00,7,7,3,9,13,0,39
2024-03-02 06:50:00,11,11,6,7,6,2,43
2024-03-02 07:00:00,6,13,5,5,4,2,35
2024-03-02 07:10:00,15,17,10,10,9,3,64
2024-03-02 07:20:00,19,14,11,10,11,3,68
2024-03-02 07:30:00,17,18,11,17,14,1,78
2024-03-02 07:40:00,12,9,13,13,11,3,61
2024-03-02 07:50:00,19,20,18,14,12,5,88
2024-03-02 08:00:00,18,19,25,16,18,6,102
2024-03-02 08:10:00,19,16,18,15,18,9,95
2024-03-02 08:20:00,22,26,11,17,19,6,101
2024-03-02 08:30:00,29,25,22,23,22,4,125
2024-03-02 08:40:00,27,24,21,16,9,6,103
2024-03-02 08:50:00,22,31,20,20,18,7,118
2024-03-02 09:00:00,21,23,15,22,20,6,107
2024-03-02 09:10:00,30,32,22,25,16,17,142
2024-03-02 09:20:00,37,35,16,25,20,12,145
2024-03-02 09:30:00,42,31,26,26,18,11,154
2024-03-02 09:40:00,38,32,18,22,20,6,136
2024-03-02 09:50:00,40,28,21,32,25,4,150
2024-03-02 10:00:00,45,39,13,25,17,8,147
2024-03-02 10:10:00,36,30,23,34,22,9,154
2024-03-02 10:20:00,47,38,16,35,26,8,170
2024-03-02 10:30:00,33,30,21,27,14,3,128
2024-03-02 10:40:00,41,25,15,34,16,8,139
2024-03-02 10:50:00,53,27,19,36,19,9,163
2024-03-02 11:00:00,43,27,39,41,22,10,182
2024-03-02 11:10:00,37,35,20,33,23,12,160
2024-03-02 11:20:00,52,33,15,41,13,8,162
2024-03-02 11:30:00,44,26,19,49,22,6,166
2024-03-02 11:40:00,44,29,22,39,21,14,169
2024-03-02 11:50:00,42,32,6,34,21,21,156
2024-03-02 12:00:00,44,15,23,40,17,40,179
2024-03-02 12:10:00,57,24,21,41,22,9,174
2024-03-02 12:20:00,42,29,15,37,26,13,162
2024-03-02 12:30:00,51,34,19,33,25,10,172
2024-03-02 12:40:00,49,35,21,36,13,5,159
2024-03-02 12:50:00,50,38,26,33,20,16,183
2024-03-02 13:00:00,32,29,19,25,18,12,135
2024-03-02 13:10:00,38,35,17,32,18,15,155
2024-03-02 13:20:00,45,17,18,36,18,10,144
2024-03-02 13:30:00,46,35,27,35,30,8,181
2024-03-02 13:40:00,38,34,19,32,29,6,158
2024-03-02 13:50:00,43,32,21,26,12,5,139
2024-03-02 14:00:00,38,36,18,34,24,11,161
2024-03-02 14:10:00,45,33,20,34,26,10,168
2024-03-02 14:20:00,38,40,23,25,18,14,158
2024-03-02 14:30:00,36,32,22,30,19,5,144
2024-03-02 14:40:00,36,19,19,34,20,15,143
2024-03-02 14:50:00,43,31,25,42,16,6,163
2024-03-02 15:00:00,42,29,19,37,13,8,148
2024-03-02 15:10:00,37,29,12,38,25,7,148
2024-03-02 15:20:00,30,21,23,39,19,8,140
2024-03-02 15:30:00,30,20,20,35,19,7,131
2024-03-02 15:40:00,34,33,24,54,19,20,184
2024-03-02 15:50:00,38,24,19,25,17,9,132
2024-03-02 16:00:00,25,23,21,23,23,7,122
2024-03-02 16:10:00,22,19,23,28,24,4,120
2024-03-02 16:20:00,41,24,23,31,18,5,142
2024-03-02 16:30:00,36,29,24,34,19,2,144
2024-03-02 16:40:00,26,17,16,40,27,10,136
2024-03-02 16:50:00,31,25,14,35,28,4,137
2024-03-02 17:00:00,41,28,18,46,21,6,160
2024-03-02 17:10:00,27,28,20,39,27,8,149
2024-03-02 17:20:00,33,23,22,26,18,13,135
2024-03-02 17:30:00,30,27,23,39,15,1,135
2024-03-02 17:40:00,38,32,24,33,21,9,157
2024-03-02 17:50:00,39,38,18,36,14,10,155
2024-03-02 18:00:00,31,28,20,34,23,5,141
2024-03-02 18:10:00,34,24,24,44,19,12,157
2024-03-02 18:20:00,40,22,31,45,19,48,205
2024-03-02 18:30:00,24,20,21,34,21,7,127
2024-03-02 18:40:00,36,24,25,31,22,6,144
2024-03-02 18:50:00,29,27,16,27,18,4,121
2024-03-02 19:00:00,43,23,16,30,15,7,134
2024-03-02 19:10:00,41,19,26,46,32,12,176
2024-03-02 19:20:00,25,23,22,19,17,10,116
2024-03-02 19:30:00,17,14,17,34,23,5,110
2024-03-02 19:40:00,14,15,20,25,19,5,98
2024-03-02 19:50:00,26,22,16,27,22,6,119
2024-03-02 20:00:00,25,22,13,29,16,6,111
2024-03-02 20:10:00,19,17,11,25,15,6,93
2024-03-02 20:20:00,17,15,19,22,12,5,90
2024-03-02 20:30:00,24,16,15,23,11,1,90
2024-03-02 20:40:00,20,15,11,24,12,4,86
2024-03-02 20:50:00,18,17,18,14,15,0,82
2024-03-02 21:00:00,13,14,12,17,15,0,71
2024-03-02 21:10:00,25,18,11,19,18,5,96
2024-03-02 21:20:00,13,10,11,15,14,7,70
2024-03-02 21:30:00,17,12,11,33,20,0,93
2024-03-02 21:40:00,14,9,17,17,11,0,68
2024-03-02 21:50:00,16,15,8,10,8,0,57
2024-03-02 22:00:00,17,14,3,23,17,1,75
2024-03-02 22:10:00,16,13,5,12,11,1,58
2024-03-02 22:20:00,21,16,7,22,19,1,86
2024-03-02 22:30:00,6,9,4,13,7,2,41
2024-03-02 22:40:00,12,15,16,15,11,1,70
2024-03-02 22:50:00,13,13,3,17,12,0,58
2024-03-02 23:00:00,11,9,2,11,9,1,43
2024-03-02 23:10:00,5,4,5,16,17,3,50
2024-03-02 23:20:00,10,11,13,14,11,0,59
2024-03-02 23:30:00,7,7,8,10,8,0,40
2024-03-02 23:40:00,13,9,4,4,4,2,36
2024-03-02 23:50:00,8,11,8,7,6,1,41
2024-03-03 00:00:00,7,7,5,10,7,0,36
2024-03-03 00:10:00,4,3,1,8,7,4,27
2024-03-03 00:20:00,10,9,2,4,2,3,30
2024-03-03 00:30:00,7,7,9,7,7,1,38
2024-03-03 00:40:00,4,3,0,8,7,0,22
2024-03-03 00:50:00,5,5,5,16,11,0,42
2024-03-03 01:00:00,7,8,1,14,13,2,45
2024-03-03 01:10:00,1,1,2,5,5,1,15
2024-03-03 01:20:00,2,2,4,5,5,0,18
2024-03-03 01:30:00,5,4,2,6,5,1,23
2024-03-03 01:40:00,5,4,1,7,6,1,24
2024-03-03 01:50:00,7,6,6,7,6,0,32
2024-03-03 02:00:00,5,5,2,3,4,2,21
2024-03-03 02:10:00,2,1,3,4,4,1,15
2024-03-03 02:20:00,3,2,1,2,2,1,11
2024-03-03 02:30:00,3,3,0,4,2,0,12
2024-03-03 02:40:00,2,2,1,3,3,0,11
2024-03-03 02:50:00,1,1,0,3,3,0,8
2024-03-03 03:00:00,5,6,0,4,3,0,18
2024-03-03 03:10:00,1,1,0,1,1,0,4
2024-03-03 03:20:00,1,0,0,2,2,0,5
2024-03-03 03:30:00,3,3,1,4,6,2,19
2024-03-03 03:40:00,1,2,0,1,2,0,6
2024-03-03 03:50:00,0,0,0,1,1,2,4
2024-03-03 04:00:00,5,8,0,3,4,10,30
2024-03-03 04:10:00,6,6,0,2,2,0,16
2024-03-03 04:20:00,2,2,1,2,2,1,10
2024-03-03 04:30:00,2,2,0,4,4,0,12
2024-03-03 04:40:00,2,2,0,3,3,0,10
2024-03-03 04:50:00,4,4,2,5,7,4,26
2024-03-03 05:00:00,3,3,2,3,4,0,15
2024-03-03 05:10:00,3,4,1,3,4,0,15
2024-03-03 05:20:00,2,2,0,0,0,0,4
2024-03-03 05:30:00,3,3,1,4,4,0,15
2024-03-03 05:40:00,1,0,0,1,1,0,3
2024-03-03 05:50:00,2,2,1,1,2,0,8
2024-03-03 06:00:00,3,3,5,6,6,2,25
2024-03-03 06:10:00,1,1,2,7,5,3,19
2024-03-03 06:20:00,2,2,0,4,4,0,12
2024-03-03 06:30:00,3,2,2,4,3,0,14
2024-03-03 06:40:00,1,1,1,5,5,0,13
2024-03-03 06:50:00,1,1,4,2,2,0,10
2024-03-03 07:00:00,7,7,3,7,7,0,31
2024-03-03 07:10:00,3,6,2,3,5,0,19
2024-03-03 07:20:00,6,8,3,3,3,0,23
2024-03-03 07:30:00,4,6,2,7,7,0,26
2024-03-03 07:40:00,8,9,0,6,5,1,29
2024-03-03 07:50:00,9,11,2,11,9,3,45
2024-03-03 08:00:00,9,13,6,9,5,5,47
2024-03-03 08:10:00,10,13,9,13,14,3,62
2024-03-03 08:20:00,10,11,4,12,11,0,48
2024-03-03 08:30:00,17,14,6,8,10,5,60
2024-03-03 08:40:00,18,18,9,6,8,3,62
2024-03-03 08:50:00,5,6,13,8,8,4,44
2024-03-03 09:00:00,19,20,11,16,14,0,80
2024-03-03 09:10:00,11,19,8,13,10,2,63
2024-03-03 09:20:00,23,25,9,8,7,5,77
2024-03-03 09:30:00,21,21,9,17,16,6,90
2024-03-03 09:40:00,26,34,13,16,14,5,108
2024-03-03 09:50:00,21,25,13,20,15,1,95
2024-03-03 10:00:00,30,25,6,24,19,1,105
2024-03-03 10:10:00,25,21,13,20,14,5,98
2024-03-03 10:20:00,19,19,8,23,15,11,95
2024-03-03 10:30:00,22,27,10,20,20,3,102
2024-03-03 10:40:00,24,24,7,26,16,5,102
2024-03-03 10:50:00,24,33,12,19,14,4,106
2024-03-03 11:00:00,29,29,18,15,10,4,105
2024-03-03 11:10:00,30,28,19,17,12,3,109
2024-03-03 11:20:00,25,28,11,17,14,0,95
2024-03-03 11:30:00,23,23,13,28,19,3,109
2024-03-03 11:40:00,22,23,14,19,33,13,124
2024-03-03 11:50:00,29,29,17,20,29,3,127
2024-03-03 12:00:00,31,23,7,24,32,5,122
2024-03-03 12:10:00,28,24,13,26,22,3,116
2024-03-03 12:20:00,27,33,20,15,18,8,121
2024-03-03 12:30:00,35,36,10,31,31,4,147
2024-03-03 12:40:00,26,23,12,22,17,4,104
2024-03-03 12:50:00,29,31,20,22,18,5,125
2024-03-03 13:00:00,26,18,11,32,19,4,110
2024-03-03 13:10:00,29,28,17,29,23,3,129
2024-03-03 13:20:00,23,23,21,26,21,4,118
2024-03-03 13:30:00,34,29,17,20,14,7,121
2024-03-03 13:40:00,34,27,15,31,15,3,125
2024-03-03 13:50:00,35,34,12,31,24,8,144
2024-03-03 14:00:00,38,33,23,30,17,16,157
2024-03-03 14:10:00,29,24,16,22,17,5,113
2024-03-03 14:20:00,26,30,15,31,27,9,138
2024-03-03 14:30:00,34,21,24,35,24,4,142
2024-03-03 14:40:00,27,16,32,34,23,6,138
2024-03-03 14:50:00,34,32,15,32,21,6,140
2024-03-03 15:00:00,43,30,10,31,20,1,135
2024-03-03 15:10:00,33,28,14,24,18,11,128
2024-03-03 15:20:00,34,29,15,27,17,3,125
2024-03-03 15:30:00,38,27,14,44,20,8,151
2024-03-03 15:40:00,38,27,19,28,15,6,133
2024-03-03 15:50:00,18,16,16,25,20,7,102
2024-03-03 16:00:00,28,27,18,39,15,4,131
2024-03-03 16:10:00,26,19,19,33,22,3,122
2024-03-03 16:20:00,30,21,35,30,16,1,133
2024-03-03 16:30:00,33,24,18,36,20,4,135
2024-03-03 16:40:00,28,27,25,35,20,8,143
2024-03-03 16:50:00,38,30,17,31,23,8,147
2024-03-03 17:00:00,34,22,16,36,25,3,136
2024-03-03 17:10:00,32,32,22,34,19,4,143
2024-03-03 17:20:00,26,22,16,24,13,8,109
2024-03-03 17:30:00,32,21,24,35,26,2,140
2024-03-03 17:40:00,19,23,16,31,26,1,116
2024-03-03 17:50:00,32,30,19,27,14,2,124
2024-03-03 18:00:00,32,24,10,33,16,1,116
2024-03-03 18:10:00,31,25,19,26,15,6,122
2024-03-03 18:20:00,24,22,16,27,21,3,113
2024-03-03 18:30:00,30,21,8,26,18,3,106
2024-03-03 18:40:00,30,24,10,29,21,4,118
2024-03-03 18:50:00,21,19,13,20,16,5,94
2024-03-03 19:00:00,20,19,16,22,21,4,102
2024-03-03 19:10:00,33,25,10,21,16,5,110
2024-03-03 19:20:00,23,14,14,23,19,2,95
2024-03-03 19:30:00,25,17,11,17,21,4,95
2024-03-03 19:40:00,27,18,7,25,19,5,101
2024-03-03 19:50:00,20,16,11,20,24,2,93
2024-03-03 20:00:00,20,11,8,25,17,0,81
2024-03-03 20:10:00,15,8,8,12,6,4,53
2024-03-03 20:20:00,17,12,2,16,13,6,66
2024-03-03 20:30:00,6,6,5,16,11,1,45
2024-03-03 20:40:00,5,7,4,15,8,0,39
2024-03-03 20:50:00,14,15,6,14,14,2,65
2024-03-03 21:00:00,9,9,6,19,17,1,61
2024-03-03 21:10:00,7,7,8,14,12,3,51
2024-03-03 21:20:00,9,8,0,6,7,1,31
2024-03-03 21:30:00,8,7,4,8,9,0,36
2024-03-03 21:40:00,8,9,0,8,9,0,34
2024-03-03 21:50:00,8,7,2,11,10,0,38
2024-03-03 22:00:00,11,9,3,10,11,1,45
2024-03-03 22:10:00,9,7,2,14,11,2,45
2024-03-03 22:20:00,6,6,4,10,8,3,37
2024-03-03 22:30:00,9,8,2,11,8,0,38
2024-03-03 22:40:00,7,8,8,6,4,0,33
2024-03-03 22:50:00,3,3,3,6,6,0,21
2024-03-03 23:00:00,6,5,0,7,5,0,23
2024-03-03 23:10:00,3,3,0,2,2,2,12
2024-03-03 23:20:00,6,8,1,3,3,2,23
2024-03-03 23:30:00,1,2,0,5,4,1,13
2024-03-03 23:40:00,8,11,2,11,10,0,42
2024-03-03 23:50:00,5,4,4,5,5,0,23
2024-03-04 00:00:00,5,4,0,3,3,0,15
2024-03-04 00:10:00,2,1,1,1,1,0,6
2024-03-04 00:20:00,0,0,3,3,2,0,8
2024-03-04 00:30:00,1,2,1,3,3,0,10
2024-03-04 00:40:00,2,2,1,1,2,0,8
2024-03-04 00:50:00,0,0,0,6,4,0,10
2024-03-04 01:00:00,0,0,0,4,5,0,9
2024-03-04 01:10:00,2,2,0,3,3,0,10
2024-03-04 01:20:00,0,0,0,2,2,0,4
2024-03-04 01:30:00,2,2,1,1,1,2,9
2024-03-04 01:40:00,2,2,1,1,1,0,7
2024-03-04 01:50:00,1,1,1,0,0,0,3
2024-03-04 02:00:00,0,0,0,2,1,0,3
2024-03-04 02:10:00,0,0,0,0,0,0,0
2024-03-04 02:20:00,1,1,0,2,1,0,5
2024-03-04 02:30:00,0,0,0,1,3,0,4
2024-03-04 02:40:00,2,2,0,1,1,0,6
2024-03-04 02:50:00,0,0,1,3,4,0,8
2024-03-04 03:00:00,3,2,0,1,1,0,7
2024-03-04 03:10:00,1,1,0,1,1,0,4
2024-03-04 03:20:00,1,1,0,4,3,0,9
2024-03-04 03:30:00,0,0,0,1,1,0,2
2024-03-04 03:40:00,0,0,0,2,3,0,5
2024-03-04 03:50:00,2,4,0,0,1,0,7
2024-03-04 04:00:00,1,1,0,0,0,0,2
2024-03-04 04:10:00,1,3,0,3,7,0,14
2024-03-04 04:20:00,1,1,1,1,1,0,5
2024-03-04 04:30:00,2,3,0,4,5,0,14
2024-03-04 04:40:00,5,6,0,2,1,1,15
2024-03-04 04:50:00,3,3,4,4,3,0,17
2024-03-04 05:00:00,5,6,1,5,7,2,26
2024-03-04 05:10:00,7,7,7,5,2,1,29
2024-03-04 05:20:00,6,7,2,7,7,0,29
2024-03-04 05:30:00,8,6,9,8,11,0,42
2024-03-04 05:40:00,8,7,9,3,3,0,30
2024-03-04 05:50:00,11,16,6,5,5,2,45
2024-03-04 06:00:00,10,12,8,10,11,1,52
2024-03-04 06:10:00,12,10,8,8,7,2,47
2024-03-04 06:20:00,13,15,6,22,15,0,71
2024-03-04 06:30:00,17,14,16,17,13,3,80
2024-03-04 06:40:00,15,16,6,14,14,1,66
2024-03-04 06:50:00,30,26,14,21,14,1,106
2024-03-04 07:00:00,22,19,13,15,16,3,88
2024-03-04 07:10:00,27,20,15,24,23,6,115
2024-03-04 07:20:00,38,34,17,21,17,7,134
2024-03-04 07:30:00,41,32,20,38,19,6,156
2024-03-04 07:40:00,55,27,19,37,25,2,165
2024-03-04 07:50:00,34,24,16,35,30,8,147
2024-03-04 08:00:00,35,29,17,35,22,13,151
2024-03-04 08:10:00,46,39,22,27,25,6,165
2024-03-04 08:20:00,43,30,22,29,26,12,162
2024-03-04 08:30:00,41,34,21,35,25,10,166
2024-03-04 08:40:00,36,29,18,21,17,8,129
2024-03-04 08:50:00,39,38,18,38,29,11,173
2024-03-04 09:00:00,45,38,18,33,25,8,167
2024-03-04 09:10:00,40,35,22,24,20,10,151
2024-03-04 09:20:00,46,30,21,31,28,6,162
2024-03-04 09:30:00,43,33,23,31,25,16,171
2024-03-04 09:40:00,26,22,13,37,25,5,128
2024-03-04 09:50:00,34,33,19,31,23,9,149
2024-03-04 10:00:00,29,30,32,21,13,2,127
2024-03-04 10:10:00,29,28,13,35,25,12,142
2024-03-04 10:20:00,39,20,23,39,22,6,149
2024-03-04 10:30:00,43,31,16,49,23,8,170
2024-03-04 10:40:00,33,32,23,20,11,17,136
2024-03-04 10:50:00,29,25,24,31,21,15,145
2024-03-04 11:00:00,37,22,23,35,27,6,150
2024-03-04 11:10:00,38,25,22,36,16,9,146
2024-03-04 11:20:00,32,30,20,21,19,7,129
2024-03-04 11:30:00,30,22,25,34,21,2,134
2024-03-04 11:40:00,37,34,19,34,22,7,153
2024-03-04 11:50:00,38,35,25,39,24,8,169
2024-03-04 12:00:00,28,26,20,42,29,5,150
2024-03-04 12:10:00,29,18,26,39,14,6,132
2024-03-04 12:20:00,34,27,20,26,15,7,129
2024-03-04 12:30:00,34,34,17,29,14,8,136
2024-03-04 12:40:00,33,27,20,24,19,8,131
2024-03-04 12:50:00,27,24,20,32,33,10,146
2024-03-04 13:00:00,28,19,15,33,27,7,129
2024-03-04 13:10:00,34,22,22,37,24,5,144
2024-03-04 13:20:00,25,22,24,31,21,5,128
2024-03-04 13:30:00,39,22,14,29,21,4,129
2024-03-04 13:40:00,45,35,18,22,22,12,154
2024-03-04 13:50:00,38,27,29,42,20,12,168
2024-03-04 14:00:00,30,27,22,44,26,10,159
2024-03-04 14:10:00,48,30,23,27,17,6,151
2024-03-04 14:20:00,32,31,19,29,23,6,140
2024-03-04 14:30:00,30,21,27,43,23,6,150
2024-03-04 14:40:00,33,29,19,39,17,7,144
2024-03-04 14:50:00,45,29,15,34,22,12,157
2024-03-04 15:00:00,44,42,19,43,28,5,181
2024-03-04 15:10:00,48,32,19,46,22,9,176
2024-03-04 15:20:00,46,31,18,33,17,6,151
2024-03-04 15:30:00,49,28,26,50,30,6,189
2024-03-04 15:40:00,44,30,21,33,14,15,157
2024-03-04 15:50:00,42,21,21,46,21,4,155
2024-03-04 16:00:00,49,24,25,41,20,9,168
2024-03-04 16:10:00,60,25,17,50,31,10,193
2024-03-04 16:20:00,53,35,17,45,25,10,185
2024-03-04 16:30:00,46,22,15,49,27,10,169
2024-03-04 16:40:00,36,18,8,51,19,20,152
2024-03-04 16:50:00,34,34,21,31,21,12,153
2024-03-04 17:00:00,41,32,10,42,32,10,167
2024-03-04 17:10:00,49,41,21,40,22,5,178
2024-03-04 17:20:00,48,32,20,53,28,12,193
2024-03-04 17:30:00,47,22,23,44,19,9,164
2024-03-04 17:40:00,53,35,17,48,31,6,190
2024-03-04 17:50:00,37,25,11,49,32,6,160
2024-03-04 18:00:00,45,25,19,30,17,8,144
2024-03-04 18:10:00,34,22,27,32,19,12,146
2024-03-04 18:20:00,41,24,15,31,14,10,135
2024-03-04 18:30:00,48,26,15,42,21,5,157
2024-03-04 18:40:00,36,24,15,28,19,9,131
2024-03-04 18:50:00,30,14,12,33,27,8,124
2024-03-04 19:00:00,29,22,15,24,20,14,124
2024-03-04 19:10:00,36,18,20,32,20,9,135
2024-03-04 19:20:00,33,26,20,26,17,12,134
2024-03-04 19:30:00,22,16,13,30,14,5,100
2024-03-04 19:40:00,30,19,9,20,17,2,97
2024-03-04 19:50:00,20,16,13,20,15,5,89
2024-03-04 20:00:00,16,12,9,25,15,5,82
2024-03-04 20:10:00,15,17,13,16,16,7,84
2024-03-04 20:20:00,18,16,10,22,19,3,88
2024-03-04 20:30:00,17,13,14,10,13,2,69
2024-03-04 20:40:00,18,15,7,11,10,5,66
2024-03-04 20:50:00,9,8,12,13,5,1,48
2024-03-04 21:00:00,21,12,7,21,22,8,91
2024-03-04 21:10:00,13,10,12,20,17,1,73
2024-03-04 21:20:00,10,9,6,19,12,0,56
2024-03-04 21:30:00,10,9,5,11,10,1,46
2024-03-04 21:40:00,7,4,5,5,8,0,29
2024-03-04 21:50:00,6,6,8,15,15,2,52
2024-03-04 22:00:00,8,7,10,13,14,6,58
2024-03-04 22:10:00,5,7,9,10,8,0,39
2024-03-04 22:20:00,5,5,1,11,9,2,33
2024-03-04 22:30:00,15,15,2,14,11,0,57
2024-03-04 22:40:00,12,11,4,6,4,2,39
2024-03-04 22:50:00,7,8,5,16,15,1,52
2024-03-04 23:00:00,7,5,7,6,9,0,34
2024-03-04 23:10:00,4,4,0,5,5,0,18
2024-03-04 23:20:00,7,5,0,3,5,0,20
2024-03-04 23:30:00,4,4,1,8,7,0,24
2024-03-04 23:40:00,4,4,1,3,3,1,16
2024-03-04 23:50:00,3,3,1,7,4,0,18
2024-03-05 00:00:00,2,2,0,9,6,0,19
2024-03-05 00:10:00,3,3,0,3,2,2,13
2024-03-05 00:20:00,2,1,0,4,5,0,12
2024-03-05 00:30:00,2,2,1,3,3,0,11
2024-03-05 00:40:00,2,2,0,1,1,0,6
2024-03-05 00:50:00,1,1,1,2,2,0,7
2024-03-05 01:00:00,0,0,0,5,6,0,11
2024-03-05 01:10:00,4,4,0,2,2,0,12
2024-03-05 01:20:00,1,1,0,0,0,0,2
2024-03-05 01:30:00,2,2,0,1,1,0,6
2024-03-05 01:40:00,1,1,0,3,2,0,7
2024-03-05 01:50:00,0,0,0,0,0,0,0
2024-03-05 02:00:00,0,1,3,3,3,0,10
2024-03-05 02:10:00,0,0,0,2,2,0,4
2024-03-05 02:20:00,0,0,0,0,0,0,0
2024-03-05 02:30:00,0,0,2,1,1,1,5
2024-03-05 02:40:00,0,0,0,0,0,0,0
2024-03-05 02:50:00,0,0,1,1,1,0,3
2024-03-05 03:00:00,1,1,3,1,1,0,7
2024-03-05 03:10:00,2,2,0,1,1,0,6
2024-03-05 03:20:00,1,1,1,5,5,0,13
2024-03-05 03:30:00,0,0,0,1,1,2,4
2024-03-05 03:40:00,0,0,0,2,2,0,4
2024-03-05 03:50:00,2,3,0,0,0,0,5
2024-03-05 04:00:00,2,2,0,1,1,0,6
2024-03-05 04:10:00,0,0,1,1,2,0,4
2024-03-05 04:20:00,0,1,0,1,3,0,5
2024-03-05 04:30:00,3,4,0,4,6,0,17
2024-03-05 04:40:00,3,1,1,2,2,0,9
2024-03-05 04:50:00,8,5,4,3,6,0,26
2024-03-05 05:00:00,7,3,2,5,5,2,24
2024-03-05 05:10:00,8,5,2,6,7,2,30
2024-03-05 05:20:00,4,4,3,4,4,2,21
2024-03-05 05:30:00,6,6,9,3,3,2,29
2024-03-05 05:40:00,8,9,5,5,4,0,31
2024-03-05 05:50:00,8,8,7,8,7,1,39
2024-03-05 06:00:00,14,12,13,8,7,3,57
2024-03-05 06:10:00,10,10,6,12,10,1,49
2024-03-05 06:20:00,14,13,8,19,19,2,75
2024-03-05 06:30:00,15,14,15,11,8,3,66
2024-03-05 06:40:00,15,10,11,11,13,2,62
2024-03-05 06:50:00,20,14,13,24,22,8,101
2024-03-05 07:00:00,21,28,15,28,20,2,114
2024-03-05 07:10:00,35,20,15,20,14,2,106
2024-03-05 07:20:00,34,21,18,27,18,6,124
2024-03-05 07:30:00,52,37,20,42,24,12,187
2024-03-05 07:40:00,39,31,11,30,25,10,146
2024-03-05 07:50:00,47,28,22,35,24,8,164
2024-03-05 08:00:00,46,31,15,33,20,11,156
2024-03-05 08:10:00,45,26,19,24,16,11,141
2024-03-05 08:20:00,41,33,25,29,26,7,161
2024-03-05 08:30:00,41,35,20,37,18,6,157
2024-03-05 08:40:00,53,25,21,22,16,9,146
2024-03-05 08:50:00,47,34,22,32,25,12,172
2024-03-05 09:00:00,24,26,20,27,22,9,128
2024-03-05 09:10:00,35,22,23,21,19,5,125
2024-03-05 09:20:00,38,29,16,35,24,6,148
2024-03-05 09:30:00,31,23,15,25,20,10,124
2024-03-05 09:40:00,45,31,20,36,27,16,175
2024-03-05 09:50:00,39,26,22,37,17,11,152
2024-03-05 10:00:00,37,20,15,26,19,8,125
2024-03-05 10:10:00,34,28,18,26,18,10,134
2024-03-05 10:20:00,39,26,19,31,20,8,143
2024-03-05 10:30:00,26,20,8,20,23,8,105
2024-03-05 10:40:00,35,22,22,29,22,10,140
2024-03-05 10:50:00,31,26,20,33,30,13,153
2024-03-05 11:00:00,38,36,13,33,20,3,143
2024-03-05 11:10:00,35,31,19,35,26,12,158
2024-03-05 11:20:00,44,26,18,25,19,9,141
2024-03-05 11:30:00,33,27,18,37,19,11,145
2024-03-05 11:40:00,46,37,22,38,22,7,172
2024-03-05 11:50:00,48,32,20,25,24,22,171
2024-03-05 12:00:00,37,36,20,40,14,7,154
2024-03-05 12:10:00,35,19,13,28,24,10,129
2024-03-05 12:20:00,24,23,14,33,22,11,127
2024-03-05 12:30:00,39,32,18,19,20,5,133
2024-03-05 12:40:00,27,26,22,30,15,6,126
2024-03-05 12:50:00,31,22,22,30,20,7,132
2024-03-05 13:00:00,33,32,15,27,23,8,138
2024-03-05 13:10:00,36,28,25,39,28,7,163
2024-03-05 13:20:00,33,29,14,28,14,10,128
2024-03-05 13:30:00,34,19,19,27,20,5,124
2024-03-05 13:40:00,36,21,19,37,27,10,150
2024-03-05 13:50:00,0,0,27,0,0,5,32
2024-03-05 14:00:00,0,0,23,0,0,12,35
2024-03-05 14:10:00,6,4,23,3,3,10,49
2024-03-05 14:20:00,43,34,27,32,16,9,161
2024-03-05 14:30:00,33,27,22,35,17,7,141
2024-03-05 14:40:00,50,29,19,39,26,9,172
2024-03-05 14:50:00,33,20,17,31,20,13,134
2024-03-05 15:00:00,43,28,28,34,26,6,165
2024-03-05 15:10:00,39,29,29,37,26,12,172
2024-03-05 15:20:00,53,16,11,50,19,10,159
2024-03-05 15:30:00,42,26,12,45,17,14,156
2024-03-05 15:40:00,37,27,14,51,33,11,173
2024-03-05 15:50:00,36,30,30,38,26,17,177
2024-03-05 16:00:00,48,35,14,52,26,9,184
2024-03-05 16:10:00,46,21,26,48,29,9,179
2024-03-05 16:20:00,43,25,7,44,29,13,161
2024-03-05 16:30:00,53,31,22,50,29,5,190
2024-03-05 16:40:00,42,25,11,38,24,10,150
2024-03-05 16:50:00,43,26,27,47,22,6,171
2024-03-05 17:00:00,41,36,14,34,16,9,150
2024-03-05 17:10:00,48,44,21,29,25,9,176
2024-03-05 17:20:00,40,30,16,37,20,8,151
2024-03-05 17:30:00,56,32,19,36,21,7,171
2024-03-05 17:40:00,46,35,18,40,21,7,167
2024-03-05 17:50:00,40,26,14,36,20,10,146
2024-03-05 18:00:00,44,30,23,35,28,8,168
2024-03-05 18:10:00,40,22,22,34,23,16,157
2024-03-05 18:20:00,38,24,19,34,19,4,138
2024-03-05 18:30:00,32,22,16,38,25,15,148
2024-03-05 18:40:00,29,26,24,28,16,7,130
2024-03-05 18:50:00,39,26,23,37,23,5,153
2024-03-05 19:00:00,22,18,16,32,17,8,113
2024-03-05 19:10:00,39,24,16,24,16,4,123
2024-03-05 19:20:00,29,31,21,21,18,3,123
2024-03-05 19:30:00,27,18,11,17,14,1,88
2024-03-05 19:40:00,18,9,16,25,13,0,81
2024-03-05 19:50:00,20,17,15,29,16,0,97
2024-03-05 20:00:00,21,20,13,16,10,4,84
2024-03-05 20:10:00,23,20,16,18,23,4,104
2024-03-05 20:20:00,16,14,13,17,16,2,78
2024-03-05 20:30:00,16,14,5,13,13,1,62
2024-03-05 20:40:00,17,13,6,24,14,5,79
2024-03-05 20:50:00,15,14,7,18,17,0,71
2024-03-05 21:00:00,15,12,12,12,15,0,66
2024-03-05 21:10:00,10,3,10,15,10,4,52
2024-03-05 21:20:00,10,10,15,14,15,0,64
2024-03-05 21:30:00,14,9,4,12,12,5,56
2024-03-05 21:40:00,8,10,6,13,10,1,48
2024-03-05 21:50:00,12,14,2,13,10,2,53
2024-03-05 22:00:00,11,10,4,11,13,3,52
2024-03-05 22:10:00,13,11,5,15,16,6,66
2024-03-05 22:20:00,14,13,7,16,19,1,70
2024-03-05 22:30:00,7,6,2,14,7,2,38
2024-03-05 22:40:00,10,8,4,7,8,0,37
2024-03-05 22:50:00,3,3,3,8,4,1,22
2024-03-05 23:00:00,3,3,1,8,4,0,19
2024-03-05 23:10:00,6,6,2,12,9,1,36
2024-03-05 23:20:00,6,4,4,7,6,0,27
2024-03-05 23:30:00,3,3,1,8,9,2,26
2024-03-05 23:40:00,1,1,3,4,3,0,12
2024-03-05 23:50:00,2,2,1,5,5,0,15
2024-03-06 00:00:00,6,8,0,2,2,3,21
2024-03-06 00:10:00,2,2,1,3,2,0,10
2024-03-06 00:20:00,2,3,0,2,2,0,9
2024-03-06 00:30:00,3,3,0,7,6,0,19
2024-03-06 00:40:00,3,3,1,4,4,0,15
2024-03-06 00:50:00,6,5,1,2,2,0,16
2024-03-06 01:00:00,1,1,0,4,8,0,14
2024-03-06 01:10:00,1,1,1,8,9,1,21
2024-03-06 01:20:00,1,1,1,0,0,0,3
2024-03-06 01:30:00,0,0,0,0,0,0,0
2024-03-06 01:40:00,0,0,0,0,0,0,0
2024-03-06 01:50:00,0,0,0,3,3,0,6
2024-03-06 02:00:00,2,3,4,2,2,0,13
2024-03-06 02:10:00,0,0,0,1,2,0,3
2024-03-06 02:20:00,0,0,1,1,1,0,3
2024-03-06 02:30:00,0,0,1,1,1,0,3
2024-03-06 02:40:00,1,1,0,0,0,0,2
2024-03-06 02:50:00,1,1,0,1,0,0,3
2024-03-06 03:00:00,2,2,2,2,2,0,10
2024-03-06 03:10:00,1,0,3,0,0,3,7
2024-03-06 03:20:00,1,1,0,2,2,0,6
2024-03-06 03:30:00,0,0,0,0,0,0,0
2024-03-06 03:40:00,0,0,0,4,5,0,9
2024-03-06 03:50:00,1,2,0,1,1,0,5
2024-03-06 04:00:00,2,4,2,1,1,0,10
2024-03-06 04:10:00,0,0,0,2,3,0,5
2024-03-06 04:20:00,1,0,2,1,1,0,5
2024-03-06 04:30:00,4,5,2,4,3,0,18
2024-03-06 04:40:00,2,2,0,2,1,1,8
2024-03-06 04:50:00,3,2,5,4,5,0,19
2024-03-06 05:00:00,4,5,2,5,5,1,22
2024-03-06 05:10:00,8,8,3,9,6,0,34
2024-03-06 05:20:00,5,5,6,4,4,1,25
2024-03-06 05:30:00,8,8,9,3,2,2,32
2024-03-06 05:40:00,8,7,9,6,6,0,36
2024-03-06 05:50:00,8,11,1,7,7,0,34
2024-03-06 06:00:00,18,17,12,11,10,3,71
2024-03-06 06:10:00,16,11,8,14,13,2,64
2024-03-06 06:20:00,11,15,8,12,12,0,58
2024-03-06 06:30:00,16,16,6,11,18,5,72
2024-03-06 06:40:00,21,17,10,16,15,2,81
2024-03-06 06:50:00,17,20,12,10,24,5,88
2024-03-06 07:00:00,21,21,12,0,19,2,75
2024-03-06 07:10:00,26,21,13,0,21,10,91
2024-03-06 07:20:00,36,29,18,0,17,9,109
2024-03-06 07:30:00,55,34,13,0,21,10,133
2024-03-06 07:40:00,40,35,17,0,26,8,126
2024-03-06 07:50:00,36,32,15,0,31,6,120
2024-03-06 08:00:00,41,35,18,0,17,10,121
2024-03-06 08:10:00,46,36,26,0,24,4,136
2024-03-06 08:20:00,38,30,11,0,17,6,102
2024-03-06 08:30:00,38,34,17,0,22,14,125
2024-03-06 08:40:00,37,29,17,0,26,9,118
2024-03-06 08:50:00,32,28,20,0,19,10,109
2024-03-06 09:00:00,41,26,22,0,18,6,113
2024-03-06 09:10:00,40,26,20,0,18,7,111
2024-03-06 09:20:00,36,26,19,0,19,3,103
2024-03-06 09:30:00,39,24,16,0,16,12,107
2024-03-06 09:40:00,34,27,15,0,18,10,104
2024-03-06 09:50:00,32,23,18,0,17,8,98
2024-03-06 10:00:00,35,24,15,0,21,7,102
2024-03-06 10:10:00,23,23,17,0,23,6,92
2024-03-06 10:20:00,19,18,21,0,10,5,73
2024-03-06 10:30:00,45,26,19,0,19,9,118
2024-03-06 10:40:00,41,33,14,0,16,19,123
2024-03-06 10:50:00,41,27,21,0,15,6,110
2024-03-06 11:00:00,35,23,14,0,14,10,96
2024-03-06 11:10:00,43,25,22,0,23,10,123
2024-03-06 11:20:00,40,38,22,0,18,8,126
2024-03-06 11:30:00,37,32,19,0,27,14,129
2024-03-06 11:40:00,47,33,21,0,20,8,129
2024-03-06 11:50:00,37,26,14,0,16,8,101
2024-03-06 12:00:00,32,25,14,0,17,8,96
2024-03-06 12:10:00,39,27,15,0,23,4,108
2024-03-06 12:20:00,34,26,23,0,24,4,111
2024-03-06 12:30:00,36,37,21,0,20,7,121
2024-03-06 12:40:00,29,31,16,0,19,5,100
2024-03-06 12:50:00,45,26,17,0,21,7,116
2024-03-06 13:00:00,25,24,17,0,13,7,86
2024-03-06 13:10:00,26,23,14,0,23,5,91
2024-03-06 13:20:00,24,25,19,0,20,2,90
2024-03-06 13:30:00,31,22,17,0,22,4,96
2024-03-06 13:40:00,36,33,18,0,19,6,112
2024-03-06 13:50:00,25,22,26,0,26,13,112
2024-03-06 14:00:00,35,25,26,0,22,7,115
2024-03-06 14:10:00,31,25,25,0,18,10,109
2024-03-06 14:20:00,26,24,19,0,24,9,102
2024-03-06 14:30:00,47,32,19,0,22,9,129
2024-03-06 14:40:00,46,37,17,0,20,5,125
2024-03-06 14:50:00,28,29,15,0,26,4,102
2024-03-06 15:00:00,37,27,14,0,25,3,106
2024-03-06 15:10:00,32,31,22,0,19,11,115
2024-03-06 15:20:00,34,31,21,0,24,5,115
2024-03-06 15:30:00,38,30,15,0,17,7,107
2024-03-06 15:40:00,37,33,17,0,28,14,129
2024-03-06 15:50:00,50,33,39,0,16,11,149
2024-03-06 16:00:00,35,22,24,0,28,10,119
2024-03-06 16:10:00,33,23,12,0,29,11,108
2024-03-06 16:20:00,46,38,15,0,15,9,123
2024-03-06 16:30:00,41,24,13,0,28,7,113
2024-03-06 16:40:00,38,34,21,0,12,6,111
2024-03-06 16:50:00,42,31,18,0,32,11,134
2024-03-06 17:00:00,37,23,17,0,11,12,100
2024-03-06 17:10:00,47,48,18,0,18,12,143
2024-03-06 17:20:00,42,26,13,0,20,15,116
2024-03-06 17:30:00,55,27,16,0,19,9,126
2024-03-06 17:40:00,31,28,20,0,17,7,103
2024-03-06 17:50:00,42,38,12,0,22,9,123
2024-03-06 18:00:00,42,47,20,0,14,9,132
2024-03-06 18:10:00,24,28,18,0,22,8,100
2024-03-06 18:20:00,38,32,18,0,20,8,116
2024-03-06 18:30:00,37,24,35,0,18,6,120
2024-03-06 18:40:00,43,29,11,0,17,6,106
2024-03-06 18:50:00,36,20,17,0,20,10,103
2024-03-06 19:00:00,37,33,25,0,18,7,120
2024-03-06 19:10:00,34,27,13,0,21,13,108
2024-03-06 19:20:00,28,27,16,0,23,12,106
2024-03-06 19:30:00,42,18,21,0,17,12,110
2024-03-06 19:40:00,35,13,15,0,26,7,96
2024-03-06 19:50:00,20,13,13,0,14,8,68
2024-03-06 20:00:00,17,15,26,0,13,7,78
2024-03-06 20:10:00,19,17,15,0,14,8,73
2024-03-06 20:20:00,20,19,12,0,17,3,71
2024-03-06 20:30:00,15,16,15,0,13,2,61
2024-03-06 20:40:00,17,20,13,0,14,3,67
2024-03-06 20:50:00,19,13,7,0,13,1,53
2024-03-06 21:00:00,14,9,6,0,11,0,40
2024-03-06 21:10:00,10,12,16,0,9,7,54
2024-03-06 21:20:00,6,7,8,0,16,5,42
2024-03-06 21:30:00,15,12,13,0,12,0,52
2024-03-06 21:40:00,10,10,3,0,11,2,36
2024-03-06 21:50:00,6,7,18,0,14,0,45
2024-03-06 22:00:00,11,8,15,0,12,2,48
2024-03-06 22:10:00,8,9,2,0,6,0,25
2024-03-06 22:20:00,12,13,4,0,16,2,47
2024-03-06 22:30:00,8,8,0,0,6,0,22
2024-03-06 22:40:00,11,7,6,0,8,2,34
2024-03-06 22:50:00,9,9,1,0,11,1,31
2024-03-06 23:00:00,6,6,4,0,8,2,26
2024-03-06 23:10:00,5,4,3,0,11,3,26
2024-03-06 23:20:00,6,4,1,0,8,3,22
2024-03-06 23:30:00,10,11,1,0,7,0,29
2024-03-06 23:40:00,12,9,1,0,5,0,27
2024-03-06 23:50:00,4,4,2,0,7,1,18
2024-03-07 00:00:00,3,4,1,0,5,0,13
2024-03-07 00:10:00,3,3,1,0,3,0,10
2024-03-07 00:20:00,2,2,4,0,4,2,14
2024-03-07 00:30:00,6,6,2,0,3,2,19
2024-03-07 00:40:00,2,3,0,0,3,0,8
2024-03-07 00:50:00,0,0,3,0,2,1,6
2024-03-07 01:00:00,1,1,0,0,3,0,5
2024-03-07 01:10:00,3,2,1,0,4,0,10
2024-03-07 01:20:00,3,3,0,0,3,0,9
2024-03-07 01:30:00,5,3,1,0,0,0,9
2024-03-07 01:40:00,0,0,3,0,1,0,4
2024-03-07 01:50:00,2,2,0,0,4,6,14
2024-03-07 02:00:00,0,0,0,0,0,0,0
2024-03-07 02:10:00,2,2,0,0,1,0,5
2024-03-07 02:20:00,0,0,0,0,0,0,0
2024-03-07 02:30:00,0,0,1,0,3,0,4
2024-03-07 02:40:00,5,4,0,0,1,1,11
2024-03-07 02:50:00,1,1,0,0,1,0,3
2024-03-07 03:00:00,5,5,3,0,4,0,17
2024-03-07 03:10:00,0,0,0,0,1,1,2
2024-03-07 03:20:00,0,0,1,0,1,0,2
2024-03-07 03:30:00,0,0,0,0,0,1,1
2024-03-07 03:40:00,1,4,1,0,2,0,8
2024-03-07 03:50:00,3,2,2,0,0,0,7
2024-03-07 04:00:00,2,2,2,0,0,0,6
2024-03-07 04:10:00,0,0,0,0,2,0,2
2024-03-07 04:20:00,0,1,0,0,3,0,4
2024-03-07 04:30:00,2,3,3,0,3,4,15
2024-03-07 04:40:00,4,1,1,0,2,0,8
2024-03-07 04:50:00,5,3,3,0,2,3,16
2024-03-07 05:00:00,5,5,1,0,3,2,16
2024-03-07 05:10:00,4,4,1,0,3,0,12
2024-03-07 05:20:00,6,5,6,0,6,2,25
2024-03-07 05:30:00,10,9,8,0,9,2,38
2024-03-07 05:40:00,9,9,10,0,5,1,34
2024-03-07 05:50:00,7,10,6,0,4,0,27
2024-03-07 06:00:00,20,17,5,0,7,3,52
2024-03-07 06:10:00,12,10,15,0,12,1,50
2024-03-07 06:20:00,19,19,7,0,13,2,60
2024-03-07 06:30:00,21,20,11,0,11,1,64
2024-03-07 06:40:00,12,14,6,0,12,3,47
2024-03-07 06:50:00,28,24,11,0,15,2,80
2024-03-07 07:00:00,17,14,15,0,16,3,65
2024-03-07 07:10:00,29,25,11,0,17,8,90
2024-03-07 07:20:00,36,31,16,0,22,7,112
2024-03-07 07:30:00,47,30,20,0,23,13,133
2024-03-07 07:40:00,29,29,22,0,21,8,109
2024-03-07 07:50:00,42,35,13,0,23,3,116
2024-03-07 08:00:00,40,34,18,0,25,8,125
2024-03-07 08:10:00,34,29,29,0,31,7,130
2024-03-07 08:20:00,36,31,19,0,19,14,119
2024-03-07 08:30:00,34,24,19,0,24,9,110
2024-03-07 08:40:00,42,31,17,0,20,6,116
2024-03-07 08:50:00,32,30,21,0,29,8,120
2024-03-07 09:00:00,28,25,21,0,18,0,92
2024-03-07 09:10:00,38,32,13,0,24,6,113
2024-03-07 09:20:00,28,22,19,0,23,8,100
2024-03-07 09:30:00,38,35,16,0,21,11,121
2024-03-07 09:40:00,38,37,24,0,15,9,123
2024-03-07 09:50:00,33,24,24,0,27,9,117
2024-03-07 10:00:00,33,25,17,0,20,8,103
2024-03-07 10:10:00,40,22,19,0,20,7,108
2024-03-07 10:20:00,33,24,21,0,21,14,113
2024-03-07 10:30:00,49,35,22,0,21,7,134
2024-03-07 10:40:00,39,25,14,0,14,9,101
2024-03-07 10:50:00,34,23,26,0,17,9,109
2024-03-07 11:00:00,44,28,15,0,20,9,116
2024-03-07 11:10:00,36,32,22,0,27,0,117
2024-03-07 11:20:00,33,37,21,0,20,7,118
2024-03-07 11:30:00,45,37,21,0,19,9,131
2024-03-07 11:40:00,30,22,24,0,21,12,109
2024-03-07 11:50:00,43,26,22,0,27,26,144
2024-03-07 12:00:00,31,26,22,0,41,9,129
2024-03-07 12:10:00,24,20,21,0,42,8,115
2024-03-07 12:20:00,35,35,12,0,21,8,111
2024-03-07 12:30:00,35,31,25,0,27,12,130
2024-03-07 12:40:00,42,46,18,0,27,11,144
2024-03-07 12:50:00,31,29,20,0,22,6,108
2024-03-07 13:00:00,29,34,30,0,21,5,119
2024-03-07 13:10:00,40,56,30,0,26,13,165
2024-03-07 13:20:00,25,25,15,0,22,5,92
2024-03-07 13:30:00,30,28,21,0,16,9,104
2024-03-07 13:40:00,36,27,28,0,18,5,114
2024-03-07 13:50:00,39,24,18,0,19,10,110
2024-03-07 14:00:00,39,29,16,0,19,7,110
2024-03-07 14:10:00,43,33,28,0,26,11,141
2024-03-07 14:20:00,45,35,22,0,21,5,128
2024-03-07 14:30:00,48,26,16,0,20,9,119
2024-03-07 14:40:00,35,32,19,0,25,7,118
2024-03-07 14:50:00,46,28,22,0,19,8,123
2024-03-07 15:00:00,47,31,14,0,14,6,112
2024-03-07 15:10:00,47,19,28,0,30,5,129
2024-03-07 15:20:00,34,32,21,0,23,13,123
2024-03-07 15:30:00,41,32,24,0,32,7,136
2024-03-07 15:40:00,45,30,23,0,30,9,137
2024-03-07 15:50:00,44,25,17,0,35,13,134
2024-03-07 16:00:00,46,8,20,0,16,13,103
2024-03-07 16:10:00,54,28,17,0,32,11,142
2024-03-07 16:20:00,35,35,14,0,26,7,117
2024-03-07 16:30:00,53,27,23,0,25,9,137
2024-03-07 16:40:00,39,27,16,0,29,9,120
2024-03-07 16:50:00,49,41,15,0,19,10,134
2024-03-07 17:00:00,52,23,22,0,17,16,130
2024-03-07 17:10:00,45,34,23,0,27,15,144
2024-03-07 17:20:00,61,31,25,0,24,10,151
2024-03-07 17:30:00,58,39,21,0,22,9,149
2024-03-07 17:40:00,43,36,23,0,19,10,131
2024-03-07 17:50:00,42,34,22,0,24,6,128
2024-03-07 18:00:00,29,27,26,0,20,10,112
2024-03-07 18:10:00,45,33,19,0,26,4,127
2024-03-07 18:20:00,54,32,23,0,17,10,136
2024-03-07 18:30:00,34,28,22,0,22,7,113
2024-03-07 18:40:00,26,24,19,0,25,3,97
2024-03-07 18:50:00,38,20,16,0,20,9,103
2024-03-07 19:00:00,43,21,24,0,21,6,115
2024-03-07 19:10:00,38,28,12,0,16,9,103
2024-03-07 19:20:00,31,31,15,0,15,13,105
2024-03-07 19:30:00,24,20,21,0,17,8,90
2024-03-07 19:40:00,31,18,13,0,18,8,88
2024-03-07 19:50:00,27,20,14,0,20,6,87
2024-03-07 20:00:00,24,14,24,0,14,0,76
2024-03-07 20:10:00,23,19,8,0,23,3,76
2024-03-07 20:20:00,10,9,15,0,17,2,53
2024-03-07 20:30:00,11,13,11,0,27,3,65
2024-03-07 20:40:00,15,20,11,0,16,0,62
2024-03-07 20:50:00,12,10,5,0,10,3,40
2024-03-07 21:00:00,15,13,20,0,11,5,64
2024-03-07 21:10:00,15,14,8,0,15,1,53
2024-03-07 21:20:00,19,15,7,0,17,2,60
2024-03-07 21:30:00,13,10,6,0,12,4,45
2024-03-07 21:40:00,8,6,8,0,6,1,29
2024-03-07 21:50:00,11,11,6,0,13,1,42
2024-03-07 22:00:00,12,7,3,0,9,0,31
2024-03-07 22:10:00,11,11,3,0,19,0,44
2024-03-07 22:20:00,7,8,4,0,12,0,31
2024-03-07 22:30:00,8,9,3,0,11,3,34
2024-03-07 22:40:00,13,9,2,0,10,2,36
2024-03-07 22:50:00,5,5,4,0,9,0,23
2024-03-07 23:00:00,15,13,1,0,7,2,38
2024-03-07 23:10:00,4,5,1,0,7,0,17
2024-03-07 23:20:00,4,5,2,0,2,0,13
2024-03-07 23:30:00,3,2,1,0,8,2,16
2024-03-07 23:40:00,5,5,4,0,8,1,23
2024-03-07 23:50:00,3,5,0,0,2,0,10
2024-03-08 00:00:00,2,3,1,0,7,0,13
2024-03-08 00:10:00,3,4,0,0,2,0,9
2024-03-08 00:20:00,2,1,1,0,6,0,10
2024-03-08 00:30:00,2,2,6,0,6,0,16
2024-03-08 00:40:00,3,4,1,0,1,0,9
2024-03-08 00:50:00,4,5,0,0,2,0,11
2024-03-08 01:00:00,1,1,1,0,3,0,6
2024-03-08 01:10:00,1,1,0,0,1,0,3
2024-03-08 01:20:00,2,1,0,0,2,0,5
2024-03-08 01:30:00,1,1,0,0,1,0,3
2024-03-08 01:40:00,0,0,0,0,0,0,0
2024-03-08 01:50:00,0,0,4,0,2,0,6
2024-03-08 02:00:00,0,0,0,0,2,0,2
2024-03-08 02:10:00,0,0,5,0,2,0,7
2024-03-08 02:20:00,1,1,0,0,0,0,2
2024-03-08 02:30:00,0,0,1,0,2,0,3
2024-03-08 02:40:00,1,1,2,0,1,1,6
2024-03-08 02:50:00,0,0,0,0,0,1,1
2024-03-08 03:00:00,2,2,0,0,1,0,5
2024-03-08 03:10:00,1,1,0,0,1,0,3
2024-03-08 03:20:00,0,0,0,0,1,0,1
2024-03-08 03:30:00,2,2,0,0,2,0,6
2024-03-08 03:40:00,0,0,0,0,2,0,2
2024-03-08 03:50:00,0,1,0,0,1,1,3
2024-03-08 04:00:00,2,2,0,0,1,0,5
2024-03-08 04:10:00,0,0,0,0,2,0,2
2024-03-08 04:20:00,0,0,0,0,1,0,1
2024-03-08 04:30:00,3,9,2,0,1,2,17
2024-03-08 04:40:00,3,4,0,0,2,1,10
2024-03-08 04:50:00,4,4,2,0,2,0,12
2024-03-08 05:00:00,5,8,1,0,3,2,19
2024-03-08 05:10:00,3,3,3,0,6,0,15
2024-03-08 05:20:00,3,3,5,0,6,0,17
2024-03-08 05:30:00,4,4,9,0,4,0,21
2024-03-08 05:40:00,7,9,6,0,5,0,27
2024-03-08 05:50:00,10,8,9,0,4,4,35
2024-03-08 06:00:00,7,12,10,0,6,2,37
2024-03-08 06:10:00,10,12,8,0,10,4,44
2024-03-08 06:20:00,10,9,11,0,12,1,43
2024-03-08 06:30:00,16,17,14,0,9,3,59
2024-03-08 06:40:00,18,14,12,0,12,6,62
2024-03-08 06:50:00,18,18,13,0,10,5,64
2024-03-08 07:00:00,15,17,26,0,16,2,76
2024-03-08 07:10:00,22,19,11,0,18,6,76
2024-03-08 07:20:00,40,22,12,0,21,2,97
2024-03-08 07:30:00,40,32,10,0,26,8,116
2024-03-08 07:40:00,44,28,13,0,23,12,120
2024-03-08 07:50:00,34,25,20,0,29,14,122
2024-03-08 08:00:00,44,39,31,0,22,4,140
2024-03-08 08:10:00,32,28,20,0,25,5,110
2024-03-08 08:20:00,40,33,22,0,21,5,121
2024-03-08 08:30:00,28,23,22,0,17,7,97
2024-03-08 08:40:00,31,33,20,0,27,11,122
2024-03-08 08:50:00,35,31,24,0,25,6,121
2024-03-08 09:00:00,32,33,14,0,21,6,106
2024-03-08 09:10:00,40,33,17,0,15,10,115
2024-03-08 09:20:00,45,28,16,0,19,8,116
2024-03-08 09:30:00,29,25,22,0,9,10,95
2024-03-08 09:40:00,45,30,21,0,23,6,125
2024-03-08 09:50:00,41,31,21,0,16,7,116
2024-03-08 10:00:00,40,31,27,0,24,16,138
2024-03-08 10:10:00,40,18,14,0,23,14,109
2024-03-08 10:20:00,33,28,31,0,18,8,118
2024-03-08 10:30:00,36,34,19,0,23,11,123
2024-03-08 10:40:00,38,36,20,0,20,7,121
2024-03-08 10:50:00,31,33,19,0,27,9,119
2024-03-08 11:00:00,42,40,17,0,18,14,131
2024-03-08 11:10:00,40,36,24,0,24,12,136
2024-03-08 11:20:00,33,30,21,0,17,4,105
2024-03-08 11:30:00,42,36,17,0,16,19,130
2024-03-08 11:40:00,44,25,21,0,21,8,119
2024-03-08 11:50:00,41,32,13,0,24,66,176
2024-03-08 12:00:00,40,30,11,0,17,12,110
2024-03-08 12:10:00,58,34,25,0,61,38,216
2024-03-08 12:20:00,41,31,16,0,24,16,128
2024-03-08 12:30:00,36,24,20,0,26,7,113
2024-03-08 12:40:00,41,32,13,0,25,9,120
2024-03-08 12:50:00,38,27,22,0,24,10,121
2024-03-08 13:00:00,26,26,21,0,24,7,104
2024-03-08 13:10:00,44,31,21,0,31,8,135
2024-03-08 13:20:00,35,28,13,0,27,7,110
2024-03-08 13:30:00,39,33,11,0,34,10,127
2024-03-08 13:40:00,34,28,20,0,19,5,106
2024-03-08 13:50:00,34,27,23,0,22,5,111
2024-03-08 14:00:00,50,42,12,0,20,6,130
2024-03-08 14:10:00,42,32,24,0,26,9,133
2024-03-08 14:20:00,44,30,27,0,16,8,125
2024-03-08 14:30:00,54,20,11,0,19,12,116
2024-03-08 14:40:00,43,31,18,0,22,6,120
2024-03-08 14:50:00,41,32,19,0,17,9,118
2024-03-08 15:00:00,36,30,22,0,19,8,115
2024-03-08 15:10:00,50,26,11,0,22,10,119
2024-03-08 15:20:00,51,32,21,0,28,8,140
2024-03-08 15:30:00,46,26,26,0,21,10,129
2024-03-08 15:40:00,31,22,19,0,24,3,99
2024-03-08 15:50:00,50,21,19,0,21,11,122
2024-03-08 16:00:00,30,21,30,0,25,8,114
2024-03-08 16:10:00,40,28,19,0,22,3,112
2024-03-08 16:20:00,43,28,14,0,21,9,115
2024-03-08 16:30:00,46,36,32,0,33,13,160
2024-03-08 16:40:00,48,28,20,0,26,2,124
2024-03-08 16:50:00,37,34,41,0,18,6,136
2024-03-08 17:00:00,38,34,26,0,27,10,135
2024-03-08 17:10:00,41,29,23,0,25,9,127
2024-03-08 17:20:00,54,39,24,0,26,12,155
2024-03-08 17:30:00,47,29,29,0,27,5,137
2024-03-08 17:40:00,54,27,16,0,21,11,129
2024-03-08 17:50:00,40,32,22,0,22,11,127
2024-03-08 18:00:00,40,26,14,0,22,9,111
2024-03-08 18:10:00,55,27,22,0,16,9,129
2024-03-08 18:20:00,24,24,19,0,25,10,102
2024-03-08 18:30:00,35,21,19,0,20,3,98
2024-03-08 18:40:00,38,27,18,0,20,6,109
2024-03-08 18:50:00,36,24,13,0,23,7,103
2024-03-08 19:00:00,35,28,14,0,23,17,117
2024-03-08 19:10:00,29,22,19,0,20,6,96
2024-03-08 19:20:00,35,19,24,0,18,3,99
2024-03-08 19:30:00,25,19,13,0,17,3,77
2024-03-08 19:40:00,26,30,17,0,18,4,95
2024-03-08 19:50:00,22,18,17,0,19,4,80
2024-03-08 20:00:00,19,15,13,0,13,5,65
2024-03-08 20:10:00,18,14,20,0,20,8,80
2024-03-08 20:20:00,13,12,16,0,8,3,52
2024-03-08 20:30:00,24,22,12,0,15,6,79
2024-03-08 20:40:00,22,16,8,0,15,6,67
2024-03-08 20:50:00,16,14,10,0,13,4,57
2024-03-08 21:00:00,17,12,9,0,18,0,56
2024-03-08 21:10:00,18,15,14,0,14,3,64
2024-03-08 21:20:00,16,15,10,0,15,4,60
2024-03-08 21:30:00,23,13,6,0,10,5,57
2024-03-08 21:40:00,14,13,10,0,15,0,52
2024-03-08 21:50:00,17,14,5,0,11,1,48
2024-03-08 22:00:00,17,15,11,0,13,1,57
2024-03-08 22:10:00,14,15,5,0,15,0,49
2024-03-08 22:20:00,20,16,6,0,16,5,63
2024-03-08 22:30:00,16,15,2,0,20,1,54
2024-03-08 22:40:00,8,6,4,0,18,0,36
2024-03-08 22:50:00,11,14,10,0,9,0,44
2024-03-08 23:00:00,16,12,3,0,7,1,39
2024-03-08 23:10:00,15,13,4,0,14,0,46
2024-03-08 23:20:00,7,7,5,0,5,0,24
2024-03-08 23:30:00,8,11,6,0,8,0,33
2024-03-08 23:40:00,7,5,5,0,9,0,26
2024-03-08 23:50:00,6,5,4,0,9,0,24
2024-03-09 00:00:00,9,11,3,0,5,2,30
2024-03-09 00:10:00,7,9,4,0,9,1,30
2024-03-09 00:20:00,4,3,3,0,10,0,20
2024-03-09 00:30:00,7,8,2,0,5,0,22
2024-03-09 00:40:00,3,3,4,0,4,2,16
2024-03-09 00:50:00,7,6,0,0,7,1,21
2024-03-09 01:00:00,3,3,0,0,4,4,14
2024-03-09 01:10:00,7,5,2,0,4,0,18
2024-03-09 01:20:00,2,1,3,0,3,2,11
2024-03-09 01:30:00,3,1,2,0,2,0,8
2024-03-09 01:40:00,1,1,0,0,4,0,6
2024-03-09 01:50:00,6,6,0,0,3,0,15
2024-03-09 02:00:00,2,2,2,0,3,0,9
2024-03-09 02:10:00,5,5,1,0,6,0,17
2024-03-09 02:20:00,3,3,0,0,1,0,7
2024-03-09 02:30:00,4,5,3,0,7,3,22
2024-03-09 02:40:00,1,1,0,0,2,0,4
2024-03-09 02:50:00,1,1,2,0,2,0,6
2024-03-09 03:00:00,2,2,1,0,6,0,11
2024-03-09 03:10:00,4,4,1,0,2,0,11
2024-03-09 03:20:00,3,4,1,0,2,1,11
2024-03-09 03:30:00,3,3,0,0,3,2,11
2024-03-09 03:40:00,2,1,1,0,3,0,7
2024-03-09 03:50:00,2,2,0,0,2,0,6
2024-03-09 04:00:00,1,1,0,0,3,0,5
2024-03-09 04:10:00,4,4,1,0,0,0,9
2024-03-09 04:20:00,1,1,0,0,2,0,4
2024-03-09 04:30:00,4,4,4,0,9,0,21
2024-03-09 04:40:00,4,5,0,0,1,0,10
2024-03-09 04:50:00,3,2,2,0,1,0,8
2024-03-09 05:00:00,7,7,0,0,7,1,22
2024-03-09 05:10:00,3,3,1,0,5,0,12
2024-03-09 05:20:00,1,1,1,0,6,1,10
2024-03-09 05:30:00,5,4,6,0,3,1,19
2024-03-09 05:40:00,7,6,3,0,4,0,20
2024-03-09 05:50:00,1,1,4,0,0,1,7
2024-03-09 06:00:00,4,4,5,0,6,5,24
2024-03-09 06:10:00,6,9,4,0,7,1,27
2024-03-09 06:20:00,7,6,6,0,11,0,30
2024-03-09 06:30:00,9,8,1,0,5,0,23
2024-03-09 06:40:00,11,11,7,0,6,0,35
2024-03-09 06:50:00,11,14,9,0,6,1,41
2024-03-09 07:00:00,10,7,6,0,8,2,33
2024-03-09 07:10:00,8,7,8,0,8,6,37
2024-03-09 07:20:00,15,14,11,0,7,7,54
2024-03-09 07:30:00,9,9,12,0,10,3,43
2024-03-09 07:40:00,18,23,12,0,14,0,67
2024-03-09 07:50:00,13,14,8,0,14,3,52
2024-03-09 08:00:00,19,18,18,0,19,3,77
2024-03-09 08:10:00,22,23,18,0,12,5,80
2024-03-09 08:20:00,25,28,20,0,21,5,99
2024-03-09 08:30:00,30,29,34,0,17,5,115
2024-03-09 08:40:00,22,19,23,0,11,8,83
2024-03-09 08:50:00,24,29,16,0,18,4,91
2024-03-09 09:00:00,23,25,21,0,20,14,103
2024-03-09 09:10:00,35,27,20,0,18,7,107
2024-03-09 09:20:00,30,30,16,0,17,14,107
2024-03-09 09:30:00,36,27,17,0,20,3,103
2024-03-09 09:40:00,35,25,18,0,32,5,115
2024-03-09 09:50:00,40,33,20,0,23,8,124
2024-03-09 10:00:00,36,35,14,0,24,11,120
2024-03-09 10:10:00,45,41,15,0,26,9,136
2024-03-09 10:20:00,39,31,33,0,21,12,136
2024-03-09 10:30:00,37,18,21,0,16,13,105
2024-03-09 10:40:00,37,35,24,0,18,44,158
2024-03-09 10:50:00,46,48,27,0,18,7,146
2024-03-09 11:00:00,43,38,34,0,12,8,135
2024-03-09 11:10:00,60,18,21,0,21,10,130
2024-03-09 11:20:00,41,32,23,0,17,9,122
2024-03-09 11:30:00,61,32,16,0,12,15,136
2024-03-09 11:40:00,52,5,10,0,9,12,88
2024-03-09 11:50:00,66,39,14,0,47,14,180
2024-03-09 12:00:00,45,41,9,0,10,21,126
2024-03-09 12:10:00,52,34,14,0,15,17,132
2024-03-09 12:20:00,57,35,22,0,20,16,150
2024-03-09 12:30:00,57,31,21,0,33,4,146
2024-03-09 12:40:00,50,33,18,0,7,9,117
2024-03-09 12:50:00,48,24,21,0,10,4,107
2024-03-09 13:00:00,50,26,20,0,11,13,120
2024-03-09 13:10:00,41,34,25,0,14,7,121
2024-03-09 13:20:00,43,27,11,0,27,7,115
2024-03-09 13:30:00,41,30,16,0,19,6,112
2024-03-09 13:40:00,25,29,21,0,19,6,100
2024-03-09 13:50:00,34,32,21,0,16,9,112
2024-03-09 14:00:00,46,30,17,0,17,8,118
2024-03-09 14:10:00,34,24,32,0,14,8,112
2024-03-09 14:20:00,28,34,22,0,22,9,115
2024-03-09 14:30:00,38,31,28,0,8,7,112
2024-03-09 14:40:00,39,34,29,0,13,6,121
2024-03-09 14:50:00,45,32,30,0,15,8,130
2024-03-09 15:00:00,38,23,28,0,18,7,114
2024-03-09 15:10:00,36,30,23,0,18,3,110
2024-03-09 15:20:00,38,35,24,0,22,6,125
2024-03-09 15:30:00,48,34,22,0,26,8,138
2024-03-09 15:40:00,38,33,12,0,19,9,111
2024-03-09 15:50:00,36,25,13,0,19,11,104
2024-03-09 16:00:00,46,31,31,0,13,104,225
2024-03-09 16:10:00,21,21,20,0,19,20,101
2024-03-09 16:20:00,35,21,21,0,19,16,112
2024-03-09 16:30:00,42,28,25,0,19,10,124
2024-03-09 16:40:00,37,29,20,0,24,5,115
2024-03-09 16:50:00,40,25,28,0,14,9,116
2024-03-09 17:00:00,29,28,18,0,25,13,113
2024-03-09 17:10:00,39,33,19,0,23,11,125
2024-03-09 17:20:00,35,22,16,0,18,4,95
2024-03-09 17:30:00,36,23,21,0,15,8,103
2024-03-09 17:40:00,40,31,21,0,15,10,117
2024-03-09 17:50:00,38,22,21,0,16,7,104
2024-03-09 18:00:00,35,29,31,0,25,6,126
2024-03-09 18:10:00,43,36,15,0,26,8,128
2024-03-09 18:20:00,30,23,24,0,16,6,99
2024-03-09 18:30:00,35,33,7,0,15,7,97
2024-03-09 18:40:00,35,22,34,0,23,8,122
2024-03-09 18:50:00,31,15,25,0,15,2,88
2024-03-09 19:00:00,34,32,21,0,13,5,105
2024-03-09 19:10:00,34,21,25,0,19,5,104
2024-03-09 19:20:00,28,23,21,0,17,3,92
2024-03-09 19:30:00,17,21,21,0,14,2,75
2024-03-09 19:40:00,17,14,23,0,23,1,78
2024-03-09 19:50:00,28,21,11,0,15,3,78
2024-03-09 20:00:00,18,18,9,0,25,17,87
2024-03-09 20:10:00,15,14,13,0,22,3,67
2024-03-09 20:20:00,23,21,17,0,18,4,83
2024-03-09 20:30:00,20,16,15,0,12,1,64
2024-03-09 20:40:00,10,10,17,0,16,6,59
2024-03-09 20:50:00,13,14,8,0,17,1,53
2024-03-09 21:00:00,14,12,10,0,13,5,54
2024-03-09 21:10:00,14,10,12,0,14,1,51
2024-03-09 21:20:00,6,11,12,0,15,8,52
2024-03-09 21:30:00,9,9,7,0,18,3,46
2024-03-09 21:40:00,19,15,9,0,12,0,55
2024-03-09 21:50:00,11,9,19,0,20,5,64
2024-03-09 22:00:00,12,8,8,0,21,1,50
2024-03-09 22:10:00,20,18,3,0,14,12,67
2024-03-09 22:20:00,15,14,6,0,13,0,48
2024-03-09 22:30:00,16,13,7,0,10,2,48
2024-03-09 22:40:00,12,11,3,0,11,1,38
2024-03-09 22:50:00,16,13,4,0,12,0,45
2024-03-09 23:00:00,16,15,4,0,8,1,44
2024-03-09 23:10:00,12,13,6,0,13,1,45
2024-03-09 23:20:00,13,12,4,0,10,1,40
2024-03-09 23:30:00,9,7,1,0,14,0,31
2024-03-09 23:40:00,11,10,2,0,13,1,37
2024-03-09 23:50:00,6,7,1,0,7,1,22
2024-03-10 00:00:00,8,8,7,0,10,0,33
2024-03-10 00:10:00,5,5,4,0,6,0,20
2024-03-10 00:20:00,7,8,5,0,7,2,29
2024-03-10 00:30:00,9,9,8,0,3,0,29
2024-03-10 00:40:00,8,9,1,0,9,2,29
2024-03-10 00:50:00,8,7,5,0,2,5,27
2024-03-10 01:00:00,9,10,1,0,6,2,28
2024-03-10 01:10:00,4,4,2,0,7,1,18
2024-03-10 01:20:00,4,7,1,0,3,0,15
2024-03-10 01:30:00,6,5,5,0,7,0,23
2024-03-10 01:40:00,11,11,3,0,3,0,28
2024-03-10 01:50:00,1,1,0,0,3,2,7
2024-03-10 02:00:00,2,2,1,0,10,0,15
2024-03-10 02:10:00,2,2,3,0,6,0,13
2024-03-10 02:20:00,2,2,3,0,3,0,10
2024-03-10 02:30:00,7,7,1,0,7,2,24
2024-03-10 02:40:00,7,6,1,0,3,0,17
2024-03-10 02:50:00,3,3,2,0,9,0,17
2024-03-10 03:00:00,3,3,1,0,7,0,14
2024-03-10 03:10:00,2,2,4,0,0,0,8
2024-03-10 03:20:00,0,0,0,0,4,1,5
2024-03-10 03:30:00,4,6,0,0,5,0,15
2024-03-10 03:40:00,1,2,1,0,3,0,7
2024-03-10 03:50:00,4,4,0,0,4,0,12
2024-03-10 04:00:00,3,4,1,0,2,2,12
2024-03-10 04:10:00,1,2,0,0,6,2,11
2024-03-10 04:20:00,4,6,1,0,3,0,14
2024-03-10 04:30:00,4,3,1,0,1,0,9
2024-03-10 04:40:00,1,1,1,0,4,0,7
2024-03-10 04:50:00,4,4,1,0,4,2,15
2024-03-10 05:00:00,2,5,0,0,1,0,8
2024-03-10 05:10:00,2,3,1,0,7,1,14
2024-03-10 05:20:00,3,3,6,0,2,1,15
2024-03-10 05:30:00,5,5,2,0,3,0,15
2024-03-10 05:40:00,2,2,5,0,3,0,12
2024-03-10 05:50:00,2,2,0,0,1,0,5
2024-03-10 06:00:00,3,3,1,0,8,0,15
2024-03-10 06:10:00,4,4,5,0,4,2,19
2024-03-10 06:20:00,1,1,0,0,3,0,5
2024-03-10 06:30:00,5,5,0,0,8,0,18
2024-03-10 06:40:00,2,3,2,0,3,0,10
2024-03-10 06:50:00,4,4,2,0,8,0,18
2024-03-10 07:00:00,5,8,1,0,4,1,19
2024-03-10 07:10:00,1,3,3,0,9,0,16
2024-03-10 07:20:00,4,5,4,0,7,1,21
2024-03-10 07:30:00,6,4,5,0,9,1,25
2024-03-10 07:40:00,10,13,4,0,8,1,36
2024-03-10 07:50:00,9,9,8,0,10,0,36
2024-03-10 08:00:00,10,12,7,0,5,1,35
2024-03-10 08:10:00,7,12,3,0,7,4,33
2024-03-10 08:20:00,15,17,11,0,8,3,54
2024-03-10 08:30:00,14,17,9,0,9,1,50
2024-03-10 08:40:00,14,15,10,0,9,2,50
2024-03-10 08:50:00,10,15,2,0,9,3,39
2024-03-10 09:00:00,12,13,12,0,11,1,49
2024-03-10 09:10:00,12,14,12,0,13,3,54
2024-03-10 09:20:00,16,16,14,0,14,2,62
2024-03-10 09:30:00,19,22,13,0,17,3,74
2024-03-10 09:40:00,31,28,8,0,12,5,84
2024-03-10 09:50:00,27,30,10,0,18,7,92
2024-03-10 10:00:00,18,12,7,0,18,3,58
2024-03-10 10:10:00,21,21,10,0,16,3,71
2024-03-10 10:20:00,15,17,13,0,15,10,70
2024-03-10 10:30:00,19,17,13,0,16,9,74
2024-03-10 10:40:00,19,15,4,0,14,1,53
2024-03-10 10:50:00,23,22,15,0,19,4,83
2024-03-10 11:00:00,18,23,13,0,15,7,76
2024-03-10 11:10:00,36,28,17,0,16,4,101
2024-03-10 11:20:00,25,26,4,0,12,4,71
2024-03-10 11:30:00,17,20,16,0,13,7,73
2024-03-10 11:40:00,27,23,17,0,20,4,91
2024-03-10 11:50:00,21,22,11,0,23,4,81
2024-03-10 12:00:00,22,23,11,0,18,9,83
2024-03-10 12:10:00,33,34,7,0,13,4,91
2024-03-10 12:20:00,29,30,18,0,15,1,93
2024-03-10 12:30:00,28,25,13,0,18,8,92
2024-03-10 12:40:00,24,26,12,0,14,4,80
2024-03-10 12:50:00,27,27,16,0,16,2,88
2024-03-10 13:00:00,29,24,14,0,19,21,107
2024-03-10 13:10:00,27,21,14,0,27,6,95
2024-03-10 13:20:00,31,22,12,0,20,7,92
2024-03-10 13:30:00,25,26,12,0,24,3,90
2024-03-10 13:40:00,21,22,14,0,22,7,86
2024-03-10 13:50:00,26,21,12,0,20,3,82
2024-03-10 14:00:00,28,28,18,0,23,6,103
2024-03-10 14:10:00,29,23,12,0,15,3,82
2024-03-10 14:20:00,31,32,7,0,14,1,85
2024-03-10 14:30:00,23,21,13,0,15,8,80
2024-03-10 14:40:00,23,17,14,0,30,1,85
2024-03-10 14:50:00,21,23,12,0,17,6,79
2024-03-10 15:00:00,36,27,10,0,16,4,93
2024-03-10 15:10:00,25,20,20,0,16,4,85
2024-03-10 15:20:00,27,26,14,0,17,7,91
2024-03-10 15:30:00,26,19,23,0,25,8,101
2024-03-10 15:40:00,23,21,20,0,17,1,82
2024-03-10 15:50:00,29,28,12,0,22,8,99
2024-03-10 16:00:00,33,21,15,0,11,4,84
2024-03-10 16:10:00,25,21,15,0,18,4,83
2024-03-10 16:20:00,22,24,7,0,21,6,80
2024-03-10 16:30:00,22,16,23,0,14,4,79
2024-03-10 16:40:00,32,23,10,0,24,6,95
2024-03-10 16:50:00,22,24,14,0,22,5,87
2024-03-10 17:00:00,16,14,14,0,22,9,75
2024-03-10 17:10:00,26,26,11,0,19,5,87
2024-03-10 17:20:00,22,22,18,0,30,5,97
2024-03-10 17:30:00,36,26,17,0,20,6,105
2024-03-10 17:40:00,43,27,17,0,25,4,116
2024-03-10 17:50:00,29,29,13,0,20,4,95
2024-03-10 18:00:00,22,18,11,0,20,3,74
2024-03-10 18:10:00,27,22,7,0,17,4,77
2024-03-10 18:20:00,23,17,5,0,19,4,68
2024-03-10 18:30:00,23,17,6,0,20,5,71
2024-03-10 18:40:00,18,21,9,0,16,2,66
2024-03-10 18:50:00,16,15,10,0,20,1,62
2024-03-10 19:00:00,23,20,5,0,12,4,64
2024-03-10 19:10:00,19,14,13,0,12,1,59
2024-03-10 19:20:00,20,15,8,0,11,3,57
2024-03-10 19:30:00,21,22,11,0,15,3,72
2024-03-10 19:40:00,13,14,8,0,13,0,48
2024-03-10 19:50:00,17,9,2,0,14,1,43
2024-03-10 20:00:00,20,18,10,0,15,5,68
2024-03-10 20:10:00,20,17,16,0,19,1,73
2024-03-10 20:20:00,12,11,4,0,18,1,46
2024-03-10 20:30:00,18,14,6,0,10,1,49
2024-03-10 20:40:00,16,13,5,0,12,1,47
2024-03-10 20:50:00,14,12,8,0,8,5,47
2024-03-10 21:00:00,12,10,6,0,10,0,38
2024-03-10 21:10:00,11,8,5,0,12,0,36
2024-03-10 21:20:00,8,7,4,0,19,1,39
2024-03-10 21:30:00,15,14,4,0,17,0,50
2024-03-10 21:40:00,3,4,2,0,9,0,18
2024-03-10 21:50:00,8,8,4,0,3,0,23
2024-03-10 22:00:00,7,8,6,0,11,1,33
2024-03-10 22:10:00,4,5,5,0,10,3,27
2024-03-10 22:20:00,9,7,3,0,8,0,27
2024-03-10 22:30:00,4,4,2,0,9,0,19
2024-03-10 22:40:00,5,5,1,0,6,0,17
2024-03-10 22:50:00,3,3,0,0,7,1,14
2024-03-10 23:00:00,5,6,2,0,9,1,23
2024-03-10 23:10:00,1,1,2,0,6,1,11
2024-03-10 23:20:00,4,4,0,0,4,1,13
2024-03-10 23:30:00,3,3,0,0,5,0,11
2024-03-10 23:40:00,2,3,0,0,2,0,7
2024-03-10 23:50:00,2,1,0,0,3,0,6
2024-03-11 00:00:00,5,6,1,0,5,0,17
2024-03-11 00:10:00,4,4,2,0,7,2,19
2024-03-11 00:20:00,1,1,0,0,3,0,5
2024-03-11 00:30:00,4,5,0,0,2,0,11
2024-03-11 00:40:00,1,1,0,0,2,0,4
2024-03-11 00:50:00,0,0,0,0,3,0,3
2024-03-11 01:00:00,3,3,1,0,2,0,9
2024-03-11 01:10:00,1,1,1,0,4,0,7
2024-03-11 01:20:00,1,1,1,0,2,0,5
2024-03-11 01:30:00,0,0,1,0,0,0,1
2024-03-11 01:40:00,3,3,0,0,1,0,7
2024-03-11 01:50:00,3,4,0,0,2,0,9
2024-03-11 02:00:00,1,1,0,0,0,0,2
2024-03-11 02:10:00,1,1,0,0,6,0,8
2024-03-11 02:20:00,0,0,1,0,0,0,1
2024-03-11 02:30:00,0,0,0,0,0,0,0
2024-03-11 02:40:00,0,0,0,0,0,0,0
2024-03-11 02:50:00,0,0,0,0,0,0,0
2024-03-11 03:00:00,0,0,0,0,0,0,0
2024-03-11 03:10:00,0,0,0,0,1,0,1
2024-03-11 03:20:00,0,0,0,0,0,0,0
2024-03-11 03:30:00,0,0,0,0,2,0,2
2024-03-11 03:40:00,0,4,0,0,2,0,6
2024-03-11 03:50:00,2,2,0,0,0,0,4
2024-03-11 04:00:00,2,3,0,0,4,0,9
2024-03-11 04:10:00,2,2,0,0,2,0,6
2024-03-11 04:20:00,2,3,1,0,2,0,8
2024-03-11 04:30:00,2,1,0,0,3,1,7
2024-03-11 04:40:00,1,1,0,0,0,0,2
2024-03-11 04:50:00,2,2,4,0,4,0,12
2024-03-11 05:00:00,6,6,6,0,8,1,27
2024-03-11 05:10:00,3,2,2,0,3,0,10
2024-03-11 05:20:00,4,5,3,0,5,2,19
2024-03-11 05:30:00,12,12,1,0,3,0,28
2024-03-11 05:40:00,10,9,7,0,12,2,40
2024-03-11 05:50:00,13,11,5,0,8,4,41
2024-03-11 06:00:00,10,12,7,0,6,1,36
2024-03-11 06:10:00,11,7,3,0,11,0,32
2024-03-11 06:20:00,14,13,11,0,12,3,53
2024-03-11 06:30:00,14,13,14,0,11,1,53
2024-03-11 06:40:00,16,15,7,0,12,2,52
2024-03-11 06:50:00,18,17,12,0,14,1,62
2024-03-11 07:00:00,24,18,12,0,20,2,76
2024-03-11 07:10:00,34,33,14,0,23,5,109
2024-03-11 07:20:00,44,37,19,0,18,3,121
2024-03-11 07:30:00,39,31,17,0,19,3,109
2024-03-11 07:40:00,47,27,21,0,29,7,131
2024-03-11 07:50:00,57,45,19,0,21,8,150
2024-03-11 08:00:00,44,35,19,0,19,5,122
2024-03-11 08:10:00,39,27,29,0,22,6,123
2024-03-11 08:20:00,29,23,23,0,23,5,103
2024-03-11 08:30:00,36,26,19,0,27,11,119
2024-03-11 08:40:00,44,32,20,0,22,10,128
2024-03-11 08:50:00,41,36,16,0,27,7,127
2024-03-11 09:00:00,28,29,27,0,25,9,118
2024-03-11 09:10:00,42,25,13,0,17,6,103
2024-03-11 09:20:00,35,27,21,0,24,13,120
2024-03-11 09:30:00,47,21,20,0,19,7,114
2024-03-11 09:40:00,34,25,17,0,20,5,101
2024-03-11 09:50:00,41,32,19,0,27,13,132
2024-03-11 10:00:00,24,19,22,0,23,13,101
2024-03-11 10:10:00,38,26,20,0,25,6,115
2024-03-11 10:20:00,31,25,23,0,19,9,107
2024-03-11 10:30:00,35,27,25,0,10,12,109
2024-03-11 10:40:00,44,35,15,0,22,9,125
2024-03-11 10:50:00,30,22,28,0,17,11,108
2024-03-11 11:00:00,35,29,24,0,27,10,125
2024-03-11 11:10:00,35,17,21,0,9,8,90
2024-03-11 11:20:00,35,30,16,0,20,14,115
2024-03-11 11:30:00,29,28,20,0,18,6,101
2024-03-11 11:40:00,36,19,25,0,22,10,112
2024-03-11 11:50:00,40,28,23,0,27,14,132
2024-03-11 12:00:00,31,25,21,0,22,10,109
2024-03-11 12:10:00,37,27,22,0,33,10,129
2024-03-11 12:20:00,30,20,23,0,20,14,107
2024-03-11 12:30:00,41,24,20,0,14,7,106
2024-03-11 12:40:00,46,41,22,0,22,7,138
2024-03-11 12:50:00,42,36,20,0,22,4,124
2024-03-11 13:00:00,32,22,23,0,26,9,112
2024-03-11 13:10:00,28,24,17,0,15,9,93
2024-03-11 13:20:00,35,25,19,0,15,7,101
2024-03-11 13:30:00,28,27,27,0,20,6,108
2024-03-11 13:40:00,38,22,20,0,20,6,106
2024-03-11 13:50:00,35,27,23,0,16,10,111
2024-03-11 14:00:00,25,21,17,0,18,8,89
2024-03-11 14:10:00,34,32,22,0,15,8,111
2024-03-11 14:20:00,36,33,22,0,23,8,122
2024-03-11 14:30:00,34,24,18,0,18,9,103
2024-03-11 14:40:00,38,32,21,0,19,11,121
2024-03-11 14:50:00,42,29,25,0,21,9,126
2024-03-11 15:00:00,45,19,20,0,30,9,123
2024-03-11 15:10:00,42,24,22,0,19,3,110
2024-03-11 15:20:00,42,29,23,0,21,8,123
2024-03-11 15:30:00,41,32,20,0,28,6,127
2024-03-11 15:40:00,38,29,16,0,24,12,119
2024-03-11 15:50:00,29,26,27,0,28,16,126
2024-03-11 16:00:00,39,10,29,0,13,6,97
2024-03-11 16:10:00,42,54,21,0,32,14,163
2024-03-11 16:20:00,40,23,21,0,22,6,112
2024-03-11 16:30:00,42,30,13,0,14,8,107
2024-03-11 16:40:00,37,30,13,0,27,11,118
2024-03-11 16:50:00,48,29,25,0,31,8,141
2024-03-11 17:00:00,45,30,22,0,16,9,122
2024-03-11 17:10:00,47,26,18,0,27,22,140
2024-03-11 17:20:00,46,35,20,0,24,13,138
2024-03-11 17:30:00,56,22,16,0,17,3,114
2024-03-11 17:40:00,53,29,15,0,20,9,126
2024-03-11 17:50:00,48,35,18,0,22,5,128
2024-03-11 18:00:00,42,31,20,0,18,4,115
2024-03-11 18:10:00,44,33,15,0,22,34,148
2024-03-11 18:20:00,39,28,21,0,28,8,124
2024-03-11 18:30:00,30,19,22,0,26,4,101
2024-03-11 18:40:00,39,28,9,0,15,4,95
2024-03-11 18:50:00,37,26,15,0,21,8,107
2024-03-11 19:00:00,23,16,16,0,16,1,72
2024-03-11 19:10:00,26,22,15,0,12,9,84
2024-03-11 19:20:00,34,22,18,0,21,5,100
2024-03-11 19:30:00,31,22,16,0,20,3,92
2024-03-11 19:40:00,19,15,14,0,13,6,67
2024-03-11 19:50:00,21,11,10,0,16,5,63
2024-03-11 20:00:00,24,20,15,0,12,6,77
2024-03-11 20:10:00,13,13,13,0,17,4,60
2024-03-11 20:20:00,15,21,7,0,10,5,58
2024-03-11 20:30:00,15,14,5,0,14,3,51
2024-03-11 20:40:00,17,17,7,0,13,2,56
2024-03-11 20:50:00,15,14,10,0,15,0,54
2024-03-11 21:00:00,5,6,5,0,14,1,31
2024-03-11 21:10:00,12,11,10,0,14,8,55
2024-03-11 21:20:00,11,9,12,0,16,3,51
2024-03-11 21:30:00,7,6,6,0,8,5,32
2024-03-11 21:40:00,13,9,6,0,11,2,41
2024-03-11 21:50:00,6,6,3,0,10,2,27
2024-03-11 22:00:00,4,3,15,0,9,5,36
2024-03-11 22:10:00,17,15,10,0,18,0,60
2024-03-11 22:20:00,5,5,11,0,5,0,26
2024-03-11 22:30:00,8,5,5,0,13,3,34
2024-03-11 22:40:00,7,7,3,0,8,0,25
2024-03-11 22:50:00,8,7,0,0,7,2,24
2024-03-11 23:00:00,2,2,1,0,4,2,11
2024-03-11 23:10:00,2,1,2,0,5,0,10
2024-03-11 23:20:00,5,6,0,0,2,1,14
2024-03-11 23:30:00,11,8,1,0,4,0,24
2024-03-11 23:40:00,1,1,1,0,5,3,11
2024-03-11 23:50:00,5,5,2,0,6,0,18
2024-03-12 00:00:00,3,2,2,0,4,0,11
2024-03-12 00:10:00,2,3,0,0,5,0,10
2024-03-12 00:20:00,2,4,2,0,5,0,13
2024-03-12 00:30:00,2,2,1,0,3,0,8
2024-03-12 00:40:00,2,3,0,0,5,2,12
2024-03-12 00:50:00,1,1,0,0,2,0,4
2024-03-12 01:00:00,2,2,0,0,4,0,8
2024-03-12 01:10:00,1,1,0,0,2,0,4
2024-03-12 01:20:00,1,1,1,0,0,0,3
2024-03-12 01:30:00,0,0,0,0,0,0,0
2024-03-12 01:40:00,0,0,0,0,1,0,1
2024-03-12 01:50:00,1,1,0,0,1,0,3
2024-03-12 02:00:00,1,1,0,0,2,0,4
2024-03-12 02:10:00,1,2,1,0,2,0,6
2024-03-12 02:20:00,0,1,1,0,1,0,3
2024-03-12 02:30:00,0,0,0,0,1,0,1
2024-03-12 02:40:00,2,2,0,0,3,0,7
2024-03-12 02:50:00,2,2,0,0,1,0,5
2024-03-12 03:00:00,0,0,0,0,0,0,0
2024-03-12 03:10:00,0,0,1,0,0,0,1
2024-03-12 03:20:00,1,1,0,0,3,2,7
2024-03-12 03:30:00,0,0,0,0,2,0,2
2024-03-12 03:40:00,0,0,0,0,6,0,6
2024-03-12 03:50:00,0,4,0,0,1,0,5
2024-03-12 04:00:00,2,2,0,0,0,0,4
2024-03-12 04:10:00,1,1,0,0,5,0,7
2024-03-12 04:20:00,0,0,0,0,5,0,5
2024-03-12 04:30:00,5,7,0,0,1,0,13
2024-03-12 04:40:00,1,3,1,0,2,0,7
2024-03-12 04:50:00,3,3,3,0,1,1,11
2024-03-12 05:00:00,4,5,3,0,2,1,15
2024-03-12 05:10:00,4,5,2,0,4,2,17
2024-03-12 05:20:00,7,9,6,0,4,3,29
2024-03-12 05:30:00,4,5,9,0,6,0,24
2024-03-12 05:40:00,9,13,5,0,8,4,39
2024-03-12 05:50:00,6,11,11,0,9,0,37
2024-03-12 06:00:00,15,14,6,0,7,3,45
2024-03-12 06:10:00,13,11,9,0,10,1,44
2024-03-12 06:20:00,14,11,12,0,13,1,51
2024-03-12 06:30:00,14,16,10,0,17,2,59
2024-03-12 06:40:00,23,18,14,0,13,1,69
2024-03-12 06:50:00,15,16,8,0,18,3,60
2024-03-12 07:00:00,26,25,13,0,19,4,87
2024-03-12 07:10:00,28,22,18,0,13,1,82
2024-03-12 07:20:00,24,20,15,0,19,2,80
2024-03-12 07:30:00,42,27,23,0,22,7,121
2024-03-12 07:40:00,36,33,17,0,21,5,112
2024-03-12 07:50:00,45,20,20,0,15,14,114
2024-03-12 08:00:00,55,28,16,0,21,6,126
2024-03-12 08:10:00,45,37,24,0,35,11,152
2024-03-12 08:20:00,29,24,16,0,27,7,103
2024-03-12 08:30:00,41,34,14,0,23,8,120
2024-03-12 08:40:00,41,34,10,0,18,8,111
2024-03-12 08:50:00,25,21,21,0,24,8,99
2024-03-12 09:00:00,32,25,16,0,29,10,112
2024-03-12 09:10:00,37,34,24,0,22,6,123
2024-03-12 09:20:00,39,26,18,0,22,8,113
2024-03-12 09:30:00,20,14,11,0,14,6,65
2024-03-12 09:40:00,32,24,12,0,13,3,84
2024-03-12 09:50:00,22,19,11,0,13,5,70
2024-03-12 10:00:00,33,25,20,0,14,12,104
2024-03-12 10:10:00,29,21,19,0,14,9,92
2024-03-12 10:20:00,41,37,27,0,21,7,133
2024-03-12 10:30:00,28,24,21,0,16,13,102
2024-03-12 10:40:00,32,27,21,0,18,6,104
2024-03-12 10:50:00,35,28,30,0,15,9,117
2024-03-12 11:00:00,35,30,23,0,16,6,110
2024-03-12 11:10:00,36,23,21,0,21,9,110
2024-03-12 11:20:00,32,27,19,0,18,4,100
2024-03-12 11:30:00,27,21,9,0,26,14,97
2024-03-12 11:40:00,33,34,17,0,22,10,116
2024-03-12 11:50:00,44,26,16,0,23,9,118
2024-03-12 12:00:00,36,30,25,0,15,5,111
2024-03-12 12:10:00,32,30,14,0,31,7,114
2024-03-12 12:20:00,30,28,23,0,21,7,109
2024-03-12 12:30:00,38,26,13,0,23,10,110
2024-03-12 12:40:00,37,29,25,0,23,5,119
2024-03-12 12:50:00,28,25,18,0,29,8,108
2024-03-12 13:00:00,35,25,30,0,16,7,113
2024-03-12 13:10:00,26,22,17,0,24,10,99
2024-03-12 13:20:00,34,25,17,0,30,6,112
2024-03-12 13:30:00,35,25,22,0,18,4,104
2024-03-12 13:40:00,29,27,16,0,16,4,92
2024-03-12 13:50:00,35,31,26,0,24,7,123
2024-03-12 14:00:00,33,26,20,0,22,6,107
2024-03-12 14:10:00,37,41,23,0,27,8,136
2024-03-12 14:20:00,38,29,21,0,18,10,116
2024-03-12 14:30:00,41,25,23,0,26,9,124
2024-03-12 14:40:00,42,30,15,0,13,9,109
2024-03-12 14:50:00,32,30,27,0,19,1,109
2024-03-12 15:00:00,33,22,25,0,25,12,117
2024-03-12 15:10:00,40,16,18,0,23,8,105
2024-03-12 15:20:00,41,31,16,0,22,7,117
2024-03-12 15:30:00,45,31,26,0,32,9,143
2024-03-12 15:40:00,43,29,20,0,35,9,136
2024-03-12 15:50:00,36,22,17,0,24,12,111
2024-03-12 16:00:00,25,26,27,0,24,7,109
2024-03-12 16:10:00,52,33,19,0,29,12,145
2024-03-12 16:20:00,45,32,21,0,19,10,127
2024-03-12 16:30:00,40,27,21,0,17,9,114
2024-03-12 16:40:00,49,29,18,0,24,13,133
2024-03-12 16:50:00,47,42,19,0,28,9,145
2024-03-12 17:00:00,58,24,10,0,20,15,127
2024-03-12 17:10:00,56,30,28,0,29,10,153
2024-03-12 17:20:00,47,34,21,0,32,12,146
2024-03-12 17:30:00,58,38,20,0,38,13,167
2024-03-12 17:40:00,59,51,17,0,30,9,166
2024-03-12 17:50:00,41,26,26,0,28,10,131
2024-03-12 18:00:00,38,18,21,0,15,9,101
2024-03-12 18:10:00,47,20,19,0,30,12,128
2024-03-12 18:20:00,36,23,23,0,21,3,106
2024-03-12 18:30:00,40,22,25,0,17,7,111
2024-03-12 18:40:00,38,27,27,0,29,4,125
2024-03-12 18:50:00,43,33,19,0,23,5,123
2024-03-12 19:00:00,21,16,16,0,22,5,80
2024-03-12 19:10:00,41,29,14,0,28,8,120
2024-03-12 19:20:00,24,18,16,0,12,7,77
2024-03-12 19:30:00,34,21,15,0,22,12,104
2024-03-12 19:40:00,32,26,15,0,15,4,92
2024-03-12 19:50:00,26,19,15,0,18,5,83
2024-03-12 20:00:00,17,15,16,0,18,3,69
2024-03-12 20:10:00,14,15,21,0,12,7,69
2024-03-12 20:20:00,26,17,11,0,20,4,78
2024-03-12 20:30:00,22,16,4,0,16,3,61
2024-03-12 20:40:00,10,10,6,0,14,0,40
2024-03-12 20:50:00,12,10,4,0,11,2,39
2024-03-12 21:00:00,11,11,5,0,6,2,35
2024-03-12 21:10:00,10,10,9,0,10,1,40
2024-03-12 21:20:00,14,17,8,0,20,5,64
2024-03-12 21:30:00,19,15,6,0,18,1,59
2024-03-12 21:40:00,11,9,8,0,14,3,45
2024-03-12 21:50:00,8,8,10,0,12,2,40
2024-03-12 22:00:00,9,6,8,0,10,2,35
2024-03-12 22:10:00,5,6,4,0,8,2,25
2024-03-12 22:20:00,10,7,1,0,16,3,37
2024-03-12 22:30:00,7,8,6,0,9,1,31
2024-03-12 22:40:00,7,6,4,0,5,2,24
2024-03-12 22:50:00,1,1,5,0,1,0,8
2024-03-12 23:00:00,7,10,6,0,0,0,23
2024-03-12 23:10:00,7,7,0,0,7,0,21
2024-03-12 23:20:00,5,3,2,0,2,3,15
2024-03-12 23:30:00,4,4,1,0,4,1,14
2024-03-12 23:40:00,4,4,3,0,6,0,17
2024-03-12 23:50:00,0,0,2,0,3,0,5
2024-03-13 00:00:00,9,6,0,0,3,1,19
2024-03-13 00:10:00,2,3,0,0,0,0,5
2024-03-13 00:20:00,3,3,0,0,0,0,6
2024-03-13 00:30:00,2,2,0,0,1,0,5
2024-03-13 00:40:00,2,2,0,0,2,0,6
2024-03-13 00:50:00,1,1,0,0,3,0,5
2024-03-13 01:00:00,0,0,1,0,1,0,2
2024-03-13 01:10:00,1,1,0,0,0,0,2
2024-03-13 01:20:00,0,0,1,0,1,0,2
2024-03-13 01:30:00,1,1,0,0,0,0,2
2024-03-13 01:40:00,1,1,0,0,1,0,3
2024-03-13 01:50:00,1,2,0,0,1,0,4
2024-03-13 02:00:00,0,0,0,0,2,0,2
2024-03-13 02:10:00,0,1,0,0,1,0,2
2024-03-13 02:20:00,4,4,0,0,2,0,10
2024-03-13 02:30:00,0,0,0,0,0,0,0
2024-03-13 02:40:00,2,2,3,0,1,1,9
2024-03-13 02:50:00,2,2,0,0,3,0,7
2024-03-13 03:00:00,0,0,0,0,0,0,0
2024-03-13 03:10:00,0,0,0,0,0,0,0
2024-03-13 03:20:00,0,0,3,0,1,0,4
2024-03-13 03:30:00,1,1,1,0,3,0,6
2024-03-13 03:40:00,0,0,0,0,3,0,3
2024-03-13 03:50:00,0,8,0,0,1,0,9
2024-03-13 04:00:00,2,2,0,0,0,0,4
2024-03-13 04:10:00,0,0,1,0,5,0,6
2024-03-13 04:20:00,1,1,0,0,3,0,5
2024-03-13 04:30:00,2,2,1,0,5,0,10
2024-03-13 04:40:00,3,12,0,0,2,0,17
2024-03-13 04:50:00,3,3,2,0,2,1,11
2024-03-13 05:00:00,5,6,1,0,3,0,15
2024-03-13 05:10:00,9,9,6,0,6,0,30
2024-03-13 05:20:00,7,6,2,0,4,1,20
2024-03-13 05:30:00,12,11,8,0,4,1,36
2024-03-13 05:40:00,8,10,6,0,8,1,33
2024-03-13 05:50:00,12,10,5,0,8,0,35
2024-03-13 06:00:00,7,6,3,0,7,1,24
2024-03-13 06:10:00,11,12,4,0,10,2,39
2024-03-13 06:20:00,16,15,10,0,13,0,54
2024-03-13 06:30:00,17,16,8,0,17,3,61
2024-03-13 06:40:00,21,18,34,0,13,4,90
2024-03-13 06:50:00,16,13,12,0,18,4,63
2024-03-13 07:00:00,25,17,12,0,18,6,78
2024-03-13 07:10:00,38,24,11,0,17,6,96
2024-03-13 07:20:00,33,28,12,0,13,8,94
2024-03-13 07:30:00,43,28,21,0,21,2,115
2024-03-13 07:40:00,32,21,17,0,24,9,103
2024-03-13 07:50:00,42,31,15,0,21,11,120
2024-03-13 08:00:00,39,31,27,0,23,8,128
2024-03-13 08:10:00,31,30,10,0,17,5,93
2024-03-13 08:20:00,32,27,19,0,18,8,104
2024-03-13 08:30:00,37,28,19,0,21,7,112
2024-03-13 08:40:00,37,24,14,0,20,4,99
2024-03-13 08:50:00,37,28,11,0,14,5,95
2024-03-13 09:00:00,24,24,14,0,22,5,89
2024-03-13 09:10:00,51,36,16,0,22,7,132
2024-03-13 09:20:00,42,33,25,0,28,5,133
2024-03-13 09:30:00,32,23,23,0,8,7,93
2024-03-13 09:40:00,36,31,23,0,17,8,115
2024-03-13 09:50:00,29,29,13,0,18,8,97
2024-03-13 10:00:00,33,20,13,0,21,7,94
2024-03-13 10:10:00,30,20,15,0,29,6,100
2024-03-13 10:20:00,27,15,18,0,20,18,98
2024-03-13 10:30:00,30,24,24,0,15,5,98
2024-03-13 10:40:00,31,33,21,0,16,10,111
2024-03-13 10:50:00,35,23,21,0,23,9,111
2024-03-13 11:00:00,31,25,19,0,12,13,100
2024-03-13 11:10:00,29,19,21,0,12,6,87
2024-03-13 11:20:00,35,30,22,0,18,5,110
2024-03-13 11:30:00,39,21,25,0,17,10,112
2024-03-13 11:40:00,35,26,21,0,12,9,103
2024-03-13 11:50:00,30,22,18,0,16,9,95
2024-03-13 12:00:00,35,25,22,0,28,8,118
2024-03-13 12:10:00,31,24,17,0,19,8,99
2024-03-13 12:20:00,29,25,18,0,20,7,99
2024-03-13 12:30:00,34,26,16,0,25,9,110
2024-03-13 12:40:00,33,30,29,0,26,8,126
2024-03-13 12:50:00,34,31,25,0,23,7,120
2024-03-13 13:00:00,28,27,17,0,23,7,102
2024-03-13 13:10:00,30,22,19,0,23,6,100
2024-03-13 13:20:00,31,28,21,0,27,5,112
2024-03-13 13:30:00,22,23,15,0,21,6,87
2024-03-13 13:40:00,33,29,17,0,32,13,124
2024-03-13 13:50:00,31,24,12,0,18,4,89
2024-03-13 14:00:00,41,31,14,0,19,10,115
2024-03-13 14:10:00,31,32,16,0,21,7,107
2024-03-13 14:20:00,41,23,22,0,25,12,123
2024-03-13 14:30:00,41,33,21,0,22,3,120
2024-03-13 14:40:00,33,14,22,0,27,5,101
2024-03-13 14:50:00,32,22,23,0,12,5,94
2024-03-13 15:00:00,40,27,10,0,20,5,102
2024-03-13 15:10:00,37,27,22,0,31,11,128
2024-03-13 15:20:00,43,29,31,0,28,7,138
2024-03-13 15:30:00,35,26,21,0,33,8,123
2024-03-13 15:40:00,27,19,15,0,21,9,91
2024-03-13 15:50:00,47,42,23,0,29,14,155
2024-03-13 16:00:00,47,34,21,0,11,13,126
2024-03-13 16:10:00,36,37,13,0,29,7,122
2024-03-13 16:20:00,33,26,25,0,29,4,117
2024-03-13 16:30:00,45,37,24,0,19,6,131
2024-03-13 16:40:00,48,34,22,0,14,7,125
2024-03-13 16:50:00,41,31,21,0,41,8,142
2024-03-13 17:00:00,40,32,18,0,26,13,129
2024-03-13 17:10:00,41,33,23,0,28,9,134
2024-03-13 17:20:00,34,34,18,0,16,12,114
2024-03-13 17:30:00,38,33,23,0,24,10,128
2024-03-13 17:40:00,36,27,13,0,14,15,105
2024-03-13 17:50:00,46,30,21,0,17,7,121
2024-03-13 18:00:00,33,30,25,0,19,3,110
2024-03-13 18:10:00,44,32,22,0,19,14,131
2024-03-13 18:20:00,47,40,24,0,15,7,133
2024-03-13 18:30:00,37,26,20,0,17,10,110
2024-03-13 18:40:00,36,25,15,0,19,6,101
2024-03-13 18:50:00,27,17,18,0,24,4,90
2024-03-13 19:00:00,37,23,16,0,15,6,97
2024-03-13 19:10:00,40,22,15,0,19,7,103
2024-03-13 19:20:00,20,16,18,0,20,1,75
2024-03-13 19:30:00,41,27,18,0,9,3,98
2024-03-13 19:40:00,31,22,11,0,14,1,79
2024-03-13 19:50:00,23,20,19,0,18,4,84
2024-03-13 20:00:00,14,13,14,0,7,13,61
2024-03-13 20:10:00,15,13,8,0,14,10,60
2024-03-13 20:20:00,18,19,15,0,21,4,77
2024-03-13 20:30:00,21,16,11,0,14,3,65
2024-03-13 20:40:00,19,13,9,0,14,0,55
2024-03-13 20:50:00,18,11,14,0,15,2,60
2024-03-13 21:00:00,18,15,10,0,21,2,66
2024-03-13 21:10:00,15,13,10,0,16,0,54
2024-03-13 21:20:00,17,17,7,0,20,7,68
2024-03-13 21:30:00,8,12,4,0,18,5,47
2024-03-13 21:40:00,12,13,5,0,15,0,45
2024-03-13 21:50:00,9,7,4,0,13,0,33
2024-03-13 22:00:00,19,16,0,0,9,1,45
2024-03-13 22:10:00,13,14,5,0,13,0,45
2024-03-13 22:20:00,9,9,3,0,13,0,34
2024-03-13 22:30:00,15,11,4,0,10,0,40
2024-03-13 22:40:00,2,4,2,0,15,5,28
2024-03-13 22:50:00,7,9,4,0,7,3,30
2024-03-13 23:00:00,4,4,3,0,9,0,20
2024-03-13 23:10:00,8,6,2,0,11,2,29
2024-03-13 23:20:00,4,3,3,0,5,0,15
2024-03-13 23:30:00,3,3,1,0,6,0,13
2024-03-13 23:40:00,2,2,0,0,5,0,9
2024-03-13 23:50:00,3,3,3,0,5,1,15
2024-03-14 00:00:00,5,4,0,0,7,3,19
2024-03-14 00:10:00,2,2,1,0,4,0,9
2024-03-14 00:20:00,4,5,1,0,4,0,14
2024-03-14 00:30:00,1,1,2,0,5,2,11
2024-03-14 00:40:00,3,3,1,0,0,0,7
2024-03-14 00:50:00,1,1,0,0,4,0,6
2024-03-14 01:00:00,5,3,0,0,3,0,11
2024-03-14 01:10:00,2,2,0,0,1,0,5
2024-03-14 01:20:00,3,4,0,0,1,0,8
2024-03-14 01:30:00,2,2,1,0,4,0,9
2024-03-14 01:40:00,1,1,0,0,3,0,5
2024-03-14 01:50:00,1,1,0,0,1,0,3
2024-03-14 02:00:00,1,1,0,0,3,0,5
2024-03-14 02:10:00,4,4,0,0,0,0,8
2024-03-14 02:20:00,2,2,0,0,1,0,5
2024-03-14 02:30:00,0,0,2,0,1,0,3
2024-03-14 02:40:00,1,1,0,0,1,0,3
2024-03-14 02:50:00,1,1,0,0,1,0,3
2024-03-14 03:00:00,0,0,1,0,2,0,3
2024-03-14 03:10:00,0,0,0,0,2,2,4
2024-03-14 03:20:00,0,0,2,0,0,0,2
2024-03-14 03:30:00,0,1,0,0,3,0,4
2024-03-14 03:40:00,2,2,0,0,2,1,7
2024-03-14 03:50:00,2,6,3,0,1,1,13
2024-03-14 04:00:00,1,1,0,0,3,0,5
2024-03-14 04:10:00,0,2,0,0,6,0,8
2024-03-14 04:20:00,3,3,0,0,4,0,10
2024-03-14 04:30:00,1,1,2,0,1,2,7
2024-03-14 04:40:00,2,2,1,0,2,1,8
2024-03-14 04:50:00,2,3,2,0,3,0,10
2024-03-14 05:00:00,3,2,0,0,4,1,10
2024-03-14 05:10:00,6,6,9,0,6,0,27
2024-03-14 05:20:00,8,13,3,0,4,1,29
2024-03-14 05:30:00,9,12,9,0,4,2,36
2024-03-14 05:40:00,6,8,8,0,10,0,32
2024-03-14 05:50:00,9,8,5,0,6,1,29
2024-03-14 06:00:00,10,9,5,0,9,4,37
2024-03-14 06:10:00,11,8,6,0,11,3,39
2024-03-14 06:20:00,15,13,6,0,19,2,55
2024-03-14 06:30:00,18,20,16,0,12,9,75
2024-03-14 06:40:00,18,16,5,0,17,0,56
2024-03-14 06:50:00,17,20,47,0,27,2,113
2024-03-14 07:00:00,20,20,14,0,24,0,78
2024-03-14 07:10:00,37,37,17,0,19,5,115
2024-03-14 07:20:00,36,29,18,0,22,6,111
2024-03-14 07:30:00,39,33,16,0,15,7,110
2024-03-14 07:40:00,45,31,18,0,25,6,125
2024-03-14 07:50:00,43,28,28,0,29,6,134
2024-03-14 08:00:00,27,23,20,0,18,9,97
2024-03-14 08:10:00,27,22,14,10,21,6,100
2024-03-14 08:20:00,30,36,19,40,29,6,160
2024-03-14 08:30:00,32,20,24,30,19,7,132
2024-03-14 08:40:00,29,26,12,34,30,20,151
2024-03-14 08:50:00,41,31,16,24,20,9,141
2024-03-14 09:00:00,35,31,16,38,31,9,160
2024-03-14 09:10:00,45,39,23,31,29,8,175
2024-03-14 09:20:00,32,28,15,25,22,9,131
2024-03-14 09:30:00,38,34,18,26,20,11,147
2024-03-14 09:40:00,39,30,18,31,18,8,144
2024-03-14 09:50:00,47,31,21,34,27,6,166
2024-03-14 10:00:00,34,26,12,25,23,8,128
2024-03-14 10:10:00,38,31,14,26,16,15,140
2024-03-14 10:20:00,31,26,24,26,18,6,131
2024-03-14 10:30:00,33,23,16,32,26,10,140
2024-03-14 10:40:00,33,27,20,34,28,7,149
2024-03-14 10:50:00,31,31,18,31,17,7,135
2024-03-14 11:00:00,36,31,24,45,21,12,169
2024-03-14 11:10:00,37,37,18,29,22,6,149
2024-03-14 11:20:00,23,29,21,29,21,9,132
2024-03-14 11:30:00,26,30,19,33,18,10,136
2024-03-14 11:40:00,42,22,14,38,15,10,141
2024-03-14 11:50:00,30,27,20,34,18,5,134
2024-03-14 12:00:00,35,25,24,22,16,10,132
2024-03-14 12:10:00,40,29,20,44,23,18,174
2024-03-14 12:20:00,34,27,21,36,27,7,152
2024-03-14 12:30:00,29,23,20,30,24,33,159
2024-03-14 12:40:00,25,26,19,36,19,8,133
2024-03-14 12:50:00,34,25,16,34,20,8,137
2024-03-14 13:00:00,34,20,19,30,21,7,131
2024-03-14 13:10:00,35,32,28,38,20,7,160
2024-03-14 13:20:00,41,29,13,31,25,17,156
2024-03-14 13:30:00,40,28,17,40,22,8,155
2024-03-14 13:40:00,30,25,26,39,31,4,155
2024-03-14 13:50:00,34,38,24,34,22,14,166
2024-03-14 14:00:00,30,38,19,34,24,7,152
2024-03-14 14:10:00,30,26,21,33,20,7,137
2024-03-14 14:20:00,39,31,25,27,25,8,155
2024-03-14 14:30:00,42,31,20,31,19,9,152
2024-03-14 14:40:00,36,25,17,40,19,8,145
2024-03-14 14:50:00,44,23,20,20,16,15,138
2024-03-14 15:00:00,46,29,22,49,15,12,173
2024-03-14 15:10:00,54,35,20,59,29,12,209
2024-03-14 15:20:00,33,33,25,43,29,7,170
2024-03-14 15:30:00,51,26,28,39,20,14,178
2024-03-14 15:40:00,33,23,17,39,16,16,144
2024-03-14 15:50:00,48,32,23,38,19,8,168
2024-03-14 16:00:00,76,21,15,26,23,9,170
2024-03-14 16:10:00,47,26,19,50,31,5,178
2024-03-14 16:20:00,42,37,16,34,17,16,162
2024-03-14 16:30:00,53,43,22,50,20,9,197
2024-03-14 16:40:00,36,14,26,44,11,2,133
2024-03-14 16:50:00,53,32,13,45,7,14,164
2024-03-14 17:00:00,38,22,15,56,19,8,158
2024-03-14 17:10:00,62,32,24,42,25,13,198
2024-03-14 17:20:00,34,34,22,42,29,16,177
2024-03-14 17:30:00,50,17,16,51,11,13,158
2024-03-14 17:40:00,52,15,18,40,14,20,159
2024-03-14 17:50:00,38,26,15,46,27,15,167
2024-03-14 18:00:00,37,23,23,47,15,6,151
2024-03-14 18:10:00,39,38,12,38,18,8,153
2024-03-14 18:20:00,36,28,24,49,28,8,173
2024-03-14 18:30:00,35,23,14,40,26,19,157
2024-03-14 18:40:00,35,27,20,22,10,11,125
2024-03-14 18:50:00,38,21,18,35,19,8,139
2024-03-14 19:00:00,38,24,28,29,21,3,143
2024-03-14 19:10:00,26,26,21,35,22,10,140
2024-03-14 19:20:00,28,17,18,28,16,6,113
2024-03-14 19:30:00,27,19,19,23,17,2,107
2024-03-14 19:40:00,29,27,8,21,20,8,113
2024-03-14 19:50:00,23,20,14,19,11,5,92
2024-03-14 20:00:00,17,20,23,21,18,3,102
2024-03-14 20:10:00,15,14,12,18,16,3,78
2024-03-14 20:20:00,18,17,9,14,9,2,69
2024-03-14 20:30:00,16,20,11,11,16,5,79
2024-03-14 20:40:00,11,8,5,26,16,2,68
2024-03-14 20:50:00,10,9,7,11,9,1,47
2024-03-14 21:00:00,17,13,12,23,14,5,84
2024-03-14 21:10:00,14,12,7,21,18,3,75
2024-03-14 21:20:00,9,9,3,14,14,3,52
2024-03-14 21:30:00,7,8,12,25,16,3,71
2024-03-14 21:40:00,6,6,9,16,12,0,49
2024-03-14 21:50:00,12,11,2,9,9,1,44
2024-03-14 22:00:00,15,12,3,19,13,2,64
2024-03-14 22:10:00,17,16,4,7,6,1,51
2024-03-14 22:20:00,6,5,2,8,7,2,30
2024-03-14 22:30:00,12,10,7,16,12,2,59
2024-03-14 22:40:00,10,11,2,18,18,5,64
2024-03-14 22:50:00,7,7,1,16,13,0,44
2024-03-14 23:00:00,13,12,3,4,4,0,36
2024-03-14 23:10:00,9,7,2,10,10,0,38
2024-03-14 23:20:00,4,5,1,7,8,0,25
2024-03-14 23:30:00,5,3,1,11,13,1,34
2024-03-14 23:40:00,2,2,4,7,6,0,21
2024-03-14 23:50:00,2,2,0,7,4,0,15
2024-03-15 00:00:00,3,3,2,8,5,0,21
2024-03-15 00:10:00,2,2,0,8,7,1,20
2024-03-15 00:20:00,2,1,0,5,5,0,13
2024-03-15 00:30:00,2,2,1,4,2,0,11
2024-03-15 00:40:00,5,5,1,6,5,1,23
2024-03-15 00:50:00,2,2,3,3,3,2,15
2024-03-15 01:00:00,2,2,0,4,4,0,12
2024-03-15 01:10:00,1,1,0,2,1,0,5
2024-03-15 01:20:00,1,1,0,1,2,0,5
2024-03-15 01:30:00,3,3,1,3,3,0,13
2024-03-15 01:40:00,3,3,0,1,1,0,8
2024-03-15 01:50:00,2,2,0,2,2,2,10
2024-03-15 02:00:00,0,0,0,2,1,0,3
2024-03-15 02:10:00,2,2,0,1,1,0,6
2024-03-15 02:20:00,0,0,0,1,2,1,4
2024-03-15 02:30:00,1,0,0,0,0,0,1
2024-03-15 02:40:00,0,0,0,0,0,0,0
2024-03-15 02:50:00,0,0,0,0,0,0,0
2024-03-15 03:00:00,0,0,1,4,3,3,11
2024-03-15 03:10:00,1,1,0,0,0,0,2
2024-03-15 03:20:00,0,0,0,0,0,0,0
2024-03-15 03:30:00,1,1,1,2,2,1,8
2024-03-15 03:40:00,0,0,0,2,2,0,4
2024-03-15 03:50:00,0,4,0,3,3,0,10
2024-03-15 04:00:00,1,1,0,2,2,0,6
2024-03-15 04:10:00,1,1,0,2,3,0,7
2024-03-15 04:20:00,0,0,2,1,1,0,4
2024-03-15 04:30:00,3,6,0,3,3,1,16
2024-03-15 04:40:00,3,3,1,4,5,1,17
2024-03-15 04:50:00,3,2,3,4,4,0,16
2024-03-15 05:00:00,3,3,2,2,2,2,14
2024-03-15 05:10:00,2,4,5,4,6,0,21
2024-03-15 05:20:00,4,5,2,1,3,0,15
2024-03-15 05:30:00,8,10,9,6,6,0,39
2024-03-15 05:40:00,5,6,7,8,6,0,32
2024-03-15 05:50:00,10,10,9,4,5,2,40
2024-03-15 06:00:00,9,10,6,9,9,3,46
2024-03-15 06:10:00,10,10,6,7,8,1,42
2024-03-15 06:20:00,9,9,7,23,12,2,62
2024-03-15 06:30:00,20,19,8,17,16,3,83
2024-03-15 06:40:00,17,13,9,18,13,3,73
2024-03-15 06:50:00,19,17,10,24,25,5,100
2024-03-15 07:00:00,14,14,7,24,17,2,78
2024-03-15 07:10:00,29,13,58,26,18,3,147
2024-03-15 07:20:00,33,27,11,35,34,4,144
2024-03-15 07:30:00,38,26,21,32,23,5,145
2024-03-15 07:40:00,48,32,14,34,24,8,160
2024-03-15 07:50:00,45,38,18,53,30,6,190
2024-03-15 08:00:00,44,33,19,21,22,8,147
2024-03-15 08:10:00,34,23,13,30,18,6,124
2024-03-15 08:20:00,40,33,13,23,15,6,130
2024-03-15 08:30:00,45,40,17,24,21,7,154
2024-03-15 08:40:00,32,25,17,26,19,6,125
2024-03-15 08:50:00,45,29,22,40,23,7,166
2024-03-15 09:00:00,35,31,15,23,20,7,131
2024-03-15 09:10:00,44,33,20,36,20,4,157
2024-03-15 09:20:00,31,33,21,26,21,8,140
2024-03-15 09:30:00,30,23,27,36,18,10,144
2024-03-15 09:40:00,34,27,14,26,16,10,127
2024-03-15 09:50:00,37,28,11,34,17,6,133
2024-03-15 10:00:00,36,27,57,31,18,9,178
2024-03-15 10:10:00,34,25,25,37,17,11,149
2024-03-15 10:20:00,37,26,25,30,25,13,156
2024-03-15 10:30:00,34,34,21,33,25,11,158
2024-03-15 10:40:00,42,30,12,20,18,15,137
2024-03-15 10:50:00,40,24,23,49,15,8,159
2024-03-15 11:00:00,34,31,9,36,17,13,140
2024-03-15 11:10:00,48,30,20,27,17,8,150
2024-03-15 11:20:00,37,24,18,37,23,10,149
2024-03-15 11:30:00,34,22,28,34,19,7,144
2024-03-15 11:40:00,44,26,17,38,16,1,142
2024-03-15 11:50:00,25,20,32,43,15,4,139
2024-03-15 12:00:00,40,28,21,38,23,10,160
2024-03-15 12:10:00,35,33,23,37,23,3,154
2024-03-15 12:20:00,33,27,13,33,20,15,141
2024-03-15 12:30:00,37,20,13,48,25,4,147
2024-03-15 12:40:00,36,33,18,32,20,10,149
2024-03-15 12:50:00,38,34,22,39,22,4,159
2024-03-15 13:00:00,33,24,8,32,20,9,126
2024-03-15 13:10:00,38,19,22,48,26,5,158
2024-03-15 13:20:00,32,24,22,35,23,8,144
2024-03-15 13:30:00,34,28,22,50,26,24,184
2024-03-15 13:40:00,54,34,18,35,22,8,171
2024-03-15 13:50:00,34,28,16,48,26,4,156
2024-03-15 14:00:00,30,23,18,28,21,8,128
2024-03-15 14:10:00,39,24,20,46,26,7,162
2024-03-15 14:20:00,41,25,20,43,26,6,161
2024-03-15 14:30:00,48,26,15,32,15,12,148
2024-03-15 14:40:00,35,26,16,42,23,12,154
2024-03-15 14:50:00,35,30,20,50,23,7,165
2024-03-15 15:00:00,43,22,14,39,22,8,148
2024-03-15 15:10:00,37,22,19,38,27,13,156
2024-03-15 15:20:00,47,25,12,48,16,8,156
2024-03-15 15:30:00,41,28,19,49,24,6,167
2024-03-15 15:40:00,40,31,23,42,18,7,161
2024-03-15 15:50:00,55,37,17,47,20,18,194
2024-03-15 16:00:00,35,26,10,31,20,1,123
2024-03-15 16:10:00,46,32,22,35,25,7,167
2024-03-15 16:20:00,40,31,19,28,12,0,130
2024-03-15 16:30:00,33,27,16,48,32,13,169
2024-03-15 16:40:00,34,31,22,35,24,17,163
2024-03-15 16:50:00,48,41,30,53,31,8,211
2024-03-15 17:00:00,42,27,13,26,20,11,139
2024-03-15 17:10:00,45,15,27,49,8,5,149
2024-03-15 17:20:00,45,34,27,60,29,11,206
2024-03-15 17:30:00,44,32,18,32,18,11,155
2024-03-15 17:40:00,48,37,9,32,20,10,156
2024-03-15 17:50:00,36,26,14,44,25,9,154
2024-03-15 18:00:00,44,32,20,43,22,10,171
2024-03-15 18:10:00,39,33,26,53,31,10,192
2024-03-15 18:20:00,46,38,23,33,19,9,168
2024-03-15 18:30:00,41,22,19,31,20,10,143
2024-03-15 18:40:00,33,17,10,25,15,5,105
2024-03-15 18:50:00,31,23,21,28,23,12,138
2024-03-15 19:00:00,30,23,13,28,27,1,122
2024-03-15 19:10:00,30,15,15,27,17,2,106
2024-03-15 19:20:00,24,13,15,21,18,5,96
2024-03-15 19:30:00,32,27,23,30,10,5,127
2024-03-15 19:40:00,28,21,14,24,12,6,105
2024-03-15 19:50:00,30,28,16,34,24,4,136
2024-03-15 20:00:00,24,20,14,34,20,6,118
2024-03-15 20:10:00,26,20,19,26,16,4,111
2024-03-15 20:20:00,21,17,13,25,14,3,93
2024-03-15 20:30:00,22,16,11,15,9,5,78
2024-03-15 20:40:00,17,15,8,22,6,5,73
2024-03-15 20:50:00,17,16,9,11,13,0,66
2024-03-15 21:00:00,14,13,9,22,19,2,79
2024-03-15 21:10:00,20,12,11,15,12,0,70
2024-03-15 21:20:00,18,14,9,19,16,2,78
2024-03-15 21:30:00,13,13,15,16,14,2,73
2024-03-15 21:40:00,12,8,4,17,11,5,57
2024-03-15 21:50:00,12,9,5,19,13,2,60
2024-03-15 22:00:00,12,11,7,14,11,0,55
2024-03-15 22:10:00,15,13,6,14,14,0,62
2024-03-15 22:20:00,12,12,5,11,10,3,53
2024-03-15 22:30:00,11,7,4,9,7,2,40
2024-03-15 22:40:00,14,10,1,11,10,0,46
2024-03-15 22:50:00,13,16,6,12,10,0,57
2024-03-15 23:00:00,13,10,3,8,8,1,43
2024-03-15 23:10:00,12,10,5,11,9,6,53
2024-03-15 23:20:00,12,12,2,8,9,0,43
2024-03-15 23:30:00,9,8,2,17,14,1,51
2024-03-15 23:40:00,7,5,2,9,8,0,31
2024-03-15 23:50:00,4,3,5,13,10,0,35
2024-03-16 00:00:00,6,6,6,16,16,2,52
2024-03-16 00:10:00,7,8,0,8,11,0,34
2024-03-16 00:20:00,8,7,1,11,12,0,39
2024-03-16 00:30:00,6,6,0,7,6,1,26
2024-03-16 00:40:00,4,3,5,4,1,2,19
2024-03-16 00:50:00,6,7,0,7,8,0,28
2024-03-16 01:00:00,5,5,3,9,8,0,30
2024-03-16 01:10:00,4,7,1,8,7,1,28
2024-03-16 01:20:00,2,2,1,3,3,0,11
2024-03-16 01:30:00,3,5,2,7,7,0,24
2024-03-16 01:40:00,5,4,3,6,7,0,25
2024-03-16 01:50:00,0,0,0,4,4,0,8
2024-03-16 02:00:00,1,1,2,5,4,0,13
2024-03-16 02:10:00,0,0,3,1,0,2,6
2024-03-16 02:20:00,3,4,0,2,2,0,11
2024-03-16 02:30:00,7,4,0,6,6,0,23
2024-03-16 02:40:00,2,3,1,3,3,0,12
2024-03-16 02:50:00,2,2,0,2,3,0,9
2024-03-16 03:00:00,3,3,0,3,3,0,12
2024-03-16 03:10:00,5,6,1,0,0,3,15
2024-03-16 03:20:00,1,1,2,1,1,1,7
2024-03-16 03:30:00,3,4,0,2,2,0,11
2024-03-16 03:40:00,4,8,2,2,2,0,18
2024-03-16 03:50:00,1,1,0,2,2,0,6
2024-03-16 04:00:00,4,2,1,3,3,0,13
2024-03-16 04:10:00,1,4,1,1,1,0,8
2024-03-16 04:20:00,0,0,0,3,4,0,7
2024-03-16 04:30:00,3,4,0,1,1,0,9
2024-03-16 04:40:00,4,4,2,1,1,0,12
2024-03-16 04:50:00,1,1,0,3,3,0,8
2024-03-16 05:00:00,2,2,3,3,3,0,13
2024-03-16 05:10:00,2,2,0,4,4,1,13
2024-03-16 05:20:00,2,2,0,2,3,0,9
2024-03-16 05:30:00,4,4,1,4,4,0,17
2024-03-16 05:40:00,2,2,1,2,4,0,11
2024-03-16 05:50:00,5,5,2,5,7,5,29
2024-03-16 06:00:00,4,5,6,3,3,0,21
2024-03-16 06:10:00,6,7,4,8,5,0,30
2024-03-16 06:20:00,3,3,7,8,8,0,29
2024-03-16 06:30:00,10,10,4,9,8,0,41
2024-03-16 06:40:00,7,8,2,9,7,0,33
2024-03-16 06:50:00,9,9,4,8,7,0,37
2024-03-16 07:00:00,11,10,13,9,11,4,58
2024-03-16 07:10:00,13,15,8,13,13,2,64
2024-03-16 07:20:00,12,8,15,11,10,2,58
2024-03-16 07:30:00,14,15,17,12,12,1,71
2024-03-16 07:40:00,14,11,20,15,13,5,78
2024-03-16 07:50:00,10,12,17,18,18,4,79
2024-03-16 08:00:00,17,18,14,20,20,5,94
2024-03-16 08:10:00,14,14,18,27,19,5,97
2024-03-16 08:20:00,17,21,12,11,9,7,77
2024-03-16 08:30:00,31,23,16,33,15,7,125
2024-03-16 08:40:00,33,19,18,21,16,6,113
2024-03-16 08:50:00,28,24,29,19,21,12,133
2024-03-16 09:00:00,21,17,14,25,15,5,97
2024-03-16 09:10:00,33,25,25,24,19,13,139
2024-03-16 09:20:00,30,26,14,26,17,5,118
2024-03-16 09:30:00,29,25,26,24,16,10,130
2024-03-16 09:40:00,35,31,12,33,20,4,135
2024-03-16 09:50:00,39,31,17,34,22,5,148
2024-03-16 10:00:00,36,33,16,33,24,6,148
2024-03-16 10:10:00,41,34,11,39,24,15,164
2024-03-16 10:20:00,34,31,19,39,29,8,160
2024-03-16 10:30:00,31,26,18,22,18,5,120
2024-03-16 10:40:00,38,23,23,44,20,8,156
2024-03-16 10:50:00,45,37,21,37,23,10,173
2024-03-16 11:00:00,37,27,14,42,18,13,151
2024-03-16 11:10:00,46,40,22,37,16,1,162
2024-03-16 11:20:00,43,39,20,36,23,8,169
2024-03-16 11:30:00,40,21,33,42,21,8,165
2024-03-16 11:40:00,43,31,19,24,22,14,153
2024-03-16 11:50:00,32,32,6,39,16,11,136
2024-03-16 12:00:00,44,34,6,33,22,6,145
2024-03-16 12:10:00,34,27,18,39,19,13,150
2024-03-16 12:20:00,40,32,3,48,25,7,155
2024-03-16 12:30:00,38,25,23,34,26,10,156
2024-03-16 12:40:00,41,31,18,35,25,10,160
2024-03-16 12:50:00,40,32,23,31,20,11,157
2024-03-16 13:00:00,37,29,18,43,31,5,163
2024-03-16 13:10:00,56,27,25,39,22,6,175
2024-03-16 13:20:00,35,26,17,21,14,4,117
2024-03-16 13:30:00,41,30,24,38,13,97,243
2024-03-16 13:40:00,31,28,19,41,24,10,153
2024-03-16 13:50:00,47,28,24,35,19,2,155
2024-03-16 14:00:00,31,29,12,27,21,10,130
2024-03-16 14:10:00,32,21,19,39,24,9,144
2024-03-16 14:20:00,27,19,18,32,22,10,128
2024-03-16 14:30:00,35,23,16,43,28,13,158
2024-03-16 14:40:00,50,32,15,22,15,7,141
2024-03-16 14:50:00,43,29,21,37,24,2,156
2024-03-16 15:00:00,32,29,17,33,20,5,136
2024-03-16 15:10:00,31,29,21,31,15,5,132
2024-03-16 15:20:00,31,23,17,31,26,6,134
2024-03-16 15:30:00,30,23,19,27,15,10,124
2024-03-16 15:40:00,33,29,19,37,29,10,157
2024-03-16 15:50:00,28,28,22,30,24,12,144
2024-03-16 16:00:00,25,18,26,26,17,9,121
2024-03-16 16:10:00,33,33,24,29,21,9,149
2024-03-16 16:20:00,32,27,19,28,10,8,124
2024-03-16 16:30:00,31,20,18,27,16,7,119
2024-03-16 16:40:00,26,22,17,26,16,4,111
2024-03-16 16:50:00,33,27,14,36,17,11,138
2024-03-16 17:00:00,36,25,23,30,16,9,139
2024-03-16 17:10:00,39,39,21,30,18,7,154
2024-03-16 17:20:00,34,24,19,31,21,10,139
2024-03-16 17:30:00,30,29,17,38,26,7,147
2024-03-16 17:40:00,23,21,21,25,16,6,112
2024-03-16 17:50:00,31,23,21,38,21,9,143
2024-03-16 18:00:00,26,27,21,38,20,4,136
2024-03-16 18:10:00,41,21,19,33,21,6,141
2024-03-16 18:20:00,35,28,21,28,19,4,135
2024-03-16 18:30:00,33,19,19,36,12,4,123
2024-03-16 18:40:00,23,17,16,41,20,6,123
2024-03-16 18:50:00,31,21,20,24,17,9,122
2024-03-16 19:00:00,26,18,23,25,19,2,113
2024-03-16 19:10:00,30,24,13,32,22,2,123
2024-03-16 19:20:00,24,20,15,21,17,6,103
2024-03-16 19:30:00,17,15,14,20,14,6,86
2024-03-16 19:40:00,23,25,16,29,21,4,118
2024-03-16 19:50:00,24,12,14,23,18,7,98
2024-03-16 20:00:00,23,19,9,23,21,3,98
2024-03-16 20:10:00,22,15,18,20,17,3,95
2024-03-16 20:20:00,22,21,11,10,8,8,80
2024-03-16 20:30:00,13,13,10,22,16,4,78
2024-03-16 20:40:00,9,10,9,18,15,0,61
2024-03-16 20:50:00,12,11,11,21,11,2,68
2024-03-16 21:00:00,21,16,12,18,22,6,95
2024-03-16 21:10:00,17,16,15,20,14,0,82
2024-03-16 21:20:00,15,14,10,19,17,9,84
2024-03-16 21:30:00,13,8,1,17,13,1,53
2024-03-16 21:40:00,10,8,3,21,10,0,52
2024-03-16 21:50:00,16,10,5,17,18,1,67
2024-03-16 22:00:00,14,12,11,23,17,0,77
2024-03-16 22:10:00,10,8,9,23,13,0,63
2024-03-16 22:20:00,14,10,7,20,15,2,68
2024-03-16 22:30:00,15,14,2,14,11,3,59
2024-03-16 22:40:00,9,7,6,12,12,0,46
2024-03-16 22:50:00,20,20,4,16,13,2,75
2024-03-16 23:00:00,13,11,9,8,7,5,53
2024-03-16 23:10:00,12,8,11,8,7,0,46
2024-03-16 23:20:00,6,6,4,17,16,0,49
2024-03-16 23:30:00,13,10,6,12,11,1,53
2024-03-16 23:40:00,3,3,3,11,12,0,32
2024-03-16 23:50:00,10,9,3,8,7,0,37
2024-03-17 00:00:00,7,7,6,9,7,2,38
2024-03-17 00:10:00,5,5,2,13,8,0,33
2024-03-17 00:20:00,7,7,1,8,7,2,32
2024-03-17 00:30:00,5,6,4,12,10,0,37
2024-03-17 00:40:00,5,5,3,6,5,1,25
2024-03-17 00:50:00,7,5,4,8,6,1,31
2024-03-17 01:00:00,8,7,4,9,5,1,34
2024-03-17 01:10:00,5,5,17,6,5,0,38
2024-03-17 01:20:00,6,6,12,11,5,0,40
2024-03-17 01:30:00,5,5,1,7,8,0,26
2024-03-17 01:40:00,5,5,1,5,4,2,22
2024-03-17 01:50:00,3,3,0,10,7,1,24
2024-03-17 02:00:00,8,6,3,9,9,0,35
2024-03-17 02:10:00,2,2,0,3,3,0,10
2024-03-17 02:20:00,4,4,4,4,2,1,19
2024-03-17 02:30:00,4,4,2,5,3,0,18
2024-03-17 02:40:00,4,3,1,3,2,0,13
2024-03-17 02:50:00,1,1,0,2,1,0,5
2024-03-17 03:00:00,2,3,2,3,3,0,13
2024-03-17 03:10:00,2,3,1,1,1,2,10
2024-03-17 03:20:00,1,1,2,1,1,0,6
2024-03-17 03:30:00,2,2,0,2,1,0,7
2024-03-17 03:40:00,1,1,1,2,1,0,6
2024-03-17 03:50:00,2,2,0,1,1,1,7
2024-03-17 04:00:00,2,3,0,4,5,0,14
2024-03-17 04:10:00,0,2,1,1,1,0,5
2024-03-17 04:20:00,1,1,0,2,1,0,5
2024-03-17 04:30:00,3,2,1,1,0,0,7
2024-03-17 04:40:00,0,0,0,2,2,0,4
2024-03-17 04:50:00,6,5,4,3,3,0,21
2024-03-17 05:00:00,3,5,1,1,1,0,11
2024-03-17 05:10:00,1,2,1,2,1,0,7
2024-03-17 05:20:00,1,1,0,2,2,1,7
2024-03-17 05:30:00,5,6,0,5,4,0,20
2024-03-17 05:40:00,2,3,4,6,6,0,21
2024-03-17 05:50:00,3,3,1,1,2,1,11
2024-03-17 06:00:00,3,3,1,3,4,0,14
2024-03-17 06:10:00,3,3,2,2,3,1,14
2024-03-17 06:20:00,4,4,1,2,1,0,12
2024-03-17 06:30:00,4,4,0,4,3,0,15
2024-03-17 06:40:00,3,3,1,5,5,0,17
2024-03-17 06:50:00,1,1,4,5,6,1,18
2024-03-17 07:00:00,8,11,5,9,8,2,43
2024-03-17 07:10:00,1,1,5,3,3,1,14
2024-03-17 07:20:00,6,6,3,5,5,1,26
2024-03-17 07:30:00,7,9,6,10,9,0,41
2024-03-17 07:40:00,9,8,5,4,4,1,31
2024-03-17 07:50:00,9,9,6,13,13,3,53
2024-03-17 08:00:00,15,16,6,8,8,4,57
2024-03-17 08:10:00,13,15,3,8,7,3,49
2024-03-17 08:20:00,7,9,9,9,7,0,41
2024-03-17 08:30:00,13,11,4,14,13,3,58
2024-03-17 08:40:00,18,18,5,15,16,5,77
2024-03-17 08:50:00,15,18,10,14,12,0,69
2024-03-17 09:00:00,18,13,15,14,11,2,73
2024-03-17 09:10:00,17,19,7,13,14,1,71
2024-03-17 09:20:00,17,19,7,17,17,6,83
2024-03-17 09:30:00,18,18,11,17,17,2,83
2024-03-17 09:40:00,27,25,11,16,12,6,97
2024-03-17 09:50:00,21,23,16,13,13,9,95
2024-03-17 10:00:00,16,17,11,14,12,1,71
2024-03-17 10:10:00,21,16,11,18,9,6,81
2024-03-17 10:20:00,12,11,7,8,7,4,49
2024-03-17 10:30:00,19,20,12,22,12,4,89
2024-03-17 10:40:00,25,21,10,21,16,4,97
2024-03-17 10:50:00,29,31,18,19,17,7,121
2024-03-17 11:00:00,21,18,17,24,18,7,105
2024-03-17 11:10:00,29,28,12,17,12,7,105
2024-03-17 11:20:00,22,19,15,25,18,3,102
2024-03-17 11:30:00,30,29,16,30,18,5,128
2024-03-17 11:40:00,22,22,12,23,23,6,108
2024-03-17 11:50:00,28,26,10,24,20,3,111
2024-03-17 12:00:00,20,20,11,22,17,2,92
2024-03-17 12:10:00,24,24,14,17,15,2,96
2024-03-17 12:20:00,26,24,15,33,23,4,125
2024-03-17 12:30:00,32,19,15,25,9,4,104
2024-03-17 12:40:00,29,23,11,14,13,3,93
2024-03-17 12:50:00,33,26,17,31,23,2,132
2024-03-17 13:00:00,31,23,13,32,27,3,129
2024-03-17 13:10:00,26,25,14,26,16,7,114
2024-03-17 13:20:00,14,18,15,25,16,6,94
2024-03-17 13:30:00,27,19,20,24,11,4,105
2024-03-17 13:40:00,28,31,15,38,24,4,140
2024-03-17 13:50:00,22,23,9,30,24,5,113
2024-03-17 14:00:00,27,20,16,38,27,2,130
2024-03-17 14:10:00,32,32,19,34,24,7,148
2024-03-17 14:20:00,27,21,16,25,17,4,110
2024-03-17 14:30:00,30,27,13,33,21,8,132
2024-03-17 14:40:00,32,25,16,24,16,5,118
2024-03-17 14:50:00,27,23,18,28,26,8,130
2024-03-17 15:00:00,25,18,19,26,25,11,124
2024-03-17 15:10:00,34,27,13,26,20,10,130
2024-03-17 15:20:00,23,19,16,30,21,9,118
2024-03-17 15:30:00,26,25,16,22,13,3,105
2024-03-17 15:40:00,18,20,21,32,17,4,112
2024-03-17 15:50:00,21,21,11,19,16,3,91
2024-03-17 16:00:00,43,29,12,26,23,6,139
2024-03-17 16:10:00,27,22,10,29,20,7,115
2024-03-17 16:20:00,21,19,14,22,22,4,102
2024-03-17 16:30:00,22,17,17,28,16,2,102
2024-03-17 16:40:00,30,20,21,28,17,2,118
2024-03-17 16:50:00,25,23,14,28,18,2,110
2024-03-17 17:00:00,21,16,13,24,19,1,94
2024-03-17 17:10:00,36,24,12,28,12,7,119
2024-03-17 17:20:00,36,32,13,30,28,4,143
2024-03-17 17:30:00,35,25,18,30,17,7,132
2024-03-17 17:40:00,37,18,17,24,18,4,118
2024-03-17 17:50:00,33,29,23,34,23,2,144
2024-03-17 18:00:00,29,19,15,26,24,1,114
2024-03-17 18:10:00,21,18,18,33,19,5,114
2024-03-17 18:20:00,27,20,15,27,26,4,119
2024-03-17 18:30:00,19,19,8,27,23,2,98
2024-03-17 18:40:00,23,17,9,29,17,0,95
2024-03-17 18:50:00,12,9,9,11,8,1,50
2024-03-17 19:00:00,18,18,10,21,15,1,83
2024-03-17 19:10:00,19,18,7,18,14,1,77
2024-03-17 19:20:00,15,16,10,34,22,4,101
2024-03-17 19:30:00,25,20,14,23,21,1,104
2024-03-17 19:40:00,24,17,8,15,8,3,75
2024-03-17 19:50:00,20,19,5,17,16,6,83
2024-03-17 20:00:00,24,14,15,16,15,1,85
2024-03-17 20:10:00,9,7,7,13,8,4,48
2024-03-17 20:20:00,17,17,11,12,9,2,68
2024-03-17 20:30:00,14,13,8,13,13,3,64
2024-03-17 20:40:00,12,8,3,12,14,0,49
2024-03-17 20:50:00,16,10,3,10,10,0,49
2024-03-17 21:00:00,12,8,6,17,13,0,56
2024-03-17 21:10:00,9,9,2,10,10,1,41
2024-03-17 21:20:00,10,9,11,13,11,4,58
2024-03-17 21:30:00,13,7,3,13,10,1,47
2024-03-17 21:40:00,10,7,5,16,15,2,55
2024-03-17 21:50:00,10,7,1,16,13,0,47
2024-03-17 22:00:00,8,9,1,8,9,1,36
2024-03-17 22:10:00,17,16,4,10,7,0,54
2024-03-17 22:20:00,5,5,2,3,3,0,18
2024-03-17 22:30:00,6,6,4,7,14,0,37
2024-03-17 22:40:00,8,11,4,6,6,1,36
2024-03-17 22:50:00,2,3,6,9,8,2,30
2024-03-17 23:00:00,9,8,6,7,5,0,35
2024-03-17 23:10:00,4,4,1,6,8,1,24
2024-03-17 23:20:00,2,2,3,4,7,0,18
2024-03-17 23:30:00,1,1,1,6,3,1,13
2024-03-17 23:40:00,4,6,2,7,6,0,25
2024-03-17 23:50:00,3,3,1,5,4,0,16
2024-03-18 00:00:00,5,3,1,5,6,1,21
2024-03-18 00:10:00,3,3,0,3,3,0,12
2024-03-18 00:20:00,1,1,0,3,3,2,10
2024-03-18 00:30:00,1,1,1,4,3,0,10
2024-03-18 00:40:00,2,3,1,3,6,0,15
2024-03-18 00:50:00,2,2,0,2,3,0,9
2024-03-18 01:00:00,4,4,0,4,5,0,17
2024-03-18 01:10:00,3,3,0,5,2,0,13
2024-03-18 01:20:00,0,0,0,3,3,2,8
2024-03-18 01:30:00,1,1,0,1,1,0,4
2024-03-18 01:40:00,0,0,2,3,2,0,7
2024-03-18 01:50:00,0,0,0,0,0,0,0
2024-03-18 02:00:00,0,0,0,0,0,0,0
2024-03-18 02:10:00,0,0,1,0,0,0,1
2024-03-18 02:20:00,3,3,0,1,1,0,8
2024-03-18 02:30:00,0,0,0,1,1,0,2
2024-03-18 02:40:00,1,1,0,1,1,0,4
2024-03-18 02:50:00,1,2,0,1,1,0,5
2024-03-18 03:00:00,0,0,0,0,0,0,0
2024-03-18 03:10:00,1,1,0,2,2,0,6
2024-03-18 03:20:00,0,0,0,1,1,0,2
2024-03-18 03:30:00,1,8,0,2,1,0,12
2024-03-18 03:40:00,0,0,0,3,3,0,6
2024-03-18 03:50:00,0,0,1,0,0,0,1
2024-03-18 04:00:00,2,3,0,3,3,0,11
2024-03-18 04:10:00,2,2,0,4,4,0,12
2024-03-18 04:20:00,1,2,0,2,2,0,7
2024-03-18 04:30:00,3,3,0,2,2,0,10
2024-03-18 04:40:00,3,3,2,1,2,0,11
2024-03-18 04:50:00,2,2,4,3,3,0,14
2024-03-18 05:00:00,6,8,5,5,5,2,31
2024-03-18 05:10:00,5,5,2,7,6,0,25
2024-03-18 05:20:00,7,7,4,3,3,0,24
2024-03-18 05:30:00,6,6,8,8,7,2,37
2024-03-18 05:40:00,10,8,9,8,6,2,43
2024-03-18 05:50:00,8,12,7,7,7,0,41
2024-03-18 06:00:00,8,11,6,8,12,2,47
2024-03-18 06:10:00,9,9,5,9,8,0,40
2024-03-18 06:20:00,14,14,5,14,13,0,60
2024-03-18 06:30:00,13,17,10,20,13,2,75
2024-03-18 06:40:00,15,12,9,18,14,1,69
2024-03-18 06:50:00,20,20,11,22,21,2,96
2024-03-18 07:00:00,20,19,5,20,18,8,90
2024-03-18 07:10:00,21,23,18,25,20,7,114
2024-03-18 07:20:00,40,28,19,17,19,8,131
2024-03-18 07:30:00,44,36,17,33,24,11,165
2024-03-18 07:40:00,37,29,19,37,24,9,155
2024-03-18 07:50:00,38,28,13,42,28,10,159
2024-03-18 08:00:00,33,29,18,35,28,7,150
2024-03-18 08:10:00,38,27,19,25,22,8,139
2024-03-18 08:20:00,28,28,19,38,38,11,162
2024-03-18 08:30:00,37,34,18,35,21,11,156
2024-03-18 08:40:00,34,26,20,33,23,5,141
2024-03-18 08:50:00,32,23,19,37,19,11,141
2024-03-18 09:00:00,35,29,11,31,20,6,132
2024-03-18 09:10:00,45,29,18,34,20,9,155
2024-03-18 09:20:00,23,18,22,21,18,9,111
2024-03-18 09:30:00,41,38,26,27,20,7,159
2024-03-18 09:40:00,33,28,19,32,19,3,134
2024-03-18 09:50:00,36,30,27,27,19,8,147
2024-03-18 10:00:00,44,34,19,25,20,6,148
2024-03-18 10:10:00,29,20,24,36,20,13,142
2024-03-18 10:20:00,24,20,23,30,18,8,123
2024-03-18 10:30:00,37,36,26,40,24,12,175
2024-03-18 10:40:00,40,30,21,33,20,14,158
2024-03-18 10:50:00,28,24,14,34,19,7,126
2024-03-18 11:00:00,27,26,23,33,22,6,137
2024-03-18 11:10:00,31,25,16,39,25,4,140
2024-03-18 11:20:00,30,26,18,34,19,10,137
2024-03-18 11:30:00,29,27,19,32,27,7,141
2024-03-18 11:40:00,28,25,23,36,20,16,148
2024-03-18 11:50:00,34,24,25,42,29,3,157
2024-03-18 12:00:00,35,29,19,34,13,6,136
2024-03-18 12:10:00,31,24,25,26,18,9,133
2024-03-18 12:20:00,41,34,19,25,34,9,162
2024-03-18 12:30:00,27,24,28,25,17,11,132
2024-03-18 12:40:00,41,37,11,22,16,14,141
2024-03-18 12:50:00,34,27,18,31,27,8,145
2024-03-18 13:00:00,27,27,20,37,21,6,138
2024-03-18 13:10:00,37,26,19,47,26,10,165
2024-03-18 13:20:00,38,31,21,36,18,7,151
2024-03-18 13:30:00,32,28,24,27,14,6,131
2024-03-18 13:40:00,39,29,19,34,16,6,143
2024-03-18 13:50:00,43,31,17,34,18,3,146
2024-03-18 14:00:00,39,34,19,33,23,5,153
2024-03-18 14:10:00,29,23,23,35,15,10,135
2024-03-18 14:20:00,34,30,24,34,23,9,154
2024-03-18 14:30:00,33,26,19,26,12,10,126
2024-03-18 14:40:00,30,28,24,45,24,7,158
2024-03-18 14:50:00,48,32,21,26,24,5,156
2024-03-18 15:00:00,39,23,29,54,25,8,178
2024-03-18 15:10:00,42,26,18,52,27,10,175
2024-03-18 15:20:00,34,23,17,39,24,8,145
2024-03-18 15:30:00,32,24,16,40,19,10,141
2024-03-18 15:40:00,32,22,20,29,18,9,130
2024-03-18 15:50:00,38,33,26,44,26,16,183
2024-03-18 16:00:00,34,29,24,47,23,11,168
2024-03-18 16:10:00,42,30,21,49,26,9,177
2024-03-18 16:20:00,51,32,12,38,18,8,159
2024-03-18 16:30:00,48,36,27,40,22,16,189
2024-03-18 16:40:00,34,23,22,28,20,12,139
2024-03-18 16:50:00,56,22,24,44,27,12,185
2024-03-18 17:00:00,42,25,23,58,35,8,191
2024-03-18 17:10:00,32,23,16,53,24,3,151
2024-03-18 17:20:00,43,27,15,29,20,6,140
2024-03-18 17:30:00,35,27,15,48,19,5,149
2024-03-18 17:40:00,43,24,24,43,18,5,157
2024-03-18 17:50:00,38,23,26,35,10,4,136
2024-03-18 18:00:00,41,24,17,30,11,14,137
2024-03-18 18:10:00,41,31,25,42,23,9,171
2024-03-18 18:20:00,40,27,17,32,20,6,142
2024-03-18 18:30:00,38,26,21,39,15,8,147
2024-03-18 18:40:00,32,26,24,21,21,7,131
2024-03-18 18:50:00,29,23,19,29,19,9,128
2024-03-18 19:00:00,33,14,15,19,11,10,102
2024-03-18 19:10:00,23,13,17,32,24,6,115
2024-03-18 19:20:00,34,23,14,30,23,4,128
2024-03-18 19:30:00,28,16,16,20,14,14,108
2024-03-18 19:40:00,18,18,21,17,10,10,94
2024-03-18 19:50:00,19,11,19,22,17,4,92
2024-03-18 20:00:00,28,31,15,14,13,3,104
2024-03-18 20:10:00,15,12,11,26,17,4,85
2024-03-18 20:20:00,17,12,13,18,12,6,78
2024-03-18 20:30:00,14,11,8,15,10,1,59
2024-03-18 20:40:00,10,12,11,16,13,1,63
2024-03-18 20:50:00,13,11,10,13,13,5,65
2024-03-18 21:00:00,13,12,7,18,12,7,69
2024-03-18 21:10:00,6,7,12,14,12,1,52
2024-03-18 21:20:00,9,9,5,23,19,1,66
2024-03-18 21:30:00,11,8,11,16,15,3,64
2024-03-18 21:40:00,13,8,6,16,11,3,57
2024-03-18 21:50:00,11,13,4,11,7,1,47
2024-03-18 22:00:00,8,8,10,10,10,1,47
2024-03-18 22:10:00,10,9,17,12,12,2,62
2024-03-18 22:20:00,11,7,9,17,15,1,60
2024-03-18 22:30:00,9,8,4,10,7,0,38
2024-03-18 22:40:00,6,6,3,9,8,1,33
2024-03-18 22:50:00,9,8,4,13,12,0,46
2024-03-18 23:00:00,5,6,1,5,5,0,22
2024-03-18 23:10:00,6,5,0,8,6,1,26
2024-03-18 23:20:00,5,5,0,4,4,1,19
2024-03-18 23:30:00,5,6,2,13,11,1,38
2024-03-18 23:40:00,2,1,2,6,5,0,16
2024-03-18 23:50:00,4,3,0,9,7,0,23
2024-03-19 00:00:00,3,3,1,4,2,0,13
2024-03-19 00:10:00,5,4,0,7,6,0,22
2024-03-19 00:20:00,5,4,1,6,3,0,19
2024-03-19 00:30:00,2,2,0,5,7,0,16
2024-03-19 00:40:00,3,3,0,1,2,0,9
2024-03-19 00:50:00,1,1,0,1,0,0,3
2024-03-19 01:00:00,2,3,1,6,8,1,21
2024-03-19 01:10:00,6,6,1,2,2,0,17
2024-03-19 01:20:00,1,1,0,1,1,0,4
2024-03-19 01:30:00,1,1,0,2,2,0,6
2024-03-19 01:40:00,1,1,0,1,1,0,4
2024-03-19 01:50:00,0,0,1,1,1,0,3
2024-03-19 02:00:00,0,0,0,0,0,0,0
2024-03-19 02:10:00,0,0,0,0,0,0,0
2024-03-19 02:20:00,1,0,0,2,2,0,5
2024-03-19 02:30:00,0,0,0,0,1,0,1
2024-03-19 02:40:00,1,1,1,1,0,0,4
2024-03-19 02:50:00,0,0,0,4,3,0,7
2024-03-19 03:00:00,3,3,1,1,0,0,8
2024-03-19 03:10:00,2,2,2,1,1,0,8
2024-03-19 03:20:00,0,0,0,4,4,0,8
2024-03-19 03:30:00,0,2,2,1,1,0,6
2024-03-19 03:40:00,3,3,0,3,3,3,15
2024-03-19 03:50:00,0,0,0,2,2,1,5
2024-03-19 04:00:00,1,1,1,1,1,0,5
2024-03-19 04:10:00,0,0,0,1,1,1,3
2024-03-19 04:20:00,0,4,0,2,3,0,9
2024-03-19 04:30:00,2,2,0,3,3,0,10
2024-03-19 04:40:00,6,6,0,0,1,2,15
2024-03-19 04:50:00,5,4,6,4,4,0,23
2024-03-19 05:00:00,5,5,5,3,4,0,22
2024-03-19 05:10:00,9,8,2,5,11,0,35
2024-03-19 05:20:00,3,2,1,5,5,3,19
2024-03-19 05:30:00,7,5,10,8,11,1,42
2024-03-19 05:40:00,8,6,11,9,10,4,48
2024-03-19 05:50:00,9,12,5,5,6,0,37
2024-03-19 06:00:00,9,10,11,16,15,3,64
2024-03-19 06:10:00,9,10,9,17,15,1,61
2024-03-19 06:20:00,15,11,9,7,8,1,51
2024-03-19 06:30:00,20,22,10,19,14,3,88
2024-03-19 06:40:00,22,19,10,16,18,2,87
2024-03-19 06:50:00,14,14,49,23,20,4,124
2024-03-19 07:00:00,21,18,10,17,19,0,85
2024-03-19 07:10:00,16,16,15,20,20,7,94
2024-03-19 07:20:00,45,33,14,21,20,4,137
2024-03-19 07:30:00,39,22,15,27,14,8,125
2024-03-19 07:40:00,29,27,16,41,31,7,151
2024-03-19 07:50:00,38,32,17,40,27,6,160
2024-03-19 08:00:00,36,20,18,27,19,4,124
2024-03-19 08:10:00,37,37,23,40,31,9,177
2024-03-19 08:20:00,32,29,16,33,29,10,149
2024-03-19 08:30:00,40,33,17,29,18,11,148
2024-03-19 08:40:00,30,27,20,23,28,7,135
2024-03-19 08:50:00,50,27,18,30,24,7,156
2024-03-19 09:00:00,33,27,21,32,22,5,140
2024-03-19 09:10:00,37,23,19,29,22,8,138
2024-03-19 09:20:00,36,31,18,33,23,9,150
2024-03-19 09:30:00,38,28,14,25,20,6,131
2024-03-19 09:40:00,31,29,18,30,24,4,136
2024-03-19 09:50:00,39,26,15,34,19,11,144
2024-03-19 10:00:00,41,35,16,23,19,8,142
2024-03-19 10:10:00,31,21,28,33,18,9,140
2024-03-19 10:20:00,32,26,21,27,22,7,135
2024-03-19 10:30:00,41,38,22,21,16,10,148
2024-03-19 10:40:00,26,23,21,38,28,8,144
2024-03-19 10:50:00,29,24,22,33,23,14,145
2024-03-19 11:00:00,30,23,23,27,19,12,134
2024-03-19 11:10:00,43,25,16,28,14,7,133
2024-03-19 11:20:00,22,26,25,31,17,5,126
2024-03-19 11:30:00,32,28,15,22,20,15,132
2024-03-19 11:40:00,27,22,21,34,14,3,121
2024-03-19 11:50:00,33,33,19,32,24,7,148
2024-03-19 12:00:00,28,26,19,32,29,11,145
2024-03-19 12:10:00,34,30,21,29,23,3,140
2024-03-19 12:20:00,40,37,14,30,18,8,147
2024-03-19 12:30:00,31,22,21,33,24,5,136
2024-03-19 12:40:00,23,25,22,17,17,6,110
2024-03-19 12:50:00,30,24,17,37,21,5,134
2024-03-19 13:00:00,34,30,24,25,19,5,137
2024-03-19 13:10:00,36,25,24,38,30,13,166
2024-03-19 13:20:00,30,27,23,21,17,5,123
2024-03-19 13:30:00,28,22,26,19,16,12,123
2024-03-19 13:40:00,30,20,21,36,18,7,132
2024-03-19 13:50:00,28,21,18,28,19,8,122
2024-03-19 14:00:00,26,21,17,25,20,8,117
2024-03-19 14:10:00,29,23,25,27,20,12,136
2024-03-19 14:20:00,39,32,22,34,24,8,159
2024-03-19 14:30:00,44,33,21,37,19,9,163
2024-03-19 14:40:00,44,25,17,37,18,8,149
2024-03-19 14:50:00,38,22,26,31,19,4,140
2024-03-19 15:00:00,39,30,19,38,22,7,155
2024-03-19 15:10:00,48,40,19,40,26,10,183
2024-03-19 15:20:00,48,33,21,39,30,12,183
2024-03-19 15:30:00,34,29,21,38,20,7,149
2024-03-19 15:40:00,42,26,27,26,14,12,147
2024-03-19 15:50:00,46,32,28,36,18,14,174
2024-03-19 16:00:00,34,34,22,46,19,8,163
2024-03-19 16:10:00,45,32,21,40,26,11,175
2024-03-19 16:20:00,37,27,21,37,21,9,152
2024-03-19 16:30:00,56,43,24,38,26,14,201
2024-03-19 16:40:00,31,27,14,32,16,14,134
2024-03-19 16:50:00,43,39,19,49,17,18,185
2024-03-19 17:00:00,53,36,24,40,24,4,181
2024-03-19 17:10:00,47,37,22,34,18,11,169
2024-03-19 17:20:00,40,33,15,37,23,7,155
2024-03-19 17:30:00,49,35,20,43,21,8,176
2024-03-19 17:40:00,41,27,17,38,25,10,158
2024-03-19 17:50:00,51,36,24,48,20,6,185
2024-03-19 18:00:00,41,27,18,46,21,4,157
2024-03-19 18:10:00,49,79,14,43,27,4,216
2024-03-19 18:20:00,33,30,18,35,21,12,149
2024-03-19 18:30:00,38,39,21,33,20,10,161
2024-03-19 18:40:00,28,24,36,43,23,7,161
2024-03-19 18:50:00,36,27,16,45,18,14,156
2024-03-19 19:00:00,29,30,15,29,18,4,125
2024-03-19 19:10:00,34,25,21,29,17,11,137
2024-03-19 19:20:00,25,22,12,25,20,5,109
2024-03-19 19:30:00,38,30,18,31,16,0,133
2024-03-19 19:40:00,21,12,12,13,9,7,74
2024-03-19 19:50:00,32,21,13,19,13,6,104
2024-03-19 20:00:00,20,16,17,25,13,4,95
2024-03-19 20:10:00,16,17,21,20,21,13,108
2024-03-19 20:20:00,15,11,16,19,12,0,73
2024-03-19 20:30:00,17,13,17,19,14,4,84
2024-03-19 20:40:00,14,11,9,10,13,4,61
2024-03-19 20:50:00,20,10,5,12,10,0,57
2024-03-19 21:00:00,12,7,8,20,18,0,65
2024-03-19 21:10:00,4,3,6,16,14,1,44
2024-03-19 21:20:00,10,8,5,16,15,5,59
2024-03-19 21:30:00,14,11,10,26,20,2,83
2024-03-19 21:40:00,6,5,7,17,14,3,52
2024-03-19 21:50:00,6,5,4,17,14,1,47
2024-03-19 22:00:00,14,8,5,9,8,5,49
2024-03-19 22:10:00,7,7,6,20,17,1,58
2024-03-19 22:20:00,8,6,3,6,8,0,31
2024-03-19 22:30:00,8,8,0,18,8,2,44
2024-03-19 22:40:00,4,3,6,9,7,0,29
2024-03-19 22:50:00,3,2,3,7,4,0,19
2024-03-19 23:00:00,3,3,2,10,8,0,26
2024-03-19 23:10:00,4,3,3,11,8,0,29
2024-03-19 23:20:00,4,3,6,6,6,0,25
2024-03-19 23:30:00,8,6,0,4,6,0,24
2024-03-19 23:40:00,4,5,1,3,2,0,15
2024-03-19 23:50:00,5,6,2,3,4,1,21
2024-03-20 00:00:00,2,2,2,4,3,0,13
2024-03-20 00:10:00,0,3,1,1,1,0,6
2024-03-20 00:20:00,3,3,2,3,2,2,15
2024-03-20 00:30:00,4,3,0,4,3,0,14
2024-03-20 00:40:00,2,2,1,5,5,0,15
2024-03-20 00:50:00,1,1,0,1,0,0,3
2024-03-20 01:00:00,3,4,5,3,2,0,17
2024-03-20 01:10:00,3,3,1,3,3,0,13
2024-03-20 01:20:00,1,1,0,2,2,2,8
2024-03-20 01:30:00,0,0,0,1,2,0,3
2024-03-20 01:40:00,1,1,0,2,2,0,6
2024-03-20 01:50:00,3,2,0,1,0,0,6
2024-03-20 02:00:00,0,0,2,3,4,0,9
2024-03-20 02:10:00,2,1,1,0,0,0,4
2024-03-20 02:20:00,1,1,0,1,1,0,4
2024-03-20 02:30:00,2,2,1,0,1,0,6
2024-03-20 02:40:00,0,0,0,3,1,0,4
2024-03-20 02:50:00,0,0,1,1,1,1,4
2024-03-20 03:00:00,1,0,0,1,0,0,2
2024-03-20 03:10:00,0,0,0,3,2,0,5
2024-03-20 03:20:00,0,0,1,2,2,0,5
2024-03-20 03:30:00,1,2,0,0,0,0,3
2024-03-20 03:40:00,0,3,1,3,3,0,10
2024-03-20 03:50:00,0,0,0,0,0,0,0
2024-03-20 04:00:00,2,2,0,2,2,0,8
2024-03-20 04:10:00,1,2,0,1,1,1,6
2024-03-20 04:20:00,2,1,0,4,4,0,11
2024-03-20 04:30:00,4,4,0,1,5,3,17
2024-03-20 04:40:00,1,1,0,2,3,0,7
2024-03-20 04:50:00,4,5,4,4,3,0,20
2024-03-20 05:00:00,6,5,3,2,2,0,18
2024-03-20 05:10:00,5,5,2,7,6,0,25
2024-03-20 05:20:00,8,7,2,6,7,0,30
2024-03-20 05:30:00,7,8,10,12,7,1,45
2024-03-20 05:40:00,10,11,7,8,8,2,46
2024-03-20 05:50:00,10,12,7,16,13,2,60
2024-03-20 06:00:00,9,12,5,9,9,1,45
2024-03-20 06:10:00,12,11,8,7,4,3,45
2024-03-20 06:20:00,12,13,10,18,17,0,70
2024-03-20 06:30:00,22,19,14,18,13,2,88
2024-03-20 06:40:00,16,14,11,14,14,2,71
2024-03-20 06:50:00,26,18,10,28,20,2,104
2024-03-20 07:00:00,17,19,13,33,18,2,102
2024-03-20 07:10:00,15,16,11,21,14,4,81
2024-03-20 07:20:00,0,0,19,0,0,9,28
2024-03-20 07:30:00,0,0,17,0,0,9,26
2024-03-20 07:40:00,0,0,14,0,0,7,21
2024-03-20 07:50:00,4,3,12,7,6,11,43
2024-03-20 08:00:00,39,29,19,30,22,10,149
2024-03-20 08:10:00,41,32,13,20,22,5,133
2024-03-20 08:20:00,34,26,15,32,20,12,139
2024-03-20 08:30:00,44,33,20,40,19,8,164
2024-03-20 08:40:00,32,26,13,34,21,9,135
2024-03-20 08:50:00,45,28,18,32,22,10,155
2024-03-20 09:00:00,42,41,14,28,13,5,143
2024-03-20 09:10:00,41,35,23,30,23,7,159
2024-03-20 09:20:00,35,35,9,28,18,4,129
2024-03-20 09:30:00,32,21,16,34,18,5,126
2024-03-20 09:40:00,48,37,16,43,26,16,186
2024-03-20 09:50:00,28,24,15,28,19,10,124
2024-03-20 10:00:00,31,27,24,42,28,6,158
2024-03-20 10:10:00,29,35,36,26,15,11,152
2024-03-20 10:20:00,30,24,18,26,17,4,119
2024-03-20 10:30:00,23,22,16,31,19,0,111
2024-03-20 10:40:00,37,25,25,26,19,14,146
2024-03-20 10:50:00,29,29,19,41,22,17,157
2024-03-20 11:00:00,33,29,26,32,22,9,151
2024-03-20 11:10:00,34,33,22,25,18,6,138
2024-03-20 11:20:00,33,25,19,26,21,6,130
2024-03-20 11:30:00,30,28,23,27,19,7,134
2024-03-20 11:40:00,35,30,26,35,21,12,159
2024-03-20 11:50:00,43,38,18,31,15,4,149
2024-03-20 12:00:00,39,29,20,31,20,9,148
2024-03-20 12:10:00,40,26,21,35,24,12,158
2024-03-20 12:20:00,34,29,21,43,25,5,157
2024-03-20 12:30:00,38,35,29,26,24,6,158
2024-03-20 12:40:00,36,40,28,37,22,3,166
2024-03-20 12:50:00,39,36,29,33,17,7,161
2024-03-20 13:00:00,30,32,18,44,27,10,161
2024-03-20 13:10:00,31,24,27,33,22,9,146
2024-03-20 13:20:00,33,31,9,37,22,6,138
2024-03-20 13:30:00,48,37,15,30,23,7,160
2024-03-20 13:40:00,27,19,21,45,25,5,142
2024-03-20 13:50:00,30,35,20,26,25,6,142
2024-03-20 14:00:00,46,29,29,33,21,8,166
2024-03-20 14:10:00,39,29,18,32,20,8,146
2024-03-20 14:20:00,33,32,27,32,19,8,151
2024-03-20 14:30:00,49,36,22,28,16,13,164
2024-03-20 14:40:00,37,33,23,33,29,3,158
2024-03-20 14:50:00,31,31,28,29,19,6,144
2024-03-20 15:00:00,41,28,19,44,22,6,160
2024-03-20 15:10:00,43,30,29,40,26,9,177
2024-03-20 15:20:00,39,38,23,44,24,4,172
2024-03-20 15:30:00,37,32,22,36,19,9,155
2024-03-20 15:40:00,46,32,18,50,25,17,188
2024-03-20 15:50:00,44,35,16,34,17,11,157
2024-03-20 16:00:00,43,32,29,47,25,0,176
2024-03-20 16:10:00,46,48,19,45,20,16,194
2024-03-20 16:20:00,36,30,19,32,32,9,158
2024-03-20 16:30:00,40,36,25,41,21,8,171
2024-03-20 16:40:00,36,26,19,42,30,12,165
2024-03-20 16:50:00,48,33,29,45,26,13,194
2024-03-20 17:00:00,51,22,29,45,18,8,173
2024-03-20 17:10:00,45,25,20,45,19,13,167
2024-03-20 17:20:00,39,22,22,29,23,12,147
2024-03-20 17:30:00,45,31,22,35,16,12,161
2024-03-20 17:40:00,36,29,18,45,29,11,168
2024-03-20 17:50:00,52,35,15,49,19,12,182
2024-03-20 18:00:00,45,34,11,41,26,10,167
2024-03-20 18:10:00,56,35,19,35,19,18,182
2024-03-20 18:20:00,41,24,26,47,27,5,170
2024-03-20 18:30:00,40,21,9,29,22,8,129
2024-03-20 18:40:00,35,32,17,32,25,5,146
2024-03-20 18:50:00,35,25,18,22,15,8,123
2024-03-20 19:00:00,30,16,19,26,15,3,109
2024-03-20 19:10:00,32,22,14,27,21,4,120
2024-03-20 19:20:00,24,19,19,21,17,5,105
2024-03-20 19:30:00,27,23,17,25,21,6,119
2024-03-20 19:40:00,28,24,9,18,10,2,91
2024-03-20 19:50:00,23,22,37,27,18,10,137
2024-03-20 20:00:00,16,15,26,25,21,2,105
2024-03-20 20:10:00,16,24,13,27,24,3,107
2024-03-20 20:20:00,22,13,10,17,18,1,81
2024-03-20 20:30:00,16,13,16,25,19,4,93
2024-03-20 20:40:00,21,17,12,21,16,0,87
2024-03-20 20:50:00,12,10,6,15,16,1,60
2024-03-20 21:00:00,17,16,12,17,15,2,79
2024-03-20 21:10:00,9,5,11,25,17,0,67
2024-03-20 21:20:00,15,11,3,21,15,2,67
2024-03-20 21:30:00,26,17,16,23,16,0,98
2024-03-20 21:40:00,17,19,10,14,17,1,78
2024-03-20 21:50:00,6,5,7,20,18,1,57
2024-03-20 22:00:00,7,6,5,17,11,0,46
2024-03-20 22:10:00,8,5,5,10,10,0,38
2024-03-20 22:20:00,7,8,5,15,13,2,50
2024-03-20 22:30:00,7,6,5,14,12,1,45
2024-03-20 22:40:00,8,8,2,13,14,0,45
2024-03-20 22:50:00,8,8,4,13,11,1,45
2024-03-20 23:00:00,7,7,4,6,8,0,32
2024-03-20 23:10:00,8,9,7,10,6,0,40
2024-03-20 23:20:00,6,6,4,10,10,0,36
2024-03-20 23:30:00,8,6,0,5,4,2,25
2024-03-20 23:40:00,2,2,0,4,5,0,13
2024-03-20 23:50:00,1,5,1,3,5,2,17
2024-03-21 00:00:00,5,6,4,6,5,0,26
2024-03-21 00:10:00,6,5,1,4,3,1,20
2024-03-21 00:20:00,2,2,0,2,2,0,8
2024-03-21 00:30:00,3,2,0,6,5,0,16
2024-03-21 00:40:00,6,7,2,6,5,0,26
2024-03-21 00:50:00,2,3,1,3,3,0,12
2024-03-21 01:00:00,2,2,0,0,0,0,4
2024-03-21 01:10:00,2,2,0,4,5,0,13
2024-03-21 01:20:00,0,0,0,3,2,0,5
2024-03-21 01:30:00,3,2,0,2,2,0,9
2024-03-21 01:40:00,1,1,2,2,1,0,7
2024-03-21 01:50:00,0,0,0,1,0,0,1
2024-03-21 02:00:00,1,1,0,2,1,0,5
2024-03-21 02:10:00,3,2,0,1,2,0,8
2024-03-21 02:20:00,1,1,0,2,2,0,6
2024-03-21 02:30:00,0,0,1,0,0,0,1
2024-03-21 02:40:00,1,1,0,4,3,0,9
2024-03-21 02:50:00,1,1,0,1,1,0,4
2024-03-21 03:00:00,1,1,0,0,0,0,2
2024-03-21 03:10:00,0,0,1,3,3,2,9
2024-03-21 03:20:00,0,0,0,5,3,0,8
2024-03-21 03:30:00,0,1,0,1,0,0,2
2024-03-21 03:40:00,0,0,0,2,4,0,6
2024-03-21 03:50:00,1,1,1,1,1,0,5
2024-03-21 04:00:00,1,2,0,1,1,0,5
2024-03-21 04:10:00,1,1,0,1,3,0,6
2024-03-21 04:20:00,3,4,1,2,4,0,14
2024-03-21 04:30:00,1,1,2,1,2,1,8
2024-03-21 04:40:00,3,3,5,0,0,0,11
2024-03-21 04:50:00,4,4,1,4,5,0,18
2024-03-21 05:00:00,7,9,4,3,6,2,31
2024-03-21 05:10:00,4,4,4,6,7,5,30
2024-03-21 05:20:00,6,7,4,4,6,0,27
2024-03-21 05:30:00,7,7,6,6,8,0,34
2024-03-21 05:40:00,7,6,8,7,8,0,36
2024-03-21 05:50:00,10,12,11,6,5,2,46
2024-03-21 06:00:00,8,11,8,13,15,2,57
2024-03-21 06:10:00,13,10,9,10,7,1,50
2024-03-21 06:20:00,12,15,7,17,13,2,66
2024-03-21 06:30:00,20,21,15,16,16,1,89
2024-03-21 06:40:00,20,20,8,10,12,1,71
2024-03-21 06:50:00,23,20,10,34,24,3,114
2024-03-21 07:00:00,23,22,11,25,19,3,103
2024-03-21 07:10:00,21,22,9,32,24,2,110
2024-03-21 07:20:00,45,39,19,22,19,2,146
2024-03-21 07:30:00,37,30,19,23,13,4,126
2024-03-21 07:40:00,41,34,16,30,19,11,151
2024-03-21 07:50:00,45,32,23,33,26,5,164
2024-03-21 08:00:00,42,28,18,30,25,9,152
2024-03-21 08:10:00,31,37,12,25,18,11,134
2024-03-21 08:20:00,36,28,20,42,23,10,159
2024-03-21 08:30:00,37,26,12,32,28,8,143
2024-03-21 08:40:00,31,30,20,23,28,4,136
2024-03-21 08:50:00,42,32,22,29,25,9,159
2024-03-21 09:00:00,33,25,24,27,22,7,138
2024-03-21 09:10:00,25,27,15,35,20,11,133
2024-03-21 09:20:00,38,39,24,23,27,6,157
2024-03-21 09:30:00,37,36,18,29,19,8,147
2024-03-21 09:40:00,37,32,14,33,49,10,175
2024-03-21 09:50:00,35,31,16,29,24,10,145
2024-03-21 10:00:00,33,31,18,34,20,8,144
2024-03-21 10:10:00,31,30,22,28,21,13,145
2024-03-21 10:20:00,36,27,20,16,14,13,126
2024-03-21 10:30:00,42,36,23,26,23,6,156
2024-03-21 10:40:00,35,32,16,25,14,9,131
2024-03-21 10:50:00,32,28,28,33,24,14,159
2024-03-21 11:00:00,35,29,18,39,14,5,140
2024-03-21 11:10:00,36,31,16,28,19,9,139
2024-03-21 11:20:00,37,25,17,30,17,2,128
2024-03-21 11:30:00,29,26,11,37,19,5,127
2024-03-21 11:40:00,35,32,21,39,15,13,155
2024-03-21 11:50:00,42,38,22,24,21,14,161
2024-03-21 12:00:00,39,26,26,33,22,7,153
2024-03-21 12:10:00,36,28,21,34,21,12,152
2024-03-21 12:20:00,30,28,24,37,17,11,147
2024-03-21 12:30:00,21,15,19,23,35,14,127
2024-03-21 12:40:00,33,27,19,40,21,6,146
2024-03-21 12:50:00,32,37,21,34,23,10,157
2024-03-21 13:00:00,34,24,24,28,17,10,137
2024-03-21 13:10:00,47,20,17,44,19,6,153
2024-03-21 13:20:00,41,32,24,38,21,5,161
2024-03-21 13:30:00,32,23,26,35,20,9,145
2024-03-21 13:40:00,32,33,20,24,22,11,142
2024-03-21 13:50:00,28,22,17,35,24,12,138
2024-03-21 14:00:00,29,29,19,28,14,12,131
2024-03-21 14:10:00,36,30,27,34,30,11,168
2024-03-21 14:20:00,38,27,25,32,20,16,158
2024-03-21 14:30:00,33,30,20,30,11,6,130
2024-03-21 14:40:00,44,34,20,43,27,11,179
2024-03-21 14:50:00,40,29,24,43,17,9,162
2024-03-21 15:00:00,44,29,20,37,26,9,165
2024-03-21 15:10:00,38,35,18,38,22,12,163
2024-03-21 15:20:00,25,24,15,38,17,5,124
2024-03-21 15:30:00,31,27,21,38,20,9,146
2024-03-21 15:40:00,41,31,25,44,22,22,185
2024-03-21 15:50:00,39,32,28,36,22,11,168
2024-03-21 16:00:00,44,44,14,34,21,16,173
2024-03-21 16:10:00,42,31,19,44,27,13,176
2024-03-21 16:20:00,42,29,12,36,33,6,158
2024-03-21 16:30:00,49,22,20,39,8,9,147
2024-03-21 16:40:00,44,15,30,42,23,14,168
2024-03-21 16:50:00,42,37,21,51,36,10,197
2024-03-21 17:00:00,49,26,21,32,13,8,149
2024-03-21 17:10:00,49,38,31,53,32,9,212
2024-03-21 17:20:00,48,32,19,42,21,12,174
2024-03-21 17:30:00,45,35,20,34,18,2,154
2024-03-21 17:40:00,55,39,26,46,16,6,188
2024-03-21 17:50:00,52,32,26,46,26,3,185
2024-03-21 18:00:00,41,30,19,32,30,9,161
2024-03-21 18:10:00,42,32,20,35,24,6,159
2024-03-21 18:20:00,42,34,24,38,21,8,167
2024-03-21 18:30:00,33,27,26,36,18,3,143
2024-03-21 18:40:00,40,34,24,38,23,14,173
2024-03-21 18:50:00,37,19,23,33,20,8,140
2024-03-21 19:00:00,29,24,14,27,21,11,126
2024-03-21 19:10:00,41,24,39,29,25,8,166
2024-03-21 19:20:00,32,22,16,29,24,4,127
2024-03-21 19:30:00,35,26,17,24,14,2,118
2024-03-21 19:40:00,29,21,12,33,23,8,126
2024-03-21 19:50:00,25,25,13,33,24,6,126
2024-03-21 20:00:00,28,28,10,28,18,3,115
2024-03-21 20:10:00,22,22,8,19,10,3,84
2024-03-21 20:20:00,23,18,13,20,20,4,98
2024-03-21 20:30:00,13,14,10,13,9,3,62
2024-03-21 20:40:00,11,19,10,17,16,1,74
2024-03-21 20:50:00,13,18,11,18,18,1,79
2024-03-21 21:00:00,13,12,10,22,15,0,72
2024-03-21 21:10:00,15,10,17,23,17,0,82
2024-03-21 21:20:00,14,20,10,8,8,1,61
2024-03-21 21:30:00,17,13,9,17,17,2,75
2024-03-21 21:40:00,19,15,7,17,14,5,77
2024-03-21 21:50:00,9,6,10,19,15,0,59
2024-03-21 22:00:00,11,11,5,11,11,1,50
2024-03-21 22:10:00,9,8,3,16,11,1,48
2024-03-21 22:20:00,7,6,9,13,10,1,46
2024-03-21 22:30:00,10,9,0,13,12,3,47
2024-03-21 22:40:00,7,7,1,17,13,0,45
2024-03-21 22:50:00,6,7,2,8,5,2,30
2024-03-21 23:00:00,6,5,0,13,9,0,33
2024-03-21 23:10:00,9,8,1,5,4,0,27
2024-03-21 23:20:00,4,5,1,6,7,1,24
2024-03-21 23:30:00,6,5,6,5,6,0,28
2024-03-21 23:40:00,7,8,4,3,3,0,25
2024-03-21 23:50:00,7,6,3,6,6,0,28
2024-03-22 00:00:00,2,2,3,5,4,1,17
2024-03-22 00:10:00,2,3,4,5,7,0,21
2024-03-22 00:20:00,0,0,3,5,5,0,13
2024-03-22 00:30:00,2,2,0,4,5,0,13
2024-03-22 00:40:00,4,4,2,2,2,0,14
2024-03-22 00:50:00,1,2,0,1,1,0,5
2024-03-22 01:00:00,5,6,0,2,3,0,16
2024-03-22 01:10:00,2,2,1,1,2,0,8
2024-03-22 01:20:00,0,0,1,0,0,2,3
2024-03-22 01:30:00,1,1,1,1,1,0,5
2024-03-22 01:40:00,1,1,1,2,2,0,7
2024-03-22 01:50:00,0,0,0,2,1,0,3
2024-03-22 02:00:00,1,1,0,3,2,0,7
2024-03-22 02:10:00,1,1,1,3,4,0,10
2024-03-22 02:20:00,1,1,1,0,1,0,4
2024-03-22 02:30:00,0,0,0,3,2,0,5
2024-03-22 02:40:00,0,0,0,0,0,0,0
2024-03-22 02:50:00,2,2,0,1,1,0,6
2024-03-22 03:00:00,0,0,1,4,5,1,11
2024-03-22 03:10:00,4,5,0,3,3,0,15
2024-03-22 03:20:00,1,1,2,3,3,0,10
2024-03-22 03:30:00,1,1,0,1,1,0,4
2024-03-22 03:40:00,0,0,0,0,0,0,0
2024-03-22 03:50:00,0,0,0,0,0,0,0
2024-03-22 04:00:00,0,0,0,0,0,0,0
2024-03-22 04:10:00,0,0,0,0,0,0,0
2024-03-22 04:20:00,0,0,0,0,0,0,0
2024-03-22 04:30:00,0,0,1,0,0,1,2
2024-03-22 04:40:00,0,0,2,0,0,4,6
2024-03-22 04:50:00,0,0,4,0,0,1,5
2024-03-22 05:00:00,0,0,2,0,0,0,2
2024-03-22 05:10:00,0,0,3,0,0,0,3
2024-03-22 05:20:00,0,0,1,0,0,0,1
2024-03-22 05:30:00,5,7,13,6,7,0,38
2024-03-22 05:40:00,7,8,9,8,6,1,39
2024-03-22 05:50:00,0,0,10,0,0,5,15
2024-03-22 06:00:00,0,0,5,0,0,1,6
2024-03-22 06:10:00,0,0,5,0,0,2,7
2024-03-22 06:20:00,0,0,10,0,0,1,11
2024-03-22 06:30:00,0,0,12,0,0,3,15
2024-03-22 06:40:00,0,0,14,0,0,0,14
2024-03-22 06:50:00,0,0,11,0,0,3,14
2024-03-22 07:00:00,0,0,10,0,0,4,14
2024-03-22 07:10:00,0,0,14,0,0,8,22
2024-03-22 07:20:00,0,0,14,0,0,7,21
2024-03-22 07:30:00,0,0,14,0,0,8,22
2024-03-22 07:40:00,0,0,18,0,0,13,31
2024-03-22 07:50:00,0,0,14,0,0,20,34
2024-03-22 08:00:00,0,0,14,0,0,0,14
2024-03-22 08:10:00,0,0,26,0,0,0,26
2024-03-22 08:20:00,0,0,26,0,0,0,26
2024-03-22 08:30:00,0,0,14,0,0,5,19
2024-03-22 08:40:00,0,0,10,0,0,12,22
2024-03-22 08:50:00,0,0,25,0,0,16,41
2024-03-22 09:00:00,0,0,21,0,0,9,30
2024-03-22 09:10:00,0,0,14,0,0,17,31
2024-03-22 09:20:00,0,0,25,0,0,1,26
2024-03-22 09:30:00,0,0,21,0,0,6,27
2024-03-22 09:40:00,0,0,29,0,0,13,42
2024-03-22 09:50:00,0,0,26,0,0,3,29
2024-03-22 10:00:00,0,0,13,0,0,0,13
2024-03-22 10:10:00,0,0,25,0,0,5,30
2024-03-22 10:20:00,0,0,33,0,0,0,33
2024-03-22 10:30:00,0,0,21,0,0,8,29
2024-03-22 10:40:00,0,0,21,0,0,8,29
2024-03-22 10:50:00,0,0,12,0,0,0,12
2024-03-22 11:00:00,0,0,17,0,0,0,17
2024-03-22 11:10:00,0,0,24,0,0,0,24
2024-03-22 11:20:00,0,0,20,0,0,10,30
2024-03-22 11:30:00,0,0,14,0,0,1,15
2024-03-22 11:40:00,0,0,27,0,0,3,30
2024-03-22 11:50:00,0,0,14,0,0,1,15
2024-03-22 12:00:00,0,0,15,0,0,0,15
2024-03-22 12:10:00,0,0,19,0,0,0,19
2024-03-22 12:20:00,0,0,18,0,0,1,19
2024-03-22 12:30:00,0,0,22,0,0,1,23
2024-03-22 12:40:00,0,0,20,0,0,0,20
2024-03-22 12:50:00,0,0,19,0,0,3,22
2024-03-22 13:00:00,0,0,25,0,0,0,25
2024-03-22 13:10:00,0,0,13,0,0,8,21
2024-03-22 13:20:00,0,0,18,0,0,0,18
2024-03-22 13:30:00,0,0,18,0,0,6,24
2024-03-22 13:40:00,0,0,12,0,0,3,15
2024-03-22 13:50:00,0,0,26,0,0,0,26
2024-03-22 14:00:00,0,0,23,0,0,11,34
2024-03-22 14:10:00,0,0,20,0,0,6,26
2024-03-22 14:20:00,0,0,22,0,0,5,27
2024-03-22 14:30:00,0,0,22,0,0,11,33
2024-03-22 14:40:00,0,0,16,0,0,0,16
2024-03-22 14:50:00,0,0,20,0,0,2,22
2024-03-22 15:00:00,0,0,26,0,0,0,26
2024-03-22 15:10:00,0,0,19,0,0,1,20
2024-03-22 15:20:00,0,0,11,0,0,7,18
2024-03-22 15:30:00,0,0,20,0,0,24,44
2024-03-22 15:40:00,0,0,20,0,0,16,36
2024-03-22 15:50:00,0,0,8,0,0,6,14
2024-03-22 16:00:00,0,0,16,0,0,10,26
2024-03-22 16:10:00,0,0,17,0,0,7,24
2024-03-22 16:20:00,0,0,17,0,0,11,28
2024-03-22 16:30:00,0,0,13,0,0,19,32
2024-03-22 16:40:00,0,0,12,0,0,13,25
2024-03-22 16:50:00,0,0,20,0,0,2,22
2024-03-22 17:00:00,0,0,25,0,0,0,25
2024-03-22 17:10:00,0,0,28,0,0,0,28
2024-03-22 17:20:00,0,0,23,0,0,13,36
2024-03-22 17:30:00,0,0,21,0,0,0,21
2024-03-22 17:40:00,0,0,21,0,0,0,21
2024-03-22 17:50:00,0,0,19,0,0,13,32
2024-03-22 18:00:00,0,0,18,0,0,18,36
2024-03-22 18:10:00,0,0,12,0,0,0,12
2024-03-22 18:20:00,0,0,16,0,0,0,16
2024-03-22 18:30:00,0,0,8,0,0,0,8
2024-03-22 18:40:00,0,0,10,0,0,3,13
2024-03-22 18:50:00,0,0,19,0,0,0,19
2024-03-22 19:00:00,0,0,18,0,0,16,34
2024-03-22 19:10:00,0,0,19,0,0,8,27
2024-03-22 19:20:00,0,0,17,0,0,0,17
2024-03-22 19:30:00,0,0,18,0,0,0,18
2024-03-22 19:40:00,0,0,11,0,0,10,21
2024-03-22 19:50:00,0,0,10,0,0,10,20
2024-03-22 20:00:00,0,0,19,0,0,8,27
2024-03-22 20:10:00,0,0,19,0,0,10,29
2024-03-22 20:20:00,0,0,8,0,0,14,22
2024-03-22 20:30:00,0,0,14,0,0,16,30
2024-03-22 20:40:00,0,0,14,0,0,11,25
2024-03-22 20:50:00,0,0,15,0,0,0,15
2024-03-22 21:00:00,0,0,14,0,0,1,15
2024-03-22 21:10:00,0,0,7,0,0,0,7
2024-03-22 21:20:00,0,0,11,0,0,3,14
2024-03-22 21:30:00,0,0,6,0,0,1,7
2024-03-22 21:40:00,0,0,5,0,0,1,6
2024-03-22 21:50:00,0,0,6,0,0,2,8
2024-03-22 22:00:00,0,0,6,0,0,1,7
2024-03-22 22:10:00,0,0,4,0,0,1,5
2024-03-22 22:20:00,0,0,3,0,0,2,5
2024-03-22 22:30:00,0,0,9,0,0,0,9
2024-03-22 22:40:00,0,0,7,0,0,0,7
2024-03-22 22:50:00,0,0,3,0,0,0,3
2024-03-22 23:00:00,0,0,6,0,0,2,8
2024-03-22 23:10:00,0,0,2,0,0,4,6
2024-03-22 23:20:00,0,0,9,0,0,1,10
2024-03-22 23:30:00,0,0,2,0,0,0,2
2024-03-22 23:40:00,0,0,0,0,0,3,3
2024-03-22 23:50:00,0,0,1,0,0,0,1
2024-03-23 00:00:00,0,0,6,0,0,3,9
2024-03-23 00:10:00,0,0,4,0,0,2,6
2024-03-23 00:20:00,0,0,1,0,0,3,4
2024-03-23 00:30:00,0,0,1,0,0,0,1
2024-03-23 00:40:00,0,0,4,0,0,0,4
2024-03-23 00:50:00,0,0,1,0,0,0,1
2024-03-23 01:00:00,0,0,1,0,0,0,1
2024-03-23 01:10:00,0,0,1,0,0,1,2
2024-03-23 01:20:00,0,0,2,0,0,1,3
2024-03-23 01:30:00,0,0,2,0,0,3,5
2024-03-23 01:40:00,0,0,0,0,0,2,2
2024-03-23 01:50:00,0,0,2,0,0,0,2
2024-03-23 02:00:00,0,0,2,0,0,0,2
2024-03-23 02:10:00,0,0,0,0,0,0,0
2024-03-23 02:20:00,0,0,2,0,0,1,3
2024-03-23 02:30:00,0,0,0,0,0,0,0
2024-03-23 02:40:00,0,0,2,0,0,2,4
2024-03-23 02:50:00,0,0,1,0,0,0,1
2024-03-23 03:00:00,0,0,1,0,0,0,1
2024-03-23 03:10:00,0,0,0,0,0,1,1
2024-03-23 03:20:00,0,0,3,0,0,0,3
2024-03-23 03:30:00,0,0,0,0,0,1,1
2024-03-23 03:40:00,0,0,1,0,0,2,3
2024-03-23 03:50:00,0,0,0,0,0,0,0
2024-03-23 04:00:00,0,0,0,0,0,1,1
2024-03-23 04:10:00,0,0,2,0,0,0,2
2024-03-23 04:20:00,0,0,2,0,0,0,2
2024-03-23 04:30:00,0,0,2,0,0,0,2
2024-03-23 04:40:00,0,0,2,0,0,0,2
2024-03-23 04:50:00,0,0,0,0,0,0,0
2024-03-23 05:00:00,0,0,4,0,0,0,4
2024-03-23 05:10:00,0,0,0,0,0,0,0
2024-03-23 05:20:00,0,0,0,0,0,0,0
2024-03-23 05:30:00,0,0,0,0,0,0,0
2024-03-23 05:40:00,0,0,4,0,0,2,6
2024-03-23 05:50:00,0,0,2,0,0,4,6
2024-03-23 06:00:00,3,4,1,3,3,2,16
2024-03-23 06:10:00,3,2,6,8,7,0,26
2024-03-23 06:20:00,10,11,2,8,6,0,37
2024-03-23 06:30:00,10,8,9,13,13,2,55
2024-03-23 06:40:00,10,7,11,11,13,1,53
2024-03-23 06:50:00,10,12,12,9,10,1,54
2024-03-23 07:00:00,10,10,10,14,14,5,63
2024-03-23 07:10:00,13,14,18,12,10,3,70
2024-03-23 07:20:00,10,10,18,7,9,8,62
2024-03-23 07:30:00,12,12,11,9,11,5,60
2024-03-23 07:40:00,11,16,18,18,16,2,81
2024-03-23 07:50:00,20,20,21,10,6,8,85
2024-03-23 08:00:00,21,25,18,19,32,3,118
2024-03-23 08:10:00,21,22,17,17,17,3,97
2024-03-23 08:20:00,19,20,20,18,17,2,96
2024-03-23 08:30:00,18,18,24,17,18,7,102
2024-03-23 08:40:00,31,26,19,18,14,8,116
2024-03-23 08:50:00,30,24,18,28,23,8,131
2024-03-23 09:00:00,30,24,14,20,19,9,116
2024-03-23 09:10:00,38,32,14,23,19,8,134
2024-03-23 09:20:00,30,27,19,21,17,7,121
2024-03-23 09:30:00,26,28,16,34,17,10,131
2024-03-23 09:40:00,25,24,21,28,15,11,124
2024-03-23 09:50:00,30,30,14,36,23,15,148
2024-03-23 10:00:00,32,28,19,21,19,13,132
2024-03-23 10:10:00,47,33,12,35,22,10,159
2024-03-23 10:20:00,40,36,18,27,20,13,154
2024-03-23 10:30:00,39,31,22,42,17,17,168
2024-03-23 10:40:00,28,24,17,41,24,10,144
2024-03-23 10:50:00,42,34,27,36,19,15,173
2024-03-23 11:00:00,43,28,23,25,20,8,147
2024-03-23 11:10:00,49,32,18,29,17,5,150
2024-03-23 11:20:00,44,33,19,36,23,11,166
2024-03-23 11:30:00,42,25,13,36,17,9,142
2024-03-23 11:40:00,53,16,27,46,19,14,175
2024-03-23 11:50:00,35,30,10,46,27,11,159
2024-03-23 12:00:00,32,29,15,50,24,13,163
2024-03-23 12:10:00,52,24,13,47,29,11,176
2024-03-23 12:20:00,41,29,14,50,27,11,172
2024-03-23 12:30:00,45,23,18,37,22,14,159
2024-03-23 12:40:00,38,25,11,49,20,6,149
2024-03-23 12:50:00,39,26,17,58,22,9,171
2024-03-23 13:00:00,43,31,20,30,22,9,155
2024-03-23 13:10:00,34,34,27,13,28,7,143
2024-03-23 13:20:00,31,29,37,31,23,7,158
2024-03-23 13:30:00,29,23,15,31,22,12,132
2024-03-23 13:40:00,33,25,21,30,19,8,136
2024-03-23 13:50:00,37,29,19,40,23,9,157
2024-03-23 14:00:00,33,24,14,21,14,4,110
2024-03-23 14:10:00,58,28,23,33,20,8,170
2024-03-23 14:20:00,48,25,21,29,21,3,147
2024-03-23 14:30:00,37,33,21,25,43,5,164
2024-03-23 14:40:00,31,31,14,44,22,7,149
2024-03-23 14:50:00,35,28,16,47,15,5,146
2024-03-23 15:00:00,41,33,12,25,11,9,131
2024-03-23 15:10:00,35,31,18,28,18,7,137
2024-03-23 15:20:00,41,26,23,28,20,11,149
2024-03-23 15:30:00,28,28,18,22,17,5,118
2024-03-23 15:40:00,36,31,23,45,25,2,162
2024-03-23 15:50:00,28,22,25,31,20,0,126
2024-03-23 16:00:00,39,25,25,26,15,1,131
2024-03-23 16:10:00,27,25,22,26,20,18,138
2024-03-23 16:20:00,34,18,14,36,15,17,134
2024-03-23 16:30:00,34,24,13,31,17,4,123
2024-03-23 16:40:00,33,27,17,24,26,11,138
2024-03-23 16:50:00,42,33,16,37,14,7,149
2024-03-23 17:00:00,31,22,17,28,21,44,163
2024-03-23 17:10:00,25,20,25,23,20,7,120
2024-03-23 17:20:00,36,29,20,36,27,13,161
2024-03-23 17:30:00,25,17,13,27,14,11,107
2024-03-23 17:40:00,32,28,28,28,16,6,138
2024-03-23 17:50:00,37,31,20,23,15,1,127
2024-03-23 18:00:00,46,24,28,36,23,0,157
2024-03-23 18:10:00,30,25,22,35,29,8,149
2024-03-23 18:20:00,41,27,18,31,31,11,159
2024-03-23 18:30:00,30,26,19,49,15,8,147
2024-03-23 18:40:00,24,18,16,26,21,6,111
2024-03-23 18:50:00,27,23,30,34,20,11,145
2024-03-23 19:00:00,27,20,22,31,13,12,125
2024-03-23 19:10:00,25,25,22,23,23,9,127
2024-03-23 19:20:00,24,22,22,23,12,11,114
2024-03-23 19:30:00,24,23,15,40,28,4,134
2024-03-23 19:40:00,20,14,15,26,13,5,93
2024-03-23 19:50:00,27,18,15,27,14,4,105
2024-03-23 20:00:00,18,15,16,17,16,4,86
2024-03-23 20:10:00,19,15,15,21,13,3,86
2024-03-23 20:20:00,21,22,12,20,21,0,96
2024-03-23 20:30:00,13,11,15,16,13,5,73
2024-03-23 20:40:00,16,16,16,12,7,3,70
2024-03-23 20:50:00,26,17,7,14,13,4,81
2024-03-23 21:00:00,11,9,9,17,16,5,67
2024-03-23 21:10:00,12,13,4,16,15,2,62
2024-03-23 21:20:00,8,9,8,20,18,2,65
2024-03-23 21:30:00,23,16,6,15,11,0,71
2024-03-23 21:40:00,15,10,7,13,10,2,57
2024-03-23 21:50:00,4,3,3,17,13,5,45
2024-03-23 22:00:00,12,15,4,17,14,1,63
2024-03-23 22:10:00,17,12,9,19,9,1,67
2024-03-23 22:20:00,16,11,5,10,9,1,52
2024-03-23 22:30:00,19,11,4,16,10,2,62
2024-03-23 22:40:00,16,13,2,19,14,0,64
2024-03-23 22:50:00,8,12,8,12,10,2,52
2024-03-23 23:00:00,25,20,5,13,12,0,75
2024-03-23 23:10:00,8,8,6,11,8,3,44
2024-03-23 23:20:00,9,7,2,18,16,2,54
2024-03-23 23:30:00,5,6,2,12,8,0,33
2024-03-23 23:40:00,16,13,3,15,7,0,54
2024-03-23 23:50:00,11,10,3,9,7,2,42
2024-03-24 00:00:00,18,15,6,5,5,4,53
2024-03-24 00:10:00,13,9,2,10,9,0,43
2024-03-24 00:20:00,6,4,4,10,6,2,32
2024-03-24 00:30:00,7,5,0,9,10,0,31
2024-03-24 00:40:00,4,3,4,7,7,0,25
2024-03-24 00:50:00,5,6,0,6,6,0,23
2024-03-24 01:00:00,7,7,0,6,5,0,25
2024-03-24 01:10:00,6,6,2,10,9,0,33
2024-03-24 01:20:00,3,4,2,6,4,0,19
2024-03-24 01:30:00,6,5,0,6,4,0,21
2024-03-24 01:40:00,4,4,1,2,0,0,11
2024-03-24 01:50:00,5,5,0,2,2,0,14
2024-03-24 02:00:00,6,5,0,5,3,0,19
2024-03-24 02:10:00,1,1,2,6,3,2,15
2024-03-24 02:20:00,5,4,2,2,1,0,14
2024-03-24 02:30:00,2,3,3,4,5,2,19
2024-03-24 02:40:00,6,5,0,4,4,0,19
2024-03-24 02:50:00,5,5,3,1,2,0,16
2024-03-24 03:00:00,4,4,0,3,2,0,13
2024-03-24 03:10:00,4,4,1,2,2,0,13
2024-03-24 03:20:00,7,6,5,8,7,0,33
2024-03-24 03:30:00,0,0,0,3,3,0,6
2024-03-24 03:40:00,0,0,3,2,3,0,8
2024-03-24 03:50:00,1,1,0,2,2,0,6
2024-03-24 04:00:00,2,2,1,3,2,0,10
2024-03-24 04:10:00,2,2,2,3,3,0,12
2024-03-24 04:20:00,0,0,0,4,5,0,9
2024-03-24 04:30:00,1,3,3,1,1,0,9
2024-03-24 04:40:00,2,2,1,3,3,0,11
2024-03-24 04:50:00,2,2,2,0,1,0,7
2024-03-24 05:00:00,5,5,1,2,4,0,17
2024-03-24 05:10:00,3,5,0,0,0,2,10
2024-03-24 05:20:00,0,0,2,4,4,0,10
2024-03-24 05:30:00,4,4,2,8,5,0,23
2024-03-24 05:40:00,2,2,0,1,0,2,7
2024-03-24 05:50:00,2,2,1,2,3,1,11
2024-03-24 06:00:00,1,1,4,2,1,0,9
2024-03-24 06:10:00,0,0,1,5,5,0,11
2024-03-24 06:20:00,1,1,1,3,3,0,9
2024-03-24 06:30:00,2,2,0,6,6,1,17
2024-03-24 06:40:00,3,3,4,2,2,0,14
2024-03-24 06:50:00,2,4,4,2,2,0,14
2024-03-24 07:00:00,4,6,3,7,4,0,24
2024-03-24 07:10:00,6,6,2,6,6,0,26
2024-03-24 07:20:00,6,6,3,6,7,0,28
2024-03-24 07:30:00,5,7,3,5,4,0,24
2024-03-24 07:40:00,5,8,3,9,8,1,34
2024-03-24 07:50:00,9,9,2,7,7,2,36
2024-03-24 08:00:00,9,9,6,7,7,0,38
2024-03-24 08:10:00,7,12,4,11,12,1,47
2024-03-24 08:20:00,8,20,6,4,5,4,47
2024-03-24 08:30:00,13,12,10,6,6,1,48
2024-03-24 08:40:00,16,20,7,11,11,2,67
2024-03-24 08:50:00,11,13,11,12,9,1,57
2024-03-24 09:00:00,11,13,14,12,11,1,62
2024-03-24 09:10:00,15,12,7,14,12,0,60
2024-03-24 09:20:00,13,17,6,13,12,5,66
2024-03-24 09:30:00,17,21,11,10,10,2,71
2024-03-24 09:40:00,19,20,15,22,10,3,89
2024-03-24 09:50:00,28,26,14,20,19,5,112
2024-03-24 10:00:00,27,28,14,25,17,3,114
2024-03-24 10:10:00,27,20,9,18,12,4,90
2024-03-24 10:20:00,14,15,11,22,18,0,80
2024-03-24 10:30:00,26,20,11,19,15,2,93
2024-03-24 10:40:00,22,18,12,23,15,4,94
2024-03-24 10:50:00,16,17,15,26,25,5,104
2024-03-24 11:00:00,19,21,16,21,12,2,91
2024-03-24 11:10:00,23,21,10,15,14,2,85
2024-03-24 11:20:00,26,25,15,22,22,7,117
2024-03-24 11:30:00,20,22,15,25,18,6,106
2024-03-24 11:40:00,31,30,18,28,21,4,132
2024-03-24 11:50:00,32,27,14,28,25,0,126
2024-03-24 12:00:00,21,20,19,29,25,0,114
2024-03-24 12:10:00,24,27,15,29,19,4,118
2024-03-24 12:20:00,28,30,13,24,20,4,119
2024-03-24 12:30:00,33,26,19,17,18,4,117
2024-03-24 12:40:00,24,25,18,4,14,4,89
2024-03-24 12:50:00,24,22,14,21,17,2,100
2024-03-24 13:00:00,24,16,10,6,22,1,79
2024-03-24 13:10:00,27,22,13,10,15,6,93
2024-03-24 13:20:00,24,26,14,34,16,4,118
2024-03-24 13:30:00,19,20,12,20,18,3,92
2024-03-24 13:40:00,27,19,10,17,14,3,90
2024-03-24 13:50:00,19,12,6,34,22,2,95
2024-03-24 14:00:00,26,27,11,23,24,1,112
2024-03-24 14:10:00,19,19,8,24,13,5,88
2024-03-24 14:20:00,22,16,15,20,16,2,91
2024-03-24 14:30:00,30,25,13,37,22,3,130
2024-03-24 14:40:00,29,24,21,32,16,1,123
2024-03-24 14:50:00,27,25,12,22,21,6,113
2024-03-24 15:00:00,23,19,16,22,25,2,107
2024-03-24 15:10:00,19,12,12,31,20,5,99
2024-03-24 15:20:00,24,21,13,17,13,7,95
2024-03-24 15:30:00,28,24,15,26,23,5,121
2024-03-24 15:40:00,25,33,18,19,15,3,113
2024-03-24 15:50:00,16,16,21,16,18,2,89
2024-03-24 16:00:00,24,22,17,29,18,8,118
2024-03-24 16:10:00,21,16,15,19,13,4,88
2024-03-24 16:20:00,27,22,15,24,24,2,114
2024-03-24 16:30:00,25,17,14,23,18,5,102
2024-03-24 16:40:00,25,25,13,25,21,1,110
2024-03-24 16:50:00,20,19,9,28,19,5,100
2024-03-24 17:00:00,25,26,15,30,21,3,120
2024-03-24 17:10:00,25,22,14,27,18,5,111
2024-03-24 17:20:00,16,15,12,30,25,2,100
2024-03-24 17:30:00,21,21,13,25,18,3,101
2024-03-24 17:40:00,20,16,25,38,21,4,124
2024-03-24 17:50:00,28,26,13,30,25,3,125
2024-03-24 18:00:00,18,19,12,25,22,4,100
2024-03-24 18:10:00,26,18,16,26,25,4,115
2024-03-24 18:20:00,15,13,12,17,19,3,79
2024-03-24 18:30:00,29,19,13,22,15,2,100
2024-03-24 18:40:00,13,12,11,25,15,4,80
2024-03-24 18:50:00,20,20,12,26,18,2,98
2024-03-24 19:00:00,20,19,11,12,12,7,81
2024-03-24 19:10:00,16,16,5,27,10,1,75
2024-03-24 19:20:00,14,12,7,18,6,3,60
2024-03-24 19:30:00,13,10,2,21,15,2,63
2024-03-24 19:40:00,25,16,8,18,13,3,83
2024-03-24 19:50:00,18,16,4,16,14,3,71
2024-03-24 20:00:00,24,18,9,16,11,8,86
2024-03-24 20:10:00,12,13,12,19,17,0,73
2024-03-24 20:20:00,22,18,4,18,14,2,78
2024-03-24 20:30:00,12,9,6,24,13,2,66
2024-03-24 20:40:00,14,16,7,14,11,1,63
2024-03-24 20:50:00,23,20,5,8,3,0,59
2024-03-24 21:00:00,16,14,5,17,9,2,63
2024-03-24 21:10:00,5,6,9,13,8,0,41
2024-03-24 21:20:00,12,9,1,18,8,5,53
2024-03-24 21:30:00,5,5,3,15,6,1,35
2024-03-24 21:40:00,17,15,6,18,17,3,76
2024-03-24 21:50:00,8,7,5,11,8,0,39
2024-03-24 22:00:00,18,13,5,18,10,6,70
2024-03-24 22:10:00,4,4,2,13,10,1,34
2024-03-24 22:20:00,12,9,7,6,4,0,38
2024-03-24 22:30:00,10,10,3,14,9,0,46
2024-03-24 22:40:00,4,2,1,11,12,2,32
2024-03-24 22:50:00,6,6,1,10,5,0,28
2024-03-24 23:00:00,5,6,4,10,10,0,35
2024-03-24 23:10:00,6,6,2,4,3,1,22
2024-03-24 23:20:00,4,4,1,3,3,0,15
2024-03-24 23:30:00,11,5,0,4,4,0,24
2024-03-24 23:40:00,3,3,1,4,7,0,18
2024-03-24 23:50:00,2,2,0,5,2,2,13
2024-03-25 00:00:00,2,2,0,3,2,2,11
2024-03-25 00:10:00,5,4,2,4,2,0,17
2024-03-25 00:20:00,1,1,1,3,3,0,9
2024-03-25 00:30:00,2,2,1,2,2,0,9
2024-03-25 00:40:00,3,4,1,1,1,0,10
2024-03-25 00:50:00,5,4,1,6,2,0,18
2024-03-25 01:00:00,2,2,0,1,1,0,6
2024-03-25 01:10:00,2,2,0,4,3,0,11
2024-03-25 01:20:00,2,3,2,2,0,0,9
2024-03-25 01:30:00,0,0,2,1,0,0,3
2024-03-25 01:40:00,3,3,1,2,2,0,11
2024-03-25 01:50:00,1,1,0,4,2,0,8
2024-03-25 02:00:00,2,3,0,1,3,0,9
2024-03-25 02:10:00,2,2,0,4,2,0,10
2024-03-25 02:20:00,0,0,1,0,0,0,1
2024-03-25 02:30:00,1,2,0,2,2,0,7
2024-03-25 02:40:00,1,1,0,0,0,0,2
2024-03-25 02:50:00,0,1,1,1,1,0,4
2024-03-25 03:00:00,3,3,0,3,0,0,9
2024-03-25 03:10:00,0,0,0,3,3,0,6
2024-03-25 03:20:00,1,2,2,1,2,0,8
2024-03-25 03:30:00,1,1,0,4,3,3,12
2024-03-25 03:40:00,1,1,1,1,1,0,5
2024-03-25 03:50:00,1,3,0,0,0,0,4
2024-03-25 04:00:00,3,3,2,1,1,0,10
2024-03-25 04:10:00,1,1,0,3,3,0,8
2024-03-25 04:20:00,2,1,2,2,3,0,10
2024-03-25 04:30:00,1,1,1,2,1,1,7
2024-03-25 04:40:00,3,3,4,4,3,0,17
2024-03-25 04:50:00,3,5,4,3,3,0,18
2024-03-25 05:00:00,4,5,1,4,4,2,20
2024-03-25 05:10:00,5,4,1,4,5,0,19
2024-03-25 05:20:00,8,8,4,10,9,0,39
2024-03-25 05:30:00,6,5,9,7,7,3,37
2024-03-25 05:40:00,12,9,7,8,7,0,43
2024-03-25 05:50:00,6,10,6,6,6,3,37
2024-03-25 06:00:00,9,5,5,9,9,1,38
2024-03-25 06:10:00,13,14,7,9,6,0,49
2024-03-25 06:20:00,13,15,8,15,17,3,71
2024-03-25 06:30:00,23,23,7,16,17,3,89
2024-03-25 06:40:00,21,19,8,15,12,0,75
2024-03-25 06:50:00,12,11,9,19,17,0,68
2024-03-25 07:00:00,25,23,11,17,14,8,98
2024-03-25 07:10:00,26,24,12,24,17,3,106
2024-03-25 07:20:00,23,26,13,23,19,5,109
2024-03-25 07:30:00,27,21,10,14,13,9,94
2024-03-25 07:40:00,33,27,13,16,15,4,108
2024-03-25 07:50:00,37,27,29,35,19,5,152
2024-03-25 08:00:00,31,27,28,29,19,2,136
2024-03-25 08:10:00,32,25,19,31,22,10,139
2024-03-25 08:20:00,24,23,14,27,21,16,125
2024-03-25 08:30:00,33,29,19,25,24,9,139
2024-03-25 08:40:00,33,30,15,24,21,15,138
2024-03-25 08:50:00,38,34,20,29,20,6,147
2024-03-25 09:00:00,27,28,15,24,26,9,129
2024-03-25 09:10:00,38,38,12,34,11,21,154
2024-03-25 09:20:00,36,32,21,31,21,17,158
2024-03-25 09:30:00,42,42,27,38,25,10,184
2024-03-25 09:40:00,49,24,22,25,18,5,143
2024-03-25 09:50:00,32,21,20,30,25,10,138
2024-03-25 10:00:00,32,34,12,38,34,7,157
2024-03-25 10:10:00,34,29,20,28,17,9,137
2024-03-25 10:20:00,29,29,23,31,15,9,136
2024-03-25 10:30:00,37,35,20,30,9,14,145
2024-03-25 10:40:00,29,28,20,30,23,16,146
2024-03-25 10:50:00,43,36,18,40,26,4,167
2024-03-25 11:00:00,43,38,23,37,24,7,172
2024-03-25 11:10:00,34,23,22,33,16,2,130
2024-03-25 11:20:00,37,27,22,39,20,10,155
2024-03-25 11:30:00,40,25,17,35,22,10,149
2024-03-25 11:40:00,39,31,31,31,20,7,159
2024-03-25 11:50:00,36,31,23,38,22,9,159
2024-03-25 12:00:00,29,30,21,34,21,13,148
2024-03-25 12:10:00,32,26,19,34,19,16,146
2024-03-25 12:20:00,38,24,23,44,18,10,157
2024-03-25 12:30:00,34,32,12,31,15,13,137
2024-03-25 12:40:00,35,35,26,33,29,9,167
2024-03-25 12:50:00,39,22,20,39,25,9,154
2024-03-25 13:00:00,35,32,17,34,19,6,143
2024-03-25 13:10:00,38,23,19,34,19,2,135
2024-03-25 13:20:00,33,32,22,37,23,8,155
2024-03-25 13:30:00,38,36,15,41,26,8,164
2024-03-25 13:40:00,45,34,24,37,34,7,181
2024-03-25 13:50:00,35,31,15,41,25,10,157
2024-03-25 14:00:00,26,25,13,24,19,11,118
2024-03-25 14:10:00,40,29,20,37,23,10,159
2024-03-25 14:20:00,38,31,25,33,24,19,170
2024-03-25 14:30:00,47,29,21,43,17,7,164
2024-03-25 14:40:00,45,29,34,39,16,13,176
2024-03-25 14:50:00,43,34,12,31,30,11,161
2024-03-25 15:00:00,47,29,18,37,25,9,165
2024-03-25 15:10:00,40,26,25,58,31,7,187
2024-03-25 15:20:00,37,35,20,36,21,14,163
2024-03-25 15:30:00,55,28,32,39,17,2,173
2024-03-25 15:40:00,53,23,33,42,18,5,174
2024-03-25 15:50:00,35,26,28,47,22,8,166
2024-03-25 16:00:00,44,19,20,47,21,9,160
2024-03-25 16:10:00,49,29,19,34,24,2,157
2024-03-25 16:20:00,35,26,20,52,17,1,151
2024-03-25 16:30:00,40,23,31,54,24,3,175
2024-03-25 16:40:00,38,34,18,45,30,19,184
2024-03-25 16:50:00,35,26,18,40,23,15,157
2024-03-25 17:00:00,38,32,14,41,22,13,160
2024-03-25 17:10:00,57,32,19,38,15,18,179
2024-03-25 17:20:00,44,39,19,38,29,10,179
2024-03-25 17:30:00,54,27,26,48,24,4,183
2024-03-25 17:40:00,44,30,49,39,15,15,192
2024-03-25 17:50:00,40,35,17,35,24,2,153
2024-03-25 18:00:00,42,31,12,28,17,10,140
2024-03-25 18:10:00,31,30,19,46,25,0,151
2024-03-25 18:20:00,43,28,21,39,26,7,164
2024-03-25 18:30:00,34,24,27,29,20,7,141
2024-03-25 18:40:00,27,26,23,28,17,4,125
2024-03-25 18:50:00,26,25,14,38,21,7,131
2024-03-25 19:00:00,30,22,23,32,20,1,128
2024-03-25 19:10:00,38,27,20,26,22,14,147
2024-03-25 19:20:00,27,20,13,28,18,7,113
2024-03-25 19:30:00,23,21,16,22,15,5,102
2024-03-25 19:40:00,21,21,10,29,21,5,107
2024-03-25 19:50:00,30,21,11,22,21,4,109
2024-03-25 20:00:00,28,32,22,23,23,1,129
2024-03-25 20:10:00,17,12,15,20,15,3,82
2024-03-25 20:20:00,17,14,15,20,21,13,100
2024-03-25 20:30:00,18,13,4,9,10,1,55
2024-03-25 20:40:00,14,10,11,17,17,3,72
2024-03-25 20:50:00,10,12,14,14,11,2,63
2024-03-25 21:00:00,15,13,11,13,12,1,65
2024-03-25 21:10:00,16,11,9,15,17,7,75
2024-03-25 21:20:00,12,13,14,10,8,0,57
2024-03-25 21:30:00,12,8,3,20,15,4,62
2024-03-25 21:40:00,13,7,4,12,12,3,51
2024-03-25 21:50:00,9,11,7,11,10,0,48
2024-03-25 22:00:00,12,8,1,10,8,1,40
2024-03-25 22:10:00,7,6,8,16,9,0,46
2024-03-25 22:20:00,8,8,4,11,11,1,43
2024-03-25 22:30:00,8,7,6,5,6,0,32
2024-03-25 22:40:00,5,7,5,6,4,0,27
2024-03-25 22:50:00,6,6,3,14,9,0,38
2024-03-25 23:00:00,5,7,6,8,6,2,34
2024-03-25 23:10:00,6,4,1,8,7,0,26
2024-03-25 23:20:00,4,5,1,4,4,2,20
2024-03-25 23:30:00,2,1,3,6,4,2,18
2024-03-25 23:40:00,2,2,6,7,7,2,26
2024-03-25 23:50:00,4,4,0,5,2,0,15
2024-03-26 00:00:00,5,2,1,8,9,1,26
2024-03-26 00:10:00,0,0,2,2,1,0,5
2024-03-26 00:20:00,3,3,0,3,2,0,11
2024-03-26 00:30:00,5,4,2,3,3,0,17
2024-03-26 00:40:00,5,4,1,4,5,0,19
2024-03-26 00:50:00,3,3,0,1,1,0,8
2024-03-26 01:00:00,2,2,2,5,3,0,14
2024-03-26 01:10:00,1,1,0,2,1,0,5
2024-03-26 01:20:00,3,2,0,3,3,1,12
2024-03-26 01:30:00,1,1,0,0,0,0,2
2024-03-26 01:40:00,0,0,1,0,0,0,1
2024-03-26 01:50:00,1,1,4,0,0,0,6
2024-03-26 02:00:00,0,0,1,0,1,0,2
2024-03-26 02:10:00,1,1,0,2,2,0,6
2024-03-26 02:20:00,0,0,0,0,0,0,0
2024-03-26 02:30:00,2,2,0,0,0,0,4
2024-03-26 02:40:00,2,2,0,0,1,0,5
2024-03-26 02:50:00,0,0,0,1,1,0,2
2024-03-26 03:00:00,0,0,1,2,0,2,5
2024-03-26 03:10:00,1,3,0,3,2,0,9
2024-03-26 03:20:00,0,0,0,1,0,0,1
2024-03-26 03:30:00,0,0,0,4,4,0,8
2024-03-26 03:40:00,1,3,1,1,1,2,9
2024-03-26 03:50:00,2,3,2,1,1,0,9
2024-03-26 04:00:00,1,1,0,0,0,1,3
2024-03-26 04:10:00,2,2,0,1,1,0,6
2024-03-26 04:20:00,1,1,0,4,4,0,10
2024-03-26 04:30:00,3,3,2,1,0,0,9
2024-03-26 04:40:00,2,4,1,2,1,0,10
2024-03-26 04:50:00,3,3,4,2,2,0,14
2024-03-26 05:00:00,5,5,0,1,2,0,13
2024-03-26 05:10:00,6,7,2,6,5,2,28
2024-03-26 05:20:00,6,6,3,6,3,0,24
2024-03-26 05:30:00,9,7,6,7,5,1,35
2024-03-26 05:40:00,4,5,7,9,7,2,34
2024-03-26 05:50:00,9,10,7,8,8,0,42
2024-03-26 06:00:00,11,14,4,9,10,1,49
2024-03-26 06:10:00,11,8,8,8,7,1,43
2024-03-26 06:20:00,15,15,8,21,19,2,80
2024-03-26 06:30:00,14,15,15,16,12,0,72
2024-03-26 06:40:00,22,23,12,12,10,2,81
2024-03-26 06:50:00,14,16,8,20,20,2,80
2024-03-26 07:00:00,12,13,13,16,18,0,72
2024-03-26 07:10:00,25,22,16,20,14,0,97
2024-03-26 07:20:00,25,26,11,18,16,3,99
2024-03-26 07:30:00,28,20,42,18,17,5,130
2024-03-26 07:40:00,26,27,16,24,22,6,121
2024-03-26 07:50:00,43,38,13,31,24,7,156
2024-03-26 08:00:00,26,23,15,29,20,3,116
2024-03-26 08:10:00,30,31,24,25,20,9,139
2024-03-26 08:20:00,29,26,20,23,18,13,129
2024-03-26 08:30:00,32,29,16,24,15,8,124
2024-03-26 08:40:00,29,24,18,28,27,5,131
2024-03-26 08:50:00,35,32,11,38,43,8,167
2024-03-26 09:00:00,27,24,16,28,20,10,125
2024-03-26 09:10:00,42,27,21,28,12,3,133
2024-03-26 09:20:00,40,31,16,21,22,9,139
2024-03-26 09:30:00,40,19,16,30,17,3,125
2024-03-26 09:40:00,37,30,11,31,17,11,137
2024-03-26 09:50:00,43,27,25,40,19,7,161
2024-03-26 10:00:00,38,23,24,26,19,9,139
2024-03-26 10:10:00,41,23,32,26,19,13,154
2024-03-26 10:20:00,22,17,16,21,20,10,106
2024-03-26 10:30:00,31,25,23,29,22,8,138
2024-03-26 10:40:00,31,23,20,35,16,16,141
2024-03-26 10:50:00,25,23,23,32,26,11,140
2024-03-26 11:00:00,33,29,18,40,20,9,149
2024-03-26 11:10:00,42,27,12,29,19,5,134
2024-03-26 11:20:00,28,29,28,42,25,9,161
2024-03-26 11:30:00,31,29,12,25,11,7,115
2024-03-26 11:40:00,41,42,26,35,22,9,175
2024-03-26 11:50:00,28,26,21,41,21,4,141
2024-03-26 12:00:00,38,24,24,33,14,7,140
2024-03-26 12:10:00,34,31,22,18,15,5,125
2024-03-26 12:20:00,33,26,26,30,16,12,143
2024-03-26 12:30:00,30,29,24,31,21,8,143
2024-03-26 12:40:00,25,25,11,30,26,13,130
2024-03-26 12:50:00,32,34,21,32,17,6,142
2024-03-26 13:00:00,29,28,20,36,18,6,137
2024-03-26 13:10:00,32,31,22,36,16,8,145
2024-03-26 13:20:00,39,22,17,26,14,9,127
2024-03-26 13:30:00,34,22,22,33,19,7,137
2024-03-26 13:40:00,33,31,36,35,17,7,159
2024-03-26 13:50:00,38,26,20,32,21,8,145
2024-03-26 14:00:00,34,23,24,29,19,8,137
2024-03-26 14:10:00,43,29,28,28,19,10,157
2024-03-26 14:20:00,35,25,23,42,18,11,154
2024-03-26 14:30:00,40,34,25,39,26,10,174
2024-03-26 14:40:00,38,39,21,26,20,6,150
2024-03-26 14:50:00,35,19,29,27,16,13,139
2024-03-26 15:00:00,45,32,25,42,23,12,179
2024-03-26 15:10:00,39,34,32,34,22,8,169
2024-03-26 15:20:00,43,32,19,36,24,7,161
2024-03-26 15:30:00,47,32,22,40,29,12,182
2024-03-26 15:40:00,36,37,17,23,20,9,142
2024-03-26 15:50:00,40,29,27,50,19,19,184
2024-03-26 16:00:00,51,23,17,35,18,10,154
2024-03-26 16:10:00,48,39,20,33,21,20,181
2024-03-26 16:20:00,32,31,16,54,21,14,168
2024-03-26 16:30:00,42,33,29,34,14,10,162
2024-03-26 16:40:00,45,32,17,44,28,12,178
2024-03-26 16:50:00,38,30,22,50,26,11,177
2024-03-26 17:00:00,33,15,20,34,21,7,130
2024-03-26 17:10:00,47,33,25,37,27,11,180
2024-03-26 17:20:00,30,26,15,30,25,8,134
2024-03-26 17:30:00,41,34,24,42,17,4,162
2024-03-26 17:40:00,41,26,30,45,13,0,155
2024-03-26 17:50:00,39,27,20,41,14,5,146
2024-03-26 18:00:00,46,32,20,36,15,13,162
2024-03-26 18:10:00,41,37,18,40,35,4,175
2024-03-26 18:20:00,42,32,14,30,12,9,139
2024-03-26 18:30:00,35,25,15,58,30,6,169
2024-03-26 18:40:00,34,32,17,38,25,8,154
2024-03-26 18:50:00,30,33,20,30,20,9,142
2024-03-26 19:00:00,20,18,21,29,18,5,111
2024-03-26 19:10:00,30,22,16,34,24,2,128
2024-03-26 19:20:00,27,20,13,25,18,4,107
2024-03-26 19:30:00,21,14,12,28,19,9,103
2024-03-26 19:40:00,28,24,14,18,19,3,106
2024-03-26 19:50:00,13,11,12,21,17,5,79
2024-03-26 20:00:00,24,22,11,17,15,9,98
2024-03-26 20:10:00,19,13,19,22,23,5,101
2024-03-26 20:20:00,23,20,11,20,11,3,88
2024-03-26 20:30:00,14,11,7,15,12,3,62
2024-03-26 20:40:00,11,9,9,16,22,1,68
2024-03-26 20:50:00,15,12,9,14,15,0,65
2024-03-26 21:00:00,17,16,12,12,11,0,68
2024-03-26 21:10:00,9,9,9,17,12,2,58
2024-03-26 21:20:00,12,10,9,19,15,0,65
2024-03-26 21:30:00,11,9,4,8,7,0,39
2024-03-26 21:40:00,12,9,2,9,6,2,40
2024-03-26 21:50:00,14,10,3,15,9,1,52
2024-03-26 22:00:00,21,8,6,19,12,1,67
2024-03-26 22:10:00,13,8,13,14,10,4,62
2024-03-26 22:20:00,5,5,4,12,10,5,41
2024-03-26 22:30:00,7,8,4,8,3,2,32
2024-03-26 22:40:00,6,6,7,7,9,1,36
2024-03-26 22:50:00,5,5,1,10,10,0,31
2024-03-26 23:00:00,9,8,0,8,9,3,37
2024-03-26 23:10:00,5,5,3,11,10,0,34
2024-03-26 23:20:00,4,3,4,11,9,1,32
2024-03-26 23:30:00,6,7,1,6,5,2,27
2024-03-26 23:40:00,4,5,1,4,4,0,18
2024-03-26 23:50:00,9,6,0,5,5,0,25
2024-03-27 00:00:00,4,4,0,8,6,2,24
2024-03-27 00:10:00,3,3,3,2,3,2,16
2024-03-27 00:20:00,4,4,1,5,2,0,16
2024-03-27 00:30:00,4,4,1,5,4,0,18
2024-03-27 00:40:00,5,5,1,2,2,0,15
2024-03-27 00:50:00,0,0,0,2,1,0,3
2024-03-27 01:00:00,1,1,2,5,6,0,15
2024-03-27 01:10:00,2,2,0,5,4,0,13
2024-03-27 01:20:00,1,1,1,1,2,0,6
2024-03-27 01:30:00,0,0,1,1,0,0,2
2024-03-27 01:40:00,2,2,2,5,4,2,17
2024-03-27 01:50:00,1,1,1,2,1,0,6
2024-03-27 02:00:00,1,1,0,0,0,0,2
2024-03-27 02:10:00,0,0,0,3,3,0,6
2024-03-27 02:20:00,0,0,0,2,2,0,4
2024-03-27 02:30:00,1,1,3,3,3,0,11
2024-03-27 02:40:00,0,0,0,0,0,2,2
2024-03-27 02:50:00,1,1,1,2,2,0,7
2024-03-27 03:00:00,0,0,2,1,1,0,4
2024-03-27 03:10:00,0,0,0,5,3,0,8
2024-03-27 03:20:00,0,0,0,2,0,0,2
2024-03-27 03:30:00,0,0,0,0,0,0,0
2024-03-27 03:40:00,0,2,0,2,2,0,6
2024-03-27 03:50:00,0,0,0,0,0,1,1
2024-03-27 04:00:00,4,4,0,0,0,0,8
2024-03-27 04:10:00,0,0,0,1,6,1,8
2024-03-27 04:20:00,0,0,2,2,2,0,6
2024-03-27 04:30:00,4,5,3,2,1,1,16
2024-03-27 04:40:00,3,4,5,4,3,0,19
2024-03-27 04:50:00,3,3,2,2,3,0,13
2024-03-27 05:00:00,4,3,1,2,2,0,12
2024-03-27 05:10:00,6,6,2,6,3,2,25
2024-03-27 05:20:00,8,6,7,7,4,0,32
2024-03-27 05:30:00,9,8,4,6,5,1,33
2024-03-27 05:40:00,6,7,9,8,10,2,42
2024-03-27 05:50:00,13,11,4,8,5,0,41
2024-03-27 06:00:00,9,11,7,12,7,3,49
2024-03-27 06:10:00,13,11,5,4,4,4,41
2024-03-27 06:20:00,11,11,17,14,14,1,68
2024-03-27 06:30:00,18,18,14,17,16,2,85
2024-03-27 06:40:00,19,15,9,13,11,0,67
2024-03-27 06:50:00,15,16,11,25,20,0,87
2024-03-27 07:00:00,22,20,8,28,21,0,99
2024-03-27 07:10:00,13,17,13,22,15,0,80
2024-03-27 07:20:00,25,24,10,22,15,7,103
2024-03-27 07:30:00,25,24,21,26,21,2,119
2024-03-27 07:40:00,28,22,16,22,13,3,104
2024-03-27 07:50:00,31,34,23,30,19,1,138
2024-03-27 08:00:00,25,15,11,27,25,9,112
2024-03-27 08:10:00,26,25,23,22,16,8,120
2024-03-27 08:20:00,29,27,19,27,21,9,132
2024-03-27 08:30:00,49,42,17,33,23,9,173
2024-03-27 08:40:00,29,29,12,19,16,6,111
2024-03-27 08:50:00,35,24,13,33,21,9,135
2024-03-27 09:00:00,25,22,15,28,25,4,119
2024-03-27 09:10:00,28,22,20,25,20,2,117
2024-03-27 09:20:00,41,36,17,40,21,1,156
2024-03-27 09:30:00,31,29,0,22,15,0,97
2024-03-27 09:40:00,40,26,10,34,15,2,127
2024-03-27 09:50:00,38,29,24,26,18,10,145
2024-03-27 10:00:00,36,29,23,38,21,6,153
2024-03-27 10:10:00,38,21,23,33,13,7,135
2024-03-27 10:20:00,35,32,16,27,16,10,136
2024-03-27 10:30:00,32,26,20,19,15,10,122
2024-03-27 10:40:00,30,27,25,29,13,11,135
2024-03-27 10:50:00,40,35,15,44,27,8,169
2024-03-27 11:00:00,47,31,23,31,17,7,156
2024-03-27 11:10:00,39,31,22,26,19,10,147
2024-03-27 11:20:00,30,24,18,38,22,6,138
2024-03-27 11:30:00,49,37,20,25,21,10,162
2024-03-27 11:40:00,26,26,24,35,17,5,133
2024-03-27 11:50:00,33,27,11,34,17,12,134
2024-03-27 12:00:00,37,29,21,39,19,7,152
2024-03-27 12:10:00,38,35,21,38,27,11,170
2024-03-27 12:20:00,43,34,18,30,20,7,152
2024-03-27 12:30:00,37,25,19,37,22,7,147
2024-03-27 12:40:00,35,23,25,32,19,5,139
2024-03-27 12:50:00,37,26,27,37,19,4,150
2024-03-27 13:00:00,33,32,21,34,18,7,145
2024-03-27 13:10:00,21,13,18,35,16,9,112
2024-03-27 13:20:00,26,21,22,38,18,8,133
2024-03-27 13:30:00,40,32,16,31,19,4,142
2024-03-27 13:40:00,32,25,17,25,17,6,122
2024-03-27 13:50:00,38,30,21,33,19,9,150
2024-03-27 14:00:00,27,15,16,31,17,6,112
2024-03-27 14:10:00,34,16,26,41,18,16,151
2024-03-27 14:20:00,35,26,25,44,20,16,166
2024-03-27 14:30:00,36,20,22,40,14,8,140
2024-03-27 14:40:00,34,32,25,41,31,10,173
2024-03-27 14:50:00,38,25,21,27,17,0,128
2024-03-27 15:00:00,33,26,18,36,17,11,141
2024-03-27 15:10:00,38,21,23,45,26,11,164
2024-03-27 15:20:00,32,27,18,26,20,41,164
2024-03-27 15:30:00,48,40,17,44,18,14,181
2024-03-27 15:40:00,37,22,25,36,27,10,157
2024-03-27 15:50:00,34,13,22,41,28,12,150
2024-03-27 16:00:00,34,24,21,52,26,11,168
2024-03-27 16:10:00,46,28,14,46,33,8,175
2024-03-27 16:20:00,38,22,16,41,23,16,156
2024-03-27 16:30:00,44,16,23,32,6,9,130
2024-03-27 16:40:00,45,26,12,69,28,5,185
2024-03-27 16:50:00,46,34,15,51,18,13,177
2024-03-27 17:00:00,35,29,17,38,25,8,152
2024-03-27 17:10:00,42,26,20,40,18,7,153
2024-03-27 17:20:00,34,21,17,37,24,13,146
2024-03-27 17:30:00,34,29,6,47,23,11,150
2024-03-27 17:40:00,41,21,20,31,24,8,145
2024-03-27 17:50:00,29,27,22,38,23,6,145
2024-03-27 18:00:00,46,28,17,29,23,8,151
2024-03-27 18:10:00,38,27,11,28,13,9,126
2024-03-27 18:20:00,34,16,25,37,12,12,136
2024-03-27 18:30:00,35,23,19,38,21,11,147
2024-03-27 18:40:00,30,20,13,44,29,7,143
2024-03-27 18:50:00,25,22,22,23,21,6,119
2024-03-27 19:00:00,27,28,14,25,16,4,114
2024-03-27 19:10:00,30,25,14,17,18,5,109
2024-03-27 19:20:00,29,19,13,25,21,1,108
2024-03-27 19:30:00,28,21,12,26,18,3,108
2024-03-27 19:40:00,30,25,15,20,15,10,115
2024-03-27 19:50:00,27,18,13,19,11,3,91
2024-03-27 20:00:00,18,17,15,20,17,7,94
2024-03-27 20:10:00,23,19,13,27,20,8,110
2024-03-27 20:20:00,22,15,9,21,15,6,88
2024-03-27 20:30:00,20,12,13,19,16,0,80
2024-03-27 20:40:00,21,15,8,19,14,2,79
2024-03-27 20:50:00,20,16,13,14,14,4,81
2024-03-27 21:00:00,15,16,6,14,9,2,62
2024-03-27 21:10:00,17,15,16,17,15,1,81
2024-03-27 21:20:00,14,16,5,16,12,1,64
2024-03-27 21:30:00,11,11,6,14,13,4,59
2024-03-27 21:40:00,15,11,9,8,8,2,53
2024-03-27 21:50:00,10,10,8,20,16,0,64
2024-03-27 22:00:00,12,13,8,14,4,0,51
2024-03-27 22:10:00,17,17,2,10,9,0,55
2024-03-27 22:20:00,9,7,5,20,14,5,60
2024-03-27 22:30:00,8,9,4,19,14,0,54
2024-03-27 22:40:00,12,8,6,15,11,0,52
2024-03-27 22:50:00,5,6,7,7,8,3,36
2024-03-27 23:00:00,6,7,1,13,14,0,41
2024-03-27 23:10:00,7,7,4,13,12,2,45
2024-03-27 23:20:00,9,7,3,10,6,2,37
2024-03-27 23:30:00,6,5,5,8,8,1,33
2024-03-27 23:40:00,7,8,0,5,3,3,26
2024-03-27 23:50:00,8,6,1,8,5,0,28
2024-03-28 00:00:00,2,3,3,4,4,2,18
2024-03-28 00:10:00,2,5,2,4,2,0,15
2024-03-28 00:20:00,5,5,1,3,2,0,16
2024-03-28 00:30:00,7,6,0,6,4,0,23
2024-03-28 00:40:00,2,2,2,1,0,0,7
2024-03-28 00:50:00,1,1,1,0,0,0,3
2024-03-28 01:00:00,1,1,1,3,3,0,9
2024-03-28 01:10:00,0,0,0,0,0,0,0
2024-03-28 01:20:00,0,0,0,0,0,0,0
2024-03-28 01:30:00,0,0,2,0,0,0,2
2024-03-28 01:40:00,0,0,1,0,0,0,1
2024-03-28 01:50:00,0,0,0,0,0,0,0
2024-03-28 02:00:00,0,0,2,0,0,0,2
2024-03-28 02:10:00,0,0,0,0,0,0,0
2024-03-28 02:20:00,0,0,2,0,0,2,4
2024-03-28 02:30:00,0,0,0,0,0,0,0
2024-03-28 02:40:00,0,0,0,0,0,0,0
2024-03-28 02:50:00,0,0,0,0,0,0,0
2024-03-28 03:00:00,0,0,0,0,0,0,0
2024-03-28 03:10:00,0,0,4,0,0,0,4
2024-03-28 03:20:00,0,0,0,0,0,0,0
2024-03-28 03:30:00,0,0,0,0,0,0,0
2024-03-28 03:40:00,0,0,0,0,0,0,0
2024-03-28 03:50:00,0,0,0,0,0,0,0
2024-03-28 04:00:00,0,0,0,0,0,0,0
2024-03-28 04:10:00,0,0,1,0,0,0,1
2024-03-28 04:20:00,0,0,0,0,0,0,0
2024-03-28 04:30:00,0,0,3,0,0,1,4
2024-03-28 04:40:00,0,0,2,0,0,1,3
2024-03-28 04:50:00,2,2,2,2,2,0,10
2024-03-28 05:00:00,5,4,7,4,7,0,27
2024-03-28 05:10:00,4,4,2,10,4,0,24
2024-03-28 05:20:00,4,4,4,4,4,1,21
2024-03-28 05:30:00,8,7,5,5,6,0,31
2024-03-28 05:40:00,6,5,8,8,6,0,33
2024-03-28 05:50:00,7,8,4,7,5,3,34
2024-03-28 06:00:00,14,17,8,9,10,2,60
2024-03-28 06:10:00,11,11,5,12,10,0,49
2024-03-28 06:20:00,12,12,6,15,13,4,62
2024-03-28 06:30:00,15,16,15,14,13,1,74
2024-03-28 06:40:00,16,13,13,21,24,0,87
2024-03-28 06:50:00,17,15,11,22,15,3,83
2024-03-28 07:00:00,13,13,10,20,23,5,84
2024-03-28 07:10:00,21,16,15,16,18,4,90
2024-03-28 07:20:00,22,22,15,19,16,4,98
2024-03-28 07:30:00,25,26,16,24,15,3,109
2024-03-28 07:40:00,25,25,17,16,15,7,105
2024-03-28 07:50:00,37,35,16,23,23,13,147
2024-03-28 08:00:00,29,24,22,19,11,21,126
2024-03-28 08:10:00,35,33,34,39,25,13,179
2024-03-28 08:20:00,21,25,20,31,23,15,135
2024-03-28 08:30:00,34,26,22,33,26,3,144
2024-03-28 08:40:00,44,34,21,34,24,12,169
2024-03-28 08:50:00,48,24,15,38,25,12,162
2024-03-28 09:00:00,30,22,18,37,19,14,140
2024-03-28 09:10:00,39,24,16,36,27,6,148
2024-03-28 09:20:00,34,26,15,25,28,13,141
2024-03-28 09:30:00,46,28,19,46,20,11,170
2024-03-28 09:40:00,43,35,18,32,19,8,155
2024-03-28 09:50:00,40,35,13,38,28,10,164
2024-03-28 10:00:00,47,37,8,35,20,12,159
2024-03-28 10:10:00,51,31,8,43,31,13,177
2024-03-28 10:20:00,37,24,13,33,19,8,134
2024-03-28 10:30:00,36,28,18,51,24,3,160
2024-03-28 10:40:00,45,32,20,35,20,7,159
2024-03-28 10:50:00,45,29,18,39,16,6,153
2024-03-28 11:00:00,56,29,24,36,24,13,182
2024-03-28 11:10:00,38,30,24,38,13,5,148
2024-03-28 11:20:00,39,37,23,45,14,13,171
2024-03-28 11:30:00,46,25,9,44,26,20,170
2024-03-28 11:40:00,35,23,31,45,18,10,162
2024-03-28 11:50:00,36,36,22,35,23,14,166
2024-03-28 12:00:00,38,16,12,22,23,10,121
2024-03-28 12:10:00,45,26,9,27,39,118,264
2024-03-28 12:20:00,36,33,17,46,17,11,160
2024-03-28 12:30:00,37,26,16,54,12,7,152
2024-03-28 12:40:00,46,26,27,36,10,17,162
2024-03-28 12:50:00,30,31,24,40,25,9,159
2024-03-28 13:00:00,34,30,22,36,20,7,149
2024-03-28 13:10:00,44,30,21,29,27,9,160
2024-03-28 13:20:00,39,16,21,43,25,7,151
2024-03-28 13:30:00,44,39,22,37,13,6,161
2024-03-28 13:40:00,46,28,17,35,19,10,155
2024-03-28 13:50:00,41,32,19,37,18,9,156
2024-03-28 14:00:00,43,29,21,25,15,11,144
2024-03-28 14:10:00,41,29,21,27,15,12,145
2024-03-28 14:20:00,36,31,18,40,22,7,154
2024-03-28 14:30:00,48,25,19,33,21,7,153
2024-03-28 14:40:00,44,32,16,45,18,14,169
2024-03-28 14:50:00,47,29,22,41,22,8,169
2024-03-28 15:00:00,45,31,24,45,19,13,177
2024-03-28 15:10:00,47,35,24,45,23,12,186
2024-03-28 15:20:00,39,28,20,39,28,12,166
2024-03-28 15:30:00,53,27,13,49,21,11,174
2024-03-28 15:40:00,43,36,20,53,7,21,180
2024-03-28 15:50:00,48,33,25,29,26,11,172
2024-03-28 16:00:00,31,29,8,55,28,9,160
2024-03-28 16:10:00,62,24,4,52,25,6,173
2024-03-28 16:20:00,38,20,13,39,22,10,142
2024-03-28 16:30:00,49,27,12,46,17,9,160
2024-03-28 16:40:00,44,36,18,40,26,6,170
2024-03-28 16:50:00,48,30,22,39,22,10,171
2024-03-28 17:00:00,36,33,20,42,15,15,161
2024-03-28 17:10:00,49,27,20,47,25,8,176
2024-03-28 17:20:00,43,34,19,43,28,10,177
2024-03-28 17:30:00,45,32,21,38,24,22,182
2024-03-28 17:40:00,44,37,34,51,26,7,199
2024-03-28 17:50:00,33,25,18,44,17,10,147
2024-03-28 18:00:00,43,33,18,31,20,14,159
2024-03-28 18:10:00,47,33,21,51,22,12,186
2024-03-28 18:20:00,37,20,23,48,27,10,165
2024-03-28 18:30:00,41,29,23,38,20,8,159
2024-03-28 18:40:00,29,18,13,43,9,8,120
2024-03-28 18:50:00,37,31,20,43,26,6,163
2024-03-28 19:00:00,31,25,19,26,12,12,125
2024-03-28 19:10:00,33,22,29,33,30,7,154
2024-03-28 19:20:00,20,27,20,18,12,11,108
2024-03-28 19:30:00,37,25,15,19,14,9,119
2024-03-28 19:40:00,32,21,13,25,19,1,111
2024-03-28 19:50:00,35,27,26,33,21,3,145
2024-03-28 20:00:00,24,19,7,27,21,6,104
2024-03-28 20:10:00,25,18,21,26,21,4,115
2024-03-28 20:20:00,26,16,25,27,21,6,121
2024-03-28 20:30:00,17,17,14,27,24,7,106
2024-03-28 20:40:00,21,20,14,24,17,5,101
2024-03-28 20:50:00,15,14,9,23,14,2,77
2024-03-28 21:00:00,15,11,16,15,19,10,86
2024-03-28 21:10:00,20,13,12,15,16,2,78
2024-03-28 21:20:00,29,20,12,25,22,1,109
2024-03-28 21:30:00,21,15,16,26,26,5,109
2024-03-28 21:40:00,17,18,6,19,15,1,76
2024-03-28 21:50:00,8,8,2,19,18,0,55
2024-03-28 22:00:00,11,9,2,17,17,2,58
2024-03-28 22:10:00,13,10,5,16,12,0,56
2024-03-28 22:20:00,10,9,6,18,12,0,55
2024-03-28 22:30:00,8,8,5,19,14,0,54
2024-03-28 22:40:00,11,11,4,17,12,0,55
2024-03-28 22:50:00,6,5,7,8,7,3,36
2024-03-28 23:00:00,9,6,6,11,11,2,45
2024-03-28 23:10:00,10,9,2,8,6,1,36
2024-03-28 23:20:00,8,5,6,11,11,0,41
2024-03-28 23:30:00,10,9,3,9,8,0,39
2024-03-28 23:40:00,12,13,4,9,8,2,48
2024-03-28 23:50:00,9,7,2,9,10,0,37
2024-03-29 00:00:00,7,6,0,12,10,0,35
2024-03-29 00:10:00,3,4,2,7,8,0,24
2024-03-29 00:20:00,3,3,3,5,3,2,19
2024-03-29 00:30:00,3,3,4,11,7,0,28
2024-03-29 00:40:00,4,5,0,5,4,0,18
2024-03-29 00:50:00,2,3,5,5,6,1,22
2024-03-29 01:00:00,5,3,1,6,7,0,22
2024-03-29 01:10:00,1,1,0,4,4,0,10
2024-03-29 01:20:00,5,5,0,6,5,0,21
2024-03-29 01:30:00,4,4,0,7,5,0,20
2024-03-29 01:40:00,7,6,0,4,4,1,22
2024-03-29 01:50:00,3,4,3,5,5,0,20
2024-03-29 02:00:00,2,2,4,3,4,0,15
2024-03-29 02:10:00,3,3,2,1,1,0,10
2024-03-29 02:20:00,5,4,6,5,6,0,26
2024-03-29 02:30:00,0,0,4,2,4,1,11
2024-03-29 02:40:00,7,9,0,5,4,2,27
2024-03-29 02:50:00,1,1,1,4,3,0,10
2024-03-29 03:00:00,4,4,0,3,3,0,14
2024-03-29 03:10:00,1,1,0,3,3,0,8
2024-03-29 03:20:00,1,1,1,4,3,1,11
2024-03-29 03:30:00,2,2,0,3,3,0,10
2024-03-29 03:40:00,1,1,1,3,3,0,9
2024-03-29 03:50:00,1,1,0,3,3,0,8
2024-03-29 04:00:00,1,1,0,2,2,0,6
2024-03-29 04:10:00,1,1,0,1,1,2,6
2024-03-29 04:20:00,1,4,1,0,0,0,6
2024-03-29 04:30:00,2,2,5,3,4,0,16
2024-03-29 04:40:00,2,2,4,1,1,0,10
2024-03-29 04:50:00,4,2,0,1,2,0,9
2024-03-29 05:00:00,3,4,1,2,0,0,10
2024-03-29 05:10:00,1,1,1,2,2,0,7
2024-03-29 05:20:00,4,3,1,3,3,0,14
2024-03-29 05:30:00,5,4,7,3,4,0,23
2024-03-29 05:40:00,1,1,0,3,3,0,8
2024-03-29 05:50:00,0,0,0,3,2,0,5
2024-03-29 06:00:00,1,1,3,3,3,0,11
2024-03-29 06:10:00,1,1,0,4,4,0,10
2024-03-29 06:20:00,0,0,2,2,2,0,6
2024-03-29 06:30:00,4,4,5,5,5,0,23
2024-03-29 06:40:00,4,5,2,4,4,0,19
2024-03-29 06:50:00,1,1,5,3,2,0,12
2024-03-29 07:00:00,3,3,2,3,8,0,19
2024-03-29 07:10:00,2,9,3,5,5,2,26
2024-03-29 07:20:00,4,4,6,2,6,2,24
2024-03-29 07:30:00,5,6,7,8,8,2,36
2024-03-29 07:40:00,8,9,1,4,6,0,28
2024-03-29 07:50:00,7,7,3,7,6,0,30
2024-03-29 08:00:00,12,17,5,4,4,1,43
2024-03-29 08:10:00,9,10,0,5,5,4,33
2024-03-29 08:20:00,2,2,1,2,2,1,10
2024-03-29 08:30:00,7,9,3,9,8,0,36
2024-03-29 08:40:00,11,13,5,6,6,1,42
2024-03-29 08:50:00,16,17,9,13,10,0,65
2024-03-29 09:00:00,16,15,10,13,13,2,69
2024-03-29 09:10:00,12,15,13,11,11,2,64
2024-03-29 09:20:00,8,11,5,8,7,1,40
2024-03-29 09:30:00,11,9,13,12,9,5,59
2024-03-29 09:40:00,15,18,6,13,13,4,69
2024-03-29 09:50:00,22,23,10,16,15,4,90
2024-03-29 10:00:00,16,15,11,25,21,5,93
2024-03-29 10:10:00,21,20,16,10,7,2,76
2024-03-29 10:20:00,18,19,7,14,14,2,74
2024-03-29 10:30:00,17,22,9,16,16,2,82
2024-03-29 10:40:00,28,23,10,16,13,2,92
2024-03-29 10:50:00,19,21,4,21,26,4,95
2024-03-29 11:00:00,10,15,11,29,22,1,88
2024-03-29 11:10:00,17,19,9,20,20,3,88
2024-03-29 11:20:00,12,11,10,22,13,6,74
2024-03-29 11:30:00,24,23,16,20,16,1,100
2024-03-29 11:40:00,26,24,7,24,19,4,104
2024-03-29 11:50:00,13,13,11,15,13,3,68
2024-03-29 12:00:00,16,13,12,20,19,5,85
2024-03-29 12:10:00,17,15,12,16,15,2,77
2024-03-29 12:20:00,9,15,13,14,16,0,67
2024-03-29 12:30:00,24,16,13,26,32,0,111
2024-03-29 12:40:00,30,27,8,25,20,2,112
2024-03-29 12:50:00,19,21,7,25,22,6,100
2024-03-29 13:00:00,16,16,16,19,16,4,87
2024-03-29 13:10:00,18,23,13,19,12,2,87
2024-03-29 13:20:00,19,20,14,18,18,1,90
2024-03-29 13:30:00,12,13,9,15,14,4,67
2024-03-29 13:40:00,16,16,8,15,13,2,70
2024-03-29 13:50:00,15,14,13,16,15,4,77
2024-03-29 14:00:00,22,19,13,20,19,1,94
2024-03-29 14:10:00,25,16,9,23,18,8,99
2024-03-29 14:20:00,24,25,13,29,21,1,113
2024-03-29 14:30:00,21,21,14,33,20,3,112
2024-03-29 14:40:00,24,18,12,25,15,9,103
2024-03-29 14:50:00,30,23,20,32,29,4,138
2024-03-29 15:00:00,27,22,18,28,18,10,123
2024-03-29 15:10:00,24,20,11,25,10,3,93
2024-03-29 15:20:00,19,20,14,16,18,3,90
2024-03-29 15:30:00,30,25,9,29,20,9,122
2024-03-29 15:40:00,20,19,7,16,11,2,75
2024-03-29 15:50:00,14,16,14,9,9,3,65
2024-03-29 16:00:00,19,16,12,24,13,5,89
2024-03-29 16:10:00,30,17,13,20,20,5,105
2024-03-29 16:20:00,24,25,2,25,19,1,96
2024-03-29 16:30:00,23,22,16,28,20,8,117
2024-03-29 16:40:00,16,14,11,22,13,2,78
2024-03-29 16:50:00,19,18,9,14,15,7,82
2024-03-29 17:00:00,16,17,13,22,17,3,88
2024-03-29 17:10:00,24,22,18,25,17,2,108
2024-03-29 17:20:00,16,15,11,22,16,6,86
2024-03-29 17:30:00,19,15,16,30,22,2,104
2024-03-29 17:40:00,36,25,5,16,14,2,98
2024-03-29 17:50:00,16,17,9,21,18,2,83
2024-03-29 18:00:00,27,23,10,17,21,8,106
2024-03-29 18:10:00,24,20,10,21,16,6,97
2024-03-29 18:20:00,14,12,13,11,9,2,61
2024-03-29 18:30:00,26,24,17,24,20,0,111
2024-03-29 18:40:00,14,13,18,31,19,4,99
2024-03-29 18:50:00,20,15,10,15,11,2,73
2024-03-29 19:00:00,17,23,10,20,11,2,83
2024-03-29 19:10:00,12,10,7,17,16,2,64
2024-03-29 19:20:00,9,8,11,17,17,5,67
2024-03-29 19:30:00,21,14,9,16,14,1,75
2024-03-29 19:40:00,22,14,7,17,19,4,83
2024-03-29 19:50:00,9,9,5,11,11,0,45
2024-03-29 20:00:00,18,13,5,11,8,6,61
2024-03-29 20:10:00,18,19,6,16,17,3,79
2024-03-29 20:20:00,11,7,11,11,9,1,50
2024-03-29 20:30:00,17,13,5,13,14,3,65
2024-03-29 20:40:00,20,17,4,19,15,3,78
2024-03-29 20:50:00,10,9,4,15,13,1,52
2024-03-29 21:00:00,10,12,6,15,11,1,55
2024-03-29 21:10:00,9,9,9,10,10,2,49
2024-03-29 21:20:00,12,13,3,15,13,1,57
2024-03-29 21:30:00,8,8,7,10,10,0,43
2024-03-29 21:40:00,7,7,7,11,9,0,41
2024-03-29 21:50:00,10,9,0,12,9,2,42
2024-03-29 22:00:00,11,8,4,16,11,1,51
2024-03-29 22:10:00,10,8,12,6,9,0,45
2024-03-29 22:20:00,8,6,3,18,15,2,52
2024-03-29 22:30:00,9,6,8,15,9,0,47
2024-03-29 22:40:00,7,6,1,8,7,2,31
2024-03-29 22:50:00,6,6,0,11,10,0,33
2024-03-29 23:00:00,6,5,2,6,5,2,26
2024-03-29 23:10:00,12,9,7,2,2,0,32
2024-03-29 23:20:00,4,4,1,6,6,0,21
2024-03-29 23:30:00,4,4,4,14,9,1,36
2024-03-29 23:40:00,1,1,5,9,7,3,26
2024-03-29 23:50:00,4,5,1,11,12,1,34
2024-03-30 00:00:00,9,7,1,4,4,2,27
2024-03-30 00:10:00,1,1,1,9,7,1,20
2024-03-30 00:20:00,9,7,0,5,4,1,26
2024-03-30 00:30:00,5,3,0,7,6,0,21
2024-03-30 00:40:00,1,1,1,7,6,0,16
2024-03-30 00:50:00,6,8,1,6,7,1,29
2024-03-30 01:00:00,2,3,0,7,5,1,18
2024-03-30 01:10:00,7,9,0,4,4,0,24
2024-03-30 01:20:00,3,3,1,2,4,0,13
2024-03-30 01:30:00,3,3,1,5,6,0,18
2024-03-30 01:40:00,8,7,1,2,2,0,20
2024-03-30 01:50:00,2,2,0,3,3,1,11
2024-03-30 02:00:00,2,2,0,2,2,1,9
2024-03-30 02:10:00,3,3,3,5,5,0,19
2024-03-30 02:20:00,4,3,0,1,1,0,9
2024-03-30 02:30:00,1,1,3,3,3,0,11
2024-03-30 02:40:00,2,2,1,3,3,0,11
2024-03-30 02:50:00,3,3,2,1,1,0,10
2024-03-30 03:00:00,3,3,0,0,1,0,7
2024-03-30 03:10:00,1,1,0,1,1,0,4
2024-03-30 03:20:00,5,5,0,2,2,0,14
2024-03-30 03:30:00,1,1,0,2,1,0,5
2024-03-30 03:40:00,2,2,1,6,6,0,17
2024-03-30 03:50:00,3,4,0,0,0,0,7
2024-03-30 04:00:00,2,1,0,5,5,0,13
2024-03-30 04:10:00,0,0,1,3,2,0,6
2024-03-30 04:20:00,1,2,2,3,4,0,12
2024-03-30 04:30:00,5,5,3,7,5,0,25
2024-03-30 04:40:00,0,1,2,1,1,0,5
2024-03-30 04:50:00,2,2,4,2,2,1,13
2024-03-30 05:00:00,2,2,4,1,1,0,10
2024-03-30 05:10:00,3,3,5,7,7,1,26
2024-03-30 05:20:00,1,2,1,5,5,0,14
2024-03-30 05:30:00,4,3,1,4,4,2,18
2024-03-30 05:40:00,4,5,0,1,1,0,11
2024-03-30 05:50:00,2,1,2,4,4,0,13
2024-03-30 06:00:00,2,3,2,5,4,0,16
2024-03-30 06:10:00,7,6,0,4,8,0,25
2024-03-30 06:20:00,8,8,2,4,3,0,25
2024-03-30 06:30:00,9,9,7,10,9,1,45
2024-03-30 06:40:00,10,12,10,4,6,0,42
2024-03-30 06:50:00,11,11,4,6,7,2,41
2024-03-30 07:00:00,13,16,5,15,13,7,69
2024-03-30 07:10:00,8,8,16,10,9,2,53
2024-03-30 07:20:00,9,9,14,6,7,6,51
2024-03-30 07:30:00,16,15,16,16,15,3,81
2024-03-30 07:40:00,15,15,20,18,16,3,87
2024-03-30 07:50:00,20,19,23,15,17,11,105
2024-03-30 08:00:00,13,13,17,17,19,6,85
2024-03-30 08:10:00,18,24,24,21,21,3,111
2024-03-30 08:20:00,22,21,22,17,20,12,114
2024-03-30 08:30:00,25,21,25,15,18,2,106
2024-03-30 08:40:00,33,28,23,22,15,9,130
2024-03-30 08:50:00,25,18,27,20,22,5,117
2024-03-30 09:00:00,25,22,18,23,22,7,117
2024-03-30 09:10:00,26,21,20,35,23,6,131
2024-03-30 09:20:00,30,25,20,23,21,8,127
2024-03-30 09:30:00,45,23,26,36,20,5,155
2024-03-30 09:40:00,38,29,18,26,21,9,141
2024-03-30 09:50:00,32,32,24,34,21,7,150
2024-03-30 10:00:00,41,25,22,31,22,13,154
2024-03-30 10:10:00,44,32,18,33,22,1,150
2024-03-30 10:20:00,33,29,18,29,21,1,131
2024-03-30 10:30:00,37,22,29,31,17,0,136
2024-03-30 10:40:00,34,25,25,31,24,4,143
2024-03-30 10:50:00,38,24,18,36,19,11,146
2024-03-30 11:00:00,44,30,19,41,15,14,163
2024-03-30 11:10:00,30,25,15,34,19,8,131
2024-03-30 11:20:00,42,36,20,32,21,13,164
2024-03-30 11:30:00,32,26,18,43,26,7,152
2024-03-30 11:40:00,42,21,18,32,25,7,145
2024-03-30 11:50:00,28,27,17,30,24,8,134
2024-03-30 12:00:00,35,29,25,41,14,7,151
2024-03-30 12:10:00,42,31,19,31,18,10,151
2024-03-30 12:20:00,38,28,21,29,24,10,150
2024-03-30 12:30:00,46,29,17,39,26,7,164
2024-03-30 12:40:00,39,30,24,41,19,14,167
2024-03-30 12:50:00,36,30,17,28,21,5,137
2024-03-30 13:00:00,41,30,13,40,18,7,149
2024-03-30 13:10:00,34,35,20,36,17,8,150
2024-03-30 13:20:00,46,34,21,51,17,7,176
2024-03-30 13:30:00,42,25,16,29,16,6,134
2024-03-30 13:40:00,33,30,16,25,17,7,128
2024-03-30 13:50:00,35,28,21,47,23,10,164
2024-03-30 14:00:00,34,19,17,38,21,7,136
2024-03-30 14:10:00,37,27,22,28,22,11,147
2024-03-30 14:20:00,37,27,23,23,17,11,138
2024-03-30 14:30:00,32,29,23,50,24,10,168
2024-03-30 14:40:00,21,24,15,36,22,4,122
2024-03-30 14:50:00,29,28,17,34,18,8,134
2024-03-30 15:00:00,37,29,19,31,21,11,148
2024-03-30 15:10:00,38,27,29,25,16,5,140
2024-03-30 15:20:00,31,30,16,38,23,7,145
2024-03-30 15:30:00,36,29,14,20,14,5,118
2024-03-30 15:40:00,34,30,22,34,24,6,150
2024-03-30 15:50:00,29,29,21,26,20,6,131
2024-03-30 16:00:00,36,31,14,40,18,12,151
2024-03-30 16:10:00,28,27,13,37,22,5,132
2024-03-30 16:20:00,36,30,22,22,17,9,136
2024-03-30 16:30:00,28,26,25,30,22,13,144
2024-03-30 16:40:00,33,28,15,32,20,7,135
2024-03-30 16:50:00,34,33,16,28,15,10,136
2024-03-30 17:00:00,28,32,18,31,20,12,141
2024-03-30 17:10:00,33,27,18,41,25,10,154
2024-03-30 17:20:00,28,23,12,25,22,9,119
2024-03-30 17:30:00,30,29,17,23,22,4,125
2024-03-30 17:40:00,34,27,20,30,17,14,142
2024-03-30 17:50:00,28,27,19,32,19,11,136
2024-03-30 18:00:00,33,24,20,32,15,8,132
2024-03-30 18:10:00,29,27,22,26,11,7,122
2024-03-30 18:20:00,40,25,16,41,19,6,147
2024-03-30 18:30:00,39,33,19,29,24,4,148
2024-03-30 18:40:00,31,22,22,24,15,14,128
2024-03-30 18:50:00,25,19,12,37,23,2,118
2024-03-30 19:00:00,24,14,16,24,20,12,110
2024-03-30 19:10:00,20,14,17,23,18,4,96
2024-03-30 19:20:00,20,21,7,25,19,3,95
2024-03-30 19:30:00,20,14,8,19,17,5,83
2024-03-30 19:40:00,18,23,10,19,13,6,89
2024-03-30 19:50:00,15,12,16,19,12,4,78
2024-03-30 20:00:00,19,11,17,13,13,2,75
2024-03-30 20:10:00,24,19,21,15,17,7,103
2024-03-30 20:20:00,19,16,15,24,15,3,92
2024-03-30 20:30:00,26,19,12,19,15,1,92
2024-03-30 20:40:00,19,13,6,7,7,0,52
2024-03-30 20:50:00,9,7,11,14,13,1,55
2024-03-30 21:00:00,15,12,9,20,18,3,77
2024-03-30 21:10:00,9,9,5,7,10,2,42
2024-03-30 21:20:00,10,6,6,16,18,7,63
2024-03-30 21:30:00,12,10,10,14,12,0,58
2024-03-30 21:40:00,15,13,2,9,8,2,49
2024-03-30 21:50:00,7,8,8,17,9,0,49
2024-03-30 22:00:00,19,17,8,19,12,1,76
2024-03-30 22:10:00,9,9,6,11,9,4,48
2024-03-30 22:20:00,5,6,5,15,13,13,57
2024-03-30 22:30:00,16,13,3,25,14,0,71
2024-03-30 22:40:00,17,14,5,15,12,3,66
2024-03-30 22:50:00,21,17,4,10,12,2,66
2024-03-30 23:00:00,24,17,2,11,9,2,65
2024-03-30 23:10:00,9,5,6,13,13,4,50
2024-03-30 23:20:00,5,3,1,8,9,2,28
2024-03-30 23:30:00,15,7,3,9,8,0,42
2024-03-30 23:40:00,1,1,6,7,6,5,26
2024-03-30 23:50:00,5,4,1,0,0,2,12
2024-03-31 00:00:00,6,3,0,6,6,0,21
2024-03-31 00:10:00,6,4,1,4,3,1,19
2024-03-31 00:20:00,6,6,3,9,8,1,33
2024-03-31 00:30:00,6,4,1,11,10,0,32
2024-03-31 00:40:00,9,3,4,5,3,0,24
2024-03-31 00:50:00,2,3,0,6,5,0,16
2024-03-31 01:00:00,4,2,4,7,6,2,25
2024-03-31 01:10:00,6,5,1,5,3,0,20
2024-03-31 01:20:00,4,4,1,7,4,0,20
2024-03-31 01:30:00,8,7,0,4,4,1,24
2024-03-31 01:40:00,5,5,1,5,5,0,21
2024-03-31 01:50:00,1,1,0,1,1,0,4
2024-03-31 02:00:00,0,0,0,0,0,0,0
2024-03-31 02:10:00,0,0,0,0,0,0,0
2024-03-31 02:20:00,0,0,0,0,0,0,0
2024-03-31 02:30:00,0,0,0,0,0,0,0
2024-03-31 02:40:00,0,0,0,0,0,0,0
2024-03-31 02:50:00,0,0,0,0,0,0,0
2024-03-31 03:00:00,0,0,0,0,0,0,0
2024-03-31 03:10:00,0,0,0,0,0,0,0
2024-03-31 03:20:00,0,0,0,0,0,0,0
2024-03-31 03:30:00,0,0,0,0,0,0,0
2024-03-31 03:40:00,0,0,0,0,0,0,0
2024-03-31 03:50:00,0,0,0,0,0,0,0
2024-03-31 04:00:00,3,4,1,0,0,0,8
2024-03-31 04:10:00,2,4,3,1,1,0,11
2024-03-31 04:20:00,1,1,0,2,2,0,6
2024-03-31 04:30:00,4,5,1,3,2,0,15
2024-03-31 04:40:00,2,3,2,3,3,0,13
2024-03-31 04:50:00,2,2,1,3,3,0,11
2024-03-31 05:00:00,3,12,2,3,5,0,25
2024-03-31 05:10:00,1,1,2,1,1,0,6
2024-03-31 05:20:00,0,0,1,5,4,0,10
2024-03-31 05:30:00,9,7,0,4,4,0,24
2024-03-31 05:40:00,4,5,1,6,6,1,23
2024-03-31 05:50:00,2,1,2,2,1,1,9
2024-03-31 06:00:00,2,3,1,8,5,1,20
2024-03-31 06:10:00,2,3,1,6,4,0,16
2024-03-31 06:20:00,2,3,0,3,3,0,11
2024-03-31 06:30:00,1,1,1,5,4,0,12
2024-03-31 06:40:00,3,4,2,3,3,0,15
2024-03-31 06:50:00,5,5,2,6,6,0,24
2024-03-31 07:00:00,3,3,3,7,7,0,23
2024-03-31 07:10:00,4,4,2,1,1,0,12
2024-03-31 07:20:00,1,2,3,3,3,0,12
2024-03-31 07:30:00,5,5,1,5,4,1,21
2024-03-31 07:40:00,3,3,4,4,4,0,18
2024-03-31 07:50:00,4,6,4,7,7,0,28
2024-03-31 08:00:00,5,5,4,8,8,2,32
2024-03-31 08:10:00,6,10,6,6,6,2,36
2024-03-31 08:20:00,7,6,6,8,10,3,40
2024-03-31 08:30:00,15,13,6,8,7,0,49
2024-03-31 08:40:00,10,16,9,5,4,2,46
2024-03-31 08:50:00,12,14,5,11,13,3,58
2024-03-31 09:00:00,11,10,6,14,14,2,57
2024-03-31 09:10:00,7,7,8,5,4,3,34
2024-03-31 09:20:00,8,10,4,9,8,4,43
2024-03-31 09:30:00,15,17,10,14,12,2,70
2024-03-31 09:40:00,18,15,9,14,10,3,69
2024-03-31 09:50:00,23,19,8,18,13,5,86
2024-03-31 10:00:00,18,19,13,18,17,2,87
2024-03-31 10:10:00,19,23,11,17,18,4,92
2024-03-31 10:20:00,24,22,6,16,14,7,89
2024-03-31 10:30:00,22,17,4,17,13,0,73
2024-03-31 10:40:00,21,20,12,22,22,5,102
2024-03-31 10:50:00,19,15,11,21,16,6,88
2024-03-31 11:00:00,20,19,14,9,13,4,79
2024-03-31 11:10:00,21,21,16,26,25,8,117
2024-03-31 11:20:00,19,28,10,21,20,6,104
2024-03-31 11:30:00,21,22,12,23,14,8,100
2024-03-31 11:40:00,22,20,13,15,10,9,89
2024-03-31 11:50:00,23,20,9,21,21,5,99
2024-03-31 12:00:00,31,27,18,21,12,5,114
2024-03-31 12:10:00,23,18,11,28,20,4,104
2024-03-31 12:20:00,24,24,11,20,18,11,108
2024-03-31 12:30:00,21,18,12,34,19,3,107
2024-03-31 12:40:00,25,23,14,22,20,3,107
2024-03-31 12:50:00,21,20,9,18,21,5,94
2024-03-31 13:00:00,26,25,10,35,21,6,123
2024-03-31 13:10:00,25,24,15,22,16,3,105
2024-03-31 13:20:00,21,25,8,21,22,7,104
2024-03-31 13:30:00,20,17,13,26,21,6,103
2024-03-31 13:40:00,23,16,17,20,18,5,99
2024-03-31 13:50:00,25,24,15,23,32,3,122
2024-03-31 14:00:00,27,24,16,22,29,6,124
2024-03-31 14:10:00,16,14,9,30,13,2,84
2024-03-31 14:20:00,22,22,14,18,17,8,101
2024-03-31 14:30:00,29,25,10,32,23,3,122
2024-03-31 14:40:00,24,25,9,26,17,6,107
2024-03-31 14:50:00,23,23,15,27,22,3,113
2024-03-31 15:00:00,33,28,5,31,24,3,124
2024-03-31 15:10:00,19,18,16,27,20,4,104
2024-03-31 15:20:00,20,19,10,23,13,4,89
2024-03-31 15:30:00,23,22,16,33,20,2,116
2024-03-31 15:40:00,34,24,11,27,15,1,112
2024-03-31 15:50:00,23,22,15,26,21,4,111
2024-03-31 16:00:00,28,26,7,27,17,4,109
2024-03-31 16:10:00,15,17,18,28,19,6,103
2024-03-31 16:20:00,14,16,14,21,11,5,81
2024-03-31 16:30:00,24,25,13,29,20,4,115
2024-03-31 16:40:00,20,16,13,40,13,8,110
2024-03-31 16:50:00,32,28,14,22,17,5,118
2024-03-31 17:00:00,27,28,14,24,26,6,125
2024-03-31 17:10:00,32,18,13,23,16,3,105
2024-03-31 17:20:00,27,25,10,34,28,2,126
2024-03-31 17:30:00,37,30,11,26,22,12,138
2024-03-31 17:40:00,24,22,11,25,19,8,109
2024-03-31 17:50:00,19,18,21,23,19,5,105
2024-03-31 18:00:00,31,17,17,32,20,3,120
2024-03-31 18:10:00,18,23,10,36,27,3,117
2024-03-31 18:20:00,30,25,7,34,27,4,127
2024-03-31 18:30:00,27,12,13,27,19,8,106
2024-03-31 18:40:00,20,22,14,18,14,1,89
2024-03-31 18:50:00,32,24,16,23,21,5,121
2024-03-31 19:00:00,27,23,9,23,17,6,105
2024-03-31 19:10:00,26,16,14,32,16,2,106
2024-03-31 19:20:00,12,12,8,21,17,1,71
2024-03-31 19:30:00,24,19,8,21,18,4,94
2024-03-31 19:40:00,25,22,5,14,14,1,81
2024-03-31 19:50:00,11,20,2,17,13,2,65
2024-03-31 20:00:00,25,22,10,17,13,5,92
2024-03-31 20:10:00,24,19,2,18,17,0,80
2024-03-31 20:20:00,12,13,2,13,9,1,50
2024-03-31 20:30:00,15,12,5,15,10,1,58
2024-03-31 20:40:00,16,14,8,20,13,2,73
2024-03-31 20:50:00,13,12,10,14,10,3,62
2024-03-31 21:00:00,16,17,4,22,13,1,73
2024-03-31 21:10:00,16,13,6,15,15,5,70
2024-03-31 21:20:00,10,9,4,9,9,0,41
2024-03-31 21:30:00,14,10,12,16,10,4,66
2024-03-31 21:40:00,12,9,3,18,13,0,55
2024-03-31 21:50:00,14,11,2,29,16,2,74
2024-03-31 22:00:00,12,10,4,10,9,3,48
2024-03-31 22:10:00,11,10,5,13,7,1,47
2024-03-31 22:20:00,3,1,10,19,14,4,51
2024-03-31 22:30:00,8,7,8,14,9,0,46
2024-03-31 22:40:00,7,6,4,16,11,0,44
2024-03-31 22:50:00,10,7,1,12,8,0,38
2024-03-31 23:00:00,8,8,1,17,13,0,47
2024-03-31 23:10:00,10,9,4,13,6,1,43
2024-03-31 23:20:00,8,9,4,8,7,2,38
2024-03-31 23:30:00,4,3,1,6,2,3,19
2024-03-31 23:40:00,4,3,2,4,1,0,14
2024-03-31 23:50:00,8,6,1,3,2,1,21
2024-04-01 00:00:00,9,7,2,14,8,0,40
2024-04-01 00:10:00,6,6,3,5,5,0,25
2024-04-01 00:20:00,5,4,1,7,7,0,24
2024-04-01 00:30:00,13,14,1,7,6,0,41
2024-04-01 00:40:00,5,6,0,4,4,0,19
2024-04-01 00:50:00,4,4,1,6,3,0,18
2024-04-01 01:00:00,6,6,1,5,5,0,23
2024-04-01 01:10:00,4,5,0,9,7,0,25
2024-04-01 01:20:00,4,5,3,3,2,0,17
2024-04-01 01:30:00,4,3,3,9,8,0,27
2024-04-01 01:40:00,7,8,0,3,3,0,21
2024-04-01 01:50:00,5,5,1,2,4,1,18
2024-04-01 02:00:00,2,2,0,4,3,0,11
2024-04-01 02:10:00,3,4,0,5,3,0,15
2024-04-01 02:20:00,3,3,2,2,1,0,11
2024-04-01 02:30:00,3,4,2,6,4,1,20
2024-04-01 02:40:00,1,2,0,3,3,0,9
2024-04-01 02:50:00,1,1,1,5,5,0,13
2024-04-01 03:00:00,3,3,0,2,3,1,12
2024-04-01 03:10:00,0,0,2,4,4,0,10
2024-04-01 03:20:00,6,6,1,3,3,0,19
2024-04-01 03:30:00,0,0,0,2,2,0,4
2024-04-01 03:40:00,1,1,2,2,1,0,7
2024-04-01 03:50:00,0,0,0,2,2,1,5
2024-04-01 04:00:00,3,3,3,0,0,1,10
2024-04-01 04:10:00,2,2,1,2,2,0,9
2024-04-01 04:20:00,4,4,0,2,2,0,12
2024-04-01 04:30:00,2,3,2,2,2,0,11
2024-04-01 04:40:00,0,0,1,0,0,0,1
2024-04-01 04:50:00,0,6,1,0,0,0,7
2024-04-01 05:00:00,1,1,0,2,2,0,6
2024-04-01 05:10:00,1,1,3,2,2,0,9
2024-04-01 05:20:00,4,4,1,2,2,0,13
2024-04-01 05:30:00,5,3,1,1,1,0,11
2024-04-01 05:40:00,3,4,0,4,4,1,16
2024-04-01 05:50:00,2,2,0,6,7,0,17
2024-04-01 06:00:00,4,3,0,3,2,1,13
2024-04-01 06:10:00,2,2,1,6,0,0,11
2024-04-01 06:20:00,0,2,0,4,2,0,8
2024-04-01 06:30:00,3,3,2,9,6,0,23
2024-04-01 06:40:00,4,4,1,3,3,0,15
2024-04-01 06:50:00,3,5,5,4,2,0,19
2024-04-01 07:00:00,3,3,1,6,6,0,19
2024-04-01 07:10:00,1,2,3,2,2,0,10
2024-04-01 07:20:00,2,2,0,4,3,2,13
2024-04-01 07:30:00,5,14,3,8,7,0,37
2024-04-01 07:40:00,7,7,1,3,3,0,21
2024-04-01 07:50:00,3,4,2,4,3,0,16
2024-04-01 08:00:00,10,9,3,2,1,1,26
2024-04-01 08:10:00,4,5,3,5,5,1,23
2024-04-01 08:20:00,9,12,6,5,6,0,38
2024-04-01 08:30:00,7,10,4,7,7,3,38
2024-04-01 08:40:00,10,14,3,8,8,2,45
2024-04-01 08:50:00,8,8,2,11,10,2,41
2024-04-01 09:00:00,8,10,3,8,6,2,37
2024-04-01 09:10:00,14,14,3,18,15,2,66
2024-04-01 09:20:00,13,13,4,9,9,8,56
2024-04-01 09:30:00,15,17,9,10,11,3,65
2024-04-01 09:40:00,23,25,12,17,17,4,98
2024-04-01 09:50:00,28,30,9,15,15,3,100
2024-04-01 10:00:00,17,18,10,11,9,1,66
2024-04-01 10:10:00,18,13,7,16,15,1,70
2024-04-01 10:20:00,15,16,4,12,11,1,59
2024-04-01 10:30:00,15,17,9,17,13,2,73
2024-04-01 10:40:00,16,15,8,11,9,4,63
2024-04-01 10:50:00,17,22,9,24,11,9,92
2024-04-01 11:00:00,17,18,12,18,15,7,87
2024-04-01 11:10:00,26,26,10,17,15,2,96
2024-04-01 11:20:00,16,18,11,19,13,4,81
2024-04-01 11:30:00,25,31,11,32,20,4,123
2024-04-01 11:40:00,19,20,9,19,9,5,81
2024-04-01 11:50:00,20,22,27,27,19,3,118
2024-04-01 12:00:00,25,21,6,25,17,3,97
2024-04-01 12:10:00,23,24,7,25,16,2,97
2024-04-01 12:20:00,19,19,10,15,17,2,82
2024-04-01 12:30:00,14,16,12,26,18,1,87
2024-04-01 12:40:00,23,22,3,19,14,3,84
2024-04-01 12:50:00,23,23,11,20,19,6,102
2024-04-01 13:00:00,26,22,12,24,14,3,101
2024-04-01 13:10:00,21,19,14,12,11,2,79
2024-04-01 13:20:00,21,18,10,16,14,2,81
2024-04-01 13:30:00,24,26,10,23,16,2,101
2024-04-01 13:40:00,32,31,11,22,21,5,122
2024-04-01 13:50:00,15,18,15,21,18,4,91
2024-04-01 14:00:00,27,22,14,26,22,3,114
2024-04-01 14:10:00,28,23,14,29,21,6,121
2024-04-01 14:20:00,19,19,12,29,18,1,98
2024-04-01 14:30:00,31,26,10,23,19,3,112
2024-04-01 14:40:00,38,30,8,36,28,0,140
2024-04-01 14:50:00,20,22,7,23,19,2,93
2024-04-01 15:00:00,24,25,10,33,22,2,116
2024-04-01 15:10:00,21,24,14,35,24,1,119
2024-04-01 15:20:00,26,23,13,11,12,1,86
2024-04-01 15:30:00,28,24,9,24,17,3,105
2024-04-01 15:40:00,20,20,8,16,14,1,79
2024-04-01 15:50:00,23,21,11,12,9,2,78
2024-04-01 16:00:00,26,26,12,26,12,7,109
2024-04-01 16:10:00,27,24,10,22,15,6,104
2024-04-01 16:20:00,23,22,6,14,13,1,79
2024-04-01 16:30:00,16,16,14,26,22,4,98
2024-04-01 16:40:00,22,20,11,17,10,4,84
2024-04-01 16:50:00,18,22,14,34,29,3,120
2024-04-01 17:00:00,28,25,7,24,18,3,105
2024-04-01 17:10:00,26,19,12,21,14,4,96
2024-04-01 17:20:00,27,28,11,25,18,8,117
2024-04-01 17:30:00,20,18,7,22,17,1,85
2024-04-01 17:40:00,31,21,13,28,21,4,118
2024-04-01 17:50:00,16,19,13,21,16,2,87
2024-04-01 18:00:00,26,16,9,25,15,2,93
2024-04-01 18:10:00,30,27,10,18,17,5,107
2024-04-01 18:20:00,14,14,15,16,13,3,75
2024-04-01 18:30:00,22,26,12,19,19,5,103
2024-04-01 18:40:00,22,16,6,29,25,5,103
2024-04-01 18:50:00,20,17,11,19,15,4,86
2024-04-01 19:00:00,21,17,18,26,14,3,99
2024-04-01 19:10:00,25,19,12,30,22,3,111
2024-04-01 19:20:00,21,16,12,19,15,6,89
2024-04-01 19:30:00,22,19,10,21,20,3,95
2024-04-01 19:40:00,17,14,8,24,23,2,88
2024-04-01 19:50:00,10,14,16,27,25,0,92
2024-04-01 20:00:00,19,14,12,19,18,1,83
2024-04-01 20:10:00,13,10,6,18,10,1,58
2024-04-01 20:20:00,13,9,10,12,11,3,58
2024-04-01 20:30:00,15,12,7,16,7,0,57
2024-04-01 20:40:00,18,15,2,14,10,5,64
2024-04-01 20:50:00,14,12,9,13,10,4,62
2024-04-01 21:00:00,8,8,7,12,8,0,43
2024-04-01 21:10:00,14,12,1,12,9,0,48
2024-04-01 21:20:00,10,10,3,13,13,3,52
2024-04-01 21:30:00,9,10,5,14,11,2,51
2024-04-01 21:40:00,13,12,6,15,17,0,63
2024-04-01 21:50:00,8,7,2,10,9,0,36
2024-04-01 22:00:00,9,7,3,6,5,2,32
2024-04-01 22:10:00,16,12,3,10,11,1,53
2024-04-01 22:20:00,14,17,3,15,12,1,62
2024-04-01 22:30:00,8,7,6,13,9,2,45
2024-04-01 22:40:00,7,8,4,9,10,2,40
2024-04-01 22:50:00,9,9,5,12,14,2,51
2024-04-01 23:00:00,9,7,5,10,8,0,39
2024-04-01 23:10:00,1,3,4,8,6,1,23
2024-04-01 23:20:00,4,5,0,12,11,0,32
2024-04-01 23:30:00,5,6,1,6,6,2,26
2024-04-01 23:40:00,9,8,0,7,6,0,30
2024-04-01 23:50:00,10,7,3,5,5,0,30
2024-04-02 00:00:00,5,5,3,4,6,0,23
2024-04-02 00:10:00,4,2,2,5,5,1,19
2024-04-02 00:20:00,6,6,2,2,4,0,20
2024-04-02 00:30:00,4,4,2,11,10,1,32
2024-04-02 00:40:00,5,4,1,4,5,1,20
2024-04-02 00:50:00,4,4,0,3,2,1,14
2024-04-02 01:00:00,0,0,0,3,2,0,5
2024-04-02 01:10:00,4,4,2,4,4,0,18
2024-04-02 01:20:00,4,4,0,3,4,0,15
2024-04-02 01:30:00,3,3,1,5,3,0,15
2024-04-02 01:40:00,0,0,2,1,1,0,4
2024-04-02 01:50:00,5,5,2,5,6,0,23
2024-04-02 02:00:00,1,1,0,6,5,0,13
2024-04-02 02:10:00,2,2,5,1,1,0,11
2024-04-02 02:20:00,1,1,0,0,0,0,2
2024-04-02 02:30:00,2,2,1,4,5,0,14
2024-04-02 02:40:00,2,2,0,2,1,2,9
2024-04-02 02:50:00,1,1,1,1,1,0,5
2024-04-02 03:00:00,0,0,0,3,3,0,6
2024-04-02 03:10:00,1,1,1,1,0,0,4
2024-04-02 03:20:00,0,1,0,2,2,2,7
2024-04-02 03:30:00,0,2,0,4,5,1,12
2024-04-02 03:40:00,1,3,2,2,2,1,11
2024-04-02 03:50:00,1,1,4,1,1,0,8
2024-04-02 04:00:00,1,1,0,1,1,0,4
2024-04-02 04:10:00,3,5,3,2,3,0,16
2024-04-02 04:20:00,1,1,0,1,1,0,4
2024-04-02 04:30:00,3,3,0,4,7,0,17
2024-04-02 04:40:00,2,3,3,4,4,1,17
2024-04-02 04:50:00,5,5,2,6,5,0,23
2024-04-02 05:00:00,4,3,0,0,2,0,9
2024-04-02 05:10:00,5,5,3,5,4,1,23
2024-04-02 05:20:00,5,5,1,8,5,3,27
2024-04-02 05:30:00,6,4,10,5,6,0,31
2024-04-02 05:40:00,6,7,5,5,5,0,28
2024-04-02 05:50:00,5,5,9,6,5,0,30
2024-04-02 06:00:00,9,14,9,12,11,2,57
2024-04-02 06:10:00,13,13,4,9,12,3,54
2024-04-02 06:20:00,9,10,12,12,13,0,56
2024-04-02 06:30:00,17,17,10,18,9,5,76
2024-04-02 06:40:00,17,15,15,20,17,3,87
2024-04-02 06:50:00,15,14,4,17,16,0,66
2024-04-02 07:00:00,11,13,6,20,16,0,66
2024-04-02 07:10:00,18,22,10,31,17,6,104
2024-04-02 07:20:00,26,25,11,16,20,1,99
2024-04-02 07:30:00,21,18,15,26,19,4,103
2024-04-02 07:40:00,28,19,14,26,20,3,110
2024-04-02 07:50:00,31,26,16,19,22,6,120
2024-04-02 08:00:00,24,22,15,28,19,3,111
2024-04-02 08:10:00,30,26,15,32,18,8,129
2024-04-02 08:20:00,19,18,22,16,17,7,99
2024-04-02 08:30:00,29,25,18,25,18,8,123
2024-04-02 08:40:00,37,29,15,35,21,13,150
2024-04-02 08:50:00,28,23,18,31,30,10,140
2024-04-02 09:00:00,26,22,18,30,20,4,120
2024-04-02 09:10:00,38,29,15,31,15,6,134
2024-04-02 09:20:00,28,28,22,27,20,5,130
2024-04-02 09:30:00,41,31,18,27,14,5,136
2024-04-02 09:40:00,46,33,21,31,20,3,154
2024-04-02 09:50:00,38,20,18,24,14,5,119
2024-04-02 10:00:00,30,21,23,34,26,4,138
2024-04-02 10:10:00,35,30,20,30,23,6,144
2024-04-02 10:20:00,36,24,22,41,22,4,149
2024-04-02 10:30:00,53,28,24,23,22,6,156
2024-04-02 10:40:00,35,29,20,24,14,8,130
2024-04-02 10:50:00,32,27,28,32,22,8,149
2024-04-02 11:00:00,30,24,13,38,22,12,139
2024-04-02 11:10:00,33,22,26,35,21,12,149
2024-04-02 11:20:00,38,30,24,36,21,7,156
2024-04-02 11:30:00,35,26,21,43,23,7,155
2024-04-02 11:40:00,33,29,20,35,23,4,144
2024-04-02 11:50:00,42,32,19,24,22,6,145
2024-04-02 12:00:00,28,27,18,40,15,7,135
2024-04-02 12:10:00,33,30,20,34,23,3,143
2024-04-02 12:20:00,23,19,24,37,18,8,129
2024-04-02 12:30:00,38,19,24,33,29,2,145
2024-04-02 12:40:00,27,22,23,25,12,5,114
2024-04-02 12:50:00,48,25,16,35,17,2,143
2024-04-02 13:00:00,24,24,14,25,17,7,111
2024-04-02 13:10:00,32,27,24,32,18,6,139
2024-04-02 13:20:00,20,19,11,32,25,7,114
2024-04-02 13:30:00,33,30,19,29,14,7,132
2024-04-02 13:40:00,29,22,12,20,17,7,107
2024-04-02 13:50:00,27,26,13,27,22,2,117
2024-04-02 14:00:00,36,37,17,30,19,11,150
2024-04-02 14:10:00,34,35,25,35,15,7,151
2024-04-02 14:20:00,35,20,22,25,21,11,134
2024-04-02 14:30:00,39,39,9,47,36,12,182
2024-04-02 14:40:00,33,29,16,42,36,5,161
2024-04-02 14:50:00,42,27,14,43,29,9,164
2024-04-02 15:00:00,44,36,14,25,16,10,145
2024-04-02 15:10:00,33,22,19,38,27,4,143
2024-04-02 15:20:00,26,22,17,32,27,10,134
2024-04-02 15:30:00,46,28,23,39,26,8,170
2024-04-02 15:40:00,38,24,19,39,28,9,157
2024-04-02 15:50:00,32,32,17,37,28,8,154
2024-04-02 16:00:00,41,32,15,45,12,5,150
2024-04-02 16:10:00,37,29,16,44,29,8,163
2024-04-02 16:20:00,46,34,22,40,23,8,173
2024-04-02 16:30:00,50,34,12,44,18,10,168
2024-04-02 16:40:00,45,32,15,46,30,6,174
2024-04-02 16:50:00,44,31,15,46,34,9,179
2024-04-02 17:00:00,43,39,17,40,26,8,173
2024-04-02 17:10:00,47,38,25,44,22,8,184
2024-04-02 17:20:00,31,20,16,28,20,21,136
2024-04-02 17:30:00,45,20,22,41,16,4,148
2024-04-02 17:40:00,48,37,17,38,23,7,170
2024-04-02 17:50:00,53,32,19,40,22,11,177
2024-04-02 18:00:00,37,27,25,33,20,10,152
2024-04-02 18:10:00,32,23,29,26,13,0,123
2024-04-02 18:20:00,33,38,26,27,23,0,147
2024-04-02 18:30:00,33,29,19,40,20,4,145
2024-04-02 18:40:00,33,24,21,26,17,0,121
2024-04-02 18:50:00,26,20,14,28,20,10,118
2024-04-02 19:00:00,33,33,15,32,19,4,136
2024-04-02 19:10:00,22,22,16,35,26,11,132
2024-04-02 19:20:00,29,25,13,30,18,8,123
2024-04-02 19:30:00,21,15,16,28,27,4,111
2024-04-02 19:40:00,22,20,15,18,19,5,99
2024-04-02 19:50:00,22,16,14,28,20,1,101
2024-04-02 20:00:00,22,18,18,14,13,3,88
2024-04-02 20:10:00,13,13,14,27,12,3,82
2024-04-02 20:20:00,25,19,12,17,11,2,86
2024-04-02 20:30:00,17,11,15,11,10,0,64
2024-04-02 20:40:00,11,9,8,20,17,2,67
2024-04-02 20:50:00,15,13,11,13,12,4,68
2024-04-02 21:00:00,19,14,19,9,7,8,76
2024-04-02 21:10:00,18,11,14,14,10,2,69
2024-04-02 21:20:00,15,11,9,18,16,3,72
2024-04-02 21:30:00,6,6,12,12,12,1,49
2024-04-02 21:40:00,15,13,4,9,12,1,54
2024-04-02 21:50:00,13,10,8,10,9,4,54
2024-04-02 22:00:00,9,8,2,11,11,3,44
2024-04-02 22:10:00,10,9,1,7,9,0,36
2024-04-02 22:20:00,12,8,8,9,7,0,44
2024-04-02 22:30:00,7,6,2,8,6,3,32
2024-04-02 22:40:00,9,7,3,7,6,4,36
2024-04-02 22:50:00,7,6,9,10,8,0,40
2024-04-02 23:00:00,9,7,5,8,11,2,42
2024-04-02 23:10:00,1,1,0,5,6,0,13
2024-04-02 23:20:00,3,3,3,5,5,0,19
2024-04-02 23:30:00,6,7,0,7,6,2,28
2024-04-02 23:40:00,5,3,0,7,6,0,21
2024-04-02 23:50:00,3,2,0,8,7,1,21
2024-04-03 00:00:00,4,4,6,10,8,1,33
2024-04-03 00:10:00,3,3,2,5,5,0,18
2024-04-03 00:20:00,1,1,1,3,3,2,11
2024-04-03 00:30:00,3,3,0,8,7,0,21
2024-04-03 00:40:00,3,2,3,3,3,0,14
2024-04-03 00:50:00,2,2,0,3,4,1,12
2024-04-03 01:00:00,1,1,1,4,4,0,11
2024-04-03 01:10:00,2,2,2,1,1,0,8
2024-04-03 01:20:00,4,3,1,5,2,0,15
2024-04-03 01:30:00,3,3,0,0,0,0,6
2024-04-03 01:40:00,3,3,0,4,2,0,12
2024-04-03 01:50:00,1,1,0,2,2,0,6
2024-04-03 02:00:00,0,0,3,4,3,0,10
2024-04-03 02:10:00,1,1,1,1,1,0,5
2024-04-03 02:20:00,0,0,0,3,2,0,5
2024-04-03 02:30:00,2,4,2,0,1,0,9
2024-04-03 02:40:00,1,1,0,2,2,0,6
2024-04-03 02:50:00,1,1,1,1,1,0,5
2024-04-03 03:00:00,0,0,0,1,1,0,2
2024-04-03 03:10:00,1,0,0,1,1,0,3
2024-04-03 03:20:00,3,2,0,3,2,0,10
2024-04-03 03:30:00,1,8,0,2,2,0,13
2024-04-03 03:40:00,2,2,1,4,9,0,18
2024-04-03 03:50:00,0,0,1,4,3,0,8
2024-04-03 04:00:00,3,3,3,2,2,0,13
2024-04-03 04:10:00,2,5,1,3,3,0,14
2024-04-03 04:20:00,1,0,0,1,1,0,3
2024-04-03 04:30:00,5,4,2,3,5,2,21
2024-04-03 04:40:00,2,2,0,1,1,1,7
2024-04-03 04:50:00,6,5,3,3,4,0,21
2024-04-03 05:00:00,3,3,1,3,2,0,12
2024-04-03 05:10:00,6,8,1,3,1,3,22
2024-04-03 05:20:00,1,1,0,5,5,0,12
2024-04-03 05:30:00,11,11,7,6,4,0,39
2024-04-03 05:40:00,6,7,4,6,4,0,27
2024-04-03 05:50:00,10,8,5,7,7,0,37
2024-04-03 06:00:00,9,11,2,11,9,1,43
2024-04-03 06:10:00,13,12,3,8,4,2,42
2024-04-03 06:20:00,10,12,6,16,14,0,58
2024-04-03 06:30:00,15,14,7,15,11,1,63
2024-04-03 06:40:00,18,17,10,12,11,0,68
2024-04-03 06:50:00,17,21,13,21,17,1,90
2024-04-03 07:00:00,15,14,10,24,17,3,83
2024-04-03 07:10:00,16,14,10,17,12,3,72
2024-04-03 07:20:00,17,18,15,22,16,5,93
2024-04-03 07:30:00,19,15,11,18,14,5,82
2024-04-03 07:40:00,20,18,14,28,23,5,108
2024-04-03 07:50:00,32,30,12,31,27,5,137
2024-04-03 08:00:00,30,24,19,25,20,4,122
2024-04-03 08:10:00,26,20,17,28,18,1,110
2024-04-03 08:20:00,29,26,22,26,21,10,134
2024-04-03 08:30:00,28,26,19,34,26,10,143
2024-04-03 08:40:00,31,31,20,26,26,8,142
2024-04-03 08:50:00,32,31,14,31,32,5,145
2024-04-03 09:00:00,25,27,21,24,24,8,129
2024-04-03 09:10:00,36,30,25,30,26,6,153
2024-04-03 09:20:00,22,25,24,23,22,4,120
2024-04-03 09:30:00,35,32,22,38,14,10,151
2024-04-03 09:40:00,37,29,25,27,27,12,157
2024-04-03 09:50:00,43,28,17,32,23,3,146
2024-04-03 10:00:00,38,28,14,38,33,10,161
2024-04-03 10:10:00,26,29,24,40,25,4,148
2024-04-03 10:20:00,39,32,16,24,25,6,142
2024-04-03 10:30:00,36,28,21,32,18,8,143
2024-04-03 10:40:00,43,36,23,28,23,9,162
2024-04-03 10:50:00,32,33,23,30,18,8,144
2024-04-03 11:00:00,27,18,6,16,7,0,74
2024-04-03 11:10:00,41,23,16,32,8,4,124
2024-04-03 11:20:00,38,23,20,32,10,46,169
2024-04-03 11:30:00,36,19,29,27,14,6,131
2024-04-03 11:40:00,29,19,13,23,18,9,111
2024-04-03 11:50:00,33,35,15,31,19,8,141
2024-04-03 12:00:00,35,28,14,29,14,13,133
2024-04-03 12:10:00,32,32,17,29,21,6,137
2024-04-03 12:20:00,25,22,19,29,15,8,118
2024-04-03 12:30:00,35,25,23,36,29,8,156
2024-04-03 12:40:00,21,22,18,30,19,5,115
2024-04-03 12:50:00,22,25,15,26,21,5,114
2024-04-03 13:00:00,23,21,15,27,15,8,109
2024-04-03 13:10:00,31,24,21,26,17,5,124
2024-04-03 13:20:00,36,29,17,31,19,9,141
2024-04-03 13:30:00,24,21,14,27,18,4,108
2024-04-03 13:40:00,29,25,14,26,21,8,123
2024-04-03 13:50:00,33,31,12,31,19,1,127
2024-04-03 14:00:00,35,27,20,26,16,7,131
2024-04-03 14:10:00,28,28,16,27,20,7,126
2024-04-03 14:20:00,35,27,21,23,22,8,136
2024-04-03 14:30:00,31,25,21,33,17,12,139
2024-04-03 14:40:00,36,28,16,27,19,3,129
2024-04-03 14:50:00,37,27,20,35,15,7,141
2024-04-03 15:00:00,34,26,20,40,20,5,145
2024-04-03 15:10:00,42,37,25,37,27,8,176
2024-04-03 15:20:00,33,31,16,49,21,8,158
2024-04-03 15:30:00,30,22,18,40,31,2,143
2024-04-03 15:40:00,36,26,21,34,20,9,146
2024-04-03 15:50:00,36,30,20,35,18,14,153
2024-04-03 16:00:00,37,26,8,41,19,2,133
2024-04-03 16:10:00,34,29,19,32,24,5,143
2024-04-03 16:20:00,34,17,14,44,23,7,139
2024-04-03 16:30:00,45,20,16,58,21,5,165
2024-04-03 16:40:00,36,27,17,24,17,10,131
2024-04-03 16:50:00,57,41,20,46,30,9,203
2024-04-03 17:00:00,39,30,12,29,21,5,136
2024-04-03 17:10:00,37,33,16,37,13,9,145
2024-04-03 17:20:00,36,39,24,40,26,9,174
2024-04-03 17:30:00,47,40,16,28,14,11,156
2024-04-03 17:40:00,42,29,17,30,26,12,156
2024-04-03 17:50:00,42,26,20,26,17,7,138
2024-04-03 18:00:00,31,25,19,30,24,8,137
2024-04-03 18:10:00,31,25,15,29,18,11,129
2024-04-03 18:20:00,26,25,20,33,16,5,125
2024-04-03 18:30:00,39,33,19,34,16,4,145
2024-04-03 18:40:00,36,32,17,27,20,5,137
2024-04-03 18:50:00,30,24,19,36,29,26,164
2024-04-03 19:00:00,18,24,14,26,17,3,102
2024-04-03 19:10:00,37,28,21,21,19,4,130
2024-04-03 19:20:00,25,20,14,24,19,4,106
2024-04-03 19:30:00,32,25,17,24,13,9,120
2024-04-03 19:40:00,21,17,17,19,14,2,90
2024-04-03 19:50:00,26,28,14,25,21,3,117
2024-04-03 20:00:00,19,14,12,17,16,2,80
2024-04-03 20:10:00,19,13,21,35,18,1,107
2024-04-03 20:20:00,1,1,21,1,2,1,27
2024-04-03 20:30:00,0,0,17,0,0,0,17
2024-04-03 20:40:00,0,0,3,0,0,0,3
2024-04-03 20:50:00,0,0,10,0,0,4,14
2024-04-03 21:00:00,0,0,15,0,0,0,15
2024-04-03 21:10:00,0,0,11,0,0,6,17
2024-04-03 21:20:00,0,0,23,0,0,3,26
2024-04-03 21:30:00,0,0,6,0,0,0,6
2024-04-03 21:40:00,0,0,4,0,0,2,6
2024-04-03 21:50:00,0,0,2,0,0,0,2
2024-04-03 22:00:00,0,0,5,0,0,4,9
2024-04-03 22:10:00,0,0,7,0,0,1,8
2024-04-03 22:20:00,0,0,6,0,0,0,6
2024-04-03 22:30:00,0,0,4,0,0,1,5
2024-04-03 22:40:00,0,0,2,0,0,2,4
2024-04-03 22:50:00,4,2,2,6,5,1,20
2024-04-03 23:00:00,9,10,4,12,11,5,51
2024-04-03 23:10:00,8,7,99,13,10,0,137
2024-04-03 23:20:00,7,6,3,7,7,0,30
2024-04-03 23:30:00,6,10,2,7,7,0,32
2024-04-03 23:40:00,7,7,1,3,4,0,22
2024-04-03 23:50:00,3,2,0,6,6,0,17
2024-04-04 00:00:00,3,3,1,6,5,1,19
2024-04-04 00:10:00,2,2,2,0,0,0,6
2024-04-04 00:20:00,2,3,0,1,1,1,8
2024-04-04 00:30:00,5,6,0,8,6,0,25
2024-04-04 00:40:00,3,3,1,4,3,0,14
2024-04-04 00:50:00,0,1,2,4,3,0,10
2024-04-04 01:00:00,4,4,0,1,1,0,10
2024-04-04 01:10:00,1,1,0,4,3,0,9
2024-04-04 01:20:00,1,1,0,6,5,0,13
2024-04-04 01:30:00,1,1,1,3,3,0,9
2024-04-04 01:40:00,1,1,2,2,3,0,9
2024-04-04 01:50:00,2,2,0,0,0,0,4
2024-04-04 02:00:00,3,4,0,3,4,0,14
2024-04-04 02:10:00,0,0,0,2,2,0,4
2024-04-04 02:20:00,0,0,2,2,2,0,6
2024-04-04 02:30:00,0,0,0,2,2,0,4
2024-04-04 02:40:00,2,1,1,2,2,0,8
2024-04-04 02:50:00,2,2,0,3,2,0,9
2024-04-04 03:00:00,1,1,0,1,1,0,4
2024-04-04 03:10:00,0,0,0,1,1,0,2
2024-04-04 03:20:00,1,1,2,2,2,2,10
2024-04-04 03:30:00,1,5,1,2,2,0,11
2024-04-04 03:40:00,0,0,1,4,4,0,9
2024-04-04 03:50:00,2,2,2,0,0,0,6
2024-04-04 04:00:00,3,4,0,1,2,0,10
2024-04-04 04:10:00,0,0,0,2,2,0,4
2024-04-04 04:20:00,0,1,0,1,1,1,4
2024-04-04 04:30:00,2,2,1,3,2,0,10
2024-04-04 04:40:00,3,4,1,2,2,0,12
2024-04-04 04:50:00,3,3,4,4,4,0,18
2024-04-04 05:00:00,3,3,1,4,4,0,15
2024-04-04 05:10:00,4,4,0,3,3,0,14
2024-04-04 05:20:00,2,3,1,4,4,1,15
2024-04-04 05:30:00,9,9,4,6,5,0,33
2024-04-04 05:40:00,10,10,12,7,6,3,48
2024-04-04 05:50:00,5,8,2,8,7,0,30
2024-04-04 06:00:00,13,14,12,9,10,1,59
2024-04-04 06:10:00,14,15,7,7,7,0,50
2024-04-04 06:20:00,12,12,6,17,32,0,79
2024-04-04 06:30:00,14,15,11,9,10,0,59
2024-04-04 06:40:00,14,13,9,17,18,4,75
2024-04-04 06:50:00,18,12,10,22,11,3,76
2024-04-04 07:00:00,14,11,8,20,19,1,73
2024-04-04 07:10:00,19,18,11,21,20,1,90
2024-04-04 07:20:00,25,19,17,20,15,5,101
2024-04-04 07:30:00,21,22,16,19,17,4,99
2024-04-04 07:40:00,36,31,12,17,15,5,116
2024-04-04 07:50:00,32,30,12,35,16,5,130
2024-04-04 08:00:00,26,17,13,22,20,7,105
2024-04-04 08:10:00,29,22,12,24,16,9,112
2024-04-04 08:20:00,31,31,16,23,18,8,127
2024-04-04 08:30:00,27,19,18,29,18,24,135
2024-04-04 08:40:00,39,28,17,28,22,8,142
2024-04-04 08:50:00,32,25,21,27,19,8,132
2024-04-04 09:00:00,28,27,16,40,23,8,142
2024-04-04 09:10:00,24,31,18,36,29,4,142
2024-04-04 09:20:00,35,24,12,33,20,2,126
2024-04-04 09:30:00,37,28,17,19,17,2,120
2024-04-04 09:40:00,33,34,17,26,19,11,140
2024-04-04 09:50:00,36,34,17,36,25,7,155
2024-04-04 10:00:00,41,36,16,24,17,9,143
2024-04-04 10:10:00,33,28,21,39,26,10,157
2024-04-04 10:20:00,35,29,29,26,21,6,146
2024-04-04 10:30:00,37,24,19,29,23,4,136
2024-04-04 10:40:00,47,31,19,38,24,10,169
2024-04-04 10:50:00,36,34,19,28,25,8,150
2024-04-04 11:00:00,35,30,22,31,23,10,151
2024-04-04 11:10:00,43,34,30,34,25,6,172
2024-04-04 11:20:00,30,29,20,23,18,8,128
2024-04-04 11:30:00,25,18,24,49,13,4,133
2024-04-04 11:40:00,37,18,19,29,19,6,128
2024-04-04 11:50:00,35,29,26,29,15,8,142
2024-04-04 12:00:00,36,25,21,27,19,7,135
2024-04-04 12:10:00,33,27,16,33,19,3,131
2024-04-04 12:20:00,35,24,26,38,18,7,148
2024-04-04 12:30:00,28,27,16,24,14,3,112
2024-04-04 12:40:00,31,21,19,31,20,6,128
2024-04-04 12:50:00,21,12,20,33,24,4,114
2024-04-04 13:00:00,34,26,16,29,24,11,140
2024-04-04 13:10:00,40,34,29,38,17,8,166
2024-04-04 13:20:00,23,25,17,26,12,3,106
2024-04-04 13:30:00,28,23,15,21,49,6,142
2024-04-04 13:40:00,33,29,17,33,25,7,144
2024-04-04 13:50:00,35,23,16,23,17,3,117
2024-04-04 14:00:00,33,23,19,31,11,10,127
2024-04-04 14:10:00,32,24,21,33,16,8,134
2024-04-04 14:20:00,41,26,15,28,25,7,142
2024-04-04 14:30:00,37,31,16,39,15,10,148
2024-04-04 14:40:00,35,32,23,32,19,7,148
2024-04-04 14:50:00,34,25,22,26,23,8,138
2024-04-04 15:00:00,44,29,13,43,15,13,157
2024-04-04 15:10:00,43,27,25,46,24,7,172
2024-04-04 15:20:00,43,36,20,34,21,8,162
2024-04-04 15:30:00,39,36,18,53,33,7,186
2024-04-04 15:40:00,45,30,23,36,20,0,154
2024-04-04 15:50:00,32,30,22,51,22,5,162
2024-04-04 16:00:00,36,23,16,34,23,9,141
2024-04-04 16:10:00,47,26,16,43,25,7,164
2024-04-04 16:20:00,36,28,21,45,26,2,158
2024-04-04 16:30:00,42,23,23,54,11,20,173
2024-04-04 16:40:00,51,27,18,44,28,3,171
2024-04-04 16:50:00,39,21,26,35,24,7,152
2024-04-04 17:00:00,45,29,20,29,18,9,150
2024-04-04 17:10:00,45,34,21,40,31,7,178
2024-04-04 17:20:00,45,34,22,45,28,10,184
2024-04-04 17:30:00,39,27,28,41,19,15,169
2024-04-04 17:40:00,43,26,31,44,26,11,181
2024-04-04 17:50:00,46,30,20,46,26,8,176
2024-04-04 18:00:00,41,25,23,43,27,17,176
2024-04-04 18:10:00,36,32,20,38,22,7,155
2024-04-04 18:20:00,36,30,22,34,23,8,153
2024-04-04 18:30:00,41,32,16,36,28,6,159
2024-04-04 18:40:00,37,23,12,31,19,5,127
2024-04-04 18:50:00,24,24,8,35,17,11,119
2024-04-04 19:00:00,31,30,12,25,25,7,130
2024-04-04 19:10:00,37,26,19,43,21,4,150
2024-04-04 19:20:00,21,19,21,22,17,4,104
2024-04-04 19:30:00,24,25,14,26,19,7,115
2024-04-04 19:40:00,20,23,12,20,16,7,98
2024-04-04 19:50:00,22,17,18,20,19,8,104
2024-04-04 20:00:00,14,18,15,22,11,4,84
2024-04-04 20:10:00,19,15,14,14,12,27,101
2024-04-04 20:20:00,19,14,10,18,15,2,78
2024-04-04 20:30:00,18,12,8,18,14,0,70
2024-04-04 20:40:00,21,19,7,19,20,3,89
2024-04-04 20:50:00,16,10,12,21,20,0,79
2024-04-04 21:00:00,17,16,18,16,18,1,86
2024-04-04 21:10:00,14,10,11,9,12,4,60
2024-04-04 21:20:00,12,12,11,15,13,1,64
2024-04-04 21:30:00,14,9,14,14,10,1,62
2024-04-04 21:40:00,12,12,10,11,12,2,59
2024-04-04 21:50:00,7,8,4,17,14,1,51
2024-04-04 22:00:00,12,12,7,10,11,1,53
2024-04-04 22:10:00,11,6,9,9,10,0,45
2024-04-04 22:20:00,9,8,4,13,12,3,49
2024-04-04 22:30:00,10,10,8,17,12,1,58
2024-04-04 22:40:00,4,4,1,17,15,0,41
2024-04-04 22:50:00,4,3,5,12,7,2,33
2024-04-04 23:00:00,7,5,9,12,9,1,43
2024-04-04 23:10:00,5,7,4,10,10,1,37
2024-04-04 23:20:00,3,6,5,15,10,1,40
2024-04-04 23:30:00,8,8,1,6,7,1,31
2024-04-04 23:40:00,5,5,1,9,5,3,28
2024-04-04 23:50:00,5,4,0,4,4,0,17
2024-04-05 00:00:00,2,2,2,10,8,0,24
2024-04-05 00:10:00,6,9,0,3,2,0,20
2024-04-05 00:20:00,3,5,0,5,4,0,17
2024-04-05 00:30:00,3,3,0,2,3,0,11
2024-04-05 00:40:00,3,3,0,4,3,0,13
2024-04-05 00:50:00,2,1,0,6,5,2,16
2024-04-05 01:00:00,5,4,1,3,1,0,14
2024-04-05 01:10:00,6,5,0,2,1,0,14
2024-04-05 01:20:00,3,3,1,10,6,0,23
2024-04-05 01:30:00,3,2,1,3,3,0,12
2024-04-05 01:40:00,2,2,0,3,2,0,9
2024-04-05 01:50:00,2,2,1,3,3,0,11
2024-04-05 02:00:00,0,0,0,0,2,0,2
