datetime,D21Z,D22Z,D31Z,D32Z,D41Z,D42Z,D55Z,Total
2024-03-01 01:00:00,3,1,0,0,1,1,0,6
2024-03-01 01:10:00,4,3,0,0,6,1,0,14
2024-03-01 01:20:00,3,0,1,0,7,4,0,15
2024-03-01 01:30:00,1,0,0,0,3,2,0,6
2024-03-01 01:40:00,2,1,0,0,1,0,0,4
2024-03-01 01:50:00,3,2,1,0,2,0,0,8
2024-03-01 02:00:00,1,0,0,0,4,1,0,6
2024-03-01 02:10:00,3,1,0,0,0,0,0,4
2024-03-01 02:20:00,0,0,0,0,5,1,0,6
2024-03-01 02:30:00,2,1,0,0,5,4,0,12
2024-03-01 02:40:00,3,0,0,0,3,1,0,7
2024-03-01 02:50:00,1,1,0,0,3,0,0,5
2024-03-01 03:00:00,0,0,0,0,1,1,0,2
2024-03-01 03:10:00,0,0,0,0,0,0,0,0
2024-03-01 03:20:00,1,2,0,0,2,0,0,5
2024-03-01 03:30:00,3,2,1,0,4,1,0,11
2024-03-01 03:40:00,3,2,0,0,2,5,0,12
2024-03-01 03:50:00,1,2,0,0,5,4,0,12
2024-03-01 04:00:00,1,0,0,0,4,1,0,6
2024-03-01 04:10:00,3,2,0,0,3,0,0,8
2024-03-01 04:20:00,5,5,0,0,5,5,0,20
2024-03-01 04:30:00,4,3,0,0,6,1,0,14
2024-03-01 04:40:00,3,3,0,0,9,3,0,18
2024-03-01 04:50:00,5,2,0,0,5,1,0,13
2024-03-01 05:00:00,12,6,0,0,8,5,0,31
2024-03-01 05:10:00,17,6,0,0,8,6,0,37
2024-03-01 05:20:00,23,5,0,0,15,6,0,49
2024-03-01 05:30:00,33,9,0,0,15,5,0,62
2024-03-01 05:40:00,32,6,0,0,28,6,0,72
2024-03-01 05:50:00,46,4,1,1,35,6,0,93
2024-03-01 06:00:00,41,6,1,0,23,5,0,76
2024-03-01 06:10:00,48,3,0,0,45,4,0,100
2024-03-01 06:20:00,54,4,0,0,29,2,0,89
2024-03-01 06:30:00,69,6,0,3,39,4,0,121
2024-03-01 06:40:00,74,7,1,4,46,3,0,135
2024-03-01 06:50:00,78,9,0,3,54,7,0,151
2024-03-01 07:00:00,71,3,0,3,53,6,0,136
2024-03-01 07:10:00,90,12,3,5,59,8,0,177
2024-03-01 07:20:00,91,16,1,7,84,13,0,212
2024-03-01 07:30:00,64,19,9,15,113,13,0,233
2024-03-01 07:40:00,84,21,12,25,128,9,0,279
2024-03-01 07:50:00,64,16,12,23,95,6,0,216
2024-03-01 08:00:00,81,4,5,6,89,11,0,196
2024-03-01 08:10:00,78,11,0,6,72,7,0,174
2024-03-01 08:20:00,65,9,2,5,76,10,0,167
2024-03-01 08:30:00,66,9,8,10,61,11,0,165
2024-03-01 08:40:00,91,10,3,10,85,7,0,206
2024-03-01 08:50:00,62,8,6,9,72,7,0,164
2024-03-01 09:00:00,66,7,7,7,57,7,0,151
2024-03-01 09:10:00,69,8,9,10,66,9,0,171
2024-03-01 09:20:00,60,15,6,3,62,6,0,152
2024-03-01 09:30:00,61,8,3,7,62,9,0,150
2024-03-01 09:40:00,51,4,7,6,54,15,0,137
2024-03-01 09:50:00,46,7,2,9,59,10,0,133
2024-03-01 10:00:00,64,7,3,8,58,11,0,151
2024-03-01 10:10:00,59,5,4,3,49,9,0,129
2024-03-01 10:20:00,50,8,2,3,59,7,0,129
2024-03-01 10:30:00,59,7,0,5,65,7,0,143
2024-03-01 10:40:00,60,5,2,6,66,11,0,150
2024-03-01 10:50:00,65,6,1,4,58,9,0,143
2024-03-01 11:00:00,69,5,2,7,57,10,0,150
2024-03-01 11:10:00,56,8,3,2,56,15,0,140
2024-03-01 11:20:00,61,9,6,9,59,11,0,155
2024-03-01 11:30:00,60,8,5,11,76,7,0,167
2024-03-01 11:40:00,63,12,9,4,88,8,0,184
2024-03-01 11:50:00,65,10,8,12,71,7,0,173
2024-03-01 12:00:00,60,14,5,4,79,5,0,167
2024-03-01 12:10:00,74,8,3,7,90,13,0,195
2024-03-01 12:20:00,69,7,1,3,106,6,0,192
2024-03-01 12:30:00,68,9,3,8,88,15,0,191
2024-03-01 12:40:00,79,9,6,5,84,5,0,188
2024-03-01 12:50:00,74,11,4,6,77,9,0,181
2024-03-01 13:00:00,67,14,7,17,94,11,0,210
2024-03-01 13:10:00,85,12,15,20,94,13,0,239
2024-03-01 13:20:00,83,10,5,11,100,10,0,219
2024-03-01 13:30:00,63,7,4,12,87,9,0,182
2024-03-01 13:40:00,69,15,5,12,82,14,0,197
2024-03-01 13:50:00,63,16,5,4,84,9,0,181
2024-03-01 14:00:00,76,6,8,7,78,11,0,186
2024-03-01 14:10:00,82,6,7,7,94,6,0,202
2024-03-01 14:20:00,70,10,7,11,107,10,0,215
2024-03-01 14:30:00,81,6,6,10,92,9,0,204
2024-03-01 14:40:00,92,14,5,10,107,14,0,242
2024-03-01 14:50:00,61,15,6,12,89,10,0,193
2024-03-01 15:00:00,83,20,9,8,105,14,0,239
2024-03-01 15:10:00,83,14,6,11,91,8,0,213
2024-03-01 15:20:00,81,11,6,12,96,12,0,218
2024-03-01 15:30:00,91,19,7,10,109,16,0,252
2024-03-01 15:40:00,91,14,3,10,104,18,0,240
2024-03-01 15:50:00,85,10,5,15,91,9,0,215
2024-03-01 16:00:00,92,7,11,18,93,17,0,238
2024-03-01 16:10:00,88,11,7,8,105,11,0,230
2024-03-01 16:20:00,84,13,2,6,83,14,0,202
2024-03-01 16:30:00,82,6,12,15,79,10,0,204
2024-03-01 16:40:00,84,11,7,3,110,11,0,226
2024-03-01 16:50:00,88,8,9,10,82,12,0,209
2024-03-01 17:00:00,68,9,8,12,91,7,0,195
2024-03-01 17:10:00,81,11,8,7,98,13,0,218
2024-03-01 17:20:00,74,16,3,7,88,11,0,199
2024-03-01 17:30:00,66,8,5,14,83,23,0,199
2024-03-01 17:40:00,68,10,7,12,90,10,0,197
2024-03-01 17:50:00,58,8,6,7,102,9,0,190
2024-03-01 18:00:00,65,10,6,15,92,16,0,204
2024-03-01 18:10:00,70,8,6,9,84,10,0,187
2024-03-01 18:20:00,72,9,4,11,101,6,0,203
2024-03-01 18:30:00,66,10,8,7,89,9,0,189
2024-03-01 18:40:00,60,8,3,6,93,11,0,181
2024-03-01 18:50:00,69,8,8,5,78,13,0,181
2024-03-01 19:00:00,44,5,1,4,78,9,0,141
2024-03-01 19:10:00,48,5,5,11,70,8,0,147
2024-03-01 19:20:00,38,6,5,3,82,12,0,146
2024-03-01 19:30:00,44,4,2,5,62,9,0,126
2024-03-01 19:40:00,46,7,3,2,60,8,0,126
2024-03-01 19:50:00,41,5,4,3,45,4,0,102
2024-03-01 20:00:00,30,8,3,1,40,5,0,87
2024-03-01 20:10:00,37,2,1,5,40,4,0,89
2024-03-01 20:20:00,40,3,3,3,43,9,0,101
2024-03-01 20:30:00,32,3,2,4,38,11,0,90
2024-03-01 20:40:00,24,1,2,1,27,0,0,55
2024-03-01 20:50:00,30,9,0,0,27,10,0,76
2024-03-01 21:00:00,25,5,8,12,29,2,0,81
2024-03-01 21:10:00,40,5,6,2,34,4,0,91
2024-03-01 21:20:00,32,4,0,3,31,11,0,81
2024-03-01 21:30:00,25,3,1,4,36,2,0,71
2024-03-01 21:40:00,30,3,2,1,44,4,0,84
2024-03-01 21:50:00,21,4,2,0,36,7,0,70
2024-03-01 22:00:00,30,7,1,0,38,5,0,81
2024-03-01 22:10:00,23,6,1,1,29,6,0,66
2024-03-01 22:20:00,25,6,1,1,42,2,0,77
2024-03-01 22:30:00,33,4,0,2,35,5,0,79
2024-03-01 22:40:00,25,2,0,0,39,5,0,71
2024-03-01 22:50:00,24,3,0,1,29,7,0,64
2024-03-01 23:00:00,13,4,0,0,15,3,0,35
2024-03-01 23:10:00,18,7,1,3,26,7,0,62
2024-03-01 23:20:00,9,0,2,1,15,0,0,27
2024-03-01 23:30:00,13,6,1,0,15,2,0,37
2024-03-01 23:40:00,12,3,0,2,19,4,0,40
2024-03-01 23:50:00,5,2,0,0,22,3,0,32
2024-03-02 00:00:00,12,3,0,0,18,2,0,35
2024-03-02 00:10:00,11,1,0,1,8,7,0,28
2024-03-02 00:20:00,6,0,0,0,9,4,0,19
2024-03-02 00:30:00,4,0,1,5,11,2,0,23
2024-03-02 00:40:00,13,3,0,0,8,2,0,26
2024-03-02 00:50:00,7,3,0,0,6,1,0,17
2024-03-02 01:00:00,7,0,0,0,6,2,0,15
2024-03-02 01:10:00,1,0,0,0,7,3,0,11
2024-03-02 01:20:00,3,0,0,1,4,2,0,10
2024-03-02 01:30:00,7,4,0,0,2,0,0,13
2024-03-02 01:40:00,5,1,1,0,8,1,0,16
2024-03-02 01:50:00,4,0,0,1,6,2,0,13
2024-03-02 02:00:00,3,1,1,0,5,1,0,11
2024-03-02 02:10:00,4,2,0,0,6,1,0,13
2024-03-02 02:20:00,5,2,0,0,6,1,0,14
2024-03-02 02:30:00,2,1,0,0,4,1,0,8
2024-03-02 02:40:00,4,3,0,0,6,1,0,14
2024-03-02 02:50:00,9,3,0,1,7,3,0,23
2024-03-02 03:00:00,3,1,0,0,5,0,0,9
2024-03-02 03:10:00,2,3,0,0,5,4,0,14
2024-03-02 03:20:00,2,0,2,0,7,2,0,13
2024-03-02 03:30:00,3,1,0,0,4,1,0,9
2024-03-02 03:40:00,6,2,0,0,7,1,0,16
2024-03-02 03:50:00,2,2,0,0,5,2,0,11
2024-03-02 04:00:00,2,1,0,0,4,3,0,10
2024-03-02 04:10:00,6,0,0,0,4,1,0,11
2024-03-02 04:20:00,3,1,0,0,4,0,0,8
2024-03-02 04:30:00,4,4,0,0,5,7,0,20
2024-03-02 04:40:00,1,0,0,0,4,2,0,7
2024-03-02 04:50:00,10,4,0,0,5,2,0,21
2024-03-02 05:00:00,5,4,0,0,2,3,0,14
2024-03-02 05:10:00,7,3,0,0,8,3,0,21
2024-03-02 05:20:00,14,4,0,1,5,2,0,26
2024-03-02 05:30:00,8,1,0,0,7,2,0,18
2024-03-02 05:40:00,13,1,0,0,4,3,0,21
2024-03-02 05:50:00,3,1,0,0,11,2,0,17
2024-03-02 06:00:00,13,4,0,0,4,0,0,21
2024-03-02 06:10:00,11,3,1,0,8,3,0,26
2024-03-02 06:20:00,14,1,1,0,9,3,0,28
2024-03-02 06:30:00,8,1,1,0,7,1,0,18
2024-03-02 06:40:00,5,0,0,0,11,3,0,19
2024-03-02 06:50:00,17,5,0,2,16,3,0,43
2024-03-02 07:00:00,4,3,0,1,11,6,0,25
2024-03-02 07:10:00,13,4,0,1,12,2,0,32
2024-03-02 07:20:00,12,4,1,1,16,5,0,39
2024-03-02 07:30:00,10,0,0,1,10,1,0,22
2024-03-02 07:40:00,26,4,0,0,27,7,0,64
2024-03-02 07:50:00,16,4,1,2,15,5,0,43
2024-03-02 08:00:00,30,5,1,3,17,3,0,59
2024-03-02 08:10:00,21,8,0,0,20,4,0,53
2024-03-02 08:20:00,31,6,1,2,35,2,0,77
2024-03-02 08:30:00,39,7,1,4,30,3,0,84
2024-03-02 08:40:00,36,4,3,4,35,6,0,88
2024-03-02 08:50:00,33,5,1,1,32,7,0,79
2024-03-02 09:00:00,33,5,0,5,30,1,0,74
2024-03-02 09:10:00,55,1,2,4,31,4,0,97
2024-03-02 09:20:00,38,5,0,4,40,6,0,93
2024-03-02 09:30:00,48,4,0,4,48,4,0,108
2024-03-02 09:40:00,53,4,5,3,59,7,0,131
2024-03-02 09:50:00,51,4,4,6,67,8,0,140
2024-03-02 10:00:00,55,8,3,8,59,8,0,141
2024-03-02 10:10:00,45,6,3,2,62,3,0,121
2024-03-02 10:20:00,49,4,3,7,61,9,0,133
2024-03-02 10:30:00,69,10,5,8,47,12,0,151
2024-03-02 10:40:00,61,5,5,9,60,9,0,149
2024-03-02 10:50:00,48,8,0,6,62,10,0,134
2024-03-02 11:00:00,57,13,1,3,54,9,0,137
2024-03-02 11:10:00,47,5,2,8,79,12,0,153
2024-03-02 11:20:00,55,7,5,8,65,5,0,145
2024-03-02 11:30:00,56,11,6,3,64,8,0,148
2024-03-02 11:40:00,55,11,3,5,84,7,0,165
2024-03-02 11:50:00,51,1,3,7,70,6,0,138
2024-03-02 12:00:00,52,7,5,4,89,10,0,167
2024-03-02 12:10:00,62,6,1,8,72,18,0,167
2024-03-02 12:20:00,50,5,4,5,67,6,0,137
2024-03-02 12:30:00,56,10,4,4,66,13,0,153
2024-03-02 12:40:00,54,8,0,3,91,7,0,163
2024-03-02 12:50:00,49,5,2,3,71,5,0,135
2024-03-02 13:00:00,73,16,2,8,83,11,0,193
2024-03-02 13:10:00,71,15,3,2,85,10,0,186
2024-03-02 13:20:00,51,8,1,5,89,10,0,164
2024-03-02 13:30:00,51,11,4,6,91,8,0,171
2024-03-02 13:40:00,46,6,7,2,101,18,0,180
2024-03-02 13:50:00,50,8,3,8,107,16,0,192
2024-03-02 14:00:00,54,4,5,3,135,17,0,218
2024-03-02 14:10:00,51,4,1,9,125,15,0,205
2024-03-02 14:20:00,40,6,5,18,118,24,0,211
2024-03-02 14:30:00,62,9,5,6,126,19,0,227
2024-03-02 14:40:00,61,10,3,11,110,18,0,213
2024-03-02 14:50:00,61,4,0,3,107,13,0,188
2024-03-02 15:00:00,55,6,3,8,81,10,0,163
2024-03-02 15:10:00,47,7,3,3,89,18,0,167
2024-03-02 15:20:00,50,9,1,5,86,9,0,160
2024-03-02 15:30:00,35,10,1,7,68,14,0,135
2024-03-02 15:40:00,37,9,4,6,46,4,0,106
2024-03-02 15:50:00,44,9,9,10,54,6,0,132
2024-03-02 16:00:00,40,5,5,7,41,9,0,107
2024-03-02 16:10:00,56,5,3,4,52,7,0,127
2024-03-02 16:20:00,57,8,2,1,55,5,0,128
2024-03-02 16:30:00,55,13,3,4,42,12,0,129
2024-03-02 16:40:00,50,3,2,4,52,7,0,118
2024-03-02 16:50:00,51,7,4,8,66,10,0,146
2024-03-02 17:00:00,50,6,5,3,53,10,0,127
2024-03-02 17:10:00,57,4,17,15,53,10,0,156
2024-03-02 17:20:00,89,12,8,10,55,10,0,184
2024-03-02 17:30:00,118,15,7,8,64,14,0,226
2024-03-02 17:40:00,116,9,2,4,61,10,0,202
2024-03-02 17:50:00,120,12,7,9,45,9,0,202
2024-03-02 18:00:00,99,15,1,7,73,13,0,208
2024-03-02 18:10:00,101,6,6,6,54,8,0,181
2024-03-02 18:20:00,86,4,1,9,76,14,0,190
2024-03-02 18:30:00,69,5,2,5,67,5,0,153
2024-03-02 18:40:00,76,3,5,1,57,16,0,158
2024-03-02 18:50:00,83,7,1,3,54,10,0,158
2024-03-02 19:00:00,67,7,3,11,44,8,0,140
2024-03-02 19:10:00,55,6,0,3,46,5,0,115
2024-03-02 19:20:00,49,4,2,1,54,5,0,115
2024-03-02 19:30:00,49,6,2,5,47,5,0,114
2024-03-02 19:40:00,40,1,2,4,47,8,0,102
2024-03-02 19:50:00,58,5,0,1,43,5,0,112
2024-03-02 20:00:00,41,10,4,0,44,7,0,106
2024-03-02 20:10:00,29,5,0,1,36,5,0,76
2024-03-02 20:20:00,33,6,2,0,30,8,0,79
2024-03-02 20:30:00,35,6,3,0,36,9,0,89
2024-03-02 20:40:00,27,1,0,2,28,7,0,65
2024-03-02 20:50:00,23,3,0,0,40,9,0,75
2024-03-02 21:00:00,32,6,0,0,28,4,0,70
2024-03-02 21:10:00,23,2,1,4,27,4,0,61
2024-03-02 21:20:00,18,2,0,1,22,4,0,47
2024-03-02 21:30:00,24,5,0,2,22,4,0,57
2024-03-02 21:40:00,18,1,0,0,35,1,0,55
2024-03-02 21:50:00,15,1,0,0,23,4,0,43
2024-03-02 22:00:00,16,8,0,0,27,6,0,57
2024-03-02 22:10:00,16,2,0,1,19,1,0,39
2024-03-02 22:20:00,14,2,0,2,21,3,0,42
2024-03-02 22:30:00,20,7,0,0,28,7,0,62
2024-03-02 22:40:00,19,1,0,1,15,2,0,38
2024-03-02 22:50:00,15,3,0,1,29,5,0,53
2024-03-02 23:00:00,15,4,1,0,25,4,0,49
2024-03-02 23:10:00,20,5,1,0,28,7,0,61
2024-03-02 23:20:00,8,1,0,0,19,1,0,29
2024-03-02 23:30:00,18,5,0,0,22,5,0,50
2024-03-02 23:40:00,12,1,0,0,18,3,0,34
2024-03-02 23:50:00,11,2,1,0,16,3,0,33
2024-03-03 00:00:00,23,3,0,0,18,6,0,50
2024-03-03 00:10:00,6,1,1,2,28,5,0,43
2024-03-03 00:20:00,7,2,0,1,20,8,0,38
2024-03-03 00:30:00,13,2,1,0,11,2,0,29
2024-03-03 00:40:00,12,2,0,1,17,2,0,34
2024-03-03 00:50:00,6,2,1,0,17,7,0,33
2024-03-03 01:00:00,5,3,0,0,10,4,0,22
2024-03-03 01:10:00,9,4,0,0,16,4,0,33
2024-03-03 01:20:00,5,1,0,0,7,3,0,16
2024-03-03 01:30:00,9,2,0,0,4,2,0,17
2024-03-03 01:40:00,7,1,0,0,3,1,0,12
2024-03-03 01:50:00,4,2,0,0,7,2,0,15
2024-03-03 02:00:00,10,2,0,2,11,3,0,28
2024-03-03 02:10:00,4,0,1,2,9,0,0,16
2024-03-03 02:20:00,9,0,0,0,8,0,0,17
2024-03-03 02:30:00,5,2,0,0,6,1,0,14
2024-03-03 02:40:00,4,1,0,0,8,3,0,16
2024-03-03 02:50:00,9,3,0,1,7,3,0,23
2024-03-03 03:00:00,3,2,0,0,6,2,0,13
2024-03-03 03:10:00,3,2,0,0,5,0,0,10
2024-03-03 03:20:00,5,4,0,0,6,1,0,16
2024-03-03 03:30:00,2,0,0,0,0,3,0,5
2024-03-03 03:40:00,7,5,0,0,4,6,0,22
2024-03-03 03:50:00,5,1,0,0,6,1,0,13
2024-03-03 04:00:00,4,1,0,0,6,2,0,13
2024-03-03 04:10:00,6,3,0,0,2,0,0,11
2024-03-03 04:20:00,2,2,0,0,2,4,0,10
2024-03-03 04:30:00,3,1,0,0,5,3,0,12
2024-03-03 04:40:00,3,3,0,0,3,2,0,11
2024-03-03 04:50:00,8,3,0,0,5,5,0,21
2024-03-03 05:00:00,2,2,0,0,4,0,0,8
2024-03-03 05:10:00,7,2,0,0,3,1,0,13
2024-03-03 05:20:00,5,4,0,1,9,3,0,22
2024-03-03 05:30:00,5,1,0,0,2,1,0,9
2024-03-03 05:40:00,4,1,0,0,9,1,0,15
2024-03-03 05:50:00,5,1,0,0,6,3,0,15
2024-03-03 06:00:00,7,3,0,0,6,1,0,17
2024-03-03 06:10:00,13,4,0,0,5,1,0,23
2024-03-03 06:20:00,6,2,1,0,4,1,0,14
2024-03-03 06:30:00,7,1,1,0,1,0,0,10
2024-03-03 06:40:00,4,3,0,0,2,0,0,9
2024-03-03 06:50:00,8,2,0,0,4,2,0,16
2024-03-03 07:00:00,7,2,0,0,5,4,0,18
2024-03-03 07:10:00,5,1,0,0,6,1,0,13
2024-03-03 07:20:00,11,0,1,0,3,0,0,15
2024-03-03 07:30:00,6,2,0,1,5,1,0,15
2024-03-03 07:40:00,8,2,0,1,7,2,0,20
2024-03-03 07:50:00,8,0,1,1,6,2,0,18
2024-03-03 08:00:00,9,1,1,0,6,6,0,23
2024-03-03 08:10:00,4,1,0,1,8,1,0,15
2024-03-03 08:20:00,21,6,0,0,13,9,0,49
2024-03-03 08:30:00,12,3,2,1,19,6,0,43
2024-03-03 08:40:00,20,8,1,1,20,7,0,57
2024-03-03 08:50:00,22,4,1,1,27,7,0,62
2024-03-03 09:00:00,14,9,1,0,22,5,0,51
2024-03-03 09:10:00,32,3,1,0,27,4,0,67
2024-03-03 09:20:00,32,2,1,0,21,2,0,58
2024-03-03 09:30:00,43,11,2,2,37,3,0,98
2024-03-03 09:40:00,34,7,3,2,40,5,0,91
2024-03-03 09:50:00,32,5,2,1,35,8,0,83
2024-03-03 10:00:00,38,6,1,3,28,5,0,81
2024-03-03 10:10:00,30,7,3,1,31,2,0,74
2024-03-03 10:20:00,47,7,2,3,33,5,0,97
2024-03-03 10:30:00,39,6,0,1,39,8,0,93
2024-03-03 10:40:00,28,4,2,4,52,5,0,95
2024-03-03 10:50:00,41,7,1,2,43,6,0,100
2024-03-03 11:00:00,38,4,1,3,38,5,0,89
2024-03-03 11:10:00,35,7,0,4,46,8,0,100
2024-03-03 11:20:00,31,7,3,3,41,3,0,88
2024-03-03 11:30:00,42,7,1,1,52,7,0,110
2024-03-03 11:40:00,44,5,2,3,49,9,0,112
2024-03-03 11:50:00,43,2,1,13,62,9,0,130
2024-03-03 12:00:00,50,6,8,6,53,5,0,128
2024-03-03 12:10:00,50,10,4,2,74,9,0,149
2024-03-03 12:20:00,43,6,3,6,52,4,0,114
2024-03-03 12:30:00,65,6,1,4,60,6,0,142
2024-03-03 12:40:00,55,7,6,0,56,7,0,131
2024-03-03 12:50:00,48,9,4,2,50,6,0,119
2024-03-03 13:00:00,58,10,5,5,52,7,0,137
2024-03-03 13:10:00,50,10,1,4,65,5,0,135
2024-03-03 13:20:00,60,11,0,1,71,17,0,160
2024-03-03 13:30:00,48,8,4,5,46,8,0,119
2024-03-03 13:40:00,54,12,6,10,71,8,0,161
2024-03-03 13:50:00,62,7,4,5,56,8,0,142
2024-03-03 14:00:00,69,10,3,2,44,5,0,133
2024-03-03 14:10:00,49,13,4,3,58,9,0,136
2024-03-03 14:20:00,45,9,3,2,70,4,0,133
2024-03-03 14:30:00,60,12,5,6,51,8,0,142
2024-03-03 14:40:00,64,6,6,2,67,6,0,151
2024-03-03 14:50:00,51,4,3,6,69,6,0,139
2024-03-03 15:00:00,51,11,3,2,63,14,0,144
2024-03-03 15:10:00,53,17,3,2,59,10,0,144
2024-03-03 15:20:00,52,2,11,4,53,11,0,133
2024-03-03 15:30:00,37,6,5,3,44,9,0,104
2024-03-03 15:40:00,51,8,1,3,41,8,0,112
2024-03-03 15:50:00,48,7,5,1,64,6,0,131
2024-03-03 16:00:00,57,6,3,3,44,10,0,123
2024-03-03 16:10:00,49,10,5,1,34,9,0,108
2024-03-03 16:20:00,36,7,5,10,45,14,0,117
2024-03-03 16:30:00,41,7,2,6,40,11,0,107
2024-03-03 16:40:00,46,3,4,3,48,6,0,110
2024-03-03 16:50:00,67,10,3,7,56,9,0,152
2024-03-03 17:00:00,59,12,2,5,52,12,0,142
2024-03-03 17:10:00,61,4,6,1,66,6,0,144
2024-03-03 17:20:00,54,8,5,8,60,8,0,143
2024-03-03 17:30:00,75,10,3,4,53,8,0,153
2024-03-03 17:40:00,58,2,6,7,67,10,0,150
2024-03-03 17:50:00,50,9,4,6,63,14,0,146
2024-03-03 18:00:00,49,7,5,5,33,5,0,104
2024-03-03 18:10:00,53,5,2,5,62,10,0,137
2024-03-03 18:20:00,48,9,3,6,59,9,0,134
2024-03-03 18:30:00,37,8,1,2,44,9,0,101
2024-03-03 18:40:00,50,4,1,1,31,7,0,94
2024-03-03 18:50:00,35,5,3,2,48,7,0,100
2024-03-03 19:00:00,51,6,1,4,37,8,0,107
2024-03-03 19:10:00,51,5,1,0,33,6,0,96
2024-03-03 19:20:00,26,4,2,5,43,7,0,87
2024-03-03 19:30:00,23,2,6,0,33,5,0,69
2024-03-03 19:40:00,40,5,2,1,33,4,0,85
2024-03-03 19:50:00,25,7,0,1,29,6,0,68
2024-03-03 20:00:00,20,3,2,1,30,4,0,60
2024-03-03 20:10:00,16,4,0,4,28,1,0,53
2024-03-03 20:20:00,16,1,0,0,32,3,0,52
2024-03-03 20:30:00,19,2,0,1,33,4,0,59
2024-03-03 20:40:00,21,1,2,1,37,2,0,64
2024-03-03 20:50:00,17,6,0,0,28,5,0,56
2024-03-03 21:00:00,22,4,1,0,28,4,0,59
2024-03-03 21:10:00,16,2,0,1,20,2,0,41
2024-03-03 21:20:00,15,2,0,1,26,2,0,46
2024-03-03 21:30:00,21,4,0,0,14,1,0,40
2024-03-03 21:40:00,13,5,0,0,18,6,0,42
2024-03-03 21:50:00,12,2,0,0,17,5,0,36
2024-03-03 22:00:00,10,2,1,1,11,1,0,26
2024-03-03 22:10:00,12,2,0,1,24,2,0,41
2024-03-03 22:20:00,8,2,0,1,19,1,0,31
2024-03-03 22:30:00,12,3,0,1,10,2,0,28
2024-03-03 22:40:00,3,1,1,0,10,3,0,18
2024-03-03 22:50:00,5,2,0,0,17,4,0,28
2024-03-03 23:00:00,8,4,2,0,10,4,0,28
2024-03-03 23:10:00,5,1,0,0,11,3,0,20
2024-03-03 23:20:00,2,2,0,1,10,2,0,17
2024-03-03 23:30:00,1,0,0,0,7,2,0,10
2024-03-03 23:40:00,3,0,1,0,5,2,0,11
2024-03-03 23:50:00,1,0,0,1,7,0,0,9
2024-03-04 00:00:00,4,0,1,0,0,1,0,6
2024-03-04 00:10:00,5,1,0,0,3,0,0,9
2024-03-04 00:20:00,3,3,0,0,4,3,0,13
2024-03-04 00:30:00,4,0,0,1,3,0,0,8
2024-03-04 00:40:00,4,1,1,0,5,3,0,14
2024-03-04 00:50:00,6,3,0,0,3,3,0,15
2024-03-04 01:00:00,4,0,0,0,2,2,0,8
2024-03-04 01:10:00,4,0,0,1,3,1,0,9
2024-03-04 01:20:00,1,0,1,0,2,1,0,5
2024-03-04 01:30:00,4,2,0,0,3,1,0,10
2024-03-04 01:40:00,2,1,0,0,1,2,0,6
2024-03-04 01:50:00,1,1,0,0,0,1,0,3
2024-03-04 02:00:00,1,2,0,0,2,3,0,8
2024-03-04 02:10:00,2,0,0,0,3,0,0,5
2024-03-04 02:20:00,1,0,0,0,2,0,0,3
2024-03-04 02:30:00,0,0,0,0,1,0,0,1
2024-03-04 02:40:00,2,2,0,0,3,3,0,10
2024-03-04 02:50:00,0,0,0,0,1,0,0,1
2024-03-04 03:00:00,1,0,0,0,3,1,0,5
2024-03-04 03:10:00,2,2,0,0,4,2,0,10
2024-03-04 03:20:00,1,2,1,0,0,0,0,4
2024-03-04 03:30:00,5,4,0,0,1,2,0,12
2024-03-04 03:40:00,3,2,0,0,1,3,0,9
2024-03-04 03:50:00,3,2,0,0,2,1,0,8
2024-03-04 04:00:00,2,2,0,0,4,2,0,10
2024-03-04 04:10:00,4,3,0,0,6,3,0,16
2024-03-04 04:20:00,5,2,0,0,3,2,0,12
2024-03-04 04:30:00,3,6,0,0,10,6,0,25
2024-03-04 04:40:00,5,1,0,0,2,0,0,8
2024-03-04 04:50:00,6,2,0,0,8,1,0,17
2024-03-04 05:00:00,10,5,0,0,11,1,0,27
2024-03-04 05:10:00,23,7,0,0,11,7,0,48
2024-03-04 05:20:00,16,8,0,1,13,11,0,49
2024-03-04 05:30:00,37,10,0,0,26,7,0,80
2024-03-04 05:40:00,41,9,0,0,32,6,0,88
2024-03-04 05:50:00,57,5,1,1,37,3,0,104
2024-03-04 06:00:00,31,4,1,2,32,5,0,75
2024-03-04 06:10:00,46,4,0,0,37,1,0,88
2024-03-04 06:20:00,60,8,1,3,30,4,0,106
2024-03-04 06:30:00,84,7,1,3,38,7,0,140
2024-03-04 06:40:00,99,13,0,3,63,9,0,187
2024-03-04 06:50:00,58,9,1,4,67,4,0,143
2024-03-04 07:00:00,87,10,1,3,70,5,0,176
2024-03-04 07:10:00,109,5,1,4,78,11,0,208
2024-03-04 07:20:00,105,9,2,5,77,8,0,206
2024-03-04 07:30:00,103,18,5,6,109,12,0,253
2024-03-04 07:40:00,81,11,2,4,112,10,0,220
2024-03-04 07:50:00,85,7,5,4,115,13,0,229
2024-03-04 08:00:00,69,14,6,10,84,15,0,198
2024-03-04 08:10:00,89,13,0,4,97,8,0,211
2024-03-04 08:20:00,82,7,6,9,93,6,0,203
2024-03-04 08:30:00,77,9,5,8,65,11,0,175
2024-03-04 08:40:00,93,10,9,9,88,6,0,215
2024-03-04 08:50:00,69,11,7,7,63,7,0,164
2024-03-04 09:00:00,67,16,7,7,78,14,0,189
2024-03-04 09:10:00,52,8,4,9,46,8,0,127
2024-03-04 09:20:00,61,5,10,1,62,7,0,146
2024-03-04 09:30:00,67,7,2,5,42,1,0,124
2024-03-04 09:40:00,64,7,4,2,67,11,0,155
2024-03-04 09:50:00,55,6,3,5,57,7,0,133
2024-03-04 10:00:00,68,8,4,3,53,10,0,146
2024-03-04 10:10:00,57,8,5,5,59,9,0,143
2024-03-04 10:20:00,68,5,2,3,42,11,0,131
2024-03-04 10:30:00,66,5,1,4,45,6,0,127
2024-03-04 10:40:00,60,10,2,9,60,4,0,145
2024-03-04 10:50:00,68,9,5,5,48,16,0,151
2024-03-04 11:00:00,50,8,1,2,54,8,0,123
2024-03-04 11:10:00,61,11,2,9,48,7,0,138
2024-03-04 11:20:00,57,6,0,8,72,8,0,151
2024-03-04 11:30:00,57,3,4,7,70,14,0,155
2024-03-04 11:40:00,51,7,3,11,75,11,0,158
2024-03-04 11:50:00,54,8,3,7,57,6,0,135
2024-03-04 12:00:00,62,3,1,3,67,9,0,145
2024-03-04 12:10:00,54,10,1,4,59,7,0,135
2024-03-04 12:20:00,65,5,0,6,66,6,0,148
2024-03-04 12:30:00,64,9,9,2,62,14,0,160
2024-03-04 12:40:00,58,6,2,9,75,12,0,162
2024-03-04 12:50:00,51,7,6,9,78,7,0,158
2024-03-04 13:00:00,62,10,6,4,76,8,0,166
2024-03-04 13:10:00,83,12,3,4,74,7,0,183
2024-03-04 13:20:00,60,11,1,4,59,13,0,148
2024-03-04 13:30:00,71,9,5,4,62,12,0,163
2024-03-04 13:40:00,60,8,2,2,92,11,0,175
2024-03-04 13:50:00,53,5,4,3,82,9,0,156
2024-03-04 14:00:00,64,13,4,8,72,14,0,175
2024-03-04 14:10:00,68,10,4,9,94,10,0,195
2024-03-04 14:20:00,63,12,1,6,78,13,0,173
2024-03-04 14:30:00,59,9,4,8,83,10,0,173
2024-03-04 14:40:00,58,11,11,10,93,9,0,192
2024-03-04 14:50:00,74,14,3,5,105,10,0,211
2024-03-04 15:00:00,66,7,4,7,100,11,0,195
2024-03-04 15:10:00,57,9,11,12,99,13,0,201
2024-03-04 15:20:00,74,6,6,13,91,11,0,201
2024-03-04 15:30:00,86,8,11,14,96,7,0,222
2024-03-04 15:40:00,67,11,10,11,114,12,0,225
2024-03-04 15:50:00,91,19,9,15,90,19,0,243
2024-03-04 16:00:00,74,5,12,11,101,10,0,213
2024-03-04 16:10:00,68,9,7,11,105,7,0,207
2024-03-04 16:20:00,80,12,13,13,118,5,0,241
2024-03-04 16:30:00,65,6,21,22,124,10,0,248
2024-03-04 16:40:00,84,7,8,11,101,10,0,221
2024-03-04 16:50:00,84,13,7,8,132,11,0,255
2024-03-04 17:00:00,69,11,5,18,106,13,0,222
2024-03-04 17:10:00,86,14,5,7,97,13,0,222
2024-03-04 17:20:00,87,10,9,6,100,15,0,227
2024-03-04 17:30:00,72,9,8,14,109,17,0,229
2024-03-04 17:40:00,53,9,3,11,103,12,0,191
2024-03-04 17:50:00,70,12,9,11,98,11,0,211
2024-03-04 18:00:00,62,7,9,9,93,13,0,193
2024-03-04 18:10:00,70,9,6,18,103,15,0,221
2024-03-04 18:20:00,62,8,6,9,99,12,0,196
2024-03-04 18:30:00,61,12,7,8,86,10,0,184
2024-03-04 18:40:00,72,7,3,3,83,8,0,176
2024-03-04 18:50:00,56,4,4,10,80,9,0,163
2024-03-04 19:00:00,41,7,4,3,62,6,0,123
2024-03-04 19:10:00,44,12,3,4,55,6,0,124
2024-03-04 19:20:00,36,11,4,2,54,10,0,117
2024-03-04 19:30:00,39,9,1,3,48,8,0,108
2024-03-04 19:40:00,30,3,13,10,52,13,0,121
2024-03-04 19:50:00,22,2,3,10,37,12,0,86
2024-03-04 20:00:00,33,2,2,6,38,3,0,84
2024-03-04 20:10:00,36,1,8,7,47,3,0,102
2024-03-04 20:20:00,27,5,2,3,35,5,0,77
2024-03-04 20:30:00,30,8,1,2,27,5,0,73
2024-03-04 20:40:00,19,3,4,0,41,9,0,76
2024-03-04 20:50:00,22,2,1,3,40,6,0,74
2024-03-04 21:00:00,27,8,8,3,28,6,0,80
2024-03-04 21:10:00,19,1,1,3,36,8,0,68
2024-03-04 21:20:00,15,5,4,5,30,5,0,64
2024-03-04 21:30:00,21,0,0,3,31,4,0,59
2024-03-04 21:40:00,12,1,1,2,20,1,0,37
2024-03-04 21:50:00,26,5,0,0,25,7,0,63
2024-03-04 22:00:00,18,1,8,3,32,2,0,64
2024-03-04 22:10:00,16,5,3,1,30,1,0,56
2024-03-04 22:20:00,12,2,2,1,26,2,0,45
2024-03-04 22:30:00,14,2,1,0,35,4,0,56
2024-03-04 22:40:00,8,2,1,1,10,2,0,24
2024-03-04 22:50:00,10,2,0,1,15,6,0,34
2024-03-04 23:00:00,12,0,0,0,10,1,0,23
2024-03-04 23:10:00,4,0,1,1,14,4,0,24
2024-03-04 23:20:00,10,2,0,0,15,2,0,29
2024-03-04 23:30:00,10,2,0,0,6,1,0,19
2024-03-04 23:40:00,7,1,0,0,9,1,0,18
2024-03-04 23:50:00,9,3,0,0,6,3,0,21
2024-03-05 00:00:00,9,4,0,0,7,1,0,21
2024-03-05 00:10:00,2,1,0,0,7,4,0,14
2024-03-05 00:20:00,6,0,0,0,4,1,0,11
2024-03-05 00:30:00,8,0,0,0,4,1,0,13
2024-03-05 00:40:00,2,0,0,0,7,6,0,15
2024-03-05 00:50:00,2,3,0,0,3,1,0,9
2024-03-05 01:00:00,5,1,1,0,4,1,0,12
2024-03-05 01:10:00,4,0,0,0,0,0,0,4
2024-03-05 01:20:00,1,3,0,0,5,3,0,12
2024-03-05 01:30:00,3,1,0,0,2,1,0,7
2024-03-05 01:40:00,0,0,0,0,2,0,0,2
2024-03-05 01:50:00,1,0,0,0,2,2,0,5
2024-03-05 02:00:00,2,0,0,0,1,1,0,4
2024-03-05 02:10:00,2,0,0,0,2,0,0,4
2024-03-05 02:20:00,0,0,0,0,1,1,0,2
2024-03-05 02:30:00,1,1,0,0,4,0,0,6
2024-03-05 02:40:00,1,1,0,0,2,1,0,5
2024-03-05 02:50:00,1,0,0,0,1,0,0,2
2024-03-05 03:00:00,2,1,0,0,3,1,0,7
2024-03-05 03:10:00,2,0,0,0,2,0,0,4
2024-03-05 03:20:00,1,1,0,0,3,2,0,7
2024-03-05 03:30:00,2,4,0,0,3,2,0,11
2024-03-05 03:40:00,2,2,1,0,2,1,0,8
2024-03-05 03:50:00,3,4,0,0,10,7,0,24
2024-03-05 04:00:00,2,3,0,0,7,3,0,15
2024-03-05 04:10:00,2,0,0,1,5,2,0,10
2024-03-05 04:20:00,4,1,0,0,3,0,0,8
2024-03-05 04:30:00,6,7,0,0,3,0,0,16
2024-03-05 04:40:00,6,1,0,0,7,1,0,15
2024-03-05 04:50:00,5,2,0,0,8,4,0,19
2024-03-05 05:00:00,14,5,0,1,4,4,0,28
2024-03-05 05:10:00,19,7,0,0,16,4,0,46
2024-03-05 05:20:00,18,7,0,0,12,7,0,44
2024-03-05 05:30:00,32,5,0,0,25,5,0,67
2024-03-05 05:40:00,50,9,1,1,25,4,0,90
2024-03-05 05:50:00,45,5,0,1,41,4,0,96
2024-03-05 06:00:00,35,3,1,2,30,3,0,74
2024-03-05 06:10:00,54,4,0,1,36,2,0,97
2024-03-05 06:20:00,73,2,1,2,38,2,0,118
2024-03-05 06:30:00,82,10,0,3,33,7,0,135
2024-03-05 06:40:00,91,10,1,7,67,12,0,188
2024-03-05 06:50:00,85,10,0,5,53,5,0,158
2024-03-05 07:00:00,90,5,1,2,65,3,0,166
2024-03-05 07:10:00,98,19,1,2,84,9,0,213
2024-03-05 07:20:00,100,14,3,6,89,11,0,223
2024-03-05 07:30:00,86,24,4,17,98,12,0,241
2024-03-05 07:40:00,74,18,10,25,128,9,0,264
2024-03-05 07:50:00,73,10,25,22,110,17,0,257
2024-03-05 08:00:00,90,11,4,5,81,7,0,198
2024-03-05 08:10:00,87,3,4,7,104,6,0,211
2024-03-05 08:20:00,96,12,4,8,96,8,0,224
2024-03-05 08:30:00,92,11,2,8,73,10,0,196
2024-03-05 08:40:00,95,12,7,15,85,7,0,221
2024-03-05 08:50:00,87,8,9,13,77,11,0,205
2024-03-05 09:00:00,71,9,5,9,66,8,0,168
2024-03-05 09:10:00,72,9,0,10,72,11,0,174
2024-03-05 09:20:00,69,6,2,2,71,7,0,157
2024-03-05 09:30:00,71,6,3,6,54,9,0,149
2024-03-05 09:40:00,70,7,5,7,57,15,0,161
2024-03-05 09:50:00,64,7,5,6,55,9,0,146
2024-03-05 10:00:00,48,10,6,5,48,11,0,128
2024-03-05 10:10:00,55,6,5,6,60,10,0,142
2024-03-05 10:20:00,51,9,3,5,62,6,0,136
2024-03-05 10:30:00,73,6,4,8,52,8,0,151
2024-03-05 10:40:00,49,5,4,10,56,8,0,132
2024-03-05 10:50:00,66,9,3,1,52,6,0,137
2024-03-05 11:00:00,56,11,0,6,50,10,0,133
2024-03-05 11:10:00,54,9,3,6,63,9,0,144
2024-03-05 11:20:00,81,11,4,3,63,10,0,172
2024-03-05 11:30:00,54,7,2,5,61,4,0,133
2024-03-05 11:40:00,66,7,4,6,60,14,0,157
2024-03-05 11:50:00,47,6,3,4,74,13,0,147
2024-03-05 12:00:00,59,4,1,8,72,9,0,153
2024-03-05 12:10:00,53,7,6,4,79,10,0,159
2024-03-05 12:20:00,56,6,3,2,77,10,0,154
2024-03-05 12:30:00,69,9,1,4,75,9,0,167
2024-03-05 12:40:00,53,11,1,7,88,7,0,167
2024-03-05 12:50:00,64,10,4,7,84,12,0,181
2024-03-05 13:00:00,58,6,5,10,82,5,0,166
2024-03-05 13:10:00,60,9,12,22,69,11,0,183
2024-03-05 13:20:00,79,12,7,13,90,14,0,215
2024-03-05 13:30:00,56,8,7,6,80,5,0,162
2024-03-05 13:40:00,51,8,8,10,89,10,0,176
2024-03-05 13:50:00,59,23,3,6,83,9,0,183
2024-03-05 14:00:00,63,10,6,12,78,14,0,183
2024-03-05 14:10:00,68,14,12,9,93,9,0,205
2024-03-05 14:20:00,67,8,7,8,83,6,0,179
2024-03-05 14:30:00,67,6,6,11,88,15,0,193
2024-03-05 14:40:00,69,7,5,9,87,8,0,185
2024-03-05 14:50:00,76,18,8,13,92,7,0,214
2024-03-05 15:00:00,84,6,12,6,89,10,0,207
2024-03-05 15:10:00,68,10,10,11,91,8,0,198
2024-03-05 15:20:00,67,15,10,18,111,8,0,229
2024-03-05 15:30:00,80,9,14,10,89,10,0,212
2024-03-05 15:40:00,81,9,11,17,103,12,0,233
2024-03-05 15:50:00,71,10,7,11,107,11,0,217
2024-03-05 16:00:00,77,10,16,13,92,8,0,216
2024-03-05 16:10:00,87,6,7,13,118,9,0,240
2024-03-05 16:20:00,82,14,6,13,112,10,0,237
2024-03-05 16:30:00,82,9,7,13,112,8,0,231
2024-03-05 16:40:00,80,7,7,9,143,16,0,262
2024-03-05 16:50:00,77,8,7,4,110,13,0,219
2024-03-05 17:00:00,78,6,6,6,113,9,0,218
2024-03-05 17:10:00,78,6,12,10,107,20,0,233
2024-03-05 17:20:00,67,12,10,19,129,16,0,253
2024-03-05 17:30:00,65,7,9,17,113,11,0,222
2024-03-05 17:40:00,74,8,8,9,112,24,0,235
2024-03-05 17:50:00,52,10,4,15,129,19,0,229
2024-03-05 18:00:00,77,5,10,19,86,14,0,211
2024-03-05 18:10:00,71,13,4,12,108,11,0,219
2024-03-05 18:20:00,56,8,8,8,102,11,0,193
2024-03-05 18:30:00,46,4,12,13,87,17,0,179
2024-03-05 18:40:00,53,5,5,5,86,13,0,167
2024-03-05 18:50:00,57,11,0,5,76,10,0,159
2024-03-05 19:00:00,51,6,3,7,90,19,0,176
2024-03-05 19:10:00,46,3,3,5,69,8,0,134
2024-03-05 19:20:00,53,4,0,4,74,15,0,150
2024-03-05 19:30:00,33,6,14,3,60,11,0,127
2024-03-05 19:40:00,35,3,6,8,56,7,0,115
2024-03-05 19:50:00,33,5,2,4,66,12,0,122
2024-03-05 20:00:00,26,5,7,7,50,6,0,101
2024-03-05 20:10:00,24,4,3,8,54,8,0,101
2024-03-05 20:20:00,41,3,1,2,44,6,0,97
2024-03-05 20:30:00,26,5,3,1,27,8,0,70
2024-03-05 20:40:00,16,1,3,4,57,7,0,88
2024-03-05 20:50:00,17,1,1,3,34,8,0,64
2024-03-05 21:00:00,24,3,2,2,29,10,0,70
2024-03-05 21:10:00,18,3,2,0,33,8,0,64
2024-03-05 21:20:00,30,9,1,4,35,9,0,88
2024-03-05 21:30:00,24,5,4,1,28,5,0,67
2024-03-05 21:40:00,21,3,1,1,31,3,0,60
2024-03-05 21:50:00,24,8,1,1,26,4,0,64
2024-03-05 22:00:00,27,5,1,0,31,7,0,71
2024-03-05 22:10:00,11,3,6,3,33,2,0,58
2024-03-05 22:20:00,15,1,5,5,32,2,0,60
2024-03-05 22:30:00,22,6,1,0,19,4,0,52
2024-03-05 22:40:00,6,3,1,0,21,4,0,35
2024-03-05 22:50:00,19,6,0,0,17,4,0,46
2024-03-05 23:00:00,18,4,0,1,16,3,0,42
2024-03-05 23:10:00,8,2,1,0,16,2,0,29
2024-03-05 23:20:00,9,3,0,2,11,4,0,29
2024-03-05 23:30:00,10,1,0,1,15,1,0,28
2024-03-05 23:40:00,8,3,0,0,7,3,0,21
2024-03-05 23:50:00,5,4,0,0,8,0,0,17
2024-03-06 00:00:00,3,1,0,0,7,3,0,14
2024-03-06 00:10:00,7,2,0,0,6,5,0,20
2024-03-06 00:20:00,4,2,0,0,4,0,0,10
2024-03-06 00:30:00,2,2,0,0,5,0,0,9
2024-03-06 00:40:00,3,4,0,0,3,4,0,14
2024-03-06 00:50:00,5,0,0,1,1,0,0,7
2024-03-06 01:00:00,2,0,0,0,2,1,0,5
2024-03-06 01:10:00,1,0,0,0,6,3,0,10
2024-03-06 01:20:00,3,2,1,0,6,5,0,17
2024-03-06 01:30:00,1,1,0,0,3,2,0,7
2024-03-06 01:40:00,3,1,0,0,2,1,0,7
2024-03-06 01:50:00,3,3,0,0,1,3,0,10
2024-03-06 02:00:00,2,0,0,0,3,1,0,6
2024-03-06 02:10:00,4,3,0,0,1,0,0,8
2024-03-06 02:20:00,3,2,0,0,6,3,0,14
2024-03-06 02:30:00,3,2,0,0,1,2,0,8
2024-03-06 02:40:00,4,1,0,0,3,2,0,10
2024-03-06 02:50:00,1,0,0,0,1,0,0,2
2024-03-06 03:00:00,1,0,0,0,3,1,0,5
2024-03-06 03:10:00,1,0,0,0,2,2,0,5
2024-03-06 03:20:00,0,2,0,0,4,1,0,7
2024-03-06 03:30:00,1,3,1,0,5,1,0,11
2024-03-06 03:40:00,2,2,0,0,1,2,0,7
2024-03-06 03:50:00,1,3,0,0,6,4,0,14
2024-03-06 04:00:00,2,1,0,0,2,2,0,7
2024-03-06 04:10:00,3,0,0,0,5,1,0,9
2024-03-06 04:20:00,6,0,0,0,2,2,0,10
2024-03-06 04:30:00,5,3,0,0,3,3,0,14
2024-03-06 04:40:00,4,1,0,0,12,4,0,21
2024-03-06 04:50:00,6,2,0,0,9,7,0,24
2024-03-06 05:00:00,10,4,0,0,11,4,0,29
2024-03-06 05:10:00,22,8,0,0,8,8,0,46
2024-03-06 05:20:00,21,5,0,0,19,6,0,51
2024-03-06 05:30:00,38,9,0,0,20,7,0,74
2024-03-06 05:40:00,43,5,0,1,32,5,0,86
2024-03-06 05:50:00,45,12,1,2,36,2,0,98
2024-03-06 06:00:00,55,8,1,1,40,7,0,112
2024-03-06 06:10:00,56,6,0,1,33,5,0,101
2024-03-06 06:20:00,61,13,0,0,41,2,0,117
2024-03-06 06:30:00,84,10,0,4,54,4,0,156
2024-03-06 06:40:00,89,10,0,4,49,7,0,159
2024-03-06 06:50:00,80,10,1,3,63,7,0,164
2024-03-06 07:00:00,93,5,2,3,60,7,0,170
2024-03-06 07:10:00,105,6,1,0,80,6,0,198
2024-03-06 07:20:00,103,13,3,10,104,13,0,246
2024-03-06 07:30:00,92,15,9,15,95,14,0,240
2024-03-06 07:40:00,72,11,19,12,131,12,0,257
2024-03-06 07:50:00,69,17,16,31,95,14,0,242
2024-03-06 08:00:00,83,10,5,10,90,10,0,208
2024-03-06 08:10:00,87,14,8,6,79,11,0,205
2024-03-06 08:20:00,96,5,5,9,77,9,0,201
2024-03-06 08:30:00,98,6,8,9,84,9,0,214
2024-03-06 08:40:00,91,15,5,9,84,12,0,216
2024-03-06 08:50:00,77,17,3,12,64,11,0,184
2024-03-06 09:00:00,90,11,7,15,69,12,0,204
2024-03-06 09:10:00,69,11,3,8,61,8,0,160
2024-03-06 09:20:00,66,8,1,3,74,12,0,164
2024-03-06 09:30:00,63,13,1,8,74,16,0,175
2024-03-06 09:40:00,69,12,5,6,67,8,0,167
2024-03-06 09:50:00,73,5,2,1,61,11,0,153
2024-03-06 10:00:00,48,13,1,4,46,4,0,116
2024-03-06 10:10:00,62,6,2,3,49,10,0,132
2024-03-06 10:20:00,50,8,3,4,68,6,0,139
2024-03-06 10:30:00,61,6,4,2,50,11,0,134
2024-03-06 10:40:00,64,5,1,5,46,9,0,130
2024-03-06 10:50:00,51,10,3,2,76,9,0,151
2024-03-06 11:00:00,55,11,3,1,55,6,0,131
2024-03-06 11:10:00,41,6,4,6,53,6,0,116
2024-03-06 11:20:00,48,10,1,6,59,10,0,134
2024-03-06 11:30:00,65,6,4,5,69,5,0,154
2024-03-06 11:40:00,49,11,5,6,66,8,0,145
2024-03-06 11:50:00,62,11,4,5,65,14,0,161
2024-03-06 12:00:00,69,8,8,10,75,9,0,179
2024-03-06 12:10:00,55,6,3,6,68,13,0,151
2024-03-06 12:20:00,56,9,5,6,74,18,0,168
2024-03-06 12:30:00,74,12,5,2,80,13,0,186
2024-03-06 12:40:00,56,8,2,8,65,8,0,147
2024-03-06 12:50:00,58,9,3,7,69,10,0,156
2024-03-06 13:00:00,52,16,5,11,53,17,0,154
2024-03-06 13:10:00,71,20,7,19,67,9,0,193
2024-03-06 13:20:00,70,7,5,4,82,3,0,171
2024-03-06 13:30:00,60,12,10,7,86,13,0,188
2024-03-06 13:40:00,76,14,6,8,89,12,0,205
2024-03-06 13:50:00,54,8,3,9,88,5,0,167
2024-03-06 14:00:00,88,7,10,12,96,13,0,226
2024-03-06 14:10:00,72,7,4,9,68,12,0,172
2024-03-06 14:20:00,69,5,5,9,99,6,0,193
2024-03-06 14:30:00,82,8,8,10,74,11,0,193
2024-03-06 14:40:00,87,8,3,7,94,19,0,218
2024-03-06 14:50:00,60,8,6,6,92,52,0,224
2024-03-06 15:00:00,83,8,6,7,100,32,0,236
2024-03-06 15:10:00,70,8,9,11,95,31,0,224
2024-03-06 15:20:00,63,16,6,10,119,23,0,237
2024-03-06 15:30:00,83,9,17,19,88,22,0,238
2024-03-06 15:40:00,91,8,7,18,103,13,0,240
2024-03-06 15:50:00,79,12,8,11,112,12,0,234
2024-03-06 16:00:00,85,16,4,8,96,17,0,226
2024-03-06 16:10:00,85,8,10,7,104,32,0,246
2024-03-06 16:20:00,79,8,8,8,100,38,0,241
2024-03-06 16:30:00,72,7,2,8,104,18,0,211
2024-03-06 16:40:00,82,13,5,10,116,7,0,233
2024-03-06 16:50:00,65,9,6,8,105,15,0,208
2024-03-06 17:00:00,76,9,6,8,101,16,0,216
2024-03-06 17:10:00,60,9,6,4,143,16,0,238
2024-03-06 17:20:00,78,11,10,15,116,12,0,242
2024-03-06 17:30:00,82,5,4,15,108,7,0,221
2024-03-06 17:40:00,61,11,4,5,103,10,0,194
2024-03-06 17:50:00,81,12,3,10,129,14,0,249
2024-03-06 18:00:00,53,4,6,5,85,10,0,163
2024-03-06 18:10:00,84,7,5,11,103,8,0,218
2024-03-06 18:20:00,57,4,2,9,95,13,0,180
2024-03-06 18:30:00,67,9,7,4,86,9,0,182
2024-03-06 18:40:00,62,8,2,1,81,15,0,169
2024-03-06 18:50:00,45,5,2,7,83,21,0,163
2024-03-06 19:00:00,48,7,5,9,61,18,0,148
2024-03-06 19:10:00,41,3,4,3,68,9,0,128
2024-03-06 19:20:00,31,5,2,1,55,9,0,103
2024-03-06 19:30:00,46,5,10,9,47,7,0,124
2024-03-06 19:40:00,33,6,6,6,47,6,0,104
2024-03-06 19:50:00,42,5,1,6,48,8,0,110
2024-03-06 20:00:00,27,5,3,3,40,4,0,82
2024-03-06 20:10:00,32,1,4,1,47,8,0,93
2024-03-06 20:20:00,29,1,4,3,48,9,0,94
2024-03-06 20:30:00,29,8,2,5,37,10,0,91
2024-03-06 20:40:00,22,3,4,1,36,4,0,70
2024-03-06 20:50:00,23,1,2,2,40,4,0,72
2024-03-06 21:00:00,29,4,2,2,33,1,0,71
2024-03-06 21:10:00,32,4,2,0,48,6,0,92
2024-03-06 21:20:00,29,6,2,4,36,6,0,83
2024-03-06 21:30:00,32,3,2,0,25,4,0,66
2024-03-06 21:40:00,19,1,1,0,37,9,0,67
2024-03-06 21:50:00,30,1,1,0,24,8,0,64
2024-03-06 22:00:00,22,7,2,1,32,5,0,69
2024-03-06 22:10:00,14,1,9,1,28,2,0,55
2024-03-06 22:20:00,8,1,2,1,28,1,0,41
2024-03-06 22:30:00,15,3,1,1,24,5,0,49
2024-03-06 22:40:00,14,1,0,3,28,5,0,51
2024-03-06 22:50:00,11,1,0,0,18,6,0,36
2024-03-06 23:00:00,11,3,0,0,18,3,0,35
2024-03-06 23:10:00,6,3,0,0,24,5,0,38
2024-03-06 23:20:00,5,3,1,1,18,1,0,29
2024-03-06 23:30:00,9,2,0,0,10,2,0,23
2024-03-06 23:40:00,3,2,0,1,9,3,0,18
2024-03-06 23:50:00,10,2,0,0,12,3,0,27
2024-03-07 00:00:00,6,1,0,0,9,2,0,18
2024-03-07 00:10:00,3,1,0,0,8,1,0,13
2024-03-07 00:20:00,0,0,0,0,1,0,0,1
2024-03-07 00:30:00,2,1,0,0,3,3,0,9
2024-03-07 00:40:00,4,2,0,1,7,2,0,16
2024-03-07 00:50:00,4,6,0,0,10,6,0,26
2024-03-07 01:00:00,6,0,0,0,4,1,0,11
2024-03-07 01:10:00,6,3,0,0,7,2,0,18
2024-03-07 01:20:00,5,2,1,0,7,3,0,18
2024-03-07 01:30:00,2,1,0,0,4,3,0,10
2024-03-07 01:40:00,2,0,0,0,1,0,0,3
2024-03-07 01:50:00,2,0,0,0,2,0,0,4
2024-03-07 02:00:00,0,0,0,0,0,0,0,0
2024-03-07 02:10:00,4,2,0,0,4,1,0,11
2024-03-07 02:20:00,5,1,0,0,4,2,0,12
2024-03-07 02:30:00,3,2,0,0,1,1,0,7
2024-03-07 02:40:00,2,1,0,0,4,2,0,9
2024-03-07 02:50:00,0,1,0,0,2,0,0,3
2024-03-07 03:00:00,0,1,0,0,0,1,0,2
2024-03-07 03:10:00,0,0,0,0,6,0,0,6
2024-03-07 03:20:00,1,0,0,1,2,1,0,5
2024-03-07 03:30:00,1,3,1,0,5,4,0,14
2024-03-07 03:40:00,2,2,0,0,5,3,0,12
2024-03-07 03:50:00,1,1,0,0,3,0,0,5
2024-03-07 04:00:00,3,1,0,0,5,3,0,12
2024-03-07 04:10:00,5,3,0,0,6,2,0,16
2024-03-07 04:20:00,5,1,0,0,3,2,0,11
2024-03-07 04:30:00,4,4,0,0,3,1,0,12
2024-03-07 04:40:00,6,5,0,0,8,2,0,21
2024-03-07 04:50:00,6,1,0,0,4,1,0,12
2024-03-07 05:00:00,3,3,0,0,1,3,0,10
2024-03-07 05:10:00,0,0,0,0,0,0,0,0
2024-03-07 05:20:00,0,0,0,0,0,0,0,0
2024-03-07 05:30:00,0,0,0,0,0,0,0,0
2024-03-07 05:40:00,0,0,0,0,0,0,0,0
2024-03-07 05:50:00,0,0,0,0,0,0,0,0
2024-03-07 06:00:00,0,0,0,0,0,0,0,0
2024-03-07 06:10:00,0,0,0,0,0,0,0,0
2024-03-07 06:20:00,0,0,0,0,0,0,0,0
2024-03-07 06:30:00,0,0,0,0,0,0,0,0
2024-03-07 06:40:00,0,0,0,0,0,0,0,0
2024-03-07 06:50:00,0,0,0,0,0,0,0,0
2024-03-07 07:00:00,0,0,0,0,0,0,0,0
2024-03-07 07:10:00,0,0,0,0,0,0,0,0
2024-03-07 07:20:00,0,0,0,0,0,0,0,0
2024-03-07 07:30:00,0,0,0,0,0,0,0,0
2024-03-07 07:40:00,0,0,0,0,0,0,0,0
2024-03-07 07:50:00,0,0,0,0,0,0,0,0
2024-03-07 08:00:00,0,0,0,0,0,0,0,0
2024-03-07 08:10:00,0,0,0,0,0,0,0,0
2024-03-07 08:20:00,0,0,0,0,0,0,0,0
2024-03-07 08:30:00,0,0,0,0,0,0,0,0
2024-03-07 08:40:00,0,0,0,0,0,0,0,0
2024-03-07 08:50:00,0,0,0,0,0,0,0,0
2024-03-07 09:00:00,0,0,0,0,0,0,0,0
2024-03-07 09:10:00,0,0,0,0,0,0,0,0
2024-03-07 09:20:00,0,0,0,0,0,0,0,0
2024-03-07 09:30:00,0,0,0,0,0,0,0,0
2024-03-07 09:40:00,0,0,0,0,0,0,0,0
2024-03-07 09:50:00,0,0,0,0,0,0,0,0
2024-03-07 10:00:00,0,0,0,0,0,0,0,0
2024-03-07 10:10:00,0,0,0,0,0,0,0,0
2024-03-07 10:20:00,0,0,0,0,0,0,0,0
2024-03-07 10:30:00,0,0,0,0,0,0,0,0
2024-03-07 10:40:00,0,0,0,0,0,0,0,0
2024-03-07 10:50:00,0,0,0,0,0,0,0,0
2024-03-07 11:00:00,0,0,0,0,0,0,0,0
2024-03-07 11:10:00,0,0,0,0,0,0,0,0
2024-03-07 11:20:00,0,0,0,0,0,0,0,0
2024-03-07 11:30:00,0,0,0,0,0,0,0,0
2024-03-07 11:40:00,0,0,0,0,0,0,0,0
2024-03-07 11:50:00,0,0,0,0,0,0,0,0
2024-03-07 12:00:00,0,0,0,0,0,0,0,0
2024-03-07 12:10:00,0,0,0,0,0,0,0,0
2024-03-07 12:20:00,0,0,0,0,0,0,0,0
2024-03-07 12:30:00,0,0,0,0,0,0,0,0
2024-03-07 12:40:00,0,0,0,0,0,0,0,0
2024-03-07 12:50:00,0,0,0,0,0,0,0,0
2024-03-07 13:00:00,0,0,0,0,0,0,0,0
2024-03-07 13:10:00,0,0,0,0,0,0,0,0
2024-03-07 13:20:00,0,0,0,0,0,0,0,0
2024-03-07 13:30:00,0,0,0,0,0,0,0,0
2024-03-07 13:40:00,0,0,0,0,0,0,0,0
2024-03-07 13:50:00,0,0,0,0,0,0,0,0
2024-03-07 14:00:00,0,0,0,0,0,0,0,0
2024-03-07 14:10:00,0,0,0,0,0,0,0,0
2024-03-07 14:20:00,0,0,0,0,0,0,0,0
2024-03-07 14:30:00,0,0,0,0,0,0,0,0
2024-03-07 14:40:00,0,0,0,0,0,0,0,0
2024-03-07 14:50:00,0,0,0,0,0,0,0,0
2024-03-07 15:00:00,0,0,0,0,0,0,0,0
2024-03-07 15:10:00,0,0,0,0,0,0,0,0
2024-03-07 15:20:00,0,0,0,0,0,0,0,0
2024-03-07 15:30:00,0,0,0,0,0,0,0,0
2024-03-07 15:40:00,0,0,0,0,0,0,0,0
2024-03-07 15:50:00,0,0,0,0,0,0,0,0
2024-03-07 16:00:00,0,0,0,0,0,0,0,0
2024-03-07 16:10:00,0,0,0,0,0,0,0,0
2024-03-07 16:20:00,0,0,0,0,0,0,0,0
2024-03-07 16:30:00,0,0,0,0,0,0,0,0
2024-03-07 16:40:00,0,0,0,0,0,0,0,0
2024-03-07 16:50:00,0,0,0,0,0,0,0,0
2024-03-07 17:00:00,0,0,0,0,0,0,0,0
2024-03-07 17:10:00,0,0,0,0,0,0,0,0
2024-03-07 17:20:00,0,0,0,0,0,0,0,0
2024-03-07 17:30:00,0,0,0,0,0,0,0,0
2024-03-07 17:40:00,0,0,0,0,0,0,0,0
2024-03-07 17:50:00,0,0,0,0,0,0,0,0
2024-03-07 18:00:00,0,0,0,0,0,0,0,0
2024-03-07 18:10:00,0,0,0,0,0,0,0,0
2024-03-07 18:20:00,0,0,0,0,0,0,0,0
2024-03-07 18:30:00,0,0,0,0,0,0,0,0
2024-03-07 18:40:00,0,0,0,0,0,0,0,0
2024-03-07 18:50:00,0,0,0,0,0,0,0,0
2024-03-07 19:00:00,0,0,0,0,0,0,0,0
2024-03-07 19:10:00,0,0,0,0,0,0,0,0
2024-03-07 19:20:00,0,0,0,0,0,0,0,0
2024-03-07 19:30:00,0,0,0,0,0,0,0,0
2024-03-07 19:40:00,0,0,0,0,0,0,0,0
2024-03-07 19:50:00,0,0,0,0,0,0,0,0
2024-03-07 20:00:00,0,0,0,0,0,0,0,0
2024-03-07 20:10:00,0,0,0,0,0,0,0,0
2024-03-07 20:20:00,0,0,0,0,0,0,0,0
2024-03-07 20:30:00,0,0,0,0,0,0,0,0
2024-03-07 20:40:00,0,0,0,0,0,0,0,0
2024-03-07 20:50:00,0,0,0,0,0,0,0,0
2024-03-07 21:00:00,0,0,0,0,0,0,0,0
2024-03-07 21:10:00,0,0,0,0,0,0,0,0
2024-03-07 21:20:00,0,0,0,0,0,0,0,0
2024-03-07 21:30:00,0,0,0,0,0,0,0,0
2024-03-07 21:40:00,0,0,0,0,0,0,0,0
2024-03-07 21:50:00,0,0,0,0,0,0,0,0
2024-03-07 22:00:00,0,0,0,0,0,0,0,0
2024-03-07 22:10:00,0,0,0,0,0,0,0,0
2024-03-07 22:20:00,0,0,0,0,0,0,0,0
2024-03-07 22:30:00,0,0,0,0,0,0,0,0
2024-03-07 22:40:00,0,0,0,0,0,0,0,0
2024-03-07 22:50:00,0,0,0,0,0,0,0,0
2024-03-07 23:00:00,0,0,0,0,0,0,0,0
2024-03-07 23:10:00,0,0,0,0,0,0,0,0
2024-03-07 23:20:00,0,0,0,0,0,0,0,0
2024-03-07 23:30:00,0,0,0,0,0,0,0,0
2024-03-07 23:40:00,0,0,0,0,0,0,0,0
2024-03-07 23:50:00,0,0,0,0,0,0,0,0
2024-03-08 00:00:00,0,0,0,0,0,0,0,0
2024-03-08 00:10:00,0,0,0,0,0,0,0,0
2024-03-08 00:20:00,0,0,0,0,0,0,0,0
2024-03-08 00:30:00,0,0,0,0,0,0,0,0
2024-03-08 00:40:00,0,0,0,0,0,0,0,0
2024-03-08 00:50:00,0,0,0,0,0,0,0,0
2024-03-08 01:00:00,0,0,0,0,0,0,0,0
2024-03-08 01:10:00,0,0,0,0,0,0,0,0
2024-03-08 01:20:00,0,0,0,0,0,0,0,0
2024-03-08 01:30:00,0,0,0,0,0,0,0,0
2024-03-08 01:40:00,0,0,0,0,0,0,0,0
2024-03-08 01:50:00,0,0,0,0,0,0,0,0
2024-03-08 02:00:00,0,0,0,0,0,0,0,0
2024-03-08 02:10:00,0,0,0,0,0,0,0,0
2024-03-08 02:20:00,0,0,0,0,0,0,0,0
2024-03-08 02:30:00,0,0,0,0,0,0,0,0
2024-03-08 02:40:00,0,0,0,0,0,0,0,0
2024-03-08 02:50:00,0,0,0,0,0,0,0,0
2024-03-08 03:00:00,0,0,0,0,0,0,0,0
2024-03-08 03:10:00,0,0,0,0,0,0,0,0
2024-03-08 03:20:00,0,0,0,0,0,0,0,0
2024-03-08 03:30:00,0,0,0,0,0,0,0,0
2024-03-08 03:40:00,0,0,0,0,0,0,0,0
2024-03-08 03:50:00,0,0,0,0,0,0,0,0
2024-03-08 04:00:00,0,0,0,0,0,0,0,0
2024-03-08 04:10:00,0,0,0,0,0,0,0,0
2024-03-08 04:20:00,0,0,0,0,0,0,0,0
2024-03-08 04:30:00,0,0,0,0,0,0,0,0
2024-03-08 04:40:00,0,0,0,0,0,0,0,0
2024-03-08 04:50:00,0,0,0,0,0,0,0,0
2024-03-08 05:00:00,0,0,0,0,0,0,0,0
2024-03-08 05:10:00,0,0,0,0,0,0,0,0
2024-03-08 05:20:00,0,0,0,0,0,0,0,0
2024-03-08 05:30:00,0,0,0,0,0,0,0,0
2024-03-08 05:40:00,0,0,0,0,0,0,0,0
2024-03-08 05:50:00,0,0,0,0,0,0,0,0
2024-03-08 06:00:00,0,0,0,0,0,0,0,0
2024-03-08 06:10:00,0,0,0,0,0,0,0,0
2024-03-08 06:20:00,0,0,0,0,0,0,0,0
2024-03-08 06:30:00,0,0,0,0,0,0,0,0
2024-03-08 06:40:00,0,0,0,0,0,0,0,0
2024-03-08 06:50:00,0,0,0,0,0,0,0,0
2024-03-08 07:00:00,0,0,0,0,0,0,0,0
2024-03-08 07:10:00,0,0,0,0,0,0,0,0
2024-03-08 07:20:00,0,0,0,0,0,0,0,0
2024-03-08 07:30:00,0,0,0,0,0,0,0,0
2024-03-08 07:40:00,0,0,0,0,0,0,0,0
2024-03-08 07:50:00,0,0,0,0,0,0,0,0
2024-03-08 08:00:00,0,0,0,0,0,0,0,0
2024-03-08 08:10:00,0,0,0,0,0,0,0,0
2024-03-08 08:20:00,0,0,0,0,0,0,0,0
2024-03-08 08:30:00,0,0,0,0,0,0,0,0
2024-03-08 08:40:00,0,0,0,0,0,0,0,0
2024-03-08 08:50:00,0,0,0,0,0,0,0,0
2024-03-08 09:00:00,0,0,0,0,0,0,0,0
2024-03-08 09:10:00,0,0,0,0,0,0,0,0
2024-03-08 09:20:00,0,0,0,0,0,0,0,0
2024-03-08 09:30:00,0,0,0,0,0,0,0,0
2024-03-08 09:40:00,0,0,0,0,0,0,0,0
2024-03-08 09:50:00,0,0,0,0,0,0,0,0
2024-03-08 10:00:00,0,0,0,0,0,0,0,0
2024-03-08 10:10:00,0,0,0,0,0,0,0,0
2024-03-08 10:20:00,0,0,0,0,0,0,0,0
2024-03-08 10:30:00,0,0,0,0,0,0,0,0
2024-03-08 10:40:00,0,0,0,0,0,0,0,0
2024-03-08 10:50:00,0,0,0,0,0,0,0,0
2024-03-08 11:00:00,0,0,0,0,0,0,0,0
2024-03-08 11:10:00,0,0,0,0,0,0,0,0
2024-03-08 11:20:00,0,0,0,0,0,0,0,0
2024-03-08 11:30:00,0,0,0,0,0,0,0,0
2024-03-08 11:40:00,0,0,0,0,0,0,0,0
2024-03-08 11:50:00,0,0,0,0,0,0,0,0
2024-03-08 12:00:00,0,0,0,0,0,0,0,0
2024-03-08 12:10:00,0,0,0,0,0,0,0,0
2024-03-08 12:20:00,0,0,0,0,0,0,0,0
2024-03-08 12:30:00,0,0,0,0,0,0,0,0
2024-03-08 12:40:00,0,0,0,0,0,0,0,0
2024-03-08 12:50:00,0,0,0,0,0,0,0,0
2024-03-08 13:00:00,0,0,0,0,0,0,0,0
2024-03-08 13:10:00,0,0,0,0,0,0,0,0
2024-03-08 13:20:00,0,0,0,0,0,0,0,0
2024-03-08 13:30:00,0,0,0,0,0,0,0,0
2024-03-08 13:40:00,0,0,0,0,0,0,0,0
2024-03-08 13:50:00,0,0,0,0,0,0,0,0
2024-03-08 14:00:00,0,0,0,0,0,0,0,0
2024-03-08 14:10:00,0,0,0,0,0,0,0,0
2024-03-08 14:20:00,0,0,0,0,0,0,0,0
2024-03-08 14:30:00,0,0,0,0,0,0,0,0
2024-03-08 14:40:00,0,0,0,0,0,0,0,0
2024-03-08 14:50:00,0,0,0,0,0,0,0,0
2024-03-08 15:00:00,0,0,0,0,0,0,0,0
2024-03-08 15:10:00,0,0,0,0,0,0,0,0
2024-03-08 15:20:00,0,0,0,0,0,0,0,0
2024-03-08 15:30:00,0,0,0,0,0,0,0,0
2024-03-08 15:40:00,0,0,0,0,0,0,0,0
2024-03-08 15:50:00,0,0,0,0,0,0,0,0
2024-03-08 16:00:00,0,0,0,0,0,0,0,0
2024-03-08 16:10:00,0,0,0,0,0,0,0,0
2024-03-08 16:20:00,0,0,0,0,0,0,0,0
2024-03-08 16:30:00,0,0,0,0,0,0,0,0
2024-03-08 16:40:00,0,0,0,0,0,0,0,0
2024-03-08 16:50:00,0,0,0,0,0,0,0,0
2024-03-08 17:00:00,0,0,0,0,0,0,0,0
2024-03-08 17:10:00,0,0,0,0,0,0,0,0
2024-03-08 17:20:00,0,0,0,0,0,0,0,0
2024-03-08 17:30:00,0,0,0,0,0,0,0,0
2024-03-08 17:40:00,0,0,0,0,0,0,0,0
2024-03-08 17:50:00,0,0,0,0,0,0,0,0
2024-03-08 18:00:00,0,0,0,0,0,0,0,0
2024-03-08 18:10:00,0,0,0,0,0,0,0,0
2024-03-08 18:20:00,0,0,0,0,0,0,0,0
2024-03-08 18:30:00,0,0,0,0,0,0,0,0
2024-03-08 18:40:00,0,0,0,0,0,0,0,0
2024-03-08 18:50:00,0,0,0,0,0,0,0,0
2024-03-08 19:00:00,0,0,0,0,0,0,0,0
2024-03-08 19:10:00,0,0,0,0,0,0,0,0
2024-03-08 19:20:00,0,0,0,0,0,0,0,0
2024-03-08 19:30:00,0,0,0,0,0,0,0,0
2024-03-08 19:40:00,0,0,0,0,0,0,0,0
2024-03-08 19:50:00,0,0,0,0,0,0,0,0
2024-03-08 20:00:00,0,0,0,0,0,0,0,0
2024-03-08 20:10:00,0,0,0,0,0,0,0,0
2024-03-08 20:20:00,0,0,0,0,0,0,0,0
2024-03-08 20:30:00,0,0,0,0,0,0,0,0
2024-03-08 20:40:00,0,0,0,0,0,0,0,0
2024-03-08 20:50:00,0,0,0,0,0,0,0,0
2024-03-08 21:00:00,0,0,0,0,0,0,0,0
2024-03-08 21:10:00,0,0,0,0,0,0,0,0
2024-03-08 21:20:00,0,0,0,0,0,0,0,0
2024-03-08 21:30:00,0,0,0,0,0,0,0,0
2024-03-08 21:40:00,0,0,0,0,0,0,0,0
2024-03-08 21:50:00,0,0,0,0,0,0,0,0
2024-03-08 22:00:00,0,0,0,0,0,0,0,0
2024-03-08 22:10:00,0,0,0,0,0,0,0,0
2024-03-08 22:20:00,0,0,0,0,0,0,0,0
2024-03-08 22:30:00,0,0,0,0,0,0,0,0
2024-03-08 22:40:00,0,0,0,0,0,0,0,0
2024-03-08 22:50:00,0,0,0,0,0,0,0,0
2024-03-08 23:00:00,0,0,0,0,0,0,0,0
2024-03-08 23:10:00,0,0,0,0,0,0,0,0
2024-03-08 23:20:00,0,0,0,0,0,0,0,0
2024-03-08 23:30:00,0,0,0,0,0,0,0,0
2024-03-08 23:40:00,0,0,0,0,0,0,0,0
2024-03-08 23:50:00,0,0,0,0,0,0,0,0
2024-03-09 00:00:00,0,0,0,0,0,0,0,0
2024-03-09 00:10:00,0,0,0,0,0,0,0,0
2024-03-09 00:20:00,0,0,0,0,0,0,0,0
2024-03-09 00:30:00,0,0,0,0,0,0,0,0
2024-03-09 00:40:00,0,0,0,0,0,0,0,0
2024-03-09 00:50:00,0,0,0,0,0,0,0,0
2024-03-09 01:00:00,0,0,0,0,0,0,0,0
2024-03-09 01:10:00,0,0,0,0,0,0,0,0
2024-03-09 01:20:00,0,0,0,0,0,0,0,0
2024-03-09 01:30:00,0,0,0,0,0,0,0,0
2024-03-09 01:40:00,0,0,0,0,0,0,0,0
2024-03-09 01:50:00,0,0,0,0,0,0,0,0
2024-03-09 02:00:00,0,0,0,0,0,0,0,0
2024-03-09 02:10:00,0,0,0,0,0,0,0,0
2024-03-09 02:20:00,0,0,0,0,0,0,0,0
2024-03-09 02:30:00,0,0,0,0,0,0,0,0
2024-03-09 02:40:00,0,0,0,0,0,0,0,0
2024-03-09 02:50:00,0,0,0,0,0,0,0,0
2024-03-09 03:00:00,0,0,0,0,0,0,0,0
2024-03-09 03:10:00,0,0,0,0,0,0,0,0
2024-03-09 03:20:00,0,0,0,0,0,0,0,0
2024-03-09 03:30:00,0,0,0,0,0,0,0,0
2024-03-09 03:40:00,0,0,0,0,0,0,0,0
2024-03-09 03:50:00,0,0,0,0,0,0,0,0
2024-03-09 04:00:00,0,0,0,0,0,0,0,0
2024-03-09 04:10:00,0,0,0,0,0,0,0,0
2024-03-09 04:20:00,0,0,0,0,0,0,0,0
2024-03-09 04:30:00,0,0,0,0,0,0,0,0
2024-03-09 04:40:00,0,0,0,0,0,0,0,0
2024-03-09 04:50:00,0,0,0,0,0,0,0,0
2024-03-09 05:00:00,0,0,0,0,0,0,0,0
2024-03-09 05:10:00,0,0,0,0,0,0,0,0
2024-03-09 05:20:00,0,0,0,0,0,0,0,0
2024-03-09 05:30:00,0,0,0,0,0,0,0,0
2024-03-09 05:40:00,0,0,0,0,0,0,0,0
2024-03-09 05:50:00,0,0,0,0,0,0,0,0
2024-03-09 06:00:00,0,0,0,0,0,0,0,0
2024-03-09 06:10:00,0,0,0,0,0,0,0,0
2024-03-09 06:20:00,0,0,0,0,0,0,0,0
2024-03-09 06:30:00,0,0,0,0,0,0,0,0
2024-03-09 06:40:00,0,0,0,0,0,0,0,0
2024-03-09 06:50:00,0,0,0,0,0,0,0,0
2024-03-09 07:00:00,0,0,0,0,0,0,0,0
2024-03-09 07:10:00,0,0,0,0,0,0,0,0
2024-03-09 07:20:00,0,0,0,0,0,0,0,0
2024-03-09 07:30:00,0,0,0,0,0,0,0,0
2024-03-09 07:40:00,0,0,0,0,0,0,0,0
2024-03-09 07:50:00,0,0,0,0,0,0,0,0
2024-03-09 08:00:00,0,0,0,0,0,0,0,0
2024-03-09 08:10:00,0,0,0,0,0,0,0,0
2024-03-09 08:20:00,0,0,0,0,0,0,0,0
2024-03-09 08:30:00,0,0,0,0,0,0,0,0
2024-03-09 08:40:00,0,0,0,0,0,0,0,0
2024-03-09 08:50:00,0,0,0,0,0,0,0,0
2024-03-09 09:00:00,0,0,0,0,0,0,0,0
2024-03-09 09:10:00,0,0,0,0,0,0,0,0
2024-03-09 09:20:00,0,0,0,0,0,0,0,0
2024-03-09 09:30:00,0,0,0,0,0,0,0,0
2024-03-09 09:40:00,0,0,0,0,0,0,0,0
2024-03-09 09:50:00,0,0,0,0,0,0,0,0
2024-03-09 10:00:00,0,0,0,0,0,0,0,0
2024-03-09 10:10:00,0,0,0,0,0,0,0,0
2024-03-09 10:20:00,0,0,0,0,0,0,0,0
2024-03-09 10:30:00,0,0,0,0,0,0,0,0
2024-03-09 10:40:00,0,0,0,0,0,0,0,0
2024-03-09 10:50:00,0,0,0,0,0,0,0,0
2024-03-09 11:00:00,0,0,0,0,0,0,0,0
2024-03-09 11:10:00,0,0,0,0,0,0,0,0
2024-03-09 11:20:00,0,0,0,0,0,0,0,0
2024-03-09 11:30:00,0,0,0,0,0,0,0,0
2024-03-09 11:40:00,0,0,0,0,0,0,0,0
2024-03-09 11:50:00,0,0,0,0,0,0,0,0
2024-03-09 12:00:00,0,0,0,0,0,0,0,0
2024-03-09 12:10:00,0,0,0,0,0,0,0,0
2024-03-09 12:20:00,0,0,0,0,0,0,0,0
2024-03-09 12:30:00,0,0,0,0,0,0,0,0
2024-03-09 12:40:00,0,0,0,0,0,0,0,0
2024-03-09 12:50:00,0,0,0,0,0,0,0,0
2024-03-09 13:00:00,0,0,0,0,0,0,0,0
2024-03-09 13:10:00,0,0,0,0,0,0,0,0
2024-03-09 13:20:00,0,0,0,0,0,0,0,0
2024-03-09 13:30:00,0,0,0,0,0,0,0,0
2024-03-09 13:40:00,0,0,0,0,0,0,0,0
2024-03-09 13:50:00,0,0,0,0,0,0,0,0
2024-03-09 14:00:00,0,0,0,0,0,0,0,0
2024-03-09 14:10:00,0,0,0,0,0,0,0,0
2024-03-09 14:20:00,0,0,0,0,0,0,0,0
2024-03-09 14:30:00,0,0,0,0,0,0,0,0
2024-03-09 14:40:00,0,0,0,0,0,0,0,0
2024-03-09 14:50:00,0,0,0,0,0,0,0,0
2024-03-09 15:00:00,0,0,0,0,0,0,0,0
2024-03-09 15:10:00,0,0,0,0,0,0,0,0
2024-03-09 15:20:00,0,0,0,0,0,0,0,0
2024-03-09 15:30:00,0,0,0,0,0,0,0,0
2024-03-09 15:40:00,0,0,0,0,0,0,0,0
2024-03-09 15:50:00,0,0,0,0,0,0,0,0
2024-03-09 16:00:00,0,0,0,0,0,0,0,0
2024-03-09 16:10:00,0,0,0,0,0,0,0,0
2024-03-09 16:20:00,0,0,0,0,0,0,0,0
2024-03-09 16:30:00,0,0,0,0,0,0,0,0
2024-03-09 16:40:00,0,0,0,0,0,0,0,0
2024-03-09 16:50:00,0,0,0,0,0,0,0,0
2024-03-09 17:00:00,0,0,0,0,0,0,0,0
2024-03-09 17:10:00,0,0,0,0,0,0,0,0
2024-03-09 17:20:00,0,0,0,0,0,0,0,0
2024-03-09 17:30:00,0,0,0,0,0,0,0,0
2024-03-09 17:40:00,0,0,0,0,0,0,0,0
2024-03-09 17:50:00,0,0,0,0,0,0,0,0
2024-03-09 18:00:00,0,0,0,0,0,0,0,0
2024-03-09 18:10:00,0,0,0,0,0,0,0,0
2024-03-09 18:20:00,0,0,0,0,0,0,0,0
2024-03-09 18:30:00,0,0,0,0,0,0,0,0
2024-03-09 18:40:00,0,0,0,0,0,0,0,0
2024-03-09 18:50:00,0,0,0,0,0,0,0,0
2024-03-09 19:00:00,0,0,0,0,0,0,0,0
2024-03-09 19:10:00,0,0,0,0,0,0,0,0
2024-03-09 19:20:00,0,0,0,0,0,0,0,0
2024-03-09 19:30:00,0,0,0,0,0,0,0,0
2024-03-09 19:40:00,0,0,0,0,0,0,0,0
2024-03-09 19:50:00,0,0,0,0,0,0,0,0
2024-03-09 20:00:00,0,0,0,0,0,0,0,0
2024-03-09 20:10:00,0,0,0,0,0,0,0,0
2024-03-09 20:20:00,0,0,0,0,0,0,0,0
2024-03-09 20:30:00,0,0,0,0,0,0,0,0
2024-03-09 20:40:00,0,0,0,0,0,0,0,0
2024-03-09 20:50:00,0,0,0,0,0,0,0,0
2024-03-09 21:00:00,0,0,0,0,0,0,0,0
2024-03-09 21:10:00,0,0,0,0,0,0,0,0
2024-03-09 21:20:00,0,0,0,0,0,0,0,0
2024-03-09 21:30:00,0,0,0,0,0,0,0,0
2024-03-09 21:40:00,0,0,0,0,0,0,0,0
2024-03-09 21:50:00,0,0,0,0,0,0,0,0
2024-03-09 22:00:00,0,0,0,0,0,0,0,0
2024-03-09 22:10:00,0,0,0,0,0,0,0,0
2024-03-09 22:20:00,0,0,0,0,0,0,0,0
2024-03-09 22:30:00,0,0,0,0,0,0,0,0
2024-03-09 22:40:00,0,0,0,0,0,0,0,0
2024-03-09 22:50:00,0,0,0,0,0,0,0,0
2024-03-09 23:00:00,0,0,0,0,0,0,0,0
2024-03-09 23:10:00,0,0,0,0,0,0,0,0
2024-03-09 23:20:00,0,0,0,0,0,0,0,0
2024-03-09 23:30:00,0,0,0,0,0,0,0,0
2024-03-09 23:40:00,0,0,0,0,0,0,0,0
2024-03-09 23:50:00,0,0,0,0,0,0,0,0
2024-03-10 00:00:00,0,0,0,0,0,0,0,0
2024-03-10 00:10:00,0,0,0,0,0,0,0,0
2024-03-10 00:20:00,0,0,0,0,0,0,0,0
2024-03-10 00:30:00,0,0,0,0,0,0,0,0
2024-03-10 00:40:00,0,0,0,0,0,0,0,0
2024-03-10 00:50:00,0,0,0,0,0,0,0,0
2024-03-10 01:00:00,0,0,0,0,0,0,0,0
2024-03-10 01:10:00,0,0,0,0,0,0,0,0
2024-03-10 01:20:00,0,0,0,0,0,0,0,0
2024-03-10 01:30:00,0,0,0,0,0,0,0,0
2024-03-10 01:40:00,0,0,0,0,0,0,0,0
2024-03-10 01:50:00,0,0,0,0,0,0,0,0
2024-03-10 02:00:00,0,0,0,0,0,0,0,0
2024-03-10 02:10:00,0,0,0,0,0,0,0,0
2024-03-10 02:20:00,0,0,0,0,0,0,0,0
2024-03-10 02:30:00,0,0,0,0,0,0,0,0
2024-03-10 02:40:00,0,0,0,0,0,0,0,0
2024-03-10 02:50:00,0,0,0,0,0,0,0,0
2024-03-10 03:00:00,0,0,0,0,0,0,0,0
2024-03-10 03:10:00,0,0,0,0,0,0,0,0
2024-03-10 03:20:00,0,0,0,0,0,0,0,0
2024-03-10 03:30:00,0,0,0,0,0,0,0,0
2024-03-10 03:40:00,0,0,0,0,0,0,0,0
2024-03-10 03:50:00,0,0,0,0,0,0,0,0
2024-03-10 04:00:00,0,0,0,0,0,0,0,0
2024-03-10 04:10:00,0,0,0,0,0,0,0,0
2024-03-10 04:20:00,0,0,0,0,0,0,0,0
2024-03-10 04:30:00,0,0,0,0,0,0,0,0
2024-03-10 04:40:00,0,0,0,0,0,0,0,0
2024-03-10 04:50:00,0,0,0,0,0,0,0,0
2024-03-10 05:00:00,0,0,0,0,0,0,0,0
2024-03-10 05:10:00,0,0,0,0,0,0,0,0
2024-03-10 05:20:00,0,0,0,0,0,0,0,0
2024-03-10 05:30:00,0,0,0,0,0,0,0,0
2024-03-10 05:40:00,0,0,0,0,0,0,0,0
2024-03-10 05:50:00,0,0,0,0,0,0,0,0
2024-03-10 06:00:00,0,0,0,0,0,0,0,0
2024-03-10 06:10:00,0,0,0,0,0,0,0,0
2024-03-10 06:20:00,0,0,0,0,0,0,0,0
2024-03-10 06:30:00,0,0,0,0,0,0,0,0
2024-03-10 06:40:00,0,0,0,0,0,0,0,0
2024-03-10 06:50:00,0,0,0,0,0,0,0,0
2024-03-10 07:00:00,0,0,0,0,0,0,0,0
2024-03-10 07:10:00,0,0,0,0,0,0,0,0
2024-03-10 07:20:00,0,0,0,0,0,0,0,0
2024-03-10 07:30:00,0,0,0,0,0,0,0,0
2024-03-10 07:40:00,0,0,0,0,0,0,0,0
2024-03-10 07:50:00,0,0,0,0,0,0,0,0
2024-03-10 08:00:00,0,0,0,0,0,0,0,0
2024-03-10 08:10:00,0,0,0,0,0,0,0,0
2024-03-10 08:20:00,0,0,0,0,0,0,0,0
2024-03-10 08:30:00,0,0,0,0,0,0,0,0
2024-03-10 08:40:00,0,0,0,0,0,0,0,0
2024-03-10 08:50:00,0,0,0,0,0,0,0,0
2024-03-10 09:00:00,0,0,0,0,0,0,0,0
2024-03-10 09:10:00,0,0,0,0,0,0,0,0
2024-03-10 09:20:00,0,0,0,0,0,0,0,0
2024-03-10 09:30:00,0,0,0,0,0,0,0,0
2024-03-10 09:40:00,0,0,0,0,0,0,0,0
2024-03-10 09:50:00,0,0,0,0,0,0,0,0
2024-03-10 10:00:00,0,0,0,0,0,0,0,0
2024-03-10 10:10:00,0,0,0,0,0,0,0,0
2024-03-10 10:20:00,0,0,0,0,0,0,0,0
2024-03-10 10:30:00,0,0,0,0,0,0,0,0
2024-03-10 10:40:00,0,0,0,0,0,0,0,0
2024-03-10 10:50:00,0,0,0,0,0,0,0,0
2024-03-10 11:00:00,0,0,0,0,0,0,0,0
2024-03-10 11:10:00,0,0,0,0,0,0,0,0
2024-03-10 11:20:00,0,0,0,0,0,0,0,0
2024-03-10 11:30:00,0,0,0,0,0,0,0,0
2024-03-10 11:40:00,0,0,0,0,0,0,0,0
2024-03-10 11:50:00,0,0,0,0,0,0,0,0
2024-03-10 12:00:00,0,0,0,0,0,0,0,0
2024-03-10 12:10:00,0,0,0,0,0,0,0,0
2024-03-10 12:20:00,0,0,0,0,0,0,0,0
2024-03-10 12:30:00,0,0,0,0,0,0,0,0
2024-03-10 12:40:00,0,0,0,0,0,0,0,0
2024-03-10 12:50:00,0,0,0,0,0,0,0,0
2024-03-10 13:00:00,0,0,0,0,0,0,0,0
2024-03-10 13:10:00,0,0,0,0,0,0,0,0
2024-03-10 13:20:00,0,0,0,0,0,0,0,0
2024-03-10 13:30:00,0,0,0,0,0,0,0,0
2024-03-10 13:40:00,0,0,0,0,0,0,0,0
2024-03-10 13:50:00,0,0,0,0,0,0,0,0
2024-03-10 14:00:00,0,0,0,0,0,0,0,0
2024-03-10 14:10:00,0,0,0,0,0,0,0,0
2024-03-10 14:20:00,0,0,0,0,0,0,0,0
2024-03-10 14:30:00,0,0,0,0,0,0,0,0
2024-03-10 14:40:00,0,0,0,0,0,0,0,0
2024-03-10 14:50:00,0,0,0,0,0,0,0,0
2024-03-10 15:00:00,0,0,0,0,0,0,0,0
2024-03-10 15:10:00,0,0,0,0,0,0,0,0
2024-03-10 15:20:00,0,0,0,0,0,0,0,0
2024-03-10 15:30:00,0,0,0,0,0,0,0,0
2024-03-10 15:40:00,0,0,0,0,0,0,0,0
2024-03-10 15:50:00,0,0,0,0,0,0,0,0
2024-03-10 16:00:00,0,0,0,0,0,0,0,0
2024-03-10 16:10:00,0,0,0,0,0,0,0,0
2024-03-10 16:20:00,0,0,0,0,0,0,0,0
2024-03-10 16:30:00,0,0,0,0,0,0,0,0
2024-03-10 16:40:00,0,0,0,0,0,0,0,0
2024-03-10 16:50:00,0,0,0,0,0,0,0,0
2024-03-10 17:00:00,0,0,0,0,0,0,0,0
2024-03-10 17:10:00,0,0,0,0,0,0,0,0
2024-03-10 17:20:00,0,0,0,0,0,0,0,0
2024-03-10 17:30:00,0,0,0,0,0,0,0,0
2024-03-10 17:40:00,0,0,0,0,0,0,0,0
2024-03-10 17:50:00,0,0,0,0,0,0,0,0
2024-03-10 18:00:00,0,0,0,0,0,0,0,0
2024-03-10 18:10:00,0,0,0,0,0,0,0,0
2024-03-10 18:20:00,0,0,0,0,0,0,0,0
2024-03-10 18:30:00,0,0,0,0,0,0,0,0
2024-03-10 18:40:00,0,0,0,0,0,0,0,0
2024-03-10 18:50:00,0,0,0,0,0,0,0,0
2024-03-10 19:00:00,0,0,0,0,0,0,0,0
2024-03-10 19:10:00,0,0,0,0,0,0,0,0
2024-03-10 19:20:00,0,0,0,0,0,0,0,0
2024-03-10 19:30:00,0,0,0,0,0,0,0,0
2024-03-10 19:40:00,0,0,0,0,0,0,0,0
2024-03-10 19:50:00,0,0,0,0,0,0,0,0
2024-03-10 20:00:00,0,0,0,0,0,0,0,0
2024-03-10 20:10:00,0,0,0,0,0,0,0,0
2024-03-10 20:20:00,0,0,0,0,0,0,0,0
2024-03-10 20:30:00,0,0,0,0,0,0,0,0
2024-03-10 20:40:00,0,0,0,0,0,0,0,0
2024-03-10 20:50:00,0,0,0,0,0,0,0,0
2024-03-10 21:00:00,0,0,0,0,0,0,0,0
2024-03-10 21:10:00,0,0,0,0,0,0,0,0
2024-03-10 21:20:00,0,0,0,0,0,0,0,0
2024-03-10 21:30:00,0,0,0,0,0,0,0,0
2024-03-10 21:40:00,0,0,0,0,0,0,0,0
2024-03-10 21:50:00,0,0,0,0,0,0,0,0
2024-03-10 22:00:00,0,0,0,0,0,0,0,0
2024-03-10 22:10:00,0,0,0,0,0,0,0,0
2024-03-10 22:20:00,0,0,0,0,0,0,0,0
2024-03-10 22:30:00,0,0,0,0,0,0,0,0
2024-03-10 22:40:00,0,0,0,0,0,0,0,0
2024-03-10 22:50:00,0,0,0,0,0,0,0,0
2024-03-10 23:00:00,0,0,0,0,0,0,0,0
2024-03-10 23:10:00,0,0,0,0,0,0,0,0
2024-03-10 23:20:00,0,0,0,0,0,0,0,0
2024-03-10 23:30:00,0,0,0,0,0,0,0,0
2024-03-10 23:40:00,0,0,0,0,0,0,0,0
2024-03-10 23:50:00,0,0,0,0,0,0,0,0
2024-03-11 00:00:00,0,0,0,0,0,0,0,0
2024-03-11 00:10:00,0,0,0,0,0,0,0,0
2024-03-11 00:20:00,0,0,0,0,0,0,0,0
2024-03-11 00:30:00,0,0,0,0,0,0,0,0
2024-03-11 00:40:00,0,0,0,0,0,0,0,0
2024-03-11 00:50:00,0,0,0,0,0,0,0,0
2024-03-11 01:00:00,0,0,0,0,0,0,0,0
2024-03-11 01:10:00,0,0,0,0,0,0,0,0
2024-03-11 01:20:00,0,0,0,0,0,0,0,0
2024-03-11 01:30:00,0,0,0,0,0,0,0,0
2024-03-11 01:40:00,0,0,0,0,0,0,0,0
2024-03-11 01:50:00,0,0,0,0,0,0,0,0
2024-03-11 02:00:00,0,0,0,0,0,0,0,0
2024-03-11 02:10:00,0,0,0,0,0,0,0,0
2024-03-11 02:20:00,0,0,0,0,0,0,0,0
2024-03-11 02:30:00,0,0,0,0,0,0,0,0
2024-03-11 02:40:00,0,0,0,0,0,0,0,0
2024-03-11 02:50:00,0,0,0,0,0,0,0,0
2024-03-11 03:00:00,0,0,0,0,0,0,0,0
2024-03-11 03:10:00,0,0,0,0,0,0,0,0
2024-03-11 03:20:00,0,0,0,0,0,0,0,0
2024-03-11 03:30:00,0,0,0,0,0,0,0,0
2024-03-11 03:40:00,0,0,0,0,0,0,0,0
2024-03-11 03:50:00,0,0,0,0,0,0,0,0
2024-03-11 04:00:00,0,0,0,0,0,0,0,0
2024-03-11 04:10:00,0,0,0,0,0,0,0,0
2024-03-11 04:20:00,0,0,0,0,0,0,0,0
2024-03-11 04:30:00,0,0,0,0,0,0,0,0
2024-03-11 04:40:00,0,0,0,0,0,0,0,0
2024-03-11 04:50:00,0,0,0,0,0,0,0,0
2024-03-11 05:00:00,0,0,0,0,0,0,0,0
2024-03-11 05:10:00,0,0,0,0,0,0,0,0
2024-03-11 05:20:00,0,0,0,0,0,0,0,0
2024-03-11 05:30:00,0,0,0,0,0,0,0,0
2024-03-11 05:40:00,0,0,0,0,0,0,0,0
2024-03-11 05:50:00,0,0,0,0,0,0,0,0
2024-03-11 06:00:00,0,0,0,0,0,0,0,0
2024-03-11 06:10:00,0,0,0,0,0,0,0,0
2024-03-11 06:20:00,0,0,0,0,0,0,0,0
2024-03-11 06:30:00,0,0,0,0,0,0,0,0
2024-03-11 06:40:00,0,0,0,0,0,0,0,0
2024-03-11 06:50:00,0,0,0,0,0,0,0,0
2024-03-11 07:00:00,0,0,0,0,0,0,0,0
2024-03-11 07:10:00,0,0,0,0,0,0,0,0
2024-03-11 07:20:00,0,0,0,0,0,0,0,0
2024-03-11 07:30:00,0,0,0,0,0,0,0,0
2024-03-11 07:40:00,0,0,0,0,0,0,0,0
2024-03-11 07:50:00,0,0,0,0,0,0,0,0
2024-03-11 08:00:00,0,0,0,0,0,0,0,0
2024-03-11 08:10:00,0,0,0,0,0,0,0,0
2024-03-11 08:20:00,0,0,0,0,0,0,0,0
2024-03-11 08:30:00,0,0,0,0,0,0,0,0
2024-03-11 08:40:00,0,0,0,0,0,0,0,0
2024-03-11 08:50:00,0,0,0,0,0,0,0,0
2024-03-11 09:00:00,0,0,0,0,0,0,0,0
2024-03-11 09:10:00,0,0,0,0,0,0,0,0
2024-03-11 09:20:00,0,0,0,0,0,0,0,0
2024-03-11 09:30:00,0,0,0,0,0,0,0,0
2024-03-11 09:40:00,0,0,0,0,0,0,0,0
2024-03-11 09:50:00,0,0,0,0,0,0,0,0
2024-03-11 10:00:00,0,0,0,0,0,0,0,0
2024-03-11 10:10:00,0,0,0,0,0,0,0,0
2024-03-11 10:20:00,0,0,0,0,0,0,0,0
2024-03-11 10:30:00,0,0,0,0,0,0,0,0
2024-03-11 10:40:00,0,0,0,0,0,0,0,0
2024-03-11 10:50:00,0,0,0,0,0,0,0,0
2024-03-11 11:00:00,0,0,0,0,0,0,0,0
2024-03-11 11:10:00,0,0,0,0,0,0,0,0
2024-03-11 11:20:00,0,0,0,0,0,0,0,0
2024-03-11 11:30:00,0,0,0,0,0,0,0,0
2024-03-11 11:40:00,0,0,0,0,0,0,0,0
2024-03-11 11:50:00,0,0,0,0,0,0,0,0
2024-03-11 12:00:00,0,0,0,0,0,0,0,0
2024-03-11 12:10:00,0,0,0,0,0,0,0,0
2024-03-11 12:20:00,0,0,0,0,0,0,0,0
2024-03-11 12:30:00,0,0,0,0,0,0,0,0
2024-03-11 12:40:00,0,0,0,0,0,0,0,0
2024-03-11 12:50:00,0,0,0,0,0,0,0,0
2024-03-11 13:00:00,0,0,0,0,0,0,0,0
2024-03-11 13:10:00,0,0,0,0,0,0,0,0
2024-03-11 13:20:00,0,0,0,0,0,0,0,0
2024-03-11 13:30:00,0,0,0,0,0,0,0,0
2024-03-11 13:40:00,0,0,0,0,0,0,0,0
2024-03-11 13:50:00,0,0,0,0,0,0,0,0
2024-03-11 14:00:00,0,0,0,0,0,0,0,0
2024-03-11 14:10:00,0,0,0,0,0,0,0,0
2024-03-11 14:20:00,0,0,0,0,0,0,0,0
2024-03-11 14:30:00,0,0,0,0,0,0,0,0
2024-03-11 14:40:00,0,0,0,0,0,0,0,0
2024-03-11 14:50:00,0,0,0,0,0,0,0,0
2024-03-11 15:00:00,0,0,0,0,0,0,0,0
2024-03-11 15:10:00,0,0,0,0,0,0,0,0
2024-03-11 15:20:00,0,0,0,0,0,0,0,0
2024-03-11 15:30:00,0,0,0,0,0,0,0,0
2024-03-11 15:40:00,0,0,0,0,0,0,0,0
2024-03-11 15:50:00,0,0,0,0,0,0,0,0
2024-03-11 16:00:00,0,0,0,0,0,0,0,0
2024-03-11 16:10:00,0,0,0,0,0,0,0,0
2024-03-11 16:20:00,0,0,0,0,0,0,0,0
2024-03-11 16:30:00,0,0,0,0,0,0,0,0
2024-03-11 16:40:00,0,0,0,0,0,0,0,0
2024-03-11 16:50:00,0,0,0,0,0,0,0,0
2024-03-11 17:00:00,0,0,0,0,0,0,0,0
2024-03-11 17:10:00,0,0,0,0,0,0,0,0
2024-03-11 17:20:00,0,0,0,0,0,0,0,0
2024-03-11 17:30:00,0,0,0,0,0,0,0,0
2024-03-11 17:40:00,0,0,0,0,0,0,0,0
2024-03-11 17:50:00,0,0,0,0,0,0,0,0
2024-03-11 18:00:00,0,0,0,0,0,0,0,0
2024-03-11 18:10:00,0,0,0,0,0,0,0,0
2024-03-11 18:20:00,0,0,0,0,0,0,0,0
2024-03-11 18:30:00,0,0,0,0,0,0,0,0
2024-03-11 18:40:00,0,0,0,0,0,0,0,0
2024-03-11 18:50:00,0,0,0,0,0,0,0,0
2024-03-11 19:00:00,0,0,0,0,0,0,0,0
2024-03-11 19:10:00,0,0,0,0,0,0,0,0
2024-03-11 19:20:00,0,0,0,0,0,0,0,0
2024-03-11 19:30:00,0,0,0,0,0,0,0,0
2024-03-11 19:40:00,0,0,0,0,0,0,0,0
2024-03-11 19:50:00,0,0,0,0,0,0,0,0
2024-03-11 20:00:00,0,0,0,0,0,0,0,0
2024-03-11 20:10:00,0,0,0,0,0,0,0,0
2024-03-11 20:20:00,0,0,0,0,0,0,0,0
2024-03-11 20:30:00,0,0,0,0,0,0,0,0
2024-03-11 20:40:00,0,0,0,0,0,0,0,0
2024-03-11 20:50:00,0,0,0,0,0,0,0,0
2024-03-11 21:00:00,0,0,0,0,0,0,0,0
2024-03-11 21:10:00,0,0,0,0,0,0,0,0
2024-03-11 21:20:00,0,0,0,0,0,0,0,0
2024-03-11 21:30:00,0,0,0,0,0,0,0,0
2024-03-11 21:40:00,0,0,0,0,0,0,0,0
2024-03-11 21:50:00,0,0,0,0,0,0,0,0
2024-03-11 22:00:00,0,0,0,0,0,0,0,0
2024-03-11 22:10:00,0,0,0,0,0,0,0,0
2024-03-11 22:20:00,0,0,0,0,0,0,0,0
2024-03-11 22:30:00,0,0,0,0,0,0,0,0
2024-03-11 22:40:00,0,0,0,0,0,0,0,0
2024-03-11 22:50:00,0,0,0,0,0,0,0,0
2024-03-11 23:00:00,0,0,0,0,0,0,0,0
2024-03-11 23:10:00,0,0,0,0,0,0,0,0
2024-03-11 23:20:00,0,0,0,0,0,0,0,0
2024-03-11 23:30:00,0,0,0,0,0,0,0,0
2024-03-11 23:40:00,0,0,0,0,0,0,0,0
2024-03-11 23:50:00,0,0,0,0,0,0,0,0
2024-03-12 00:00:00,0,0,0,0,0,0,0,0
2024-03-12 00:10:00,0,0,0,0,0,0,0,0
2024-03-12 00:20:00,0,0,0,0,0,0,0,0
2024-03-12 00:30:00,0,0,0,0,0,0,0,0
2024-03-12 00:40:00,0,0,0,0,0,0,0,0
2024-03-12 00:50:00,0,0,0,0,0,0,0,0
2024-03-12 01:00:00,0,0,0,0,0,0,0,0
2024-03-12 01:10:00,0,0,0,0,0,0,0,0
2024-03-12 01:20:00,0,0,0,0,0,0,0,0
2024-03-12 01:30:00,0,0,0,0,0,0,0,0
2024-03-12 01:40:00,0,0,0,0,0,0,0,0
2024-03-12 01:50:00,0,0,0,0,0,0,0,0
2024-03-12 02:00:00,0,0,0,0,0,0,0,0
2024-03-12 02:10:00,0,0,0,0,0,0,0,0
2024-03-12 02:20:00,0,0,0,0,0,0,0,0
2024-03-12 02:30:00,0,0,0,0,0,0,0,0
2024-03-12 02:40:00,0,0,0,0,0,0,0,0
2024-03-12 02:50:00,0,0,0,0,0,0,0,0
2024-03-12 03:00:00,0,0,0,0,0,0,0,0
2024-03-12 03:10:00,0,0,0,0,0,0,0,0
2024-03-12 03:20:00,0,0,0,0,0,0,0,0
2024-03-12 03:30:00,0,0,0,0,0,0,0,0
2024-03-12 03:40:00,0,0,0,0,0,0,0,0
2024-03-12 03:50:00,0,0,0,0,0,0,0,0
2024-03-12 04:00:00,0,0,0,0,0,0,0,0
2024-03-12 04:10:00,0,0,0,0,0,0,0,0
2024-03-12 04:20:00,0,0,0,0,0,0,0,0
2024-03-12 04:30:00,0,0,0,0,0,0,0,0
2024-03-12 04:40:00,0,0,0,0,0,0,0,0
2024-03-12 04:50:00,0,0,0,0,0,0,0,0
2024-03-12 05:00:00,0,0,0,0,0,0,0,0
2024-03-12 05:10:00,0,0,0,0,0,0,0,0
2024-03-12 05:20:00,0,0,0,0,0,0,0,0
2024-03-12 05:30:00,0,0,0,0,0,0,0,0
2024-03-12 05:40:00,0,0,0,0,0,0,0,0
2024-03-12 05:50:00,0,0,0,0,0,0,0,0
2024-03-12 06:00:00,0,0,0,0,0,0,0,0
2024-03-12 06:10:00,0,0,0,0,0,0,0,0
2024-03-12 06:20:00,0,0,0,0,0,0,0,0
2024-03-12 06:30:00,0,0,0,0,0,0,0,0
2024-03-12 06:40:00,0,0,0,0,0,0,0,0
2024-03-12 06:50:00,0,0,0,0,0,0,0,0
2024-03-12 07:00:00,0,0,0,0,0,0,0,0
2024-03-12 07:10:00,0,0,0,0,0,0,0,0
2024-03-12 07:20:00,0,0,0,0,0,0,0,0
2024-03-12 07:30:00,0,0,0,0,0,0,0,0
2024-03-12 07:40:00,0,0,0,0,0,0,0,0
2024-03-12 07:50:00,0,0,0,0,0,0,0,0
2024-03-12 08:00:00,0,0,0,0,0,0,0,0
2024-03-12 08:10:00,0,0,0,0,0,0,0,0
2024-03-12 08:20:00,0,0,0,0,0,0,0,0
2024-03-12 08:30:00,0,0,0,0,0,0,0,0
2024-03-12 08:40:00,0,0,0,0,0,0,0,0
2024-03-12 08:50:00,0,0,0,0,0,0,0,0
2024-03-12 09:00:00,0,0,0,0,0,0,0,0
2024-03-12 09:10:00,0,0,0,0,0,0,0,0
2024-03-12 09:20:00,0,0,0,0,0,0,0,0
2024-03-12 09:30:00,0,0,0,0,0,0,0,0
2024-03-12 09:40:00,0,0,0,0,0,0,0,0
2024-03-12 09:50:00,0,0,0,0,0,0,0,0
2024-03-12 10:00:00,0,0,0,0,0,0,0,0
2024-03-12 10:10:00,0,0,0,0,0,0,0,0
2024-03-12 10:20:00,0,0,0,0,0,0,0,0
2024-03-12 10:30:00,0,0,0,0,0,0,0,0
2024-03-12 10:40:00,0,0,0,0,0,0,0,0
2024-03-12 10:50:00,0,0,0,0,0,0,0,0
2024-03-12 11:00:00,0,0,0,0,0,0,0,0
2024-03-12 11:10:00,0,0,0,0,0,0,0,0
2024-03-12 11:20:00,0,0,0,0,0,0,0,0
2024-03-12 11:30:00,0,0,0,0,0,0,0,0
2024-03-12 11:40:00,0,0,0,0,0,0,0,0
2024-03-12 11:50:00,0,0,0,0,0,0,0,0
2024-03-12 12:00:00,0,0,0,0,0,0,0,0
2024-03-12 12:10:00,0,0,0,0,0,0,0,0
2024-03-12 12:20:00,0,0,0,0,0,0,0,0
2024-03-12 12:30:00,0,0,0,0,0,0,0,0
2024-03-12 12:40:00,0,0,0,0,0,0,0,0
2024-03-12 12:50:00,0,0,0,0,0,0,0,0
2024-03-12 13:00:00,0,0,0,0,0,0,0,0
2024-03-12 13:10:00,0,0,0,0,0,0,0,0
2024-03-12 13:20:00,0,0,0,0,0,0,0,0
2024-03-12 13:30:00,0,0,0,0,0,0,0,0
2024-03-12 13:40:00,0,0,0,0,0,0,0,0
2024-03-12 13:50:00,0,0,0,0,0,0,0,0
2024-03-12 14:00:00,0,0,0,0,0,0,0,0
2024-03-12 14:10:00,0,0,0,0,0,0,0,0
2024-03-12 14:20:00,0,0,0,0,0,0,0,0
2024-03-12 14:30:00,0,0,0,0,0,0,0,0
2024-03-12 14:40:00,0,0,0,0,0,0,0,0
2024-03-12 14:50:00,0,0,0,0,0,0,0,0
2024-03-12 15:00:00,0,0,0,0,0,0,0,0
2024-03-12 15:10:00,0,0,0,0,0,0,0,0
2024-03-12 15:20:00,0,0,0,0,0,0,0,0
2024-03-12 15:30:00,0,0,0,0,0,0,0,0
2024-03-12 15:40:00,0,0,0,0,0,0,0,0
2024-03-12 15:50:00,0,0,0,0,0,0,0,0
2024-03-12 16:00:00,0,0,0,0,0,0,0,0
2024-03-12 16:10:00,0,0,0,0,0,0,0,0
2024-03-12 16:20:00,0,0,0,0,0,0,0,0
2024-03-12 16:30:00,0,0,0,0,0,0,0,0
2024-03-12 16:40:00,0,0,0,0,0,0,0,0
2024-03-12 16:50:00,0,0,0,0,0,0,0,0
2024-03-12 17:00:00,0,0,0,0,0,0,0,0
2024-03-12 17:10:00,0,0,0,0,0,0,0,0
2024-03-12 17:20:00,0,0,0,0,0,0,0,0
2024-03-12 17:30:00,0,0,0,0,0,0,0,0
2024-03-12 17:40:00,0,0,0,0,0,0,0,0
2024-03-12 17:50:00,0,0,0,0,0,0,0,0
2024-03-12 18:00:00,0,0,0,0,0,0,0,0
2024-03-12 18:10:00,0,0,0,0,0,0,0,0
2024-03-12 18:20:00,0,0,0,0,0,0,0,0
2024-03-12 18:30:00,0,0,0,0,0,0,0,0
2024-03-12 18:40:00,0,0,0,0,0,0,0,0
2024-03-12 18:50:00,0,0,0,0,0,0,0,0
2024-03-12 19:00:00,0,0,0,0,0,0,0,0
2024-03-12 19:10:00,0,0,0,0,0,0,0,0
2024-03-12 19:20:00,0,0,0,0,0,0,0,0
2024-03-12 19:30:00,0,0,0,0,0,0,0,0
2024-03-12 19:40:00,0,0,0,0,0,0,0,0
2024-03-12 19:50:00,0,0,0,0,0,0,0,0
2024-03-12 20:00:00,0,0,0,0,0,0,0,0
2024-03-12 20:10:00,0,0,0,0,0,0,0,0
2024-03-12 20:20:00,0,0,0,0,0,0,0,0
2024-03-12 20:30:00,0,0,0,0,0,0,0,0
2024-03-12 20:40:00,0,0,0,0,0,0,0,0
2024-03-12 20:50:00,0,0,0,0,0,0,0,0
2024-03-12 21:00:00,0,0,0,0,0,0,0,0
2024-03-12 21:10:00,0,0,0,0,0,0,0,0
2024-03-12 21:20:00,0,0,0,0,0,0,0,0
2024-03-12 21:30:00,0,0,0,0,0,0,0,0
2024-03-12 21:40:00,0,0,0,0,0,0,0,0
2024-03-12 21:50:00,0,0,0,0,0,0,0,0
2024-03-12 22:00:00,0,0,0,0,0,0,0,0
2024-03-12 22:10:00,0,0,0,0,0,0,0,0
2024-03-12 22:20:00,0,0,0,0,0,0,0,0
2024-03-12 22:30:00,0,0,0,0,0,0,0,0
2024-03-12 22:40:00,0,0,0,0,0,0,0,0
2024-03-12 22:50:00,0,0,0,0,0,0,0,0
2024-03-12 23:00:00,0,0,0,0,0,0,0,0
2024-03-12 23:10:00,0,0,0,0,0,0,0,0
2024-03-12 23:20:00,0,0,0,0,0,0,0,0
2024-03-12 23:30:00,0,0,0,0,0,0,0,0
2024-03-12 23:40:00,0,0,0,0,0,0,0,0
2024-03-12 23:50:00,0,0,0,0,0,0,0,0
2024-03-13 00:00:00,0,0,0,0,0,0,0,0
2024-03-13 00:10:00,0,0,0,0,0,0,0,0
2024-03-13 00:20:00,0,0,0,0,0,0,0,0
2024-03-13 00:30:00,0,0,0,0,0,0,0,0
2024-03-13 00:40:00,0,0,0,0,0,0,0,0
2024-03-13 00:50:00,0,0,0,0,0,0,0,0
2024-03-13 01:00:00,0,0,0,0,0,0,0,0
2024-03-13 01:10:00,0,0,0,0,0,0,0,0
2024-03-13 01:20:00,0,0,0,0,0,0,0,0
2024-03-13 01:30:00,0,0,0,0,0,0,0,0
2024-03-13 01:40:00,0,0,0,0,0,0,0,0
2024-03-13 01:50:00,0,0,0,0,0,0,0,0
2024-03-13 02:00:00,0,0,0,0,0,0,0,0
2024-03-13 02:10:00,0,0,0,0,0,0,0,0
2024-03-13 02:20:00,0,0,0,0,0,0,0,0
2024-03-13 02:30:00,0,0,0,0,0,0,0,0
2024-03-13 02:40:00,0,0,0,0,0,0,0,0
2024-03-13 02:50:00,0,0,0,0,0,0,0,0
2024-03-13 03:00:00,0,0,0,0,0,0,0,0
2024-03-13 03:10:00,0,0,0,0,0,0,0,0
2024-03-13 03:20:00,0,0,0,0,0,0,0,0
2024-03-13 03:30:00,0,0,0,0,0,0,0,0
2024-03-13 03:40:00,0,0,0,0,0,0,0,0
2024-03-13 03:50:00,0,0,0,0,0,0,0,0
2024-03-13 04:00:00,0,0,0,0,0,0,0,0
2024-03-13 04:10:00,0,0,0,0,0,0,0,0
2024-03-13 04:20:00,0,0,0,0,0,0,0,0
2024-03-13 04:30:00,0,0,0,0,0,0,0,0
2024-03-13 04:40:00,0,0,0,0,0,0,0,0
2024-03-13 04:50:00,0,0,0,0,0,0,0,0
2024-03-13 05:00:00,0,0,0,0,0,0,0,0
2024-03-13 05:10:00,0,0,0,0,0,0,0,0
2024-03-13 05:20:00,0,0,0,0,0,0,0,0
2024-03-13 05:30:00,0,0,0,0,0,0,0,0
2024-03-13 05:40:00,0,0,0,0,0,0,0,0
2024-03-13 05:50:00,0,0,0,0,0,0,0,0
2024-03-13 06:00:00,0,0,0,0,0,0,0,0
2024-03-13 06:10:00,0,0,0,0,0,0,0,0
2024-03-13 06:20:00,0,0,0,0,0,0,0,0
2024-03-13 06:30:00,0,0,0,0,0,0,0,0
2024-03-13 06:40:00,0,0,0,0,0,0,0,0
2024-03-13 06:50:00,0,0,0,0,0,0,0,0
2024-03-13 07:00:00,0,0,0,0,0,0,0,0
2024-03-13 07:10:00,0,0,0,0,0,0,0,0
2024-03-13 07:20:00,0,0,0,0,0,0,0,0
2024-03-13 07:30:00,0,0,0,0,0,0,0,0
2024-03-13 07:40:00,0,0,0,0,0,0,0,0
2024-03-13 07:50:00,0,0,0,0,0,0,0,0
2024-03-13 08:00:00,0,0,0,0,0,0,0,0
2024-03-13 08:10:00,0,0,0,0,0,0,0,0
2024-03-13 08:20:00,0,0,0,0,0,0,0,0
2024-03-13 08:30:00,0,0,0,0,0,0,0,0
2024-03-13 08:40:00,0,0,0,0,0,0,0,0
2024-03-13 08:50:00,0,0,0,0,0,0,0,0
2024-03-13 09:00:00,0,0,0,0,0,0,0,0
2024-03-13 09:10:00,0,0,0,0,0,0,0,0
2024-03-13 09:20:00,0,0,0,0,0,0,0,0
2024-03-13 09:30:00,0,0,0,0,0,0,0,0
2024-03-13 09:40:00,0,0,0,0,0,0,0,0
2024-03-13 09:50:00,0,0,0,0,0,0,0,0
2024-03-13 10:00:00,0,0,0,0,0,0,0,0
2024-03-13 10:10:00,0,0,0,0,0,0,0,0
2024-03-13 10:20:00,0,0,0,0,0,0,0,0
2024-03-13 10:30:00,0,0,0,0,0,0,0,0
2024-03-13 10:40:00,0,0,0,0,0,0,0,0
2024-03-13 10:50:00,0,0,0,0,0,0,0,0
2024-03-13 11:00:00,0,0,0,0,0,0,0,0
2024-03-13 11:10:00,0,0,0,0,0,0,0,0
2024-03-13 11:20:00,0,0,0,0,0,0,0,0
2024-03-13 11:30:00,0,0,0,0,0,0,0,0
2024-03-13 11:40:00,0,0,0,0,0,0,0,0
2024-03-13 11:50:00,0,0,0,0,0,0,0,0
2024-03-13 12:00:00,0,0,0,0,0,0,0,0
2024-03-13 12:10:00,0,0,0,0,0,0,0,0
2024-03-13 12:20:00,0,0,0,0,0,0,0,0
2024-03-13 12:30:00,0,0,0,0,0,0,0,0
2024-03-13 12:40:00,0,0,0,0,0,0,0,0
2024-03-13 12:50:00,0,0,0,0,0,0,0,0
2024-03-13 13:00:00,0,0,0,0,0,0,0,0
2024-03-13 13:10:00,0,0,0,0,0,0,0,0
2024-03-13 13:20:00,0,0,0,0,0,0,0,0
2024-03-13 13:30:00,0,0,0,0,0,0,0,0
2024-03-13 13:40:00,0,0,0,0,0,0,0,0
2024-03-13 13:50:00,0,0,0,0,0,0,0,0
2024-03-13 14:00:00,0,0,0,0,0,0,0,0
2024-03-13 14:10:00,0,0,0,0,0,0,0,0
2024-03-13 14:20:00,0,0,0,0,0,0,0,0
2024-03-13 14:30:00,0,0,0,0,0,0,0,0
2024-03-13 14:40:00,0,0,0,0,0,0,0,0
2024-03-13 14:50:00,0,0,0,0,0,0,0,0
2024-03-13 15:00:00,0,0,0,0,0,0,0,0
2024-03-13 15:10:00,0,0,0,0,0,0,0,0
2024-03-13 15:20:00,0,0,0,0,0,0,0,0
2024-03-13 15:30:00,0,0,0,0,0,0,0,0
2024-03-13 15:40:00,0,0,0,0,0,0,0,0
2024-03-13 15:50:00,0,0,0,0,0,0,0,0
2024-03-13 16:00:00,0,0,0,0,0,0,0,0
2024-03-13 16:10:00,0,0,0,0,0,0,0,0
2024-03-13 16:20:00,0,0,0,0,0,0,0,0
2024-03-13 16:30:00,0,0,0,0,0,0,0,0
2024-03-13 16:40:00,0,0,0,0,0,0,0,0
2024-03-13 16:50:00,0,0,0,0,0,0,0,0
2024-03-13 17:00:00,0,0,0,0,0,0,0,0
2024-03-13 17:10:00,0,0,0,0,0,0,0,0
2024-03-13 17:20:00,0,0,0,0,0,0,0,0
2024-03-13 17:30:00,0,0,0,0,0,0,0,0
2024-03-13 17:40:00,0,0,0,0,0,0,0,0
2024-03-13 17:50:00,0,0,0,0,0,0,0,0
2024-03-13 18:00:00,0,0,0,0,0,0,0,0
2024-03-13 18:10:00,0,0,0,0,0,0,0,0
2024-03-13 18:20:00,0,0,0,0,0,0,0,0
2024-03-13 18:30:00,0,0,0,0,0,0,0,0
2024-03-13 18:40:00,0,0,0,0,0,0,0,0
2024-03-13 18:50:00,0,0,0,0,0,0,0,0
2024-03-13 19:00:00,0,0,0,0,0,0,0,0
2024-03-13 19:10:00,0,0,0,0,0,0,0,0
2024-03-13 19:20:00,0,0,0,0,0,0,0,0
2024-03-13 19:30:00,0,0,0,0,0,0,0,0
2024-03-13 19:40:00,0,0,0,0,0,0,0,0
2024-03-13 19:50:00,0,0,0,0,0,0,0,0
2024-03-13 20:00:00,0,0,0,0,0,0,0,0
2024-03-13 20:10:00,0,0,0,0,0,0,0,0
2024-03-13 20:20:00,0,0,0,0,0,0,0,0
2024-03-13 20:30:00,0,0,0,0,0,0,0,0
2024-03-13 20:40:00,0,0,0,0,0,0,0,0
2024-03-13 20:50:00,0,0,0,0,0,0,0,0
2024-03-13 21:00:00,0,0,0,0,0,0,0,0
2024-03-13 21:10:00,0,0,0,0,0,0,0,0
2024-03-13 21:20:00,0,0,0,0,0,0,0,0
2024-03-13 21:30:00,0,0,0,0,0,0,0,0
2024-03-13 21:40:00,0,0,0,0,0,0,0,0
2024-03-13 21:50:00,0,0,0,0,0,0,0,0
2024-03-13 22:00:00,0,0,0,0,0,0,0,0
2024-03-13 22:10:00,0,0,0,0,0,0,0,0
2024-03-13 22:20:00,0,0,0,0,0,0,0,0
2024-03-13 22:30:00,0,0,0,0,0,0,0,0
2024-03-13 22:40:00,0,0,0,0,0,0,0,0
2024-03-13 22:50:00,0,0,0,0,0,0,0,0
2024-03-13 23:00:00,0,0,0,0,0,0,0,0
2024-03-13 23:10:00,0,0,0,0,0,0,0,0
2024-03-13 23:20:00,0,0,0,0,0,0,0,0
2024-03-13 23:30:00,0,0,0,0,0,0,0,0
2024-03-13 23:40:00,0,0,0,0,0,0,0,0
2024-03-13 23:50:00,0,0,0,0,0,0,0,0
2024-03-14 00:00:00,0,0,0,0,0,0,0,0
2024-03-14 00:10:00,0,0,0,0,0,0,0,0
2024-03-14 00:20:00,0,0,0,0,0,0,0,0
2024-03-14 00:30:00,0,0,0,0,0,0,0,0
2024-03-14 00:40:00,0,0,0,0,0,0,0,0
2024-03-14 00:50:00,0,0,0,0,0,0,0,0
2024-03-14 01:00:00,0,0,0,0,0,0,0,0
2024-03-14 01:10:00,0,0,0,0,0,0,0,0
2024-03-14 01:20:00,0,0,0,0,0,0,0,0
2024-03-14 01:30:00,0,0,0,0,0,0,0,0
2024-03-14 01:40:00,0,0,0,0,0,0,0,0
2024-03-14 01:50:00,0,0,0,0,0,0,0,0
2024-03-14 02:00:00,0,0,0,0,0,0,0,0
2024-03-14 02:10:00,0,0,0,0,0,0,0,0
2024-03-14 02:20:00,0,0,0,0,0,0,0,0
2024-03-14 02:30:00,0,0,0,0,0,0,0,0
2024-03-14 02:40:00,0,0,0,0,0,0,0,0
2024-03-14 02:50:00,0,0,0,0,0,0,0,0
2024-03-14 03:00:00,0,0,0,0,0,0,0,0
2024-03-14 03:10:00,0,0,0,0,0,0,0,0
2024-03-14 03:20:00,0,0,0,0,0,0,0,0
2024-03-14 03:30:00,0,0,0,0,0,0,0,0
2024-03-14 03:40:00,0,0,0,0,0,0,0,0
2024-03-14 03:50:00,0,0,0,0,0,0,0,0
2024-03-14 04:00:00,0,0,0,0,0,0,0,0
2024-03-14 04:10:00,0,0,0,0,0,0,0,0
2024-03-14 04:20:00,0,0,0,0,0,0,0,0
2024-03-14 04:30:00,0,0,0,0,0,0,0,0
2024-03-14 04:40:00,0,0,0,0,0,0,0,0
2024-03-14 04:50:00,0,0,0,0,0,0,0,0
2024-03-14 05:00:00,0,0,0,0,0,0,0,0
2024-03-14 05:10:00,0,0,0,0,0,0,0,0
2024-03-14 05:20:00,0,0,0,0,0,0,0,0
2024-03-14 05:30:00,0,0,0,0,0,0,0,0
2024-03-14 05:40:00,0,0,0,0,0,0,0,0
2024-03-14 05:50:00,0,0,0,0,0,0,0,0
2024-03-14 06:00:00,0,0,0,0,0,0,0,0
2024-03-14 06:10:00,0,0,0,0,0,0,0,0
2024-03-14 06:20:00,0,0,0,0,0,0,0,0
2024-03-14 06:30:00,0,0,0,0,0,0,0,0
2024-03-14 06:40:00,0,0,0,0,0,0,0,0
2024-03-14 06:50:00,0,0,0,0,0,0,0,0
2024-03-14 07:00:00,0,0,0,0,0,0,0,0
2024-03-14 07:10:00,0,0,0,0,0,0,0,0
2024-03-14 07:20:00,0,0,0,0,0,0,0,0
2024-03-14 07:30:00,0,0,0,0,0,0,0,0
2024-03-14 07:40:00,0,0,0,0,0,0,0,0
2024-03-14 07:50:00,0,0,0,0,0,0,0,0
2024-03-14 08:00:00,0,0,0,0,0,0,0,0
2024-03-14 08:10:00,0,0,0,0,0,0,0,0
2024-03-14 08:20:00,0,0,0,0,0,0,0,0
2024-03-14 08:30:00,0,0,0,0,0,0,0,0
2024-03-14 08:40:00,0,0,0,0,0,0,0,0
2024-03-14 08:50:00,0,0,0,0,0,0,0,0
2024-03-14 09:00:00,0,0,0,0,0,0,0,0
2024-03-14 09:10:00,0,0,0,0,0,0,0,0
2024-03-14 09:20:00,0,0,0,0,0,0,0,0
2024-03-14 09:30:00,0,0,0,0,0,0,0,0
2024-03-14 09:40:00,0,0,0,0,0,0,0,0
2024-03-14 09:50:00,0,0,0,0,0,0,0,0
2024-03-14 10:00:00,0,0,0,0,0,0,0,0
2024-03-14 10:10:00,0,0,0,0,0,0,0,0
2024-03-14 10:20:00,0,0,0,0,0,0,0,0
2024-03-14 10:30:00,0,0,0,0,0,0,0,0
2024-03-14 10:40:00,0,0,0,0,0,0,0,0
2024-03-14 10:50:00,0,0,0,0,0,0,0,0
2024-03-14 11:00:00,0,0,0,0,0,0,0,0
2024-03-14 11:10:00,0,0,0,0,0,0,0,0
2024-03-14 11:20:00,0,0,0,0,0,0,0,0
2024-03-14 11:30:00,0,0,0,0,0,0,0,0
2024-03-14 11:40:00,0,0,0,0,0,0,0,0
2024-03-14 11:50:00,0,0,0,0,0,0,0,0
2024-03-14 12:00:00,0,0,0,0,0,0,0,0
2024-03-14 12:10:00,0,0,0,0,0,0,0,0
2024-03-14 12:20:00,0,0,0,0,0,0,0,0
2024-03-14 12:30:00,0,0,0,0,0,0,0,0
2024-03-14 12:40:00,0,0,0,0,0,0,0,0
2024-03-14 12:50:00,0,0,0,0,0,0,0,0
2024-03-14 13:00:00,0,0,0,0,0,0,0,0
2024-03-14 13:10:00,0,0,0,0,0,0,0,0
2024-03-14 13:20:00,0,0,0,0,0,0,0,0
2024-03-14 13:30:00,0,0,0,0,0,0,0,0
2024-03-14 13:40:00,0,0,0,0,0,0,0,0
2024-03-14 13:50:00,0,0,0,0,0,0,0,0
2024-03-14 14:00:00,0,0,0,0,0,0,0,0
2024-03-14 14:10:00,0,0,0,0,0,0,0,0
2024-03-14 14:20:00,0,0,0,0,0,0,0,0
2024-03-14 14:30:00,0,0,0,0,0,0,0,0
2024-03-14 14:40:00,0,0,0,0,0,0,0,0
2024-03-14 14:50:00,0,0,0,0,0,0,0,0
2024-03-14 15:00:00,0,0,0,0,0,0,0,0
2024-03-14 15:10:00,0,0,0,0,0,0,0,0
2024-03-14 15:20:00,0,0,0,0,0,0,0,0
2024-03-14 15:30:00,0,0,0,0,0,0,0,0
2024-03-14 15:40:00,0,0,0,0,0,0,0,0
2024-03-14 15:50:00,0,0,0,0,0,0,0,0
2024-03-14 16:00:00,0,0,0,0,0,0,0,0
2024-03-14 16:10:00,0,0,0,0,0,0,0,0
2024-03-14 16:20:00,0,0,0,0,0,0,0,0
2024-03-14 16:30:00,0,0,0,0,0,0,0,0
2024-03-14 16:40:00,0,0,0,0,0,0,0,0
2024-03-14 16:50:00,0,0,0,0,0,0,0,0
2024-03-14 17:00:00,0,0,0,0,0,0,0,0
2024-03-14 17:10:00,0,0,0,0,0,0,0,0
2024-03-14 17:20:00,0,0,0,0,0,0,0,0
2024-03-14 17:30:00,0,0,0,0,0,0,0,0
2024-03-14 17:40:00,0,0,0,0,0,0,0,0
2024-03-14 17:50:00,0,0,0,0,0,0,0,0
2024-03-14 18:00:00,0,0,0,0,0,0,0,0
2024-03-14 18:10:00,0,0,0,0,0,0,0,0
2024-03-14 18:20:00,0,0,0,0,0,0,0,0
2024-03-14 18:30:00,0,0,0,0,0,0,0,0
2024-03-14 18:40:00,0,0,0,0,0,0,0,0
2024-03-14 18:50:00,0,0,0,0,0,0,0,0
2024-03-14 19:00:00,0,0,0,0,0,0,0,0
2024-03-14 19:10:00,0,0,0,0,0,0,0,0
2024-03-14 19:20:00,0,0,0,0,0,0,0,0
2024-03-14 19:30:00,0,0,0,0,0,0,0,0
2024-03-14 19:40:00,0,0,0,0,0,0,0,0
2024-03-14 19:50:00,0,0,0,0,0,0,0,0
2024-03-14 20:00:00,0,0,0,0,0,0,0,0
2024-03-14 20:10:00,0,0,0,0,0,0,0,0
2024-03-14 20:20:00,0,0,0,0,0,0,0,0
2024-03-14 20:30:00,0,0,0,0,0,0,0,0
2024-03-14 20:40:00,0,0,0,0,0,0,0,0
2024-03-14 20:50:00,0,0,0,0,0,0,0,0
2024-03-14 21:00:00,0,0,0,0,0,0,0,0
2024-03-14 21:10:00,0,0,0,0,0,0,0,0
2024-03-14 21:20:00,0,0,0,0,0,0,0,0
2024-03-14 21:30:00,0,0,0,0,0,0,0,0
2024-03-14 21:40:00,0,0,0,0,0,0,0,0
2024-03-14 21:50:00,0,0,0,0,0,0,0,0
2024-03-14 22:00:00,0,0,0,0,0,0,0,0
2024-03-14 22:10:00,0,0,0,0,0,0,0,0
2024-03-14 22:20:00,0,0,0,0,0,0,0,0
2024-03-14 22:30:00,0,0,0,0,0,0,0,0
2024-03-14 22:40:00,0,0,0,0,0,0,0,0
2024-03-14 22:50:00,0,0,0,0,0,0,0,0
2024-03-14 23:00:00,0,0,0,0,0,0,0,0
2024-03-14 23:10:00,0,0,0,0,0,0,0,0
2024-03-14 23:20:00,0,0,0,0,0,0,0,0
2024-03-14 23:30:00,0,0,0,0,0,0,0,0
2024-03-14 23:40:00,0,0,0,0,0,0,0,0
2024-03-14 23:50:00,0,0,0,0,0,0,0,0
2024-03-15 00:00:00,0,0,0,0,0,0,0,0
2024-03-15 00:10:00,0,0,0,0,0,0,0,0
2024-03-15 00:20:00,0,0,0,0,0,0,0,0
2024-03-15 00:30:00,0,0,0,0,0,0,0,0
2024-03-15 00:40:00,0,0,0,0,0,0,0,0
2024-03-15 00:50:00,0,0,0,0,0,0,0,0
2024-03-15 01:00:00,0,0,0,0,0,0,0,0
2024-03-15 01:10:00,0,0,0,0,0,0,0,0
2024-03-15 01:20:00,0,0,0,0,0,0,0,0
2024-03-15 01:30:00,0,0,0,0,0,0,0,0
2024-03-15 01:40:00,0,0,0,0,0,0,0,0
2024-03-15 01:50:00,0,0,0,0,0,0,0,0
2024-03-15 02:00:00,0,0,0,0,0,0,0,0
2024-03-15 02:10:00,0,0,0,0,0,0,0,0
2024-03-15 02:20:00,0,0,0,0,0,0,0,0
2024-03-15 02:30:00,0,0,0,0,0,0,0,0
2024-03-15 02:40:00,0,0,0,0,0,0,0,0
2024-03-15 02:50:00,0,0,0,0,0,0,0,0
2024-03-15 03:00:00,0,0,0,0,0,0,0,0
2024-03-15 03:10:00,0,0,0,0,0,0,0,0
2024-03-15 03:20:00,0,0,0,0,0,0,0,0
2024-03-15 03:30:00,0,0,0,0,0,0,0,0
2024-03-15 03:40:00,0,0,0,0,0,0,0,0
2024-03-15 03:50:00,0,0,0,0,0,0,0,0
2024-03-15 04:00:00,0,0,0,0,0,0,0,0
2024-03-15 04:10:00,0,0,0,0,0,0,0,0
2024-03-15 04:20:00,0,0,0,0,0,0,0,0
2024-03-15 04:30:00,0,0,0,0,0,0,0,0
2024-03-15 04:40:00,0,0,0,0,0,0,0,0
2024-03-15 04:50:00,0,0,0,0,0,0,0,0
2024-03-15 05:00:00,0,0,0,0,0,0,0,0
2024-03-15 05:10:00,0,0,0,0,0,0,0,0
2024-03-15 05:20:00,0,0,0,0,0,0,0,0
2024-03-15 05:30:00,0,0,0,0,0,0,0,0
2024-03-15 05:40:00,0,0,0,0,0,0,0,0
2024-03-15 05:50:00,0,0,0,0,0,0,0,0
2024-03-15 06:00:00,0,0,0,0,0,0,0,0
2024-03-15 06:10:00,0,0,0,0,0,0,0,0
2024-03-15 06:20:00,0,0,0,0,0,0,0,0
2024-03-15 06:30:00,0,0,0,0,0,0,0,0
2024-03-15 06:40:00,0,0,0,0,0,0,0,0
2024-03-15 06:50:00,0,0,0,0,0,0,0,0
2024-03-15 07:00:00,0,0,0,0,0,0,0,0
2024-03-15 07:10:00,0,0,0,0,0,0,0,0
2024-03-15 07:20:00,0,0,0,0,0,0,0,0
2024-03-15 07:30:00,0,0,0,0,0,0,0,0
2024-03-15 07:40:00,0,0,0,0,0,0,0,0
2024-03-15 07:50:00,0,0,0,0,0,0,0,0
2024-03-15 08:00:00,0,0,0,0,0,0,0,0
2024-03-15 08:10:00,0,0,0,0,0,0,0,0
2024-03-15 08:20:00,0,0,0,0,0,0,0,0
2024-03-15 08:30:00,0,0,0,0,0,0,0,0
2024-03-15 08:40:00,0,0,0,0,0,0,0,0
2024-03-15 08:50:00,0,0,0,0,0,0,0,0
2024-03-15 09:00:00,0,0,0,0,0,0,0,0
2024-03-15 09:10:00,0,0,0,0,0,0,0,0
2024-03-15 09:20:00,0,0,0,0,0,0,0,0
2024-03-15 09:30:00,0,0,0,0,0,0,0,0
2024-03-15 09:40:00,0,0,0,0,0,0,0,0
2024-03-15 09:50:00,0,0,0,0,0,0,0,0
2024-03-15 10:00:00,0,0,0,0,0,0,0,0
2024-03-15 10:10:00,0,0,0,0,0,0,0,0
2024-03-15 10:20:00,0,0,0,0,0,0,0,0
2024-03-15 10:30:00,0,0,0,0,0,0,0,0
2024-03-15 10:40:00,0,0,0,0,0,0,0,0
2024-03-15 10:50:00,0,0,0,0,0,0,0,0
2024-03-15 11:00:00,57,8,1,5,60,10,0,141
2024-03-15 11:10:00,59,5,2,5,70,11,0,152
2024-03-15 11:20:00,76,8,2,15,70,8,0,179
2024-03-15 11:30:00,48,8,6,13,81,6,0,162
2024-03-15 11:40:00,58,15,3,9,75,12,0,172
2024-03-15 11:50:00,91,8,4,6,71,16,0,196
2024-03-15 12:00:00,66,5,4,3,75,7,0,160
2024-03-15 12:10:00,56,6,5,4,66,10,0,147
2024-03-15 12:20:00,78,10,4,3,90,16,0,201
2024-03-15 12:30:00,70,10,2,4,80,15,0,181
2024-03-15 12:40:00,83,7,2,2,95,12,0,201
2024-03-15 12:50:00,66,12,3,8,75,10,0,174
2024-03-15 13:00:00,65,10,7,9,106,8,0,205
2024-03-15 13:10:00,70,9,20,26,88,12,0,225
2024-03-15 13:20:00,74,7,7,9,114,12,0,223
2024-03-15 13:30:00,68,7,6,11,86,12,0,190
2024-03-15 13:40:00,73,15,4,8,80,13,0,193
2024-03-15 13:50:00,68,13,2,7,116,16,0,222
2024-03-15 14:00:00,76,9,2,11,94,11,0,203
2024-03-15 14:10:00,87,9,5,12,90,12,0,215
2024-03-15 14:20:00,66,5,4,7,123,16,0,221
2024-03-15 14:30:00,92,10,4,8,77,10,0,201
2024-03-15 14:40:00,57,10,11,11,103,18,0,210
2024-03-15 14:50:00,78,13,5,4,115,15,0,230
2024-03-15 15:00:00,87,19,4,11,75,16,0,212
2024-03-15 15:10:00,87,8,5,12,78,10,0,200
2024-03-15 15:20:00,68,6,9,8,87,12,0,190
2024-03-15 15:30:00,91,11,4,3,90,14,0,213
2024-03-15 15:40:00,73,10,10,6,110,17,0,226
2024-03-15 15:50:00,73,9,5,3,92,11,0,193
2024-03-15 16:00:00,75,10,6,13,82,15,0,201
2024-03-15 16:10:00,72,11,18,15,90,9,0,215
2024-03-15 16:20:00,80,13,15,18,121,11,0,258
2024-03-15 16:30:00,77,8,13,26,89,13,0,226
2024-03-15 16:40:00,62,10,5,12,87,14,0,190
2024-03-15 16:50:00,76,4,6,11,68,10,0,175
2024-03-15 17:00:00,69,6,8,6,89,13,0,191
2024-03-15 17:10:00,65,4,7,12,75,17,0,180
2024-03-15 17:20:00,60,12,2,3,79,13,0,169
2024-03-15 17:30:00,61,8,5,4,81,11,0,170
2024-03-15 17:40:00,62,9,6,7,104,16,0,204
2024-03-15 17:50:00,85,9,5,13,90,10,0,212
2024-03-15 18:00:00,66,12,10,16,85,12,0,201
2024-03-15 18:10:00,73,5,9,8,89,12,0,196
2024-03-15 18:20:00,76,6,4,13,85,19,0,203
2024-03-15 18:30:00,71,8,7,15,79,7,0,187
2024-03-15 18:40:00,68,10,5,3,83,6,0,175
2024-03-15 18:50:00,55,13,7,15,101,8,0,199
2024-03-15 19:00:00,50,8,5,8,68,12,0,151
2024-03-15 19:10:00,54,3,2,8,66,9,0,142
2024-03-15 19:20:00,38,4,5,3,76,13,0,139
2024-03-15 19:30:00,38,7,2,2,65,10,0,124
2024-03-15 19:40:00,42,4,3,2,43,6,0,100
2024-03-15 19:50:00,35,4,2,2,48,7,0,98
2024-03-15 20:00:00,30,3,2,4,42,3,0,84
2024-03-15 20:10:00,28,4,0,6,49,5,0,92
2024-03-15 20:20:00,29,3,2,1,48,7,0,90
2024-03-15 20:30:00,44,8,1,0,31,13,0,97
2024-03-15 20:40:00,38,5,4,0,40,7,0,94
2024-03-15 20:50:00,31,8,3,6,32,8,0,88
2024-03-15 21:00:00,18,4,8,10,29,1,0,70
2024-03-15 21:10:00,26,3,2,2,42,2,0,77
2024-03-15 21:20:00,27,5,2,1,26,11,0,72
2024-03-15 21:30:00,25,6,1,2,21,4,0,59
2024-03-15 21:40:00,25,5,3,1,26,3,0,63
2024-03-15 21:50:00,21,2,2,4,27,4,0,60
2024-03-15 22:00:00,36,4,1,1,32,5,0,79
2024-03-15 22:10:00,16,1,4,1,41,5,0,68
2024-03-15 22:20:00,21,2,1,0,30,3,0,57
2024-03-15 22:30:00,17,5,0,0,33,6,0,61
2024-03-15 22:40:00,23,3,0,1,29,3,0,59
2024-03-15 22:50:00,14,1,0,0,29,5,0,49
2024-03-15 23:00:00,18,5,0,0,21,2,0,46
2024-03-15 23:10:00,15,2,1,2,23,5,0,48
2024-03-15 23:20:00,16,9,0,1,17,4,0,47
2024-03-15 23:30:00,12,2,1,1,23,3,0,42
2024-03-15 23:40:00,14,3,1,2,22,3,0,45
2024-03-15 23:50:00,13,1,3,0,15,4,0,36
2024-03-16 00:00:00,17,5,1,0,18,6,0,47
2024-03-16 00:10:00,5,3,0,0,19,5,0,32
2024-03-16 00:20:00,5,4,0,0,21,4,0,34
2024-03-16 00:30:00,10,0,0,1,11,1,0,23
2024-03-16 00:40:00,10,5,1,0,18,1,0,35
2024-03-16 00:50:00,4,1,0,0,8,2,0,15
2024-03-16 01:00:00,8,2,0,0,13,0,0,23
2024-03-16 01:10:00,5,1,0,0,8,1,0,15
2024-03-16 01:20:00,9,1,0,0,12,5,0,27
2024-03-16 01:30:00,3,1,0,0,3,3,0,10
2024-03-16 01:40:00,6,0,0,0,7,0,0,13
2024-03-16 01:50:00,7,3,0,0,5,2,0,17
2024-03-16 02:00:00,5,1,1,0,5,2,0,14
2024-03-16 02:10:00,4,2,0,0,4,0,0,10
2024-03-16 02:20:00,6,3,0,0,6,3,0,18
2024-03-16 02:30:00,3,0,0,1,7,0,0,11
2024-03-16 02:40:00,3,0,0,0,3,0,0,6
2024-03-16 02:50:00,5,0,0,0,3,2,0,10
2024-03-16 03:00:00,4,1,0,0,4,0,0,9
2024-03-16 03:10:00,4,3,0,0,4,2,0,13
2024-03-16 03:20:00,7,1,0,0,5,2,0,15
2024-03-16 03:30:00,1,2,0,0,2,0,0,5
2024-03-16 03:40:00,6,4,1,1,5,4,0,21
2024-03-16 03:50:00,4,0,0,0,2,1,0,7
2024-03-16 04:00:00,3,1,0,0,5,0,0,9
2024-03-16 04:10:00,3,1,0,0,5,1,0,10
2024-03-16 04:20:00,3,0,0,0,3,0,0,6
2024-03-16 04:30:00,5,3,0,0,6,3,0,17
2024-03-16 04:40:00,7,7,0,0,8,3,0,25
2024-03-16 04:50:00,6,6,0,0,5,4,0,21
2024-03-16 05:00:00,3,2,0,0,3,2,0,10
2024-03-16 05:10:00,13,3,0,0,5,2,0,23
2024-03-16 05:20:00,5,2,0,0,9,3,0,19
2024-03-16 05:30:00,7,1,0,0,4,2,0,14
2024-03-16 05:40:00,3,1,0,0,8,2,0,14
2024-03-16 05:50:00,5,0,0,0,6,1,0,12
2024-03-16 06:00:00,11,2,0,0,10,0,0,23
2024-03-16 06:10:00,15,3,0,1,10,3,0,32
2024-03-16 06:20:00,11,9,0,1,8,4,0,33
2024-03-16 06:30:00,19,1,0,0,7,3,0,30
2024-03-16 06:40:00,11,1,1,2,12,4,0,31
2024-03-16 06:50:00,13,6,0,1,7,8,0,35
2024-03-16 07:00:00,11,4,1,0,11,4,0,31
2024-03-16 07:10:00,16,3,0,0,19,3,0,41
2024-03-16 07:20:00,20,3,0,1,7,2,0,33
2024-03-16 07:30:00,13,2,3,1,18,6,0,43
2024-03-16 07:40:00,21,3,0,6,18,5,0,53
2024-03-16 07:50:00,25,4,1,3,19,4,0,56
2024-03-16 08:00:00,24,7,1,1,24,9,0,66
2024-03-16 08:10:00,28,10,0,0,28,4,0,70
2024-03-16 08:20:00,31,1,2,3,22,6,0,65
2024-03-16 08:30:00,35,8,0,2,32,3,0,80
2024-03-16 08:40:00,28,4,1,4,31,8,0,76
2024-03-16 08:50:00,41,1,0,2,36,4,0,84
2024-03-16 09:00:00,31,4,2,3,38,6,0,84
2024-03-16 09:10:00,39,5,0,1,37,3,0,85
2024-03-16 09:20:00,40,5,3,5,52,7,0,112
2024-03-16 09:30:00,42,8,2,4,34,8,0,98
2024-03-16 09:40:00,53,5,2,6,64,14,0,144
2024-03-16 09:50:00,54,10,5,6,89,9,0,173
2024-03-16 10:00:00,55,12,3,5,61,9,0,145
2024-03-16 10:10:00,58,15,0,6,57,5,0,141
2024-03-16 10:20:00,51,15,3,2,66,5,0,142
2024-03-16 10:30:00,71,11,1,7,62,6,0,158
2024-03-16 10:40:00,69,5,4,9,55,8,0,150
2024-03-16 10:50:00,38,2,5,2,72,9,0,128
2024-03-16 11:00:00,61,10,0,7,53,9,0,140
2024-03-16 11:10:00,54,6,3,4,64,12,0,143
2024-03-16 11:20:00,56,7,4,5,75,11,0,158
2024-03-16 11:30:00,52,10,6,6,62,14,0,150
2024-03-16 11:40:00,49,8,5,11,82,9,0,164
2024-03-16 11:50:00,52,3,2,8,82,14,0,161
2024-03-16 12:00:00,56,8,5,5,77,8,0,159
2024-03-16 12:10:00,51,4,5,16,87,14,0,177
2024-03-16 12:20:00,65,11,5,9,80,9,0,179
2024-03-16 12:30:00,55,14,9,14,73,11,0,176
2024-03-16 12:40:00,53,3,4,7,108,14,0,189
2024-03-16 12:50:00,46,11,3,7,128,32,0,227
2024-03-16 13:00:00,50,7,6,5,124,13,0,205
2024-03-16 13:10:00,61,8,4,14,115,13,0,215
2024-03-16 13:20:00,52,9,4,4,124,15,0,208
2024-03-16 13:30:00,59,4,2,8,129,14,0,216
2024-03-16 13:40:00,50,6,3,11,130,16,0,216
2024-03-16 13:50:00,42,5,8,8,144,25,0,232
2024-03-16 14:00:00,50,9,8,10,141,16,0,234
2024-03-16 14:10:00,58,2,12,7,134,11,0,224
2024-03-16 14:20:00,67,6,3,8,129,12,0,225
2024-03-16 14:30:00,60,6,2,4,124,17,0,213
2024-03-16 14:40:00,56,2,1,3,112,15,0,189
2024-03-16 14:50:00,48,3,2,2,93,12,0,160
2024-03-16 15:00:00,36,8,1,3,63,6,0,117
2024-03-16 15:10:00,40,5,1,2,53,11,0,112
2024-03-16 15:20:00,34,8,2,8,63,12,0,127
2024-03-16 15:30:00,44,5,4,9,47,10,0,119
2024-03-16 15:40:00,32,2,4,3,49,9,0,99
2024-03-16 15:50:00,37,2,3,6,39,7,0,94
2024-03-16 16:00:00,36,7,1,4,45,12,0,105
2024-03-16 16:10:00,50,7,4,4,56,12,0,133
2024-03-16 16:20:00,38,4,3,3,53,7,0,108
2024-03-16 16:30:00,43,6,2,2,69,9,0,131
2024-03-16 16:40:00,35,5,0,2,57,7,0,106
2024-03-16 16:50:00,39,1,6,4,51,4,0,105
2024-03-16 17:00:00,47,9,3,4,59,11,0,133
2024-03-16 17:10:00,57,8,2,2,60,11,0,140
2024-03-16 17:20:00,63,7,1,3,55,11,0,140
2024-03-16 17:30:00,67,8,5,3,64,9,0,156
2024-03-16 17:40:00,120,10,1,5,64,7,0,207
2024-03-16 17:50:00,109,10,1,9,57,11,0,197
2024-03-16 18:00:00,64,18,1,5,54,23,0,165
2024-03-16 18:10:00,69,13,7,11,66,10,0,176
2024-03-16 18:20:00,81,11,2,4,16,17,0,131
2024-03-16 18:30:00,117,13,0,1,56,12,0,199
2024-03-16 18:40:00,89,3,1,3,38,6,0,140
2024-03-16 18:50:00,84,9,3,5,64,7,0,172
2024-03-16 19:00:00,75,7,7,4,54,7,0,154
2024-03-16 19:10:00,69,7,1,1,44,8,0,130
2024-03-16 19:20:00,66,9,0,2,68,12,0,157
2024-03-16 19:30:00,58,14,0,0,38,2,0,112
2024-03-16 19:40:00,67,4,1,5,40,4,0,121
2024-03-16 19:50:00,40,7,0,0,45,7,0,99
2024-03-16 20:00:00,43,12,1,0,43,6,0,105
2024-03-16 20:10:00,32,5,2,2,30,4,0,75
2024-03-16 20:20:00,41,11,1,1,38,6,0,98
2024-03-16 20:30:00,36,3,0,2,33,11,0,85
2024-03-16 20:40:00,19,3,1,0,31,5,0,59
2024-03-16 20:50:00,25,10,1,0,32,6,0,74
2024-03-16 21:00:00,23,3,1,3,33,6,0,69
2024-03-16 21:10:00,28,6,0,3,24,7,0,68
2024-03-16 21:20:00,18,2,0,1,24,4,0,49
2024-03-16 21:30:00,24,5,0,1,25,5,0,60
2024-03-16 21:40:00,17,2,1,1,22,3,0,46
2024-03-16 21:50:00,24,6,1,0,26,2,0,59
2024-03-16 22:00:00,24,5,0,1,23,8,0,61
2024-03-16 22:10:00,21,2,0,0,34,3,0,60
2024-03-16 22:20:00,19,4,1,1,31,1,0,57
2024-03-16 22:30:00,29,6,0,0,17,6,0,58
2024-03-16 22:40:00,20,5,0,1,20,4,0,50
2024-03-16 22:50:00,14,1,1,0,24,5,0,45
2024-03-16 23:00:00,10,6,0,1,26,6,0,49
2024-03-16 23:10:00,14,4,1,1,33,9,0,62
2024-03-16 23:20:00,19,3,1,0,21,5,0,49
2024-03-16 23:30:00,11,3,0,2,22,3,0,41
2024-03-16 23:40:00,15,5,1,0,17,8,0,46
2024-03-16 23:50:00,21,3,0,2,18,5,0,49
2024-03-17 00:00:00,10,3,0,1,15,2,0,31
2024-03-17 00:10:00,8,2,1,0,14,4,0,29
2024-03-17 00:20:00,8,3,0,0,14,4,0,29
2024-03-17 00:30:00,17,4,0,0,17,3,0,41
2024-03-17 00:40:00,8,3,0,0,10,5,0,26
2024-03-17 00:50:00,4,2,0,0,11,4,0,21
2024-03-17 01:00:00,4,2,0,1,8,1,0,16
2024-03-17 01:10:00,5,2,0,1,12,3,0,23
2024-03-17 01:20:00,3,1,1,1,10,2,0,18
2024-03-17 01:30:00,5,2,0,0,8,1,0,16
2024-03-17 01:40:00,6,2,0,1,12,2,0,23
2024-03-17 01:50:00,9,2,0,0,8,1,0,20
2024-03-17 02:00:00,1,0,1,0,4,2,0,8
2024-03-17 02:10:00,4,1,0,0,13,1,0,19
2024-03-17 02:20:00,4,0,0,0,4,0,0,8
2024-03-17 02:30:00,8,4,0,0,8,5,0,25
2024-03-17 02:40:00,1,0,0,0,10,4,0,15
2024-03-17 02:50:00,5,1,0,0,9,3,0,18
2024-03-17 03:00:00,3,1,0,0,2,0,0,6
2024-03-17 03:10:00,2,0,0,0,3,2,0,7
2024-03-17 03:20:00,5,2,0,0,2,2,0,11
2024-03-17 03:30:00,5,2,0,0,4,1,0,12
2024-03-17 03:40:00,1,1,0,0,1,0,0,3
2024-03-17 03:50:00,2,2,0,0,4,2,0,10
2024-03-17 04:00:00,3,1,0,0,4,1,0,9
2024-03-17 04:10:00,7,0,0,0,3,3,0,13
2024-03-17 04:20:00,3,0,0,0,1,0,0,4
2024-03-17 04:30:00,1,1,0,0,5,2,0,9
2024-03-17 04:40:00,1,2,0,0,6,1,0,10
2024-03-17 04:50:00,1,1,0,0,4,1,0,7
2024-03-17 05:00:00,10,1,0,0,2,0,0,13
2024-03-17 05:10:00,2,0,0,0,0,0,0,2
2024-03-17 05:20:00,5,2,0,0,3,1,0,11
2024-03-17 05:30:00,4,0,0,0,1,0,0,5
2024-03-17 05:40:00,4,1,0,0,7,3,0,15
2024-03-17 05:50:00,2,0,0,0,5,1,0,8
2024-03-17 06:00:00,7,4,0,0,5,3,0,19
2024-03-17 06:10:00,8,2,0,0,7,3,0,20
2024-03-17 06:20:00,7,0,1,0,9,0,0,17
2024-03-17 06:30:00,6,1,1,1,3,2,0,14
2024-03-17 06:40:00,2,1,0,0,5,0,0,8
2024-03-17 06:50:00,5,2,0,0,3,3,0,13
2024-03-17 07:00:00,7,3,0,2,6,2,0,20
2024-03-17 07:10:00,5,1,0,0,11,1,0,18
2024-03-17 07:20:00,4,1,0,0,8,2,0,15
2024-03-17 07:30:00,9,1,0,0,6,0,0,16
2024-03-17 07:40:00,8,2,0,0,7,1,0,18
2024-03-17 07:50:00,6,2,1,3,8,4,0,24
2024-03-17 08:00:00,8,3,0,0,7,2,0,20
2024-03-17 08:10:00,17,2,1,0,10,3,0,33
2024-03-17 08:20:00,10,4,2,2,11,1,0,30
2024-03-17 08:30:00,18,2,1,2,13,1,0,37
2024-03-17 08:40:00,18,2,0,2,23,7,0,52
2024-03-17 08:50:00,13,0,1,1,24,3,0,42
2024-03-17 09:00:00,27,5,0,3,16,7,0,58
2024-03-17 09:10:00,28,1,2,1,18,3,0,53
2024-03-17 09:20:00,26,6,1,1,20,2,0,56
2024-03-17 09:30:00,23,4,1,3,28,5,0,64
2024-03-17 09:40:00,31,5,1,1,50,7,0,95
2024-03-17 09:50:00,39,5,5,1,42,6,0,98
2024-03-17 10:00:00,44,9,0,0,34,6,0,93
2024-03-17 10:10:00,32,3,3,1,32,4,0,75
2024-03-17 10:20:00,32,5,0,0,43,6,0,86
2024-03-17 10:30:00,31,4,1,2,32,6,0,76
2024-03-17 10:40:00,36,2,0,1,50,3,0,92
2024-03-17 10:50:00,36,8,4,4,51,4,0,107
2024-03-17 11:00:00,35,3,2,2,33,6,0,81
2024-03-17 11:10:00,39,9,1,2,49,6,0,106
2024-03-17 11:20:00,48,4,0,4,51,9,0,116
2024-03-17 11:30:00,47,5,0,0,48,4,0,104
2024-03-17 11:40:00,35,2,2,6,62,5,0,112
2024-03-17 11:50:00,33,5,2,3,64,9,0,116
2024-03-17 12:00:00,47,4,2,0,55,2,0,110
2024-03-17 12:10:00,53,11,2,3,57,7,0,133
2024-03-17 12:20:00,46,11,2,3,35,8,0,105
2024-03-17 12:30:00,46,3,2,5,63,6,0,125
2024-03-17 12:40:00,38,3,2,1,63,4,0,111
2024-03-17 12:50:00,47,5,4,1,58,9,0,124
2024-03-17 13:00:00,43,6,2,5,43,13,0,112
2024-03-17 13:10:00,52,8,2,1,67,10,0,140
2024-03-17 13:20:00,69,14,0,2,50,7,0,142
2024-03-17 13:30:00,54,6,0,6,56,6,0,128
2024-03-17 13:40:00,58,5,3,6,54,6,0,132
2024-03-17 13:50:00,52,12,2,2,65,7,0,140
2024-03-17 14:00:00,53,8,1,6,56,7,0,131
2024-03-17 14:10:00,54,6,0,0,61,6,0,127
2024-03-17 14:20:00,45,5,1,3,70,9,0,133
2024-03-17 14:30:00,53,9,3,3,52,9,0,129
2024-03-17 14:40:00,46,7,10,5,81,9,0,158
2024-03-17 14:50:00,52,10,3,3,57,8,0,133
2024-03-17 15:00:00,45,6,3,9,54,10,0,127
2024-03-17 15:10:00,44,10,3,3,57,13,0,130
2024-03-17 15:20:00,47,7,4,4,60,5,0,127
2024-03-17 15:30:00,57,7,5,3,32,11,0,115
2024-03-17 15:40:00,44,3,7,8,48,1,0,111
2024-03-17 15:50:00,49,4,5,2,71,10,0,141
2024-03-17 16:00:00,53,10,1,2,46,9,0,121
2024-03-17 16:10:00,59,6,9,0,56,4,0,134
2024-03-17 16:20:00,47,7,0,4,49,6,0,113
2024-03-17 16:30:00,50,7,2,6,59,10,0,134
2024-03-17 16:40:00,42,10,4,2,45,9,0,112
2024-03-17 16:50:00,60,6,2,3,49,8,0,128
2024-03-17 17:00:00,61,4,4,4,52,13,0,138
2024-03-17 17:10:00,46,8,4,3,53,12,0,126
2024-03-17 17:20:00,46,2,0,6,71,10,0,135
2024-03-17 17:30:00,81,9,2,1,53,6,0,152
2024-03-17 17:40:00,73,5,4,2,60,5,0,149
2024-03-17 17:50:00,55,9,4,1,54,6,0,129
2024-03-17 18:00:00,57,4,3,5,54,7,0,130
2024-03-17 18:10:00,47,8,6,6,55,12,0,134
2024-03-17 18:20:00,49,4,2,0,49,4,0,108
2024-03-17 18:30:00,49,4,6,5,42,4,0,110
2024-03-17 18:40:00,44,5,0,2,43,6,0,100
2024-03-17 18:50:00,33,3,2,3,44,6,0,91
2024-03-17 19:00:00,36,4,1,2,42,5,0,90
2024-03-17 19:10:00,27,3,2,2,40,4,0,78
2024-03-17 19:20:00,35,0,0,4,34,6,0,79
2024-03-17 19:30:00,29,1,1,5,34,6,0,76
2024-03-17 19:40:00,27,2,0,0,38,2,0,69
2024-03-17 19:50:00,33,1,1,0,32,6,0,73
2024-03-17 20:00:00,26,7,0,0,34,4,0,71
2024-03-17 20:10:00,30,9,2,0,29,12,0,82
2024-03-17 20:20:00,26,3,1,0,43,6,0,79
2024-03-17 20:30:00,27,4,4,4,35,7,0,81
2024-03-17 20:40:00,19,5,1,0,36,0,0,61
2024-03-17 20:50:00,16,2,1,0,37,4,0,60
2024-03-17 21:00:00,13,4,0,1,20,3,0,41
2024-03-17 21:10:00,26,4,0,1,32,7,0,70
2024-03-17 21:20:00,16,4,0,1,25,4,0,50
2024-03-17 21:30:00,20,1,0,0,11,4,0,36
2024-03-17 21:40:00,13,1,0,0,24,4,0,42
2024-03-17 21:50:00,17,1,1,4,12,3,0,38
2024-03-17 22:00:00,12,5,0,2,17,6,0,42
2024-03-17 22:10:00,11,4,1,1,23,1,0,41
2024-03-17 22:20:00,11,0,0,0,12,0,0,23
2024-03-17 22:30:00,15,3,0,0,13,5,0,36
2024-03-17 22:40:00,8,2,0,0,16,1,0,27
2024-03-17 22:50:00,8,3,0,0,15,1,0,27
2024-03-17 23:00:00,5,0,1,0,7,1,0,14
2024-03-17 23:10:00,5,1,0,0,17,5,0,28
2024-03-17 23:20:00,10,5,0,1,8,3,0,27
2024-03-17 23:30:00,2,2,0,0,5,4,0,13
2024-03-17 23:40:00,6,3,0,0,9,1,0,19
2024-03-17 23:50:00,3,3,0,0,5,1,0,12
2024-03-18 00:00:00,2,2,0,0,4,1,0,9
2024-03-18 00:10:00,4,3,0,0,7,3,0,17
2024-03-18 00:20:00,8,3,1,0,4,1,0,17
2024-03-18 00:30:00,3,0,1,1,1,0,0,6
2024-03-18 00:40:00,1,1,0,0,3,1,0,6
2024-03-18 00:50:00,5,0,0,0,5,4,0,14
2024-03-18 01:00:00,4,1,0,0,5,0,0,10
2024-03-18 01:10:00,2,3,0,0,3,2,0,10
2024-03-18 01:20:00,3,2,0,0,6,2,0,13
2024-03-18 01:30:00,2,0,1,0,6,1,0,10
2024-03-18 01:40:00,2,1,0,0,3,2,0,8
2024-03-18 01:50:00,4,1,0,0,1,1,0,7
2024-03-18 02:00:00,0,0,1,0,3,0,0,4
2024-03-18 02:10:00,5,2,0,0,3,2,0,12
2024-03-18 02:20:00,1,2,0,0,4,0,0,7
2024-03-18 02:30:00,0,0,0,0,5,0,0,5
2024-03-18 02:40:00,0,0,0,0,3,0,0,3
2024-03-18 02:50:00,3,2,0,0,2,4,0,11
2024-03-18 03:00:00,1,0,0,0,4,0,0,5
2024-03-18 03:10:00,4,2,0,0,5,3,0,14
2024-03-18 03:20:00,2,3,0,0,4,1,0,10
2024-03-18 03:30:00,4,2,1,0,2,3,0,12
2024-03-18 03:40:00,5,4,0,0,5,1,0,15
2024-03-18 03:50:00,6,2,0,0,1,1,0,10
2024-03-18 04:00:00,2,2,0,0,3,3,0,10
2024-03-18 04:10:00,3,0,0,0,6,2,0,11
2024-03-18 04:20:00,5,2,0,0,4,1,0,12
2024-03-18 04:30:00,5,3,0,0,6,3,0,17
2024-03-18 04:40:00,7,1,0,0,10,3,0,21
2024-03-18 04:50:00,10,4,0,0,7,3,0,24
2024-03-18 05:00:00,18,6,0,0,13,7,0,44
2024-03-18 05:10:00,24,10,0,0,18,7,0,59
2024-03-18 05:20:00,28,9,0,2,18,5,0,62
2024-03-18 05:30:00,34,10,0,0,23,7,0,74
2024-03-18 05:40:00,53,4,0,0,30,4,0,91
2024-03-18 05:50:00,46,12,1,0,41,6,0,106
2024-03-18 06:00:00,49,8,2,4,32,7,0,102
2024-03-18 06:10:00,63,5,0,2,33,5,0,108
2024-03-18 06:20:00,69,8,0,3,41,3,0,124
2024-03-18 06:30:00,70,8,2,2,41,8,0,131
2024-03-18 06:40:00,82,13,0,4,52,3,0,154
2024-03-18 06:50:00,73,8,2,0,60,7,0,150
2024-03-18 07:00:00,113,12,1,1,49,1,0,177
2024-03-18 07:10:00,89,9,2,7,86,6,0,199
2024-03-18 07:20:00,113,15,1,8,83,17,0,237
2024-03-18 07:30:00,97,21,11,18,121,4,0,272
2024-03-18 07:40:00,83,15,6,22,107,10,0,243
2024-03-18 07:50:00,71,8,15,30,129,13,0,266
2024-03-18 08:00:00,89,8,8,20,86,14,0,225
2024-03-18 08:10:00,79,10,8,11,73,10,0,191
2024-03-18 08:20:00,74,8,5,8,106,6,0,207
2024-03-18 08:30:00,76,6,6,15,82,6,0,191
2024-03-18 08:40:00,95,10,9,8,80,12,0,214
2024-03-18 08:50:00,65,8,6,13,81,12,0,185
2024-03-18 09:00:00,87,8,6,5,70,13,0,189
2024-03-18 09:10:00,54,10,4,4,73,11,0,156
2024-03-18 09:20:00,81,10,4,4,73,16,0,188
2024-03-18 09:30:00,67,7,5,5,64,10,0,158
2024-03-18 09:40:00,81,10,3,10,60,7,0,171
2024-03-18 09:50:00,64,7,3,7,67,7,0,155
2024-03-18 10:00:00,64,4,1,12,66,7,0,154
2024-03-18 10:10:00,59,13,2,4,63,10,0,151
2024-03-18 10:20:00,60,5,5,4,43,10,0,127
2024-03-18 10:30:00,78,14,2,7,55,19,0,175
2024-03-18 10:40:00,67,10,3,5,41,8,0,134
2024-03-18 10:50:00,68,9,5,3,61,11,0,157
2024-03-18 11:00:00,53,5,0,1,60,9,0,128
2024-03-18 11:10:00,61,9,5,5,58,10,0,148
2024-03-18 11:20:00,82,10,4,10,53,9,0,168
2024-03-18 11:30:00,51,8,6,7,56,8,0,136
2024-03-18 11:40:00,73,9,6,10,77,16,0,191
2024-03-18 11:50:00,58,12,7,8,64,5,0,154
2024-03-18 12:00:00,56,9,3,4,54,13,0,139
2024-03-18 12:10:00,71,4,1,5,77,8,0,166
2024-03-18 12:20:00,74,6,5,7,63,13,0,168
2024-03-18 12:30:00,90,4,2,6,65,8,0,175
2024-03-18 12:40:00,73,2,1,4,56,6,0,142
2024-03-18 12:50:00,59,9,5,4,92,15,0,184
2024-03-18 13:00:00,52,9,7,11,83,9,0,171
2024-03-18 13:10:00,84,12,13,13,78,10,0,210
2024-03-18 13:20:00,71,7,5,9,94,11,0,197
2024-03-18 13:30:00,71,5,7,6,82,8,0,179
2024-03-18 13:40:00,60,11,2,6,83,10,0,172
2024-03-18 13:50:00,67,13,4,8,84,11,0,187
2024-03-18 14:00:00,64,9,5,11,84,12,0,185
2024-03-18 14:10:00,77,9,5,14,89,7,0,201
2024-03-18 14:20:00,69,13,7,7,76,4,0,176
2024-03-18 14:30:00,68,7,6,11,94,17,0,203
2024-03-18 14:40:00,77,9,2,9,88,15,0,200
2024-03-18 14:50:00,73,10,7,7,91,13,0,201
2024-03-18 15:00:00,75,13,3,17,103,9,0,220
2024-03-18 15:10:00,80,13,7,13,119,16,0,248
2024-03-18 15:20:00,55,16,5,17,98,12,0,203
2024-03-18 15:30:00,80,10,9,22,90,12,0,223
2024-03-18 15:40:00,45,8,10,17,117,8,0,205
2024-03-18 15:50:00,71,13,4,13,108,16,0,225
2024-03-18 16:00:00,69,10,8,22,121,16,0,246
2024-03-18 16:10:00,49,9,13,18,103,12,0,204
2024-03-18 16:20:00,49,8,8,20,93,9,0,187
2024-03-18 16:30:00,62,8,8,12,104,13,0,207
2024-03-18 16:40:00,68,6,11,12,96,36,0,229
2024-03-18 16:50:00,60,11,7,6,113,3,0,200
2024-03-18 17:00:00,51,7,6,8,106,11,0,189
2024-03-18 17:10:00,51,8,5,5,109,9,0,187
2024-03-18 17:20:00,74,9,11,16,144,9,0,263
2024-03-18 17:30:00,86,12,15,19,99,16,0,247
2024-03-18 17:40:00,80,7,5,11,114,22,0,239
2024-03-18 17:50:00,73,13,3,12,131,16,0,248
2024-03-18 18:00:00,74,6,7,16,94,15,0,212
2024-03-18 18:10:00,80,13,5,12,98,11,0,219
2024-03-18 18:20:00,93,9,4,5,109,9,0,229
2024-03-18 18:30:00,58,6,6,6,101,9,0,186
2024-03-18 18:40:00,47,12,7,4,80,15,0,165
2024-03-18 18:50:00,48,7,2,5,69,12,0,143
2024-03-18 19:00:00,53,5,13,10,69,13,0,163
2024-03-18 19:10:00,57,14,6,4,79,13,0,173
2024-03-18 19:20:00,31,9,4,6,55,11,0,116
2024-03-18 19:30:00,39,7,1,4,51,8,0,110
2024-03-18 19:40:00,58,6,13,12,56,6,0,151
2024-03-18 19:50:00,52,6,4,3,35,7,0,107
2024-03-18 20:00:00,40,5,3,6,50,5,0,109
2024-03-18 20:10:00,34,2,4,7,55,4,0,106
2024-03-18 20:20:00,38,5,0,1,34,7,0,85
2024-03-18 20:30:00,33,2,2,4,29,12,0,82
2024-03-18 20:40:00,24,2,2,3,37,6,0,74
2024-03-18 20:50:00,23,4,2,2,49,14,0,94
2024-03-18 21:00:00,24,1,2,5,23,2,0,57
2024-03-18 21:10:00,36,3,2,8,31,4,0,84
2024-03-18 21:20:00,22,5,3,1,46,14,0,91
2024-03-18 21:30:00,24,2,1,2,29,3,0,61
2024-03-18 21:40:00,25,4,0,2,28,7,0,66
2024-03-18 21:50:00,21,3,0,2,23,5,0,54
2024-03-18 22:00:00,19,4,1,0,24,5,0,53
2024-03-18 22:10:00,18,1,8,6,37,1,0,71
2024-03-18 22:20:00,25,5,2,1,28,3,0,64
2024-03-18 22:30:00,17,1,5,1,17,0,0,41
2024-03-18 22:40:00,6,1,0,0,20,4,0,31
2024-03-18 22:50:00,13,1,0,1,16,4,0,35
2024-03-18 23:00:00,13,4,0,1,16,1,0,35
2024-03-18 23:10:00,5,1,0,0,12,5,0,23
2024-03-18 23:20:00,13,2,0,0,7,3,0,25
2024-03-18 23:30:00,8,0,0,2,9,3,0,22
2024-03-18 23:40:00,9,4,0,0,8,0,0,21
2024-03-18 23:50:00,5,0,0,0,8,1,0,14
2024-03-19 00:00:00,12,5,0,0,9,4,0,30
2024-03-19 00:10:00,9,4,0,0,2,3,0,18
2024-03-19 00:20:00,4,1,0,0,4,2,0,11
2024-03-19 00:30:00,5,3,0,0,10,3,0,21
2024-03-19 00:40:00,7,3,0,0,5,3,0,18
2024-03-19 00:50:00,6,5,0,0,3,5,0,19
2024-03-19 01:00:00,6,1,0,0,1,1,0,9
2024-03-19 01:10:00,4,2,0,0,2,2,0,10
2024-03-19 01:20:00,1,0,0,0,5,5,0,11
2024-03-19 01:30:00,4,2,1,0,3,2,0,12
2024-03-19 01:40:00,0,1,0,0,5,3,0,9
2024-03-19 01:50:00,2,1,0,0,4,1,0,8
2024-03-19 02:00:00,5,3,0,0,1,3,0,12
2024-03-19 02:10:00,3,1,0,0,2,1,0,7
2024-03-19 02:20:00,4,1,0,0,1,1,0,7
2024-03-19 02:30:00,1,0,0,0,7,2,0,10
2024-03-19 02:40:00,4,3,0,0,2,2,0,11
2024-03-19 02:50:00,3,3,0,1,5,2,0,14
2024-03-19 03:00:00,2,1,0,0,8,3,0,14
2024-03-19 03:10:00,2,3,0,0,1,2,0,8
2024-03-19 03:20:00,1,1,0,0,3,0,0,5
2024-03-19 03:30:00,4,3,1,0,2,4,0,14
2024-03-19 03:40:00,4,3,0,0,2,3,0,12
2024-03-19 03:50:00,0,0,0,0,5,2,0,7
2024-03-19 04:00:00,5,4,0,0,3,2,0,14
2024-03-19 04:10:00,2,0,0,0,8,1,0,11
2024-03-19 04:20:00,5,2,0,0,6,1,0,14
2024-03-19 04:30:00,5,3,0,0,7,2,0,17
2024-03-19 04:40:00,8,3,1,0,9,2,0,23
2024-03-19 04:50:00,12,7,0,1,13,13,0,46
2024-03-19 05:00:00,11,6,0,0,11,5,0,33
2024-03-19 05:10:00,16,7,0,0,17,2,0,42
2024-03-19 05:20:00,35,12,0,0,15,13,0,75
2024-03-19 05:30:00,34,8,1,0,16,11,0,70
2024-03-19 05:40:00,50,4,0,2,32,5,0,93
2024-03-19 05:50:00,45,8,1,0,36,6,0,96
2024-03-19 06:00:00,55,8,3,1,30,9,0,106
2024-03-19 06:10:00,56,4,0,1,38,1,0,100
2024-03-19 06:20:00,86,10,1,3,33,5,0,138
2024-03-19 06:30:00,90,11,2,6,42,4,0,155
2024-03-19 06:40:00,83,16,4,1,59,5,0,168
2024-03-19 06:50:00,87,9,1,2,60,3,0,162
2024-03-19 07:00:00,97,14,1,4,64,10,0,190
2024-03-19 07:10:00,123,13,5,6,82,10,0,239
2024-03-19 07:20:00,97,11,2,7,86,6,0,209
2024-03-19 07:30:00,65,14,10,17,126,7,0,239
2024-03-19 07:40:00,60,11,18,23,112,8,0,232
2024-03-19 07:50:00,29,9,17,25,102,11,0,193
2024-03-19 08:00:00,35,6,4,5,75,13,0,138
2024-03-19 08:10:00,59,12,7,7,102,9,0,196
2024-03-19 08:20:00,59,10,6,6,102,7,0,190
2024-03-19 08:30:00,76,12,8,7,67,3,0,173
2024-03-19 08:40:00,70,4,6,8,102,6,0,196
2024-03-19 08:50:00,70,9,11,13,91,6,0,200
2024-03-19 09:00:00,81,7,4,10,65,11,0,178
2024-03-19 09:10:00,80,15,9,7,83,14,0,208
2024-03-19 09:20:00,60,5,5,7,74,6,0,157
2024-03-19 09:30:00,92,7,6,7,73,10,0,195
2024-03-19 09:40:00,78,8,8,11,65,12,0,182
2024-03-19 09:50:00,64,8,6,3,57,16,0,154
2024-03-19 10:00:00,56,7,2,6,68,5,0,144
2024-03-19 10:10:00,72,5,3,5,58,13,0,156
2024-03-19 10:20:00,63,6,0,5,53,10,0,137
2024-03-19 10:30:00,61,7,3,4,52,10,0,137
2024-03-19 10:40:00,63,5,4,5,60,9,0,146
2024-03-19 10:50:00,35,6,3,2,22,3,0,71
2024-03-19 11:00:00,10,2,1,3,11,1,0,28
2024-03-19 11:10:00,57,7,2,10,67,8,0,151
2024-03-19 11:20:00,74,9,2,11,67,11,0,174
2024-03-19 11:30:00,57,13,4,7,72,10,0,163
2024-03-19 11:40:00,61,8,6,12,76,10,0,173
2024-03-19 11:50:00,73,14,6,5,63,14,0,175
2024-03-19 12:00:00,70,12,1,10,71,10,0,174
2024-03-19 12:10:00,86,10,1,8,74,9,0,188
2024-03-19 12:20:00,53,6,5,6,81,10,0,161
2024-03-19 12:30:00,62,10,5,11,84,12,0,184
2024-03-19 12:40:00,70,11,1,11,83,7,0,183
2024-03-19 12:50:00,90,14,4,3,98,4,0,213
2024-03-19 13:00:00,75,11,15,15,69,10,0,195
2024-03-19 13:10:00,68,8,15,21,92,12,0,216
2024-03-19 13:20:00,53,11,8,15,64,10,0,161
2024-03-19 13:30:00,91,21,5,5,101,9,0,232
2024-03-19 13:40:00,67,8,7,8,76,12,0,178
2024-03-19 13:50:00,73,16,3,7,90,13,0,202
2024-03-19 14:00:00,80,9,3,10,67,13,0,182
2024-03-19 14:10:00,77,9,12,12,100,11,0,221
2024-03-19 14:20:00,68,12,7,9,86,18,0,200
2024-03-19 14:30:00,82,8,9,10,96,9,0,214
2024-03-19 14:40:00,78,8,7,3,67,8,0,171
2024-03-19 14:50:00,89,11,4,8,93,8,0,213
2024-03-19 15:00:00,77,15,7,14,103,15,0,231
2024-03-19 15:10:00,76,15,9,6,85,9,0,200
2024-03-19 15:20:00,81,13,12,10,123,20,0,259
2024-03-19 15:30:00,72,8,6,16,96,12,0,210
2024-03-19 15:40:00,83,7,13,14,108,11,0,236
2024-03-19 15:50:00,84,4,17,8,82,19,0,214
2024-03-19 16:00:00,76,10,11,10,112,10,0,229
2024-03-19 16:10:00,72,8,3,7,127,17,0,234
2024-03-19 16:20:00,63,11,3,7,110,15,0,209
2024-03-19 16:30:00,77,7,9,11,112,10,0,226
2024-03-19 16:40:00,65,8,7,10,121,11,0,222
2024-03-19 16:50:00,91,8,11,15,129,19,0,273
2024-03-19 17:00:00,77,16,3,7,108,12,0,223
2024-03-19 17:10:00,62,6,7,5,87,16,0,183
2024-03-19 17:20:00,81,7,11,12,138,15,0,264
2024-03-19 17:30:00,65,7,8,11,124,14,0,229
2024-03-19 17:40:00,97,12,11,10,101,12,0,243
2024-03-19 17:50:00,73,9,8,11,125,15,0,241
2024-03-19 18:00:00,61,10,10,8,107,15,0,211
2024-03-19 18:10:00,80,8,12,7,100,7,0,214
2024-03-19 18:20:00,83,12,10,11,98,12,0,226
2024-03-19 18:30:00,68,11,2,15,79,7,0,182
2024-03-19 18:40:00,75,13,10,5,80,11,0,194
2024-03-19 18:50:00,54,7,6,12,82,12,0,173
2024-03-19 19:00:00,52,4,3,3,75,12,0,149
2024-03-19 19:10:00,65,9,1,3,76,9,0,163
2024-03-19 19:20:00,44,12,3,3,66,14,0,142
2024-03-19 19:30:00,37,2,6,5,59,3,0,112
2024-03-19 19:40:00,39,6,13,15,65,10,0,148
2024-03-19 19:50:00,58,4,12,3,46,7,0,130
2024-03-19 20:00:00,37,8,5,10,34,8,0,102
2024-03-19 20:10:00,33,6,4,7,53,4,0,107
2024-03-19 20:20:00,36,2,8,9,34,7,0,96
2024-03-19 20:30:00,35,4,2,9,45,6,0,101
2024-03-19 20:40:00,27,2,8,6,38,3,0,84
2024-03-19 20:50:00,29,6,2,6,36,8,0,87
2024-03-19 21:00:00,31,9,3,0,31,6,0,80
2024-03-19 21:10:00,33,6,1,3,30,5,0,78
2024-03-19 21:20:00,21,2,3,3,47,13,0,89
2024-03-19 21:30:00,30,4,3,3,34,3,0,77
2024-03-19 21:40:00,28,3,3,3,35,6,0,78
2024-03-19 21:50:00,24,5,0,1,33,9,0,72
2024-03-19 22:00:00,21,4,1,0,32,8,0,66
2024-03-19 22:10:00,23,9,3,2,22,5,0,64
2024-03-19 22:20:00,18,2,1,2,29,3,0,55
2024-03-19 22:30:00,21,5,0,0,21,2,0,49
2024-03-19 22:40:00,18,5,0,1,24,5,0,53
2024-03-19 22:50:00,21,6,1,0,15,5,0,48
2024-03-19 23:00:00,13,6,0,0,22,3,0,44
2024-03-19 23:10:00,8,3,0,0,11,5,0,27
2024-03-19 23:20:00,11,2,1,0,11,3,0,28
2024-03-19 23:30:00,11,5,0,2,8,4,0,30
2024-03-19 23:40:00,3,1,0,0,12,1,0,17
2024-03-19 23:50:00,7,2,0,0,7,2,0,18
2024-03-20 00:00:00,1,1,0,0,6,6,0,14
2024-03-20 00:10:00,5,3,0,0,12,6,0,26
2024-03-20 00:20:00,2,1,0,0,4,0,0,7
2024-03-20 00:30:00,2,1,0,0,6,5,0,14
2024-03-20 00:40:00,2,1,0,0,1,2,0,6
2024-03-20 00:50:00,2,1,0,0,6,2,0,11
2024-03-20 01:00:00,7,1,0,0,1,1,0,10
2024-03-20 01:10:00,3,1,0,1,3,3,0,11
2024-03-20 01:20:00,1,2,0,0,3,5,0,11
2024-03-20 01:30:00,0,2,0,0,3,1,0,6
2024-03-20 01:40:00,3,0,1,0,3,1,0,8
2024-03-20 01:50:00,3,2,0,0,1,2,0,8
2024-03-20 02:00:00,2,2,0,0,1,2,0,7
2024-03-20 02:10:00,3,0,0,0,2,1,0,6
2024-03-20 02:20:00,5,2,0,0,0,0,0,7
2024-03-20 02:30:00,0,0,0,0,5,1,0,6
2024-03-20 02:40:00,5,4,0,0,2,5,0,16
2024-03-20 02:50:00,2,1,0,0,2,2,0,7
2024-03-20 03:00:00,1,1,0,0,7,3,0,12
2024-03-20 03:10:00,1,1,0,0,5,3,0,10
2024-03-20 03:20:00,3,4,0,0,2,5,0,14
2024-03-20 03:30:00,1,0,1,0,1,0,0,3
2024-03-20 03:40:00,3,2,0,0,4,1,0,10
2024-03-20 03:50:00,2,2,0,0,5,3,0,12
2024-03-20 04:00:00,3,0,0,0,6,3,0,12
2024-03-20 04:10:00,2,0,0,1,6,1,0,10
2024-03-20 04:20:00,6,1,0,2,6,1,0,16
2024-03-20 04:30:00,4,3,0,0,8,4,0,19
2024-03-20 04:40:00,4,1,2,1,9,1,0,18
2024-03-20 04:50:00,9,5,0,0,10,3,0,27
2024-03-20 05:00:00,13,8,0,0,11,7,0,39
2024-03-20 05:10:00,19,6,0,0,13,8,0,46
2024-03-20 05:20:00,28,10,0,0,14,14,0,66
2024-03-20 05:30:00,40,8,0,0,22,6,0,76
2024-03-20 05:40:00,49,8,1,1,33,5,0,97
2024-03-20 05:50:00,55,7,0,1,36,6,0,105
2024-03-20 06:00:00,44,3,2,2,29,8,0,88
2024-03-20 06:10:00,59,8,0,2,28,6,0,103
2024-03-20 06:20:00,80,6,1,1,38,5,0,131
2024-03-20 06:30:00,83,10,0,3,47,6,0,149
2024-03-20 06:40:00,99,12,2,1,63,11,0,188
2024-03-20 06:50:00,96,11,2,1,57,10,0,177
2024-03-20 07:00:00,112,6,2,7,55,5,0,187
2024-03-20 07:10:00,126,11,3,7,75,10,0,232
2024-03-20 07:20:00,97,15,3,8,82,10,0,215
2024-03-20 07:30:00,76,15,7,14,84,7,0,203
2024-03-20 07:40:00,53,10,15,24,121,11,0,234
2024-03-20 07:50:00,27,8,26,18,83,10,0,172
2024-03-20 08:00:00,42,14,8,11,87,14,0,176
2024-03-20 08:10:00,53,5,9,6,75,4,0,152
2024-03-20 08:20:00,50,5,8,9,90,13,0,175
2024-03-20 08:30:00,80,2,2,7,92,8,0,191
2024-03-20 08:40:00,75,7,5,11,98,5,0,201
2024-03-20 08:50:00,68,13,8,5,79,10,0,183
2024-03-20 09:00:00,62,5,6,7,74,9,0,163
2024-03-20 09:10:00,67,9,10,6,77,11,0,180
2024-03-20 09:20:00,70,15,4,10,61,7,0,167
2024-03-20 09:30:00,75,8,6,7,67,9,0,172
2024-03-20 09:40:00,85,5,3,2,53,7,0,155
2024-03-20 09:50:00,46,12,5,5,67,12,0,147
2024-03-20 10:00:00,64,12,5,4,65,15,0,165
2024-03-20 10:10:00,79,11,4,7,52,5,0,158
2024-03-20 10:20:00,67,10,3,9,74,11,0,174
2024-03-20 10:30:00,68,8,3,3,71,6,0,159
2024-03-20 10:40:00,69,10,2,6,59,14,0,160
2024-03-20 10:50:00,58,7,3,6,71,12,0,157
2024-03-20 11:00:00,76,10,4,7,43,8,0,148
2024-03-20 11:10:00,62,11,6,5,62,12,0,158
2024-03-20 11:20:00,65,7,6,1,62,9,0,150
2024-03-20 11:30:00,72,5,5,8,65,9,0,164
2024-03-20 11:40:00,76,10,3,5,57,20,0,171
2024-03-20 11:50:00,57,6,1,6,57,10,0,137
2024-03-20 12:00:00,54,10,2,12,75,12,0,165
2024-03-20 12:10:00,53,5,7,5,67,8,0,145
2024-03-20 12:20:00,54,7,6,2,99,12,0,180
2024-03-20 12:30:00,80,8,4,5,88,8,0,193
2024-03-20 12:40:00,78,8,2,2,72,7,0,169
2024-03-20 12:50:00,67,5,6,12,81,14,0,185
2024-03-20 13:00:00,70,14,5,10,69,9,0,177
2024-03-20 13:10:00,90,8,11,13,84,11,0,217
2024-03-20 13:20:00,62,12,4,14,87,14,0,193
2024-03-20 13:30:00,84,16,3,4,73,6,0,186
2024-03-20 13:40:00,72,6,5,10,78,15,0,186
2024-03-20 13:50:00,64,10,15,6,79,10,0,184
2024-03-20 14:00:00,68,12,10,10,78,14,0,192
2024-03-20 14:10:00,62,15,5,13,87,9,0,191
2024-03-20 14:20:00,78,4,8,13,94,20,0,217
2024-03-20 14:30:00,77,13,6,14,87,8,0,205
2024-03-20 14:40:00,67,12,10,14,78,16,0,197
2024-03-20 14:50:00,74,15,5,12,102,12,0,220
2024-03-20 15:00:00,84,9,6,7,90,11,0,207
2024-03-20 15:10:00,74,8,12,7,117,7,0,225
2024-03-20 15:20:00,74,15,9,5,98,14,0,215
2024-03-20 15:30:00,75,10,11,27,118,10,0,251
2024-03-20 15:40:00,55,10,10,10,95,12,0,192
2024-03-20 15:50:00,55,9,8,14,85,5,0,176
2024-03-20 16:00:00,51,12,7,7,109,13,0,199
2024-03-20 16:10:00,30,5,16,7,85,10,0,153
2024-03-20 16:20:00,41,12,9,10,114,13,0,199
2024-03-20 16:30:00,60,5,8,8,124,12,0,217
2024-03-20 16:40:00,48,5,13,9,136,10,0,221
2024-03-20 16:50:00,75,7,12,6,133,8,0,241
2024-03-20 17:00:00,72,6,11,10,114,9,0,222
2024-03-20 17:10:00,66,4,9,8,113,8,0,208
2024-03-20 17:20:00,70,15,9,7,133,13,0,247
2024-03-20 17:30:00,73,15,8,9,116,17,0,238
2024-03-20 17:40:00,93,12,1,5,124,21,0,256
2024-03-20 17:50:00,75,10,4,5,105,19,0,218
2024-03-20 18:00:00,74,11,8,9,100,4,0,206
2024-03-20 18:10:00,107,7,6,7,106,10,0,243
2024-03-20 18:20:00,58,7,8,8,98,13,0,192
2024-03-20 18:30:00,85,13,10,15,103,12,0,238
2024-03-20 18:40:00,71,12,6,13,80,8,0,190
2024-03-20 18:50:00,65,11,5,4,93,14,0,192
2024-03-20 19:00:00,55,5,2,4,60,14,0,140
2024-03-20 19:10:00,45,2,0,4,80,9,0,140
2024-03-20 19:20:00,45,5,6,4,71,15,0,146
2024-03-20 19:30:00,44,6,8,10,67,11,0,146
2024-03-20 19:40:00,37,7,10,10,46,7,0,117
2024-03-20 19:50:00,48,6,7,5,44,5,0,115
2024-03-20 20:00:00,25,1,4,2,46,7,0,85
2024-03-20 20:10:00,41,4,2,7,48,3,0,105
2024-03-20 20:20:00,27,4,4,14,56,9,0,114
2024-03-20 20:30:00,16,2,9,5,31,7,0,70
2024-03-20 20:40:00,22,4,1,6,27,7,0,67
2024-03-20 20:50:00,32,2,3,2,36,8,0,83
2024-03-20 21:00:00,36,8,1,2,37,6,0,90
2024-03-20 21:10:00,22,2,2,2,30,6,0,64
2024-03-20 21:20:00,36,5,1,7,46,14,0,109
2024-03-20 21:30:00,37,5,0,1,33,2,0,78
2024-03-20 21:40:00,35,5,0,0,29,0,0,69
2024-03-20 21:50:00,28,4,2,0,36,8,0,78
2024-03-20 22:00:00,20,4,0,0,40,13,0,77
2024-03-20 22:10:00,26,4,6,3,42,6,0,87
2024-03-20 22:20:00,24,2,5,1,37,6,0,75
2024-03-20 22:30:00,28,5,1,2,31,4,0,71
2024-03-20 22:40:00,16,1,0,2,31,4,0,54
2024-03-20 22:50:00,14,4,3,0,17,7,0,45
2024-03-20 23:00:00,8,0,0,1,30,3,0,42
2024-03-20 23:10:00,13,2,0,1,23,5,0,44
2024-03-20 23:20:00,6,2,0,0,12,7,0,27
2024-03-20 23:30:00,13,7,0,0,17,8,0,45
2024-03-20 23:40:00,6,1,0,2,6,1,0,16
2024-03-20 23:50:00,7,3,1,0,17,4,0,32
2024-03-21 00:00:00,5,2,1,0,5,6,0,19
2024-03-21 00:10:00,8,5,0,0,4,6,0,23
2024-03-21 00:20:00,7,5,1,0,0,2,0,15
2024-03-21 00:30:00,2,2,1,0,4,2,0,11
2024-03-21 00:40:00,7,5,1,0,7,7,0,27
2024-03-21 00:50:00,0,0,0,0,2,2,0,4
2024-03-21 01:00:00,2,2,0,0,2,2,0,8
2024-03-21 01:10:00,5,0,0,0,5,0,0,10
2024-03-21 01:20:00,3,2,0,0,3,6,0,14
2024-03-21 01:30:00,2,1,1,0,6,4,0,14
2024-03-21 01:40:00,2,0,0,0,0,1,0,3
2024-03-21 01:50:00,7,2,0,0,3,2,0,14
2024-03-21 02:00:00,3,3,0,0,1,2,0,9
2024-03-21 02:10:00,3,1,0,0,3,4,0,11
2024-03-21 02:20:00,1,1,0,0,2,1,0,5
2024-03-21 02:30:00,2,1,0,0,6,0,0,9
2024-03-21 02:40:00,2,1,0,0,5,2,0,10
2024-03-21 02:50:00,2,0,0,0,5,1,0,8
2024-03-21 03:00:00,1,0,0,0,3,0,0,4
2024-03-21 03:10:00,5,4,0,0,5,3,0,17
2024-03-21 03:20:00,1,1,0,0,4,2,0,8
2024-03-21 03:30:00,4,4,0,0,1,3,0,12
2024-03-21 03:40:00,3,4,1,0,4,2,0,14
2024-03-21 03:50:00,1,1,0,0,4,0,0,6
2024-03-21 04:00:00,4,2,0,0,5,1,0,12
2024-03-21 04:10:00,4,2,0,0,6,2,0,14
2024-03-21 04:20:00,4,2,0,0,9,2,0,17
2024-03-21 04:30:00,7,7,0,0,4,8,0,26
2024-03-21 04:40:00,4,1,1,0,8,1,0,15
2024-03-21 04:50:00,13,7,0,0,6,9,0,35
2024-03-21 05:00:00,13,4,0,1,9,4,0,31
2024-03-21 05:10:00,20,5,0,0,16,9,0,50
2024-03-21 05:20:00,22,10,0,0,11,10,0,53
2024-03-21 05:30:00,40,6,0,1,23,3,0,73
2024-03-21 05:40:00,53,9,0,1,35,6,0,104
2024-03-21 05:50:00,45,8,1,2,40,9,0,105
2024-03-21 06:00:00,41,6,1,1,36,5,0,90
2024-03-21 06:10:00,72,4,0,2,33,6,0,117
2024-03-21 06:20:00,71,6,0,3,37,9,0,126
2024-03-21 06:30:00,74,9,0,2,37,3,0,125
2024-03-21 06:40:00,103,12,1,5,54,8,0,183
2024-03-21 06:50:00,83,26,1,5,71,15,0,201
2024-03-21 07:00:00,108,12,2,5,65,6,0,198
2024-03-21 07:10:00,117,11,2,11,79,9,0,229
2024-03-21 07:20:00,94,10,2,7,98,10,0,221
2024-03-21 07:30:00,97,15,7,13,84,7,0,223
2024-03-21 07:40:00,57,18,11,22,132,6,0,246
2024-03-21 07:50:00,35,8,26,25,101,8,0,203
2024-03-21 08:00:00,41,9,9,13,88,16,0,176
2024-03-21 08:10:00,100,16,9,7,104,14,0,250
2024-03-21 08:20:00,68,7,5,6,73,11,0,170
2024-03-21 08:30:00,81,11,7,5,90,10,0,204
2024-03-21 08:40:00,60,13,5,7,66,12,0,163
2024-03-21 08:50:00,86,15,7,5,80,9,0,202
2024-03-21 09:00:00,63,6,8,7,77,12,0,173
2024-03-21 09:10:00,80,7,6,9,58,4,0,164
2024-03-21 09:20:00,65,6,3,8,63,13,0,158
2024-03-21 09:30:00,67,8,10,8,76,10,0,179
2024-03-21 09:40:00,75,5,5,7,81,8,0,181
2024-03-21 09:50:00,79,4,1,8,67,8,0,167
2024-03-21 10:00:00,58,6,2,5,56,10,0,137
2024-03-21 10:10:00,84,10,2,7,67,13,0,183
2024-03-21 10:20:00,60,6,8,10,60,19,0,163
2024-03-21 10:30:00,66,7,3,5,77,13,0,171
2024-03-21 10:40:00,74,1,3,7,43,5,0,133
2024-03-21 10:50:00,60,9,3,11,66,11,0,160
2024-03-21 11:00:00,73,5,1,3,64,7,0,153
2024-03-21 11:10:00,54,8,4,6,50,4,0,126
2024-03-21 11:20:00,66,4,3,6,67,14,0,160
2024-03-21 11:30:00,73,8,8,7,67,9,0,172
2024-03-21 11:40:00,50,16,7,10,98,15,0,196
2024-03-21 11:50:00,79,13,5,6,74,7,0,184
2024-03-21 12:00:00,81,8,6,3,63,11,0,172
2024-03-21 12:10:00,76,7,2,5,89,12,0,191
2024-03-21 12:20:00,82,8,2,5,75,12,0,184
2024-03-21 12:30:00,80,11,2,6,70,9,0,178
2024-03-21 12:40:00,83,18,4,6,71,16,0,198
2024-03-21 12:50:00,82,11,0,4,103,11,0,211
2024-03-21 13:00:00,72,8,8,16,73,12,0,189
2024-03-21 13:10:00,66,6,10,9,88,10,0,189
2024-03-21 13:20:00,81,8,4,14,79,8,0,194
2024-03-21 13:30:00,76,12,8,8,81,8,0,193
2024-03-21 13:40:00,78,5,2,8,65,12,0,170
2024-03-21 13:50:00,59,8,6,6,82,19,0,180
2024-03-21 14:00:00,68,15,9,8,85,15,0,200
2024-03-21 14:10:00,91,10,6,11,93,7,0,218
2024-03-21 14:20:00,88,4,7,5,109,11,0,224
2024-03-21 14:30:00,54,6,6,7,85,5,0,163
2024-03-21 14:40:00,90,14,6,9,97,6,0,222
2024-03-21 14:50:00,62,7,4,5,92,14,0,184
2024-03-21 15:00:00,67,13,12,8,96,16,0,212
2024-03-21 15:10:00,66,10,13,7,110,9,0,215
2024-03-21 15:20:00,78,12,12,8,108,8,0,226
2024-03-21 15:30:00,46,6,16,18,110,7,0,203
2024-03-21 15:40:00,45,5,13,20,77,24,0,184
2024-03-21 15:50:00,60,11,4,12,127,14,0,228
2024-03-21 16:00:00,49,7,12,14,99,9,0,190
2024-03-21 16:10:00,56,10,4,10,107,10,0,197
2024-03-21 16:20:00,53,5,6,7,111,17,0,199
2024-03-21 16:30:00,63,8,11,11,106,10,0,209
2024-03-21 16:40:00,66,9,8,7,116,20,0,226
2024-03-21 16:50:00,68,10,5,4,98,8,0,193
2024-03-21 17:00:00,64,4,8,7,108,13,0,204
2024-03-21 17:10:00,75,7,8,6,113,22,0,231
2024-03-21 17:20:00,93,12,7,13,125,9,0,259
2024-03-21 17:30:00,71,10,7,6,119,11,0,224
2024-03-21 17:40:00,88,11,4,8,126,16,0,253
2024-03-21 17:50:00,71,9,4,9,123,12,0,228
2024-03-21 18:00:00,77,8,3,13,92,12,0,205
2024-03-21 18:10:00,71,12,5,9,126,13,0,236
2024-03-21 18:20:00,76,14,2,11,95,16,0,214
2024-03-21 18:30:00,54,4,13,10,94,13,0,188
2024-03-21 18:40:00,61,10,5,7,102,9,0,194
2024-03-21 18:50:00,51,6,6,3,76,10,0,152
2024-03-21 19:00:00,68,8,5,7,71,19,0,178
2024-03-21 19:10:00,50,5,1,6,78,13,0,153
2024-03-21 19:20:00,56,7,7,1,81,11,0,163
2024-03-21 19:30:00,50,8,9,6,76,14,0,163
2024-03-21 19:40:00,40,9,8,11,49,6,0,123
2024-03-21 19:50:00,41,3,16,11,54,6,0,131
2024-03-21 20:00:00,41,6,2,6,37,3,0,95
2024-03-21 20:10:00,57,4,7,6,49,7,0,130
2024-03-21 20:20:00,32,4,5,2,29,5,0,77
2024-03-21 20:30:00,39,5,1,3,26,6,0,80
2024-03-21 20:40:00,22,6,2,0,49,9,0,88
2024-03-21 20:50:00,35,1,6,2,31,4,0,79
2024-03-21 21:00:00,28,3,2,4,31,8,0,76
2024-03-21 21:10:00,25,2,5,3,27,4,0,66
2024-03-21 21:20:00,24,2,1,2,57,7,0,93
2024-03-21 21:30:00,31,4,3,3,33,5,0,79
2024-03-21 21:40:00,24,17,2,3,24,24,0,94
2024-03-21 21:50:00,22,16,4,2,17,34,0,95
2024-03-21 22:00:00,36,7,1,1,42,7,0,94
2024-03-21 22:10:00,29,4,2,3,40,4,0,82
2024-03-21 22:20:00,30,9,6,1,34,7,0,87
2024-03-21 22:30:00,26,5,4,2,27,2,0,66
2024-03-21 22:40:00,10,1,1,0,23,3,0,38
2024-03-21 22:50:00,13,3,0,0,23,4,0,43
2024-03-21 23:00:00,14,3,0,1,21,3,0,42
2024-03-21 23:10:00,13,2,0,0,19,7,0,41
2024-03-21 23:20:00,8,4,0,0,11,5,0,28
2024-03-21 23:30:00,8,1,0,0,8,0,0,17
2024-03-21 23:40:00,8,1,0,1,19,1,0,30
2024-03-21 23:50:00,4,0,0,2,12,3,0,21
2024-03-22 00:00:00,5,2,0,0,10,4,0,21
2024-03-22 00:10:00,7,1,0,0,4,4,0,16
2024-03-22 00:20:00,6,0,0,0,9,1,0,16
2024-03-22 00:30:00,6,2,0,0,0,1,0,9
2024-03-22 00:40:00,5,1,0,1,10,4,0,21
2024-03-22 00:50:00,3,0,0,0,5,4,0,12
2024-03-22 01:00:00,5,2,1,0,4,0,0,12
2024-03-22 01:10:00,2,2,0,0,5,1,0,10
2024-03-22 01:20:00,8,4,1,0,6,8,0,27
2024-03-22 01:30:00,2,1,0,0,5,1,0,9
2024-03-22 01:40:00,2,1,0,0,3,1,0,7
2024-03-22 01:50:00,1,0,0,0,2,1,0,4
2024-03-22 02:00:00,3,1,0,0,1,3,0,8
2024-03-22 02:10:00,6,2,0,0,3,1,0,12
2024-03-22 02:20:00,2,1,0,0,1,1,0,5
2024-03-22 02:30:00,2,2,0,0,4,1,0,9
2024-03-22 02:40:00,2,1,0,0,3,1,0,7
2024-03-22 02:50:00,2,1,0,0,2,1,0,6
2024-03-22 03:00:00,1,1,1,0,4,1,0,8
2024-03-22 03:10:00,0,0,1,0,1,0,0,2
2024-03-22 03:20:00,4,1,0,0,4,2,0,11
2024-03-22 03:30:00,3,4,1,0,5,5,0,18
2024-03-22 03:40:00,4,2,0,0,3,2,0,11
2024-03-22 03:50:00,4,2,0,0,4,2,0,12
2024-03-22 04:00:00,3,2,0,0,4,3,0,12
2024-03-22 04:10:00,2,1,0,0,6,1,0,10
2024-03-22 04:20:00,6,2,0,0,6,2,0,16
2024-03-22 04:30:00,7,5,0,0,5,7,0,24
2024-03-22 04:40:00,4,0,0,1,6,3,0,14
2024-03-22 04:50:00,7,2,0,0,7,4,0,20
2024-03-22 05:00:00,14,6,0,0,7,5,0,32
2024-03-22 05:10:00,15,3,0,0,15,5,0,38
2024-03-22 05:20:00,23,6,0,0,10,5,0,44
2024-03-22 05:30:00,38,8,0,0,18,4,0,68
2024-03-22 05:40:00,31,6,0,0,36,2,0,75
2024-03-22 05:50:00,51,9,1,2,33,6,0,102
2024-03-22 06:00:00,52,5,1,2,33,5,0,98
2024-03-22 06:10:00,55,3,0,1,33,6,0,98
2024-03-22 06:20:00,62,10,0,1,25,4,0,102
2024-03-22 06:30:00,72,5,0,1,44,5,0,127
2024-03-22 06:40:00,86,9,1,5,51,10,0,162
2024-03-22 06:50:00,91,14,2,10,54,5,0,176
2024-03-22 07:00:00,88,10,0,3,56,9,0,166
2024-03-22 07:10:00,99,9,1,2,66,4,0,181
2024-03-22 07:20:00,96,17,2,5,78,12,0,210
2024-03-22 07:30:00,95,15,6,17,107,12,0,252
2024-03-22 07:40:00,84,13,9,27,134,8,0,275
2024-03-22 07:50:00,67,10,8,25,98,10,0,218
2024-03-22 08:00:00,74,14,6,7,87,9,0,197
2024-03-22 08:10:00,63,4,7,7,74,9,0,164
2024-03-22 08:20:00,93,14,5,8,72,13,0,205
2024-03-22 08:30:00,76,12,4,8,63,6,0,169
2024-03-22 08:40:00,67,13,7,11,71,28,0,197
2024-03-22 08:50:00,73,12,7,8,78,13,0,191
2024-03-22 09:00:00,64,12,10,5,47,7,0,145
2024-03-22 09:10:00,84,8,8,5,60,8,0,173
2024-03-22 09:20:00,60,13,9,10,72,14,0,178
2024-03-22 09:30:00,50,28,6,6,56,9,0,155
2024-03-22 09:40:00,46,36,5,7,66,8,0,168
2024-03-22 09:50:00,40,40,7,9,67,6,0,169
2024-03-22 10:00:00,31,24,7,4,52,12,0,130
2024-03-22 10:10:00,42,37,5,3,73,12,0,172
2024-03-22 10:20:00,58,35,3,12,82,10,0,200
2024-03-22 10:30:00,58,20,17,14,71,11,0,191
2024-03-22 10:40:00,53,20,9,16,69,11,0,178
2024-03-22 10:50:00,68,9,3,8,68,10,0,166
2024-03-22 11:00:00,61,7,4,12,73,8,0,165
2024-03-22 11:10:00,57,9,6,17,70,12,0,171
2024-03-22 11:20:00,59,11,8,14,57,13,0,162
2024-03-22 11:30:00,63,7,7,14,68,10,0,169
2024-03-22 11:40:00,59,12,8,4,94,12,0,189
2024-03-22 11:50:00,68,5,4,3,88,10,0,178
2024-03-22 12:00:00,58,10,3,10,77,11,0,169
2024-03-22 12:10:00,67,6,4,5,66,7,0,155
2024-03-22 12:20:00,66,8,3,8,76,16,0,177
2024-03-22 12:30:00,65,8,2,6,82,11,0,174
2024-03-22 12:40:00,62,10,5,6,87,10,0,180
2024-03-22 12:50:00,48,7,6,5,98,11,0,175
2024-03-22 13:00:00,79,10,1,9,80,13,0,192
2024-03-22 13:10:00,77,4,4,8,111,16,0,220
2024-03-22 13:20:00,85,9,2,8,96,17,0,217
2024-03-22 13:30:00,60,11,5,7,85,14,0,182
2024-03-22 13:40:00,78,4,6,6,90,6,0,190
2024-03-22 13:50:00,80,12,7,5,123,12,0,239
2024-03-22 14:00:00,71,11,6,6,85,11,0,190
2024-03-22 14:10:00,98,9,3,14,104,12,0,240
2024-03-22 14:20:00,62,6,4,5,97,12,0,186
2024-03-22 14:30:00,77,7,8,16,91,11,0,210
2024-03-22 14:40:00,60,10,7,10,118,14,0,219
2024-03-22 14:50:00,89,13,4,10,103,9,0,228
2024-03-22 15:00:00,91,9,3,9,102,10,0,224
2024-03-22 15:10:00,74,8,8,5,110,17,0,222
2024-03-22 15:20:00,85,9,7,10,107,15,0,233
2024-03-22 15:30:00,92,10,3,6,101,10,0,222
2024-03-22 15:40:00,85,10,9,7,115,9,0,235
2024-03-22 15:50:00,66,18,3,6,108,17,0,218
2024-03-22 16:00:00,82,9,8,9,102,15,0,225
2024-03-22 16:10:00,80,7,8,7,108,7,0,217
2024-03-22 16:20:00,59,10,5,10,127,19,0,230
2024-03-22 16:30:00,63,9,4,9,101,14,0,200
2024-03-22 16:40:00,70,13,2,6,95,8,0,194
2024-03-22 16:50:00,64,9,4,7,81,17,0,182
2024-03-22 17:00:00,68,11,8,16,84,15,0,202
2024-03-22 17:10:00,58,7,6,9,109,11,0,200
2024-03-22 17:20:00,73,7,1,8,71,20,0,180
2024-03-22 17:30:00,65,10,3,10,91,15,0,194
2024-03-22 17:40:00,75,7,7,5,91,11,0,196
2024-03-22 17:50:00,61,8,4,10,98,13,0,194
2024-03-22 18:00:00,52,9,6,9,82,27,0,185
2024-03-22 18:10:00,54,3,7,15,83,16,0,178
2024-03-22 18:20:00,98,9,5,11,76,8,0,207
2024-03-22 18:30:00,36,6,2,4,36,7,0,91
2024-03-22 18:40:00,25,2,3,3,32,2,0,67
2024-03-22 18:50:00,32,6,1,2,35,4,0,80
2024-03-22 19:00:00,50,5,3,2,53,5,0,118
2024-03-22 19:10:00,42,8,5,10,52,7,0,124
2024-03-22 19:20:00,52,2,7,10,60,11,0,142
2024-03-22 19:30:00,42,4,4,5,51,7,0,113
2024-03-22 19:40:00,37,4,4,3,58,9,0,115
2024-03-22 19:50:00,26,2,4,2,47,8,0,89
2024-03-22 20:00:00,38,14,4,5,47,11,0,119
2024-03-22 20:10:00,36,8,1,2,36,7,0,90
2024-03-22 20:20:00,30,4,1,3,46,7,0,91
2024-03-22 20:30:00,31,5,1,3,44,13,0,97
2024-03-22 20:40:00,26,4,1,0,43,5,0,79
2024-03-22 20:50:00,28,4,2,1,46,8,0,89
2024-03-22 21:00:00,28,6,2,1,27,7,0,71
2024-03-22 21:10:00,11,2,2,1,47,5,0,68
2024-03-22 21:20:00,31,9,0,1,34,9,0,84
2024-03-22 21:30:00,25,7,2,0,26,5,0,65
2024-03-22 21:40:00,19,5,1,0,29,5,0,59
2024-03-22 21:50:00,22,4,1,3,30,6,0,66
2024-03-22 22:00:00,17,7,0,0,32,5,0,61
2024-03-22 22:10:00,26,5,2,0,37,4,0,74
2024-03-22 22:20:00,22,8,0,1,32,3,0,66
2024-03-22 22:30:00,22,3,0,0,20,2,0,47
2024-03-22 22:40:00,18,1,0,0,33,3,0,55
2024-03-22 22:50:00,20,2,3,0,18,4,0,47
2024-03-22 23:00:00,21,1,0,1,26,4,0,53
2024-03-22 23:10:00,8,3,0,0,26,7,0,44
2024-03-22 23:20:00,15,4,1,1,19,5,0,45
2024-03-22 23:30:00,9,4,0,0,12,6,0,31
2024-03-22 23:40:00,11,4,0,0,14,2,0,31
2024-03-22 23:50:00,13,3,0,0,22,2,0,40
2024-03-23 00:00:00,5,4,0,0,17,4,0,30
2024-03-23 00:10:00,7,4,0,0,15,3,0,29
2024-03-23 00:20:00,3,2,0,0,9,0,0,14
2024-03-23 00:30:00,6,2,0,1,11,1,0,21
2024-03-23 00:40:00,15,3,0,1,6,1,0,26
2024-03-23 00:50:00,9,4,0,0,7,4,0,24
2024-03-23 01:00:00,5,0,0,0,5,1,0,11
2024-03-23 01:10:00,9,4,0,0,10,1,0,24
2024-03-23 01:20:00,3,2,1,1,4,0,0,11
2024-03-23 01:30:00,6,1,0,0,7,1,0,15
2024-03-23 01:40:00,5,4,0,0,4,2,0,15
2024-03-23 01:50:00,3,0,0,0,3,0,0,6
2024-03-23 02:00:00,4,1,2,0,3,1,0,11
2024-03-23 02:10:00,1,0,0,0,7,0,0,8
2024-03-23 02:20:00,5,3,1,0,5,1,0,15
2024-03-23 02:30:00,6,1,0,1,6,4,0,18
2024-03-23 02:40:00,5,2,0,0,7,2,0,16
2024-03-23 02:50:00,4,2,0,0,7,1,0,14
2024-03-23 03:00:00,2,0,0,0,7,1,0,10
2024-03-23 03:10:00,3,1,0,0,2,2,0,8
2024-03-23 03:20:00,1,2,0,0,4,3,0,10
2024-03-23 03:30:00,5,2,1,0,4,2,0,14
2024-03-23 03:40:00,3,1,0,0,5,1,0,10
2024-03-23 03:50:00,3,3,0,1,4,1,0,12
2024-03-23 04:00:00,4,2,0,0,8,4,0,18
2024-03-23 04:10:00,9,4,0,0,2,3,0,18
2024-03-23 04:20:00,10,6,0,0,8,5,0,29
2024-03-23 04:30:00,11,4,0,0,6,4,0,25
2024-03-23 04:40:00,14,7,0,0,6,3,0,30
2024-03-23 04:50:00,4,3,0,0,4,3,0,14
2024-03-23 05:00:00,9,2,0,0,7,2,0,20
2024-03-23 05:10:00,8,7,0,1,4,4,0,24
2024-03-23 05:20:00,12,6,0,0,13,4,0,35
2024-03-23 05:30:00,10,6,0,0,5,1,0,22
2024-03-23 05:40:00,13,2,0,2,9,1,0,27
2024-03-23 05:50:00,11,2,2,4,8,4,0,31
2024-03-23 06:00:00,10,3,0,0,12,8,0,33
2024-03-23 06:10:00,14,6,1,1,9,5,0,36
2024-03-23 06:20:00,17,7,0,0,5,3,0,32
2024-03-23 06:30:00,15,5,2,1,14,0,0,37
2024-03-23 06:40:00,10,3,0,1,10,4,0,28
2024-03-23 06:50:00,13,2,1,0,10,4,0,30
2024-03-23 07:00:00,18,7,1,1,18,2,0,47
2024-03-23 07:10:00,21,7,0,1,24,5,0,58
2024-03-23 07:20:00,22,9,3,3,20,3,0,60
2024-03-23 07:30:00,22,6,0,1,13,4,0,46
2024-03-23 07:40:00,20,3,0,2,23,6,0,54
2024-03-23 07:50:00,25,9,0,5,20,4,0,63
2024-03-23 08:00:00,26,9,2,3,23,5,0,68
2024-03-23 08:10:00,30,8,0,2,18,2,0,60
2024-03-23 08:20:00,21,4,0,1,27,2,0,55
2024-03-23 08:30:00,24,9,0,3,31,9,0,76
2024-03-23 08:40:00,38,10,1,1,24,6,0,80
2024-03-23 08:50:00,39,11,0,1,23,5,0,79
2024-03-23 09:00:00,35,6,0,5,44,6,0,96
2024-03-23 09:10:00,43,4,3,4,36,7,0,97
2024-03-23 09:20:00,47,6,2,10,37,5,0,107
2024-03-23 09:30:00,61,5,1,4,36,8,0,115
2024-03-23 09:40:00,67,10,2,3,58,7,0,147
2024-03-23 09:50:00,55,4,4,3,38,10,0,114
2024-03-23 10:00:00,59,12,3,6,54,10,0,144
2024-03-23 10:10:00,49,8,1,3,59,8,0,128
2024-03-23 10:20:00,53,12,0,0,58,7,0,130
2024-03-23 10:30:00,37,5,4,3,46,5,0,100
2024-03-23 10:40:00,51,10,2,6,53,3,0,125
2024-03-23 10:50:00,50,7,2,5,58,9,0,131
2024-03-23 11:00:00,64,8,2,7,56,11,0,148
2024-03-23 11:10:00,47,7,3,3,42,8,0,110
2024-03-23 11:20:00,68,13,0,4,55,6,0,146
2024-03-23 11:30:00,57,12,5,6,46,10,0,136
2024-03-23 11:40:00,54,4,2,7,60,6,0,133
2024-03-23 11:50:00,54,4,0,3,67,7,0,135
2024-03-23 12:00:00,45,8,4,6,46,12,0,121
2024-03-23 12:10:00,69,19,2,7,55,8,0,160
2024-03-23 12:20:00,51,10,3,8,72,10,0,154
2024-03-23 12:30:00,54,7,2,3,54,8,0,128
2024-03-23 12:40:00,46,7,1,4,61,9,0,128
2024-03-23 12:50:00,58,5,3,4,61,7,0,138
2024-03-23 13:00:00,70,9,4,3,52,11,0,149
2024-03-23 13:10:00,55,5,1,5,72,4,0,142
2024-03-23 13:20:00,51,6,2,3,55,8,0,125
2024-03-23 13:30:00,64,7,1,3,62,3,0,140
2024-03-23 13:40:00,43,6,3,5,83,3,0,143
2024-03-23 13:50:00,60,7,2,3,64,8,0,144
2024-03-23 14:00:00,50,5,4,9,66,10,0,144
2024-03-23 14:10:00,51,4,2,7,59,9,0,132
2024-03-23 14:20:00,41,5,4,6,72,8,0,136
2024-03-23 14:30:00,51,10,2,5,69,8,0,145
2024-03-23 14:40:00,57,5,2,3,62,6,0,135
2024-03-23 14:50:00,47,3,2,3,62,10,0,127
2024-03-23 15:00:00,56,6,4,2,71,6,0,145
2024-03-23 15:10:00,50,9,1,3,62,9,0,134
2024-03-23 15:20:00,50,8,1,0,64,7,0,130
2024-03-23 15:30:00,44,10,2,5,64,12,0,137
2024-03-23 15:40:00,59,5,1,2,63,5,0,135
2024-03-23 15:50:00,55,6,6,3,72,9,0,151
2024-03-23 16:00:00,42,7,2,4,55,4,0,114
2024-03-23 16:10:00,29,4,4,6,52,7,0,102
2024-03-23 16:20:00,42,6,2,2,42,10,0,104
2024-03-23 16:30:00,45,6,3,6,60,6,0,126
2024-03-23 16:40:00,57,5,2,1,69,7,0,141
2024-03-23 16:50:00,42,7,2,8,97,11,0,167
2024-03-23 17:00:00,52,8,5,4,74,8,0,151
2024-03-23 17:10:00,54,8,4,7,78,10,0,161
2024-03-23 17:20:00,57,11,3,11,77,11,0,170
2024-03-23 17:30:00,60,10,1,8,77,16,0,172
2024-03-23 17:40:00,65,7,0,6,73,7,0,158
2024-03-23 17:50:00,61,7,3,9,78,4,0,162
2024-03-23 18:00:00,49,8,2,1,72,6,0,138
2024-03-23 18:10:00,62,9,6,7,53,2,0,139
2024-03-23 18:20:00,60,4,2,5,70,7,0,148
2024-03-23 18:30:00,46,5,4,1,59,7,0,122
2024-03-23 18:40:00,54,4,5,7,59,1,0,130
2024-03-23 18:50:00,49,5,1,7,64,6,0,132
2024-03-23 19:00:00,50,5,5,5,45,2,0,112
2024-03-23 19:10:00,41,7,1,5,43,9,0,106
2024-03-23 19:20:00,42,7,6,5,41,9,0,110
2024-03-23 19:30:00,34,12,1,1,50,5,0,103
2024-03-23 19:40:00,40,2,7,1,35,2,0,87
2024-03-23 19:50:00,32,7,1,2,40,5,0,87
2024-03-23 20:00:00,41,8,2,1,52,5,0,109
2024-03-23 20:10:00,24,7,1,0,42,4,0,78
2024-03-23 20:20:00,29,4,1,1,40,6,0,81
2024-03-23 20:30:00,41,11,2,1,34,3,0,92
2024-03-23 20:40:00,29,7,3,4,30,14,0,87
2024-03-23 20:50:00,28,5,0,2,31,7,0,73
2024-03-23 21:00:00,28,5,1,2,28,8,0,72
2024-03-23 21:10:00,31,3,3,3,28,5,0,73
2024-03-23 21:20:00,23,6,1,4,27,2,0,63
2024-03-23 21:30:00,18,8,0,3,24,6,0,59
2024-03-23 21:40:00,21,3,1,0,24,4,0,53
2024-03-23 21:50:00,17,5,2,0,18,7,0,49
2024-03-23 22:00:00,20,2,0,0,25,3,0,50
2024-03-23 22:10:00,24,4,9,2,30,3,0,72
2024-03-23 22:20:00,19,3,1,1,18,7,0,49
2024-03-23 22:30:00,19,8,0,1,23,6,0,57
2024-03-23 22:40:00,19,4,5,5,24,3,0,60
2024-03-23 22:50:00,19,3,0,2,32,2,0,58
2024-03-23 23:00:00,18,6,0,1,29,3,0,57
2024-03-23 23:10:00,15,2,1,1,24,4,0,47
2024-03-23 23:20:00,29,6,1,1,14,2,0,53
2024-03-23 23:30:00,14,5,0,0,16,2,0,37
2024-03-23 23:40:00,10,5,0,1,17,2,0,35
2024-03-23 23:50:00,6,3,0,0,18,4,0,31
2024-03-24 00:00:00,9,7,0,1,13,5,0,35
2024-03-24 00:10:00,15,3,1,1,19,2,0,41
2024-03-24 00:20:00,11,4,0,0,16,5,0,36
2024-03-24 00:30:00,4,3,0,0,12,2,0,21
2024-03-24 00:40:00,11,5,1,0,9,1,0,27
2024-03-24 00:50:00,7,0,0,0,6,3,0,16
2024-03-24 01:00:00,2,0,0,0,13,4,0,19
2024-03-24 01:10:00,12,3,3,0,10,1,0,29
2024-03-24 01:20:00,1,2,0,1,7,3,0,14
2024-03-24 01:30:00,5,2,0,0,6,2,0,15
2024-03-24 01:40:00,8,4,1,1,6,1,0,21
2024-03-24 01:50:00,1,0,0,0,6,1,0,8
2024-03-24 02:00:00,8,5,1,0,6,3,0,23
2024-03-24 02:10:00,7,2,0,0,6,2,0,17
2024-03-24 02:20:00,6,1,0,0,9,2,0,18
2024-03-24 02:30:00,6,4,0,0,7,3,0,20
2024-03-24 02:40:00,1,1,0,0,4,1,0,7
2024-03-24 02:50:00,5,4,0,0,4,1,0,14
2024-03-24 03:00:00,1,2,0,0,2,1,0,6
2024-03-24 03:10:00,7,2,0,0,11,2,0,22
2024-03-24 03:20:00,3,3,0,0,6,0,0,12
2024-03-24 03:30:00,6,2,0,0,6,1,0,15
2024-03-24 03:40:00,3,2,0,0,5,3,0,13
2024-03-24 03:50:00,4,3,0,0,9,2,0,18
2024-03-24 04:00:00,5,2,0,0,3,3,0,13
2024-03-24 04:10:00,3,1,0,0,5,3,0,12
2024-03-24 04:20:00,0,3,0,0,4,1,0,8
2024-03-24 04:30:00,3,0,0,0,3,0,0,6
2024-03-24 04:40:00,4,3,0,1,0,0,0,8
2024-03-24 04:50:00,6,0,0,0,4,2,0,12
2024-03-24 05:00:00,5,2,0,0,6,3,0,16
2024-03-24 05:10:00,4,1,0,0,3,0,0,8
2024-03-24 05:20:00,1,2,0,0,10,2,0,15
2024-03-24 05:30:00,3,1,0,0,4,4,0,12
2024-03-24 05:40:00,10,6,0,0,7,3,0,26
2024-03-24 05:50:00,3,2,0,0,4,0,0,9
2024-03-24 06:00:00,7,2,0,2,6,3,0,20
2024-03-24 06:10:00,9,6,0,1,6,1,0,23
2024-03-24 06:20:00,9,2,1,0,5,3,0,20
2024-03-24 06:30:00,9,0,0,1,4,1,0,15
2024-03-24 06:40:00,8,2,1,1,2,3,0,17
2024-03-24 06:50:00,3,0,0,0,7,2,0,12
2024-03-24 07:00:00,7,3,0,0,1,1,0,12
2024-03-24 07:10:00,6,2,0,0,6,0,0,14
2024-03-24 07:20:00,7,4,0,0,5,3,0,19
2024-03-24 07:30:00,10,4,0,1,4,2,0,21
2024-03-24 07:40:00,5,3,0,0,2,3,0,13
2024-03-24 07:50:00,12,5,1,0,9,5,0,32
2024-03-24 08:00:00,14,6,0,0,13,4,0,37
2024-03-24 08:10:00,13,4,1,0,6,1,0,25
2024-03-24 08:20:00,11,3,0,0,10,3,0,27
2024-03-24 08:30:00,17,4,0,0,11,0,0,32
2024-03-24 08:40:00,19,4,0,4,6,5,0,38
2024-03-24 08:50:00,20,5,0,1,20,5,0,51
2024-03-24 09:00:00,20,7,0,0,19,5,0,51
2024-03-24 09:10:00,21,8,0,0,19,7,0,55
2024-03-24 09:20:00,36,5,1,3,13,4,0,62
2024-03-24 09:30:00,29,2,0,2,28,4,0,65
2024-03-24 09:40:00,28,6,0,1,19,3,0,57
2024-03-24 09:50:00,35,7,0,0,27,6,0,75
2024-03-24 10:00:00,30,5,0,2,29,3,0,69
2024-03-24 10:10:00,35,11,1,1,21,3,0,72
2024-03-24 10:20:00,27,9,0,1,33,5,0,75
2024-03-24 10:30:00,41,6,2,0,24,3,0,76
2024-03-24 10:40:00,39,10,1,1,36,6,0,93
2024-03-24 10:50:00,36,2,1,2,37,2,0,80
2024-03-24 11:00:00,29,6,3,1,32,7,0,78
2024-03-24 11:10:00,41,7,0,0,33,7,0,88
2024-03-24 11:20:00,35,3,1,3,53,5,0,100
2024-03-24 11:30:00,51,9,1,0,43,3,0,107
2024-03-24 11:40:00,31,6,1,9,66,6,0,119
2024-03-24 11:50:00,43,11,1,0,63,5,0,123
2024-03-24 12:00:00,41,10,1,3,44,5,0,104
2024-03-24 12:10:00,37,9,1,4,58,10,0,119
2024-03-24 12:20:00,38,7,1,1,39,6,0,92
2024-03-24 12:30:00,50,7,0,6,31,7,0,101
2024-03-24 12:40:00,42,6,1,1,42,5,0,97
2024-03-24 12:50:00,32,5,2,3,48,4,0,94
2024-03-24 13:00:00,39,6,1,3,37,11,0,97
2024-03-24 13:10:00,46,10,3,0,18,5,0,82
2024-03-24 13:20:00,51,11,1,7,41,7,0,118
2024-03-24 13:30:00,74,13,2,0,45,4,0,138
2024-03-24 13:40:00,43,9,0,5,34,4,0,95
2024-03-24 13:50:00,50,12,3,2,50,8,0,125
2024-03-24 14:00:00,46,6,2,3,45,10,0,112
2024-03-24 14:10:00,54,7,1,3,45,2,0,112
2024-03-24 14:20:00,40,8,1,1,60,3,0,113
2024-03-24 14:30:00,48,7,0,6,66,10,0,137
2024-03-24 14:40:00,54,12,0,1,60,9,0,136
2024-03-24 14:50:00,44,8,1,2,74,3,0,132
2024-03-24 15:00:00,45,9,2,7,68,4,0,135
2024-03-24 15:10:00,54,14,2,4,53,7,0,134
2024-03-24 15:20:00,47,6,2,3,52,7,0,117
2024-03-24 15:30:00,47,14,6,2,41,7,0,117
2024-03-24 15:40:00,44,10,3,2,64,7,0,130
2024-03-24 15:50:00,48,11,3,2,44,6,0,114
2024-03-24 16:00:00,73,11,0,0,45,9,0,138
2024-03-24 16:10:00,38,6,2,5,53,6,0,110
2024-03-24 16:20:00,55,8,3,2,42,8,0,118
2024-03-24 16:30:00,41,13,0,7,46,7,0,114
2024-03-24 16:40:00,48,20,0,2,47,5,0,122
2024-03-24 16:50:00,54,10,3,1,43,9,0,120
2024-03-24 17:00:00,41,11,5,0,49,6,0,112
2024-03-24 17:10:00,47,7,2,6,43,8,0,113
2024-03-24 17:20:00,46,4,2,8,55,7,0,122
2024-03-24 17:30:00,62,8,6,10,42,8,0,136
2024-03-24 17:40:00,59,9,2,8,48,7,0,133
2024-03-24 17:50:00,44,7,1,3,60,8,0,123
2024-03-24 18:00:00,48,7,1,1,49,1,0,107
2024-03-24 18:10:00,36,5,0,0,57,15,0,113
2024-03-24 18:20:00,41,7,4,5,39,6,0,102
2024-03-24 18:30:00,31,3,3,6,34,9,0,86
2024-03-24 18:40:00,42,3,2,3,44,9,0,103
2024-03-24 18:50:00,36,3,0,2,59,8,0,108
2024-03-24 19:00:00,33,5,2,2,35,8,0,85
2024-03-24 19:10:00,34,3,4,3,44,1,0,89
2024-03-24 19:20:00,29,6,1,2,39,6,0,83
2024-03-24 19:30:00,36,6,7,3,27,10,0,89
2024-03-24 19:40:00,23,5,3,2,34,5,0,72
2024-03-24 19:50:00,23,7,5,0,32,3,0,70
2024-03-24 20:00:00,36,8,2,4,34,6,0,90
2024-03-24 20:10:00,27,4,1,2,22,10,0,66
2024-03-24 20:20:00,30,4,5,0,30,7,0,76
2024-03-24 20:30:00,20,7,3,1,31,5,0,67
2024-03-24 20:40:00,22,7,0,0,27,4,0,60
2024-03-24 20:50:00,20,6,0,0,24,7,0,57
2024-03-24 21:00:00,21,8,0,2,23,8,0,62
2024-03-24 21:10:00,24,6,1,1,24,8,0,64
2024-03-24 21:20:00,19,6,0,1,20,5,0,51
2024-03-24 21:30:00,29,9,0,0,29,4,0,71
2024-03-24 21:40:00,15,4,0,0,26,2,0,47
2024-03-24 21:50:00,15,5,2,0,21,6,0,49
2024-03-24 22:00:00,13,7,1,0,16,6,0,43
2024-03-24 22:10:00,18,3,1,1,25,2,0,50
2024-03-24 22:20:00,11,4,0,1,12,3,0,31
2024-03-24 22:30:00,15,4,2,1,18,1,0,41
2024-03-24 22:40:00,6,5,1,3,16,5,0,36
2024-03-24 22:50:00,6,2,1,1,13,4,0,27
2024-03-24 23:00:00,12,5,0,0,11,3,0,31
2024-03-24 23:10:00,5,2,0,0,10,5,0,22
2024-03-24 23:20:00,4,3,0,0,6,2,0,15
2024-03-24 23:30:00,2,0,1,0,9,2,0,14
2024-03-24 23:40:00,7,3,0,0,8,3,0,21
2024-03-24 23:50:00,6,1,1,0,10,1,0,19
2024-03-25 00:00:00,4,2,2,0,2,0,0,10
2024-03-25 00:10:00,3,1,0,0,5,0,0,9
2024-03-25 00:20:00,6,1,0,0,3,3,0,13
2024-03-25 00:30:00,2,0,0,0,5,1,0,8
2024-03-25 00:40:00,5,4,1,0,9,6,0,25
2024-03-25 00:50:00,6,1,0,0,6,0,0,13
2024-03-25 01:00:00,1,2,0,0,5,3,0,11
2024-03-25 01:10:00,5,5,2,1,1,2,0,16
2024-03-25 01:20:00,4,1,1,0,1,1,0,8
2024-03-25 01:30:00,3,3,0,0,2,1,0,9
2024-03-25 01:40:00,1,0,0,1,0,0,0,2
2024-03-25 01:50:00,2,0,0,0,4,0,0,6
2024-03-25 02:00:00,1,0,0,0,0,0,0,1
2024-03-25 02:10:00,2,0,0,0,0,0,0,2
2024-03-25 02:20:00,1,0,0,0,0,0,0,1
2024-03-25 02:30:00,2,1,0,0,4,3,0,10
2024-03-25 02:40:00,2,1,0,0,0,0,0,3
2024-03-25 02:50:00,3,1,0,0,5,1,0,10
2024-03-25 03:00:00,1,1,0,0,7,0,0,9
2024-03-25 03:10:00,2,2,0,0,2,2,0,8
2024-03-25 03:20:00,2,2,0,0,3,1,0,8
2024-03-25 03:30:00,5,2,1,0,5,0,0,13
2024-03-25 03:40:00,1,2,0,0,2,3,0,8
2024-03-25 03:50:00,1,1,0,0,3,0,0,5
2024-03-25 04:00:00,1,1,0,0,4,1,0,7
2024-03-25 04:10:00,4,1,0,0,1,1,0,7
2024-03-25 04:20:00,4,1,0,0,3,0,0,8
2024-03-25 04:30:00,13,11,0,0,5,5,0,34
2024-03-25 04:40:00,9,2,0,1,4,2,0,18
2024-03-25 04:50:00,7,3,0,0,6,4,0,20
2024-03-25 05:00:00,15,6,0,0,8,4,0,33
2024-03-25 05:10:00,15,6,0,0,7,3,0,31
2024-03-25 05:20:00,26,11,0,0,14,8,0,59
2024-03-25 05:30:00,38,11,1,0,18,7,0,75
2024-03-25 05:40:00,41,6,0,0,40,3,0,90
2024-03-25 05:50:00,41,8,0,0,33,4,0,86
2024-03-25 06:00:00,40,7,2,2,31,3,0,85
2024-03-25 06:10:00,60,5,1,1,50,4,0,121
2024-03-25 06:20:00,64,9,0,2,32,6,0,113
2024-03-25 06:30:00,65,10,0,3,28,3,0,109
2024-03-25 06:40:00,100,17,1,3,52,4,0,177
2024-03-25 06:50:00,78,14,2,3,49,5,0,151
2024-03-25 07:00:00,87,11,2,2,59,9,0,170
2024-03-25 07:10:00,70,7,0,5,59,6,0,147
2024-03-25 07:20:00,80,8,0,5,60,8,0,161
2024-03-25 07:30:00,82,9,3,5,66,6,0,171
2024-03-25 07:40:00,76,13,3,3,82,8,0,185
2024-03-25 07:50:00,59,10,5,8,70,6,0,158
2024-03-25 08:00:00,57,8,2,5,80,11,0,163
2024-03-25 08:10:00,79,10,2,10,57,7,0,165
2024-03-25 08:20:00,69,9,2,6,63,2,0,151
2024-03-25 08:30:00,79,14,3,10,66,3,0,175
2024-03-25 08:40:00,88,18,6,11,75,14,0,212
2024-03-25 08:50:00,45,7,4,6,81,12,0,155
2024-03-25 09:00:00,75,11,9,6,63,17,0,181
2024-03-25 09:10:00,66,16,5,3,58,12,0,160
2024-03-25 09:20:00,58,9,2,8,73,17,0,167
2024-03-25 09:30:00,60,9,3,6,63,8,0,149
2024-03-25 09:40:00,66,11,4,8,67,9,0,165
2024-03-25 09:50:00,58,6,6,8,54,3,0,135
2024-03-25 10:00:00,57,10,2,6,57,10,0,142
2024-03-25 10:10:00,76,5,3,5,39,11,0,139
2024-03-25 10:20:00,34,24,6,4,55,8,0,131
2024-03-25 10:30:00,2,68,1,4,43,7,0,125
2024-03-25 10:40:00,3,52,5,5,75,15,0,155
2024-03-25 10:50:00,4,50,1,5,52,12,0,124
2024-03-25 11:00:00,4,63,5,6,65,23,0,166
2024-03-25 11:10:00,8,66,0,4,51,13,0,142
2024-03-25 11:20:00,4,66,3,6,52,7,0,138
2024-03-25 11:30:00,3,60,6,5,51,13,0,138
2024-03-25 11:40:00,8,66,1,2,59,14,0,150
2024-03-25 11:50:00,3,71,3,9,66,9,0,161
2024-03-25 12:00:00,11,68,2,3,75,13,0,172
2024-03-25 12:10:00,3,56,3,8,58,7,0,135
2024-03-25 12:20:00,27,43,4,2,75,12,0,163
2024-03-25 12:30:00,69,9,2,5,70,8,0,163
2024-03-25 12:40:00,62,10,5,7,67,7,0,158
2024-03-25 12:50:00,60,15,2,6,85,11,0,179
2024-03-25 13:00:00,49,14,3,3,54,8,0,131
2024-03-25 13:10:00,46,10,1,5,62,13,0,137
2024-03-25 13:20:00,62,9,1,8,70,8,0,158
2024-03-25 13:30:00,47,8,4,5,75,8,0,147
2024-03-25 13:40:00,61,7,4,9,59,15,0,155
2024-03-25 13:50:00,49,13,4,4,61,8,0,139
2024-03-25 14:00:00,58,9,3,6,73,12,0,161
2024-03-25 14:10:00,66,8,9,10,78,6,0,177
2024-03-25 14:20:00,66,8,3,7,85,11,0,180
2024-03-25 14:30:00,53,7,2,5,82,15,0,164
2024-03-25 14:40:00,73,14,2,7,88,4,0,188
2024-03-25 14:50:00,62,12,5,6,77,10,0,172
2024-03-25 15:00:00,71,14,9,2,68,7,0,171
2024-03-25 15:10:00,58,8,6,7,90,16,0,185
2024-03-25 15:20:00,62,11,13,6,96,18,0,206
2024-03-25 15:30:00,74,5,3,6,73,10,0,171
2024-03-25 15:40:00,76,11,2,8,109,11,0,217
2024-03-25 15:50:00,66,12,7,4,105,13,0,207
2024-03-25 16:00:00,79,13,8,6,109,16,0,231
2024-03-25 16:10:00,73,15,5,7,105,15,0,220
2024-03-25 16:20:00,69,15,4,7,92,17,0,204
2024-03-25 16:30:00,75,14,4,4,106,13,0,216
2024-03-25 16:40:00,73,11,6,7,89,25,0,211
2024-03-25 16:50:00,66,15,5,8,105,13,0,212
2024-03-25 17:00:00,72,10,3,3,103,10,0,201
2024-03-25 17:10:00,87,5,3,4,81,7,0,187
2024-03-25 17:20:00,74,5,5,7,115,16,0,222
2024-03-25 17:30:00,57,7,8,6,82,11,0,171
2024-03-25 17:40:00,67,8,3,5,93,13,0,189
2024-03-25 17:50:00,68,8,3,2,83,10,0,174
2024-03-25 18:00:00,68,7,4,4,87,7,0,177
2024-03-25 18:10:00,58,6,2,10,89,9,0,174
2024-03-25 18:20:00,56,10,2,12,74,12,0,166
2024-03-25 18:30:00,50,9,3,3,70,9,0,144
2024-03-25 18:40:00,62,9,2,2,79,9,0,163
2024-03-25 18:50:00,48,9,1,3,69,8,0,138
2024-03-25 19:00:00,55,13,2,4,64,10,0,148
2024-03-25 19:10:00,52,11,0,0,51,0,0,114
2024-03-25 19:20:00,32,8,2,2,51,12,0,107
2024-03-25 19:30:00,29,5,3,4,43,11,0,95
2024-03-25 19:40:00,31,11,1,3,60,7,0,113
2024-03-25 19:50:00,29,6,0,2,35,9,0,81
2024-03-25 20:00:00,29,3,2,0,43,8,0,85
2024-03-25 20:10:00,36,8,0,2,36,5,0,87
2024-03-25 20:20:00,31,3,0,1,39,9,0,83
2024-03-25 20:30:00,27,7,2,4,43,9,0,92
2024-03-25 20:40:00,14,5,1,1,30,10,0,61
2024-03-25 20:50:00,18,4,3,1,42,7,0,75
2024-03-25 21:00:00,25,11,0,1,26,4,0,67
2024-03-25 21:10:00,12,5,3,3,28,5,0,56
2024-03-25 21:20:00,22,8,0,0,39,8,0,77
2024-03-25 21:30:00,23,4,0,0,22,6,0,55
2024-03-25 21:40:00,12,2,1,0,24,0,0,39
2024-03-25 21:50:00,16,0,0,0,24,4,0,44
2024-03-25 22:00:00,21,8,2,2,35,7,0,75
2024-03-25 22:10:00,25,7,4,2,31,6,0,75
2024-03-25 22:20:00,10,4,6,6,27,2,0,55
2024-03-25 22:30:00,17,3,5,1,24,8,0,58
2024-03-25 22:40:00,19,5,1,1,22,6,0,54
2024-03-25 22:50:00,10,3,0,0,21,3,0,37
2024-03-25 23:00:00,10,2,0,4,11,2,0,29
2024-03-25 23:10:00,11,3,1,0,6,2,0,23
2024-03-25 23:20:00,5,2,1,0,9,4,0,21
2024-03-25 23:30:00,14,7,0,4,9,2,0,36
2024-03-25 23:40:00,6,5,0,0,13,3,0,27
2024-03-25 23:50:00,5,1,0,0,4,1,0,11
2024-03-26 00:00:00,7,6,0,2,9,5,0,29
2024-03-26 00:10:00,4,3,1,0,7,3,0,18
2024-03-26 00:20:00,5,2,0,0,4,0,0,11
2024-03-26 00:30:00,2,1,0,0,5,1,0,9
2024-03-26 00:40:00,10,10,1,0,5,2,0,28
2024-03-26 00:50:00,1,1,1,0,5,3,0,11
2024-03-26 01:00:00,5,3,1,0,2,1,0,12
2024-03-26 01:10:00,4,3,2,1,1,1,0,12
2024-03-26 01:20:00,5,3,0,0,5,2,0,15
2024-03-26 01:30:00,4,4,1,0,3,2,0,14
2024-03-26 01:40:00,5,1,0,0,1,1,0,8
2024-03-26 01:50:00,2,1,0,0,1,1,0,5
2024-03-26 02:00:00,0,0,0,0,2,0,0,2
2024-03-26 02:10:00,4,3,0,0,4,5,0,16
2024-03-26 02:20:00,1,0,0,0,2,1,0,4
2024-03-26 02:30:00,1,1,0,0,6,3,0,11
2024-03-26 02:40:00,0,0,0,0,1,0,0,1
2024-03-26 02:50:00,1,0,0,0,2,2,0,5
2024-03-26 03:00:00,1,1,0,0,5,3,0,10
2024-03-26 03:10:00,1,2,0,0,4,3,0,10
2024-03-26 03:20:00,1,1,0,0,2,1,0,5
2024-03-26 03:30:00,4,4,1,0,3,2,0,14
2024-03-26 03:40:00,2,2,0,0,4,4,0,12
2024-03-26 03:50:00,4,1,0,0,2,1,0,8
2024-03-26 04:00:00,2,1,0,0,3,2,0,8
2024-03-26 04:10:00,2,3,0,0,3,3,0,11
2024-03-26 04:20:00,8,5,0,0,4,1,0,18
2024-03-26 04:30:00,9,5,0,0,9,8,0,31
2024-03-26 04:40:00,5,4,1,0,6,3,0,19
2024-03-26 04:50:00,7,3,0,0,3,2,0,15
2024-03-26 05:00:00,15,9,0,0,6,3,0,33
2024-03-26 05:10:00,18,7,0,0,9,4,0,38
2024-03-26 05:20:00,31,12,0,0,13,10,0,66
2024-03-26 05:30:00,34,8,0,1,21,11,0,75
2024-03-26 05:40:00,42,10,0,0,42,9,0,103
2024-03-26 05:50:00,56,15,1,1,36,9,0,118
2024-03-26 06:00:00,36,3,1,0,34,5,0,79
2024-03-26 06:10:00,53,7,0,0,30,10,0,100
2024-03-26 06:20:00,55,9,1,1,37,7,0,110
2024-03-26 06:30:00,79,8,1,1,40,8,0,137
2024-03-26 06:40:00,82,7,2,4,59,10,0,164
2024-03-26 06:50:00,63,16,2,1,52,6,0,140
2024-03-26 07:00:00,83,16,0,3,45,11,0,158
2024-03-26 07:10:00,67,4,1,2,53,11,0,138
2024-03-26 07:20:00,75,11,2,5,60,11,0,164
2024-03-26 07:30:00,80,11,5,1,77,8,0,182
2024-03-26 07:40:00,86,11,2,2,86,7,0,194
2024-03-26 07:50:00,58,16,4,1,71,9,0,159
2024-03-26 08:00:00,83,8,3,4,71,11,0,180
2024-03-26 08:10:00,76,9,3,4,67,7,0,166
2024-03-26 08:20:00,85,5,6,4,76,10,0,186
2024-03-26 08:30:00,77,11,3,6,68,9,0,174
2024-03-26 08:40:00,83,16,5,5,78,10,0,197
2024-03-26 08:50:00,55,13,7,11,60,13,0,159
2024-03-26 09:00:00,64,15,4,6,73,13,0,175
2024-03-26 09:10:00,68,11,2,10,75,11,0,177
2024-03-26 09:20:00,59,9,8,5,49,14,0,144
2024-03-26 09:30:00,64,13,4,3,57,11,0,152
2024-03-26 09:40:00,77,8,6,4,74,7,0,176
2024-03-26 09:50:00,68,4,7,4,64,9,0,156
2024-03-26 10:00:00,64,11,2,3,41,8,0,129
2024-03-26 10:10:00,49,8,2,6,48,10,0,123
2024-03-26 10:20:00,52,8,3,6,53,14,0,136
2024-03-26 10:30:00,71,5,1,3,51,11,0,142
2024-03-26 10:40:00,72,10,1,4,54,10,0,151
2024-03-26 10:50:00,63,7,3,4,73,13,0,163
2024-03-26 11:00:00,54,10,3,1,50,11,0,129
2024-03-26 11:10:00,42,6,5,5,59,8,0,125
2024-03-26 11:20:00,74,14,7,4,66,16,0,181
2024-03-26 11:30:00,64,9,2,2,51,4,0,132
2024-03-26 11:40:00,54,10,3,7,63,14,0,151
2024-03-26 11:50:00,59,6,2,6,54,8,0,135
2024-03-26 12:00:00,65,12,3,8,67,11,0,166
2024-03-26 12:10:00,54,8,4,6,72,15,0,159
2024-03-26 12:20:00,64,11,3,4,64,12,0,158
2024-03-26 12:30:00,48,4,1,2,103,11,0,169
2024-03-26 12:40:00,48,8,2,2,82,11,0,153
2024-03-26 12:50:00,56,11,1,5,70,11,0,154
2024-03-26 13:00:00,60,10,6,4,71,10,0,161
2024-03-26 13:10:00,69,12,3,4,83,14,0,185
2024-03-26 13:20:00,61,10,1,4,58,12,0,146
2024-03-26 13:30:00,45,8,0,4,76,6,0,139
2024-03-26 13:40:00,63,6,6,5,85,19,0,184
2024-03-26 13:50:00,64,12,1,3,66,8,0,154
2024-03-26 14:00:00,62,13,6,6,79,23,0,189
2024-03-26 14:10:00,70,7,2,6,63,10,0,158
2024-03-26 14:20:00,69,11,3,3,74,13,0,173
2024-03-26 14:30:00,79,11,3,6,76,11,0,186
2024-03-26 14:40:00,77,10,2,2,78,11,0,180
2024-03-26 14:50:00,60,9,4,11,113,11,0,208
2024-03-26 15:00:00,79,14,6,8,99,10,0,216
2024-03-26 15:10:00,70,16,6,8,77,9,0,186
2024-03-26 15:20:00,91,10,10,8,97,13,0,229
2024-03-26 15:30:00,63,9,9,4,90,12,0,187
2024-03-26 15:40:00,60,10,3,5,118,14,0,210
2024-03-26 15:50:00,86,9,10,7,92,12,0,216
2024-03-26 16:00:00,70,10,1,6,99,9,0,195
2024-03-26 16:10:00,86,13,4,7,95,13,0,218
2024-03-26 16:20:00,78,8,3,9,107,18,0,223
2024-03-26 16:30:00,86,6,4,11,101,13,0,221
2024-03-26 16:40:00,57,8,1,4,100,9,0,179
2024-03-26 16:50:00,81,12,6,4,92,8,0,203
2024-03-26 17:00:00,78,16,6,5,113,15,0,233
2024-03-26 17:10:00,86,13,4,6,93,12,0,214
2024-03-26 17:20:00,92,5,3,5,119,10,0,234
2024-03-26 17:30:00,86,9,3,5,99,12,0,214
2024-03-26 17:40:00,95,11,4,6,82,11,0,209
2024-03-26 17:50:00,43,6,4,3,105,8,0,169
2024-03-26 18:00:00,53,4,1,7,93,10,0,168
2024-03-26 18:10:00,73,8,4,7,99,12,0,203
2024-03-26 18:20:00,65,12,3,7,109,13,0,209
2024-03-26 18:30:00,50,7,3,7,79,9,0,155
2024-03-26 18:40:00,57,8,1,5,89,11,0,171
2024-03-26 18:50:00,57,11,3,2,90,7,0,170
2024-03-26 19:00:00,53,4,2,0,56,17,0,132
2024-03-26 19:10:00,27,6,2,1,60,10,0,106
2024-03-26 19:20:00,33,9,1,1,53,13,0,110
2024-03-26 19:30:00,33,7,2,4,49,6,0,101
2024-03-26 19:40:00,28,4,1,5,44,8,0,90
2024-03-26 19:50:00,23,7,2,0,37,4,0,73
2024-03-26 20:00:00,33,6,1,0,46,3,0,89
2024-03-26 20:10:00,34,4,1,1,32,2,0,74
2024-03-26 20:20:00,41,7,1,1,50,5,0,105
2024-03-26 20:30:00,31,9,1,0,31,10,0,82
2024-03-26 20:40:00,27,7,3,3,34,8,0,82
2024-03-26 20:50:00,24,5,0,0,37,7,0,73
2024-03-26 21:00:00,17,8,3,3,27,9,0,67
2024-03-26 21:10:00,14,6,1,1,20,3,0,45
2024-03-26 21:20:00,31,6,1,1,34,7,0,80
2024-03-26 21:30:00,25,3,1,3,25,4,0,61
2024-03-26 21:40:00,14,4,1,1,28,3,0,51
2024-03-26 21:50:00,18,4,0,0,28,7,0,57
2024-03-26 22:00:00,17,4,0,2,28,8,0,59
2024-03-26 22:10:00,25,10,2,2,31,6,0,76
2024-03-26 22:20:00,27,5,5,4,18,3,0,62
2024-03-26 22:30:00,21,4,5,4,22,4,0,60
2024-03-26 22:40:00,23,12,2,1,15,4,0,57
2024-03-26 22:50:00,10,5,0,2,18,5,0,40
2024-03-26 23:00:00,11,6,1,2,18,5,0,43
2024-03-26 23:10:00,7,3,4,0,16,4,0,34
2024-03-26 23:20:00,4,1,0,0,13,4,0,22
2024-03-26 23:30:00,8,2,1,0,10,3,0,24
2024-03-26 23:40:00,8,3,0,0,19,2,0,32
2024-03-26 23:50:00,4,1,2,1,8,3,0,19
2024-03-27 00:00:00,6,3,1,0,1,3,0,14
2024-03-27 00:10:00,8,8,1,1,9,6,0,33
2024-03-27 00:20:00,3,2,0,0,7,1,0,13
2024-03-27 00:30:00,2,2,0,0,5,5,0,14
2024-03-27 00:40:00,4,2,1,0,4,4,0,15
2024-03-27 00:50:00,4,1,1,0,6,1,0,13
2024-03-27 01:00:00,4,2,0,0,2,0,0,8
2024-03-27 01:10:00,5,3,1,0,2,1,0,12
2024-03-27 01:20:00,2,1,0,0,2,1,0,6
2024-03-27 01:30:00,3,1,1,0,4,3,0,12
2024-03-27 01:40:00,1,1,0,0,4,2,0,8
2024-03-27 01:50:00,3,2,0,0,3,1,0,9
2024-03-27 02:00:00,3,2,0,0,2,0,0,7
2024-03-27 02:10:00,5,1,1,1,3,1,0,12
2024-03-27 02:20:00,1,1,0,0,2,2,0,6
2024-03-27 02:30:00,0,1,0,0,4,3,0,8
2024-03-27 02:40:00,2,1,0,0,3,3,0,9
2024-03-27 02:50:00,4,0,0,0,5,1,0,10
2024-03-27 03:00:00,0,0,0,0,3,0,0,3
2024-03-27 03:10:00,4,3,0,0,5,6,0,18
2024-03-27 03:20:00,3,2,1,0,1,0,0,7
2024-03-27 03:30:00,3,3,1,0,0,3,0,10
2024-03-27 03:40:00,4,5,0,0,4,5,0,18
2024-03-27 03:50:00,9,4,0,0,6,4,0,23
2024-03-27 04:00:00,4,2,0,0,2,0,0,8
2024-03-27 04:10:00,3,3,0,0,2,1,0,9
2024-03-27 04:20:00,6,3,0,0,7,4,0,20
2024-03-27 04:30:00,3,4,0,0,8,7,0,22
2024-03-27 04:40:00,6,4,0,0,2,3,0,15
2024-03-27 04:50:00,13,7,0,0,3,7,0,30
2024-03-27 05:00:00,12,9,1,0,9,7,0,38
2024-03-27 05:10:00,23,9,0,0,13,7,0,52
2024-03-27 05:20:00,26,7,1,0,14,5,0,53
2024-03-27 05:30:00,39,12,0,0,26,3,0,80
2024-03-27 05:40:00,40,5,0,0,29,8,0,82
2024-03-27 05:50:00,54,13,0,1,38,10,0,116
2024-03-27 06:00:00,36,8,1,0,27,4,0,76
2024-03-27 06:10:00,53,13,1,2,50,5,0,124
2024-03-27 06:20:00,61,8,1,1,33,9,0,113
2024-03-27 06:30:00,70,7,1,1,44,8,0,131
2024-03-27 06:40:00,97,10,0,5,52,8,0,172
2024-03-27 06:50:00,78,11,2,2,50,14,0,157
2024-03-27 07:00:00,71,15,1,3,62,11,0,163
2024-03-27 07:10:00,63,5,1,2,40,1,0,112
2024-03-27 07:20:00,77,13,1,5,74,6,0,176
2024-03-27 07:30:00,53,6,2,0,64,7,0,132
2024-03-27 07:40:00,70,10,7,6,67,17,0,177
2024-03-27 07:50:00,68,15,1,6,66,11,0,167
2024-03-27 08:00:00,71,12,2,5,65,9,0,164
2024-03-27 08:10:00,76,13,6,5,73,15,0,188
2024-03-27 08:20:00,91,10,4,7,90,10,0,212
2024-03-27 08:30:00,82,14,2,11,66,9,0,184
2024-03-27 08:40:00,91,11,9,5,78,10,0,204
2024-03-27 08:50:00,77,14,5,5,79,18,0,198
2024-03-27 09:00:00,86,9,6,9,53,12,0,175
2024-03-27 09:10:00,70,10,6,10,53,12,0,161
2024-03-27 09:20:00,59,11,4,6,54,12,0,146
2024-03-27 09:30:00,64,8,5,13,52,10,0,152
2024-03-27 09:40:00,22,51,3,6,72,14,0,168
2024-03-27 09:50:00,16,52,3,3,85,10,0,169
2024-03-27 10:00:00,4,43,3,10,63,13,0,136
2024-03-27 10:10:00,15,59,2,5,63,13,0,157
2024-03-27 10:20:00,13,39,5,9,65,14,0,145
2024-03-27 10:30:00,29,38,5,4,57,11,0,144
2024-03-27 10:40:00,53,8,2,3,79,10,0,155
2024-03-27 10:50:00,61,7,4,5,65,9,0,151
2024-03-27 11:00:00,59,9,3,6,60,9,0,146
2024-03-27 11:10:00,56,8,3,2,60,7,0,136
2024-03-27 11:20:00,8,37,2,6,50,8,0,111
2024-03-27 11:30:00,10,42,2,4,74,14,0,146
2024-03-27 11:40:00,5,45,6,6,65,9,0,136
2024-03-27 11:50:00,6,45,5,6,69,9,0,140
2024-03-27 12:00:00,8,68,2,7,66,11,0,162
2024-03-27 12:10:00,9,49,3,11,81,13,0,166
2024-03-27 12:20:00,5,52,5,4,69,8,0,143
2024-03-27 12:30:00,52,23,3,2,73,9,0,162
2024-03-27 12:40:00,47,6,7,6,76,15,0,157
2024-03-27 12:50:00,56,6,3,4,59,10,0,138
2024-03-27 13:00:00,60,9,3,2,75,7,0,156
2024-03-27 13:10:00,63,11,3,6,68,13,0,164
2024-03-27 13:20:00,8,40,2,4,74,21,0,149
2024-03-27 13:30:00,4,62,3,3,55,10,0,137
2024-03-27 13:40:00,6,62,5,6,88,15,0,182
2024-03-27 13:50:00,11,46,6,5,56,6,0,130
2024-03-27 14:00:00,4,42,5,4,71,14,0,140
2024-03-27 14:10:00,2,49,3,10,83,16,0,163
2024-03-27 14:20:00,6,47,3,10,78,4,0,148
2024-03-27 14:30:00,7,51,4,5,101,12,0,180
2024-03-27 14:40:00,5,71,5,8,85,12,0,186
2024-03-27 14:50:00,12,64,3,3,87,8,0,177
2024-03-27 15:00:00,46,39,2,7,92,13,0,199
2024-03-27 15:10:00,72,10,7,8,75,9,0,181
2024-03-27 15:20:00,71,14,6,8,81,14,0,194
2024-03-27 15:30:00,85,6,5,2,91,10,0,199
2024-03-27 15:40:00,76,11,3,15,121,13,0,239
2024-03-27 15:50:00,58,15,5,4,107,18,0,207
2024-03-27 16:00:00,86,7,4,13,96,8,0,214
2024-03-27 16:10:00,88,13,4,5,111,14,0,235
2024-03-27 16:20:00,80,11,6,13,126,12,0,248
2024-03-27 16:30:00,79,5,3,8,92,18,0,205
2024-03-27 16:40:00,73,6,7,8,100,9,0,203
2024-03-27 16:50:00,88,5,1,6,101,7,0,208
2024-03-27 17:00:00,73,5,2,3,106,11,0,200
2024-03-27 17:10:00,77,15,0,2,86,13,0,193
2024-03-27 17:20:00,85,6,3,5,105,14,0,218
2024-03-27 17:30:00,72,11,2,9,83,13,0,190
2024-03-27 17:40:00,59,6,3,3,99,9,0,179
2024-03-27 17:50:00,67,14,4,4,84,10,0,183
2024-03-27 18:00:00,51,10,4,3,85,9,0,162
2024-03-27 18:10:00,74,7,2,6,96,3,0,188
2024-03-27 18:20:00,53,9,6,3,88,11,0,170
2024-03-27 18:30:00,56,6,1,0,80,9,0,152
2024-03-27 18:40:00,50,6,2,3,75,13,0,149
2024-03-27 18:50:00,42,7,1,4,75,16,0,145
2024-03-27 19:00:00,41,3,2,0,55,6,0,107
2024-03-27 19:10:00,45,6,1,3,59,14,0,128
2024-03-27 19:20:00,43,8,1,1,62,11,0,126
2024-03-27 19:30:00,31,7,2,0,48,8,0,96
2024-03-27 19:40:00,27,5,0,2,25,27,0,86
2024-03-27 19:50:00,30,4,3,1,54,10,0,102
2024-03-27 20:00:00,25,7,1,0,37,7,0,77
2024-03-27 20:10:00,35,3,1,0,33,7,0,79
2024-03-27 20:20:00,24,4,1,1,44,7,0,81
2024-03-27 20:30:00,24,9,0,0,31,3,0,67
2024-03-27 20:40:00,14,3,0,0,43,11,0,71
2024-03-27 20:50:00,33,10,1,0,28,8,0,80
2024-03-27 21:00:00,29,6,0,3,29,9,0,76
2024-03-27 21:10:00,19,6,2,4,26,8,0,65
2024-03-27 21:20:00,30,7,1,1,31,7,0,77
2024-03-27 21:30:00,29,1,0,2,32,5,0,69
2024-03-27 21:40:00,22,5,1,0,29,8,0,65
2024-03-27 21:50:00,17,6,0,0,27,7,0,57
2024-03-27 22:00:00,24,7,1,1,21,6,0,60
2024-03-27 22:10:00,19,4,5,7,37,2,0,74
2024-03-27 22:20:00,11,5,4,1,33,8,0,62
2024-03-27 22:30:00,20,3,0,1,26,3,0,53
2024-03-27 22:40:00,13,6,1,4,25,6,0,55
2024-03-27 22:50:00,16,6,0,0,17,7,0,46
2024-03-27 23:00:00,9,1,0,0,20,4,0,34
2024-03-27 23:10:00,9,4,1,0,16,2,0,32
2024-03-27 23:20:00,10,4,0,0,11,3,0,28
2024-03-27 23:30:00,6,3,0,0,7,2,0,18
2024-03-27 23:40:00,6,1,0,0,8,2,0,17
2024-03-27 23:50:00,6,2,0,0,6,3,0,17
2024-03-28 00:00:00,5,4,1,0,8,3,0,21
2024-03-28 00:10:00,6,6,1,1,5,4,0,23
2024-03-28 00:20:00,7,3,0,0,6,2,0,18
2024-03-28 00:30:00,3,1,0,0,5,3,0,12
2024-03-28 00:40:00,7,1,0,0,4,1,0,13
2024-03-28 00:50:00,2,0,0,0,3,1,0,6
2024-03-28 01:00:00,3,1,0,0,5,1,0,10
2024-03-28 01:10:00,2,3,1,0,7,1,0,14
2024-03-28 01:20:00,2,0,1,0,4,1,0,8
2024-03-28 01:30:00,2,1,0,0,2,1,0,6
2024-03-28 01:40:00,2,2,0,0,0,3,0,7
2024-03-28 01:50:00,2,1,0,0,2,1,0,6
2024-03-28 02:00:00,3,1,0,0,4,0,0,8
2024-03-28 02:10:00,1,0,0,0,2,1,0,4
2024-03-28 02:20:00,4,1,0,0,4,1,0,10
2024-03-28 02:30:00,2,0,0,0,1,0,0,3
2024-03-28 02:40:00,1,2,0,0,1,2,0,6
2024-03-28 02:50:00,3,1,0,0,2,1,0,7
2024-03-28 03:00:00,0,0,0,0,2,0,0,2
2024-03-28 03:10:00,1,3,0,0,4,4,0,12
2024-03-28 03:20:00,2,1,0,0,3,1,0,7
2024-03-28 03:30:00,3,3,0,0,1,1,0,8
2024-03-28 03:40:00,3,4,1,0,3,3,0,14
2024-03-28 03:50:00,2,2,0,0,4,3,0,11
2024-03-28 04:00:00,2,1,0,0,5,3,0,11
2024-03-28 04:10:00,2,4,0,0,10,5,0,21
2024-03-28 04:20:00,3,2,0,0,5,5,0,15
2024-03-28 04:30:00,10,6,0,0,7,6,0,29
2024-03-28 04:40:00,8,4,0,0,7,4,0,23
2024-03-28 04:50:00,8,5,0,0,7,3,0,23
2024-03-28 05:00:00,7,4,0,0,7,3,0,21
2024-03-28 05:10:00,17,9,0,0,17,11,0,54
2024-03-28 05:20:00,25,11,0,0,7,6,0,49
2024-03-28 05:30:00,33,8,0,0,20,9,0,70
2024-03-28 05:40:00,28,3,0,1,27,4,0,63
2024-03-28 05:50:00,43,7,1,0,32,4,0,87
2024-03-28 06:00:00,38,7,1,0,29,3,0,78
2024-03-28 06:10:00,39,7,1,0,33,2,0,82
2024-03-28 06:20:00,50,7,0,1,36,3,0,97
2024-03-28 06:30:00,54,6,2,3,44,10,0,119
2024-03-28 06:40:00,68,15,1,1,51,5,0,141
2024-03-28 06:50:00,69,18,1,1,46,8,0,143
2024-03-28 07:00:00,78,7,0,4,53,5,0,147
2024-03-28 07:10:00,70,6,1,3,44,4,0,128
2024-03-28 07:20:00,54,11,2,5,54,8,0,134
2024-03-28 07:30:00,59,22,1,1,56,6,0,145
2024-03-28 07:40:00,56,8,5,5,74,8,0,156
2024-03-28 07:50:00,80,6,5,1,63,12,0,167
2024-03-28 08:00:00,66,11,4,6,55,11,0,153
2024-03-28 08:10:00,71,10,3,4,67,15,0,170
2024-03-28 08:20:00,76,6,3,7,78,13,0,183
2024-03-28 08:30:00,55,10,1,8,56,3,0,133
2024-03-28 08:40:00,82,6,3,7,83,16,0,197
2024-03-28 08:50:00,67,13,7,14,57,14,0,172
2024-03-28 09:00:00,75,10,6,7,55,16,0,169
2024-03-28 09:10:00,81,10,7,9,56,15,0,178
2024-03-28 09:20:00,59,10,2,4,68,24,0,167
2024-03-28 09:30:00,78,14,1,9,55,12,0,169
2024-03-28 09:40:00,83,12,6,4,58,8,0,171
2024-03-28 09:50:00,82,12,2,5,60,12,0,173
2024-03-28 10:00:00,52,13,3,7,54,5,0,134
2024-03-28 10:10:00,65,13,2,4,58,14,0,156
2024-03-28 10:20:00,60,9,1,7,60,20,0,157
2024-03-28 10:30:00,63,8,3,6,60,5,0,145
2024-03-28 10:40:00,76,11,2,2,49,5,0,145
2024-03-28 10:50:00,51,10,4,4,71,22,0,162
2024-03-28 11:00:00,73,10,4,7,73,12,0,179
2024-03-28 11:10:00,67,8,3,9,65,9,0,161
2024-03-28 11:20:00,66,11,3,5,62,11,0,158
2024-03-28 11:30:00,66,7,9,5,78,6,0,171
2024-03-28 11:40:00,63,6,3,9,79,12,0,172
2024-03-28 11:50:00,57,6,3,6,70,5,0,147
2024-03-28 12:00:00,69,11,4,4,81,11,0,180
2024-03-28 12:10:00,72,9,3,10,78,10,0,182
2024-03-28 12:20:00,68,10,7,4,85,13,0,187
2024-03-28 12:30:00,67,7,6,6,70,13,0,169
2024-03-28 12:40:00,72,9,3,9,76,22,0,191
2024-03-28 12:50:00,50,10,1,7,76,17,0,161
2024-03-28 13:00:00,58,5,3,6,68,12,0,152
2024-03-28 13:10:00,50,5,4,3,77,7,0,146
2024-03-28 13:20:00,56,4,1,5,75,14,0,155
2024-03-28 13:30:00,64,7,2,8,63,5,0,149
2024-03-28 13:40:00,72,9,0,8,93,17,0,199
2024-03-28 13:50:00,53,4,4,10,90,17,0,178
2024-03-28 14:00:00,75,9,3,7,86,10,0,190
2024-03-28 14:10:00,93,13,6,10,88,19,0,229
2024-03-28 14:20:00,80,12,3,8,80,10,0,193
2024-03-28 14:30:00,69,6,1,9,70,5,0,160
2024-03-28 14:40:00,63,10,0,5,105,9,0,192
2024-03-28 14:50:00,64,8,7,9,85,11,0,184
2024-03-28 15:00:00,76,16,3,6,84,13,0,198
2024-03-28 15:10:00,77,12,5,6,87,12,0,199
2024-03-28 15:20:00,71,13,9,9,108,12,0,222
2024-03-28 15:30:00,66,7,3,6,85,9,0,176
2024-03-28 15:40:00,84,9,2,2,111,13,0,221
2024-03-28 15:50:00,69,7,5,5,97,20,0,203
2024-03-28 16:00:00,85,7,2,7,93,10,0,204
2024-03-28 16:10:00,84,9,5,6,109,12,0,225
2024-03-28 16:20:00,67,9,4,8,109,6,0,203
2024-03-28 16:30:00,66,15,4,3,116,13,0,217
2024-03-28 16:40:00,80,3,0,1,111,13,0,208
2024-03-28 16:50:00,70,12,2,2,93,5,0,184
2024-03-28 17:00:00,60,13,8,9,99,13,0,202
2024-03-28 17:10:00,69,7,4,7,96,8,0,191
2024-03-28 17:20:00,73,8,3,5,109,15,0,213
2024-03-28 17:30:00,78,8,2,6,101,17,0,212
2024-03-28 17:40:00,69,6,2,3,99,13,0,192
2024-03-28 17:50:00,73,8,4,9,96,8,0,198
2024-03-28 18:00:00,61,16,7,3,84,11,0,182
2024-03-28 18:10:00,61,12,3,3,93,11,0,183
2024-03-28 18:20:00,67,9,0,5,83,11,0,175
2024-03-28 18:30:00,47,9,3,6,89,12,0,166
2024-03-28 18:40:00,86,15,3,7,73,16,0,200
2024-03-28 18:50:00,65,6,2,0,93,31,0,197
2024-03-28 19:00:00,61,2,1,1,62,11,0,138
2024-03-28 19:10:00,52,8,1,4,60,10,0,135
2024-03-28 19:20:00,33,5,3,3,81,15,0,140
2024-03-28 19:30:00,32,6,0,3,55,15,0,111
2024-03-28 19:40:00,37,6,0,2,64,12,0,121
2024-03-28 19:50:00,35,5,2,2,54,9,0,107
2024-03-28 20:00:00,41,10,1,2,46,8,0,108
2024-03-28 20:10:00,34,4,3,0,46,6,0,93
2024-03-28 20:20:00,46,3,3,1,47,8,0,108
2024-03-28 20:30:00,31,2,1,3,42,11,0,90
2024-03-28 20:40:00,26,6,2,3,27,3,0,67
2024-03-28 20:50:00,39,8,0,2,45,11,0,105
2024-03-28 21:00:00,19,4,2,4,39,4,0,72
2024-03-28 21:10:00,23,7,1,0,30,3,0,64
2024-03-28 21:20:00,33,9,1,1,37,8,0,89
2024-03-28 21:30:00,25,2,4,0,34,4,0,69
2024-03-28 21:40:00,25,4,0,0,23,3,0,55
2024-03-28 21:50:00,34,6,0,1,30,3,0,74
2024-03-28 22:00:00,24,9,0,1,30,8,0,72
2024-03-28 22:10:00,37,4,3,4,35,2,0,85
2024-03-28 22:20:00,24,8,4,0,34,7,0,77
2024-03-28 22:30:00,21,10,3,0,31,13,0,78
2024-03-28 22:40:00,14,6,1,0,24,1,0,46
2024-03-28 22:50:00,15,4,0,2,24,5,0,50
2024-03-28 23:00:00,20,5,0,0,19,7,0,51
2024-03-28 23:10:00,17,6,2,0,19,4,0,48
2024-03-28 23:20:00,17,2,0,0,10,0,0,29
2024-03-28 23:30:00,14,2,0,1,17,2,0,36
2024-03-28 23:40:00,18,3,0,0,12,2,0,35
2024-03-28 23:50:00,13,4,0,1,12,3,0,33
2024-03-29 00:00:00,8,4,0,0,22,6,0,40
2024-03-29 00:10:00,10,3,2,0,20,8,0,43
2024-03-29 00:20:00,7,1,1,1,3,1,0,14
2024-03-29 00:30:00,5,3,0,0,12,2,0,22
2024-03-29 00:40:00,7,3,2,0,9,2,0,23
2024-03-29 00:50:00,8,4,0,0,10,0,0,22
2024-03-29 01:00:00,9,4,0,0,9,3,0,25
2024-03-29 01:10:00,13,6,1,1,7,3,0,31
2024-03-29 01:20:00,14,2,0,0,10,1,0,27
2024-03-29 01:30:00,14,4,0,0,5,5,0,28
2024-03-29 01:40:00,8,5,1,2,7,0,0,23
2024-03-29 01:50:00,4,0,0,0,2,1,0,7
2024-03-29 02:00:00,3,2,0,0,8,2,0,15
2024-03-29 02:10:00,6,4,0,0,1,1,0,12
2024-03-29 02:20:00,4,3,0,0,10,2,0,19
2024-03-29 02:30:00,3,0,1,0,8,1,0,13
2024-03-29 02:40:00,2,1,0,1,5,3,0,12
2024-03-29 02:50:00,3,1,0,0,4,0,0,8
2024-03-29 03:00:00,8,5,0,0,2,3,0,18
2024-03-29 03:10:00,2,3,0,0,3,2,0,10
2024-03-29 03:20:00,3,2,0,0,4,1,0,10
2024-03-29 03:30:00,3,2,0,0,5,1,0,11
2024-03-29 03:40:00,4,1,0,0,1,3,0,9
2024-03-29 03:50:00,6,5,0,0,4,4,0,19
2024-03-29 04:00:00,2,0,0,2,1,0,0,5
2024-03-29 04:10:00,2,0,0,0,2,1,0,5
2024-03-29 04:20:00,2,0,0,0,3,1,0,6
2024-03-29 04:30:00,2,2,0,0,3,2,0,9
2024-03-29 04:40:00,5,3,0,0,1,1,0,10
2024-03-29 04:50:00,2,0,0,0,0,1,0,3
2024-03-29 05:00:00,4,2,0,0,4,3,0,13
2024-03-29 05:10:00,11,5,0,0,2,2,0,20
2024-03-29 05:20:00,9,5,0,0,1,0,0,15
2024-03-29 05:30:00,8,2,0,0,6,2,0,18
2024-03-29 05:40:00,9,3,0,1,11,5,0,29
2024-03-29 05:50:00,4,1,0,0,6,2,0,13
2024-03-29 06:00:00,7,4,0,1,10,8,0,30
2024-03-29 06:10:00,17,6,2,0,5,1,0,31
2024-03-29 06:20:00,8,1,0,0,6,0,0,15
2024-03-29 06:30:00,5,0,0,0,6,0,0,11
2024-03-29 06:40:00,10,4,0,0,8,1,0,23
2024-03-29 06:50:00,10,4,0,1,4,1,0,20
2024-03-29 07:00:00,9,4,0,0,9,3,0,25
2024-03-29 07:10:00,12,3,0,0,6,1,0,22
2024-03-29 07:20:00,7,1,1,0,4,3,0,16
2024-03-29 07:30:00,5,1,2,2,8,4,0,22
2024-03-29 07:40:00,8,5,0,1,9,2,0,25
2024-03-29 07:50:00,6,4,0,0,7,6,0,23
2024-03-29 08:00:00,8,2,0,0,7,1,0,18
2024-03-29 08:10:00,8,1,2,0,12,2,0,25
2024-03-29 08:20:00,7,3,0,0,10,5,0,25
2024-03-29 08:30:00,13,6,0,0,9,1,0,29
2024-03-29 08:40:00,10,2,0,0,14,4,0,30
2024-03-29 08:50:00,14,4,0,1,14,2,0,35
2024-03-29 09:00:00,17,4,3,1,19,2,0,46
2024-03-29 09:10:00,28,8,0,2,11,3,0,52
2024-03-29 09:20:00,20,6,0,3,24,8,0,61
2024-03-29 09:30:00,22,7,1,1,9,2,0,42
2024-03-29 09:40:00,19,6,0,1,31,3,0,60
2024-03-29 09:50:00,27,7,1,3,21,3,0,62
2024-03-29 10:00:00,20,3,1,0,27,4,0,55
2024-03-29 10:10:00,31,5,1,1,25,4,0,67
2024-03-29 10:20:00,29,5,1,1,23,5,0,64
2024-03-29 10:30:00,36,7,0,1,28,3,0,75
2024-03-29 10:40:00,28,7,2,1,28,8,0,74
2024-03-29 10:50:00,35,9,0,2,44,8,0,98
2024-03-29 11:00:00,38,9,5,2,37,7,0,98
2024-03-29 11:10:00,41,10,0,4,30,5,0,90
2024-03-29 11:20:00,23,6,1,3,27,5,0,65
2024-03-29 11:30:00,30,7,1,0,38,9,0,85
2024-03-29 11:40:00,33,5,2,1,18,3,0,62
2024-03-29 11:50:00,36,4,0,0,36,8,0,84
2024-03-29 12:00:00,26,4,1,0,28,6,0,65
2024-03-29 12:10:00,37,8,1,0,28,11,0,85
2024-03-29 12:20:00,22,7,2,0,33,5,0,69
2024-03-29 12:30:00,39,7,1,2,25,4,0,78
2024-03-29 12:40:00,47,5,0,1,27,7,0,87
2024-03-29 12:50:00,30,3,0,1,37,10,0,81
2024-03-29 13:00:00,43,5,1,2,42,3,0,96
2024-03-29 13:10:00,34,12,0,3,33,4,0,86
2024-03-29 13:20:00,36,6,1,2,32,9,0,86
2024-03-29 13:30:00,31,7,2,2,46,5,0,93
2024-03-29 13:40:00,43,10,1,1,43,4,0,102
2024-03-29 13:50:00,28,5,2,1,46,6,0,88
2024-03-29 14:00:00,28,5,0,1,39,6,0,79
2024-03-29 14:10:00,36,3,4,2,48,5,0,98
2024-03-29 14:20:00,32,6,1,3,38,9,0,89
2024-03-29 14:30:00,31,6,0,0,45,6,0,88
2024-03-29 14:40:00,41,6,3,2,50,7,0,109
2024-03-29 14:50:00,31,5,3,0,53,4,0,96
2024-03-29 15:00:00,21,7,3,1,43,10,0,85
2024-03-29 15:10:00,45,9,4,2,37,12,0,109
2024-03-29 15:20:00,32,2,3,3,31,6,0,77
2024-03-29 15:30:00,32,5,1,2,43,7,0,90
2024-03-29 15:40:00,35,5,1,2,33,8,0,84
2024-03-29 15:50:00,24,6,0,3,38,10,0,81
2024-03-29 16:00:00,31,4,0,3,36,5,0,79
2024-03-29 16:10:00,33,4,2,4,21,2,0,66
2024-03-29 16:20:00,34,11,2,1,36,6,0,90
2024-03-29 16:30:00,30,7,4,0,50,4,0,95
2024-03-29 16:40:00,37,4,1,6,39,5,0,92
2024-03-29 16:50:00,27,6,2,4,50,5,0,94
2024-03-29 17:00:00,41,4,2,1,42,5,0,95
2024-03-29 17:10:00,35,7,1,2,48,10,0,103
2024-03-29 17:20:00,53,9,3,2,42,6,0,115
2024-03-29 17:30:00,45,9,2,3,57,11,0,127
2024-03-29 17:40:00,53,7,0,5,40,4,0,109
2024-03-29 17:50:00,31,6,1,3,57,7,0,105
2024-03-29 18:00:00,41,9,2,2,38,10,0,102
2024-03-29 18:10:00,36,4,1,3,45,7,0,96
2024-03-29 18:20:00,39,9,2,2,46,8,0,106
2024-03-29 18:30:00,44,5,0,2,40,7,0,98
2024-03-29 18:40:00,38,1,0,4,25,3,0,71
2024-03-29 18:50:00,33,5,2,2,40,5,0,87
2024-03-29 19:00:00,22,4,1,4,26,3,0,60
2024-03-29 19:10:00,27,7,0,2,27,6,0,69
2024-03-29 19:20:00,27,2,1,5,24,8,0,67
2024-03-29 19:30:00,37,5,1,0,24,3,0,70
2024-03-29 19:40:00,28,5,0,0,29,8,0,70
2024-03-29 19:50:00,20,3,1,1,28,4,0,57
2024-03-29 20:00:00,25,5,1,0,27,3,0,61
2024-03-29 20:10:00,36,8,2,2,27,4,0,79
2024-03-29 20:20:00,27,4,1,3,18,5,0,58
2024-03-29 20:30:00,25,1,1,0,33,4,0,64
2024-03-29 20:40:00,26,5,1,1,28,8,0,69
2024-03-29 20:50:00,28,7,1,1,31,7,0,75
2024-03-29 21:00:00,19,2,1,1,23,1,0,47
2024-03-29 21:10:00,27,6,0,1,27,1,0,62
2024-03-29 21:20:00,18,4,0,2,28,5,0,57
2024-03-29 21:30:00,14,4,2,0,27,3,0,50
2024-03-29 21:40:00,21,4,0,0,17,3,0,45
2024-03-29 21:50:00,15,5,0,3,26,7,0,56
2024-03-29 22:00:00,21,8,0,0,26,5,0,60
2024-03-29 22:10:00,20,4,0,1,21,6,0,52
2024-03-29 22:20:00,12,3,1,0,19,4,0,39
2024-03-29 22:30:00,10,4,0,0,18,4,0,36
2024-03-29 22:40:00,8,3,1,2,21,5,0,40
2024-03-29 22:50:00,10,2,0,0,13,4,0,29
2024-03-29 23:00:00,16,9,0,0,16,2,0,43
2024-03-29 23:10:00,9,4,0,0,12,5,0,30
2024-03-29 23:20:00,10,4,0,1,14,4,0,33
2024-03-29 23:30:00,7,3,0,0,22,7,0,39
2024-03-29 23:40:00,15,3,0,0,11,0,0,29
2024-03-29 23:50:00,9,2,0,1,8,4,0,24
2024-03-30 00:00:00,6,1,1,0,10,4,0,22
2024-03-30 00:10:00,6,1,0,3,11,2,0,23
2024-03-30 00:20:00,6,3,1,0,7,4,0,21
2024-03-30 00:30:00,8,2,0,0,8,2,0,20
2024-03-30 00:40:00,9,3,1,4,8,2,0,27
2024-03-30 00:50:00,4,1,0,1,8,5,0,19
2024-03-30 01:00:00,5,2,0,0,6,1,0,14
2024-03-30 01:10:00,2,1,0,0,3,2,0,8
2024-03-30 01:20:00,7,3,0,0,5,2,0,17
2024-03-30 01:30:00,1,2,0,0,3,0,0,6
2024-03-30 01:40:00,6,1,0,0,6,2,0,15
2024-03-30 01:50:00,5,0,1,0,5,1,0,12
2024-03-30 02:00:00,1,0,0,0,2,2,0,5
2024-03-30 02:10:00,4,3,1,2,0,0,0,10
2024-03-30 02:20:00,6,1,0,0,5,1,0,13
2024-03-30 02:30:00,2,0,0,0,6,2,0,10
2024-03-30 02:40:00,5,6,0,0,3,3,0,17
2024-03-30 02:50:00,4,2,0,0,0,0,0,6
2024-03-30 03:00:00,4,2,0,0,7,2,0,15
2024-03-30 03:10:00,2,0,0,0,3,1,0,6
2024-03-30 03:20:00,3,1,0,1,4,0,0,9
2024-03-30 03:30:00,1,2,0,0,3,2,0,8
2024-03-30 03:40:00,3,2,1,0,3,2,0,11
2024-03-30 03:50:00,2,0,0,0,1,0,0,3
2024-03-30 04:00:00,2,2,0,0,6,1,0,11
2024-03-30 04:10:00,5,1,0,0,0,0,0,6
2024-03-30 04:20:00,3,4,0,0,3,1,0,11
2024-03-30 04:30:00,3,0,0,0,4,1,0,8
2024-03-30 04:40:00,9,5,0,0,5,6,0,25
2024-03-30 04:50:00,7,2,0,0,4,1,0,14
2024-03-30 05:00:00,4,3,0,1,4,2,0,14
2024-03-30 05:10:00,7,2,0,0,4,2,0,15
2024-03-30 05:20:00,7,3,0,0,4,2,0,16
2024-03-30 05:30:00,7,0,0,0,4,2,0,13
2024-03-30 05:40:00,9,1,0,0,6,1,0,17
2024-03-30 05:50:00,8,1,0,0,6,1,0,16
2024-03-30 06:00:00,16,3,0,0,12,3,0,34
2024-03-30 06:10:00,17,4,0,0,5,6,0,32
2024-03-30 06:20:00,12,4,0,1,5,2,0,24
2024-03-30 06:30:00,6,1,1,0,6,1,0,15
2024-03-30 06:40:00,11,3,0,0,11,3,0,28
2024-03-30 06:50:00,12,4,1,2,8,4,0,31
2024-03-30 07:00:00,18,7,1,1,8,3,0,38
2024-03-30 07:10:00,16,9,0,0,10,5,0,40
2024-03-30 07:20:00,12,1,0,2,10,6,0,31
2024-03-30 07:30:00,12,4,2,2,14,2,0,36
2024-03-30 07:40:00,23,4,0,1,7,2,0,37
2024-03-30 07:50:00,12,4,0,0,12,7,0,35
2024-03-30 08:00:00,31,4,0,2,17,5,0,59
2024-03-30 08:10:00,25,3,0,2,16,2,0,48
2024-03-30 08:20:00,27,4,0,3,20,4,0,58
2024-03-30 08:30:00,32,10,1,2,29,7,0,81
2024-03-30 08:40:00,36,9,1,2,25,3,0,76
2024-03-30 08:50:00,36,4,2,5,27,5,0,79
2024-03-30 09:00:00,41,8,2,1,24,10,0,86
2024-03-30 09:10:00,41,7,1,1,27,4,0,81
2024-03-30 09:20:00,41,1,3,2,29,5,0,81
2024-03-30 09:30:00,49,9,1,6,41,4,0,110
2024-03-30 09:40:00,57,14,2,7,37,6,0,123
2024-03-30 09:50:00,54,9,1,6,50,8,0,128
2024-03-30 10:00:00,48,2,1,3,49,8,0,111
2024-03-30 10:10:00,52,7,3,5,55,5,0,127
2024-03-30 10:20:00,52,5,2,4,52,8,0,123
2024-03-30 10:30:00,50,7,0,1,49,10,0,117
2024-03-30 10:40:00,42,9,3,3,54,7,0,118
2024-03-30 10:50:00,61,3,1,6,49,9,0,129
2024-03-30 11:00:00,46,5,1,5,52,10,0,119
2024-03-30 11:10:00,56,5,5,1,52,10,0,129
2024-03-30 11:20:00,64,7,3,7,55,9,0,145
2024-03-30 11:30:00,54,7,3,3,59,11,0,137
2024-03-30 11:40:00,69,7,2,5,52,6,0,141
2024-03-30 11:50:00,55,9,3,1,64,8,0,140
2024-03-30 12:00:00,49,6,2,1,73,10,0,141
2024-03-30 12:10:00,50,3,2,2,54,9,0,120
2024-03-30 12:20:00,63,6,4,4,69,12,0,158
2024-03-30 12:30:00,69,7,2,3,69,5,0,155
2024-03-30 12:40:00,50,11,2,4,60,7,0,134
2024-03-30 12:50:00,57,5,1,3,71,8,0,145
2024-03-30 13:00:00,43,9,4,9,50,6,0,121
2024-03-30 13:10:00,37,8,4,4,63,8,0,124
2024-03-30 13:20:00,55,9,2,2,81,16,0,165
2024-03-30 13:30:00,64,7,4,2,69,9,0,155
2024-03-30 13:40:00,40,3,3,4,67,3,0,120
2024-03-30 13:50:00,57,7,2,4,71,20,0,161
2024-03-30 14:00:00,57,5,1,5,65,7,0,140
2024-03-30 14:10:00,47,13,4,2,78,10,0,154
2024-03-30 14:20:00,63,4,4,5,75,10,0,161
2024-03-30 14:30:00,49,5,0,1,82,9,0,146
2024-03-30 14:40:00,44,5,0,3,81,4,0,137
2024-03-30 14:50:00,50,6,1,2,76,7,0,142
2024-03-30 15:00:00,67,4,1,2,53,9,0,136
2024-03-30 15:10:00,61,10,1,3,59,6,0,140
2024-03-30 15:20:00,64,6,1,2,55,7,0,135
2024-03-30 15:30:00,56,10,5,5,70,11,0,157
2024-03-30 15:40:00,60,7,2,1,54,5,0,129
2024-03-30 15:50:00,59,5,0,2,48,9,0,123
2024-03-30 16:00:00,38,6,0,1,49,4,0,98
2024-03-30 16:10:00,40,4,3,2,29,20,0,98
2024-03-30 16:20:00,49,10,1,3,44,20,0,127
2024-03-30 16:30:00,47,6,1,2,46,6,0,108
2024-03-30 16:40:00,35,4,4,3,45,11,0,102
2024-03-30 16:50:00,34,7,2,4,51,6,0,104
2024-03-30 17:00:00,46,12,1,3,46,6,0,114
2024-03-30 17:10:00,48,2,1,2,53,6,0,112
2024-03-30 17:20:00,39,4,2,2,55,7,0,109
2024-03-30 17:30:00,44,5,1,5,46,8,0,109
2024-03-30 17:40:00,41,6,4,3,52,5,0,111
2024-03-30 17:50:00,51,6,1,4,65,8,0,135
2024-03-30 18:00:00,39,6,5,9,40,9,0,108
2024-03-30 18:10:00,55,10,0,2,50,8,0,125
2024-03-30 18:20:00,59,8,1,3,48,13,0,132
2024-03-30 18:30:00,33,7,2,2,32,1,0,77
2024-03-30 18:40:00,38,6,6,0,39,6,0,95
2024-03-30 18:50:00,40,4,2,3,46,4,0,99
2024-03-30 19:00:00,33,2,4,2,36,6,0,83
2024-03-30 19:10:00,34,4,2,7,31,2,0,80
2024-03-30 19:20:00,31,6,1,2,48,5,0,93
2024-03-30 19:30:00,30,4,0,1,47,4,0,86
2024-03-30 19:40:00,32,8,0,1,41,7,0,89
2024-03-30 19:50:00,26,3,2,2,32,5,0,70
2024-03-30 20:00:00,30,7,3,1,32,4,0,77
2024-03-30 20:10:00,28,5,2,1,22,2,0,60
2024-03-30 20:20:00,33,10,1,0,35,2,0,81
2024-03-30 20:30:00,30,10,3,3,34,4,0,84
2024-03-30 20:40:00,25,2,0,0,39,4,0,70
2024-03-30 20:50:00,15,3,0,0,29,10,0,57
2024-03-30 21:00:00,17,7,1,2,23,4,0,54
2024-03-30 21:10:00,9,3,2,1,23,5,0,43
2024-03-30 21:20:00,14,2,0,0,23,3,0,42
2024-03-30 21:30:00,23,6,0,0,20,2,0,51
2024-03-30 21:40:00,25,8,0,0,27,4,0,64
2024-03-30 21:50:00,24,9,1,1,26,3,0,64
2024-03-30 22:00:00,25,5,1,0,29,5,0,65
2024-03-30 22:10:00,15,9,1,0,22,13,0,60
2024-03-30 22:20:00,17,8,0,0,21,6,0,52
2024-03-30 22:30:00,15,8,0,0,11,3,0,37
2024-03-30 22:40:00,13,3,2,2,24,4,0,48
2024-03-30 22:50:00,17,2,0,0,23,3,0,45
2024-03-30 23:00:00,31,6,2,0,10,2,0,51
2024-03-30 23:10:00,8,4,2,0,22,5,0,41
2024-03-30 23:20:00,19,2,1,0,22,1,0,45
2024-03-30 23:30:00,20,7,0,0,20,3,0,50
2024-03-30 23:40:00,12,3,0,1,11,0,0,27
2024-03-30 23:50:00,6,1,0,2,9,2,0,20
2024-03-31 00:00:00,7,2,0,0,18,4,0,31
2024-03-31 00:10:00,7,3,0,2,12,1,0,25
2024-03-31 00:20:00,4,1,1,0,15,4,0,25
2024-03-31 00:30:00,8,2,0,0,10,1,0,21
2024-03-31 00:40:00,12,3,0,1,12,3,0,31
2024-03-31 00:50:00,1,1,0,0,9,1,0,12
2024-03-31 01:00:00,7,2,0,0,8,2,0,19
2024-03-31 01:10:00,7,5,1,1,7,3,0,24
2024-03-31 01:20:00,7,1,0,0,7,1,0,16
2024-03-31 01:30:00,7,1,0,0,4,0,0,12
2024-03-31 01:40:00,5,3,1,1,7,1,0,18
2024-03-31 01:50:00,4,4,0,0,9,3,0,20
2024-03-31 02:00:00,0,0,0,0,0,0,0,0
2024-03-31 02:10:00,0,0,0,0,0,0,0,0
2024-03-31 02:20:00,0,0,0,0,0,0,0,0
2024-03-31 02:30:00,0,0,0,0,0,0,0,0
2024-03-31 02:40:00,0,0,0,0,0,0,0,0
2024-03-31 02:50:00,0,0,0,0,0,0,0,0
2024-03-31 03:00:00,6,5,0,0,9,5,0,25
2024-03-31 03:10:00,2,2,0,0,8,3,0,15
2024-03-31 03:20:00,5,3,0,0,10,3,0,21
2024-03-31 03:30:00,8,1,0,0,7,4,0,20
2024-03-31 03:40:00,3,0,0,0,4,2,0,9
2024-03-31 03:50:00,3,2,0,0,2,1,0,8
2024-03-31 04:00:00,2,1,0,0,0,0,0,3
2024-03-31 04:10:00,6,3,0,0,4,2,0,15
2024-03-31 04:20:00,10,2,0,0,2,0,0,14
2024-03-31 04:30:00,4,2,0,0,4,4,0,14
2024-03-31 04:40:00,6,2,0,0,6,3,0,17
2024-03-31 04:50:00,6,3,0,0,3,3,0,15
2024-03-31 05:00:00,3,2,0,0,5,0,0,10
2024-03-31 05:10:00,3,3,0,0,10,3,0,19
2024-03-31 05:20:00,7,3,0,0,8,2,0,20
2024-03-31 05:30:00,4,2,0,0,6,3,0,15
2024-03-31 05:40:00,6,5,0,0,10,3,0,24
2024-03-31 05:50:00,3,2,0,0,7,2,0,14
2024-03-31 06:00:00,6,4,0,1,11,5,0,27
2024-03-31 06:10:00,9,1,0,0,5,2,0,17
2024-03-31 06:20:00,3,1,0,2,6,1,0,13
2024-03-31 06:30:00,4,2,1,0,9,0,0,16
2024-03-31 06:40:00,3,2,0,1,2,2,0,10
2024-03-31 06:50:00,7,4,0,0,7,6,0,24
2024-03-31 07:00:00,7,3,0,0,3,2,0,15
2024-03-31 07:10:00,4,2,0,0,5,0,0,11
2024-03-31 07:20:00,8,1,0,0,3,0,0,12
2024-03-31 07:30:00,3,2,0,0,2,1,0,8
2024-03-31 07:40:00,9,3,0,0,2,1,0,15
2024-03-31 07:50:00,3,4,0,0,9,3,0,19
2024-03-31 08:00:00,5,1,1,0,7,4,0,18
2024-03-31 08:10:00,10,4,0,1,7,0,0,22
2024-03-31 08:20:00,10,3,0,1,6,3,0,23
2024-03-31 08:30:00,6,3,0,1,6,6,0,22
2024-03-31 08:40:00,12,5,0,2,7,2,0,28
2024-03-31 08:50:00,22,4,0,1,14,3,0,44
2024-03-31 09:00:00,14,2,1,3,15,3,0,38
2024-03-31 09:10:00,33,5,2,2,21,3,0,66
2024-03-31 09:20:00,18,2,0,1,18,4,0,43
2024-03-31 09:30:00,15,3,2,1,23,3,0,47
2024-03-31 09:40:00,30,5,1,0,17,3,0,56
2024-03-31 09:50:00,37,6,1,2,26,4,0,76
2024-03-31 10:00:00,26,5,0,2,31,5,0,69
2024-03-31 10:10:00,30,4,0,0,35,2,0,71
2024-03-31 10:20:00,28,8,0,3,26,3,0,68
2024-03-31 10:30:00,39,6,1,4,33,4,0,87
2024-03-31 10:40:00,29,2,1,2,36,4,0,74
2024-03-31 10:50:00,37,3,3,3,42,6,0,94
2024-03-31 11:00:00,36,5,4,6,36,6,0,93
2024-03-31 11:10:00,40,12,1,2,52,6,0,113
2024-03-31 11:20:00,28,3,1,3,48,6,0,89
2024-03-31 11:30:00,47,9,2,2,47,10,0,117
2024-03-31 11:40:00,50,3,2,1,66,6,0,128
2024-03-31 11:50:00,37,5,4,2,59,12,0,119
2024-03-31 12:00:00,40,4,1,2,54,7,0,108
2024-03-31 12:10:00,54,6,2,2,71,4,0,139
2024-03-31 12:20:00,46,4,3,1,71,6,0,131
2024-03-31 12:30:00,39,9,0,3,46,4,0,101
2024-03-31 12:40:00,45,8,0,3,61,7,0,124
2024-03-31 12:50:00,39,7,1,3,50,13,0,113
2024-03-31 13:00:00,50,7,2,2,40,4,0,105
2024-03-31 13:10:00,50,3,0,2,49,6,0,110
2024-03-31 13:20:00,44,7,1,2,41,3,0,98
2024-03-31 13:30:00,46,11,2,1,43,7,0,110
2024-03-31 13:40:00,44,8,1,3,39,2,0,97
2024-03-31 13:50:00,40,7,3,2,48,6,0,106
2024-03-31 14:00:00,45,6,0,1,41,7,0,100
2024-03-31 14:10:00,43,9,2,3,38,4,0,99
2024-03-31 14:20:00,32,3,3,1,53,11,0,103
2024-03-31 14:30:00,50,12,0,1,39,2,0,104
2024-03-31 14:40:00,45,8,0,4,35,6,0,98
2024-03-31 14:50:00,50,6,1,5,50,9,0,121
2024-03-31 15:00:00,54,8,2,2,52,10,0,128
2024-03-31 15:10:00,44,13,1,4,41,9,0,112
2024-03-31 15:20:00,42,1,2,3,35,4,0,87
2024-03-31 15:30:00,38,13,1,2,41,9,0,104
2024-03-31 15:40:00,33,5,6,2,45,7,0,98
2024-03-31 15:50:00,27,8,5,1,48,10,0,99
2024-03-31 16:00:00,45,13,1,3,39,6,0,107
2024-03-31 16:10:00,49,5,0,4,45,6,0,109
2024-03-31 16:20:00,47,9,1,3,36,9,0,105
2024-03-31 16:30:00,55,10,2,1,33,7,0,108
2024-03-31 16:40:00,42,5,4,2,54,8,0,115
2024-03-31 16:50:00,38,6,1,1,43,10,0,99
2024-03-31 17:00:00,59,11,1,2,25,5,0,103
2024-03-31 17:10:00,33,6,5,1,30,5,0,80
2024-03-31 17:20:00,44,5,0,0,42,8,0,99
2024-03-31 17:30:00,45,8,3,4,39,9,0,108
2024-03-31 17:40:00,42,6,6,5,43,8,0,110
2024-03-31 17:50:00,37,6,0,3,58,6,0,110
2024-03-31 18:00:00,57,10,2,3,39,9,0,120
2024-03-31 18:10:00,51,8,1,2,42,2,0,106
2024-03-31 18:20:00,55,3,1,3,56,10,0,128
2024-03-31 18:30:00,47,12,1,3,54,7,0,124
2024-03-31 18:40:00,55,5,5,3,44,9,0,121
2024-03-31 18:50:00,35,7,0,2,40,4,0,88
2024-03-31 19:00:00,41,6,0,0,47,8,0,102
2024-03-31 19:10:00,41,8,1,4,36,8,0,98
2024-03-31 19:20:00,40,4,0,4,44,7,0,99
2024-03-31 19:30:00,40,5,1,1,25,5,0,77
2024-03-31 19:40:00,43,6,3,2,39,8,0,101
2024-03-31 19:50:00,30,4,1,2,22,4,0,63
2024-03-31 20:00:00,29,9,0,2,29,3,0,72
2024-03-31 20:10:00,32,9,1,0,30,9,0,81
2024-03-31 20:20:00,32,11,2,0,29,8,0,82
2024-03-31 20:30:00,37,9,1,1,38,9,0,95
2024-03-31 20:40:00,20,7,3,0,21,5,0,56
2024-03-31 20:50:00,14,6,0,2,30,5,0,57
2024-03-31 21:00:00,34,6,0,1,24,3,0,68
2024-03-31 21:10:00,26,5,2,2,24,5,0,64
2024-03-31 21:20:00,34,8,1,0,20,3,0,66
2024-03-31 21:30:00,20,4,3,0,24,5,0,56
2024-03-31 21:40:00,24,9,0,2,19,5,0,59
2024-03-31 21:50:00,26,2,1,1,23,3,0,56
2024-03-31 22:00:00,17,5,0,0,28,11,0,61
2024-03-31 22:10:00,22,4,0,0,26,5,0,57
2024-03-31 22:20:00,16,6,0,2,26,5,0,55
2024-03-31 22:30:00,17,4,1,0,21,3,0,46
2024-03-31 22:40:00,20,6,2,3,23,4,0,58
2024-03-31 22:50:00,13,3,0,0,20,4,0,40
2024-03-31 23:00:00,19,7,0,1,15,7,0,49
2024-03-31 23:10:00,6,2,0,0,18,5,0,31
2024-03-31 23:20:00,10,1,0,0,8,2,0,21
2024-03-31 23:30:00,11,5,2,0,7,3,0,28
2024-03-31 23:40:00,8,1,0,1,16,3,0,29
2024-03-31 23:50:00,6,1,0,0,9,5,0,21
2024-04-01 00:00:00,6,2,0,0,9,4,0,21
2024-04-01 00:10:00,7,3,0,0,13,7,0,30
2024-04-01 00:20:00,8,3,1,0,6,2,0,20
2024-04-01 00:30:00,10,5,0,0,3,3,0,21
2024-04-01 00:40:00,7,4,1,3,5,3,0,23
2024-04-01 00:50:00,6,5,1,0,9,8,0,29
2024-04-01 01:00:00,3,1,0,0,10,5,0,19
2024-04-01 01:10:00,10,4,0,0,10,3,0,27
2024-04-01 01:20:00,11,8,0,0,10,7,0,36
2024-04-01 01:30:00,12,5,0,0,7,5,0,29
2024-04-01 01:40:00,12,11,1,1,6,3,0,34
2024-04-01 01:50:00,3,3,0,0,8,4,0,18
2024-04-01 02:00:00,3,2,0,0,5,3,0,13
2024-04-01 02:10:00,9,2,0,0,3,2,0,16
2024-04-01 02:20:00,4,2,0,0,0,2,0,8
2024-04-01 02:30:00,0,0,0,0,2,1,0,3
2024-04-01 02:40:00,2,0,0,1,3,2,0,8
2024-04-01 02:50:00,2,0,0,0,4,2,0,8
2024-04-01 03:00:00,3,3,0,0,4,3,0,13
2024-04-01 03:10:00,0,0,0,0,2,0,0,2
2024-04-01 03:20:00,3,4,0,0,2,3,0,12
2024-04-01 03:30:00,3,1,0,0,3,2,0,9
2024-04-01 03:40:00,2,2,0,0,2,1,0,7
2024-04-01 03:50:00,2,3,1,0,2,0,0,8
2024-04-01 04:00:00,8,6,0,0,3,4,0,21
2024-04-01 04:10:00,4,2,0,0,3,1,0,10
2024-04-01 04:20:00,3,0,0,0,2,1,0,6
2024-04-01 04:30:00,5,2,0,0,3,2,0,12
2024-04-01 04:40:00,4,1,0,0,3,3,0,11
2024-04-01 04:50:00,3,1,0,0,3,4,0,11
2024-04-01 05:00:00,4,2,0,0,1,0,0,7
2024-04-01 05:10:00,7,3,0,1,8,2,0,21
2024-04-01 05:20:00,8,0,0,0,6,3,0,17
2024-04-01 05:30:00,4,2,0,0,5,3,0,14
2024-04-01 05:40:00,8,3,0,2,5,1,0,19
2024-04-01 05:50:00,7,1,0,0,7,2,0,17
2024-04-01 06:00:00,6,1,0,0,9,5,0,21
2024-04-01 06:10:00,4,3,2,0,4,2,0,15
2024-04-01 06:20:00,5,2,0,0,8,0,0,15
2024-04-01 06:30:00,7,4,0,0,5,3,0,19
2024-04-01 06:40:00,8,2,0,0,3,0,0,13
2024-04-01 06:50:00,5,2,0,0,3,2,0,12
2024-04-01 07:00:00,7,7,0,0,5,3,0,22
2024-04-01 07:10:00,4,3,0,1,3,0,0,11
2024-04-01 07:20:00,9,3,0,0,3,2,0,17
2024-04-01 07:30:00,7,3,0,0,6,1,0,17
2024-04-01 07:40:00,4,2,0,0,4,1,0,11
2024-04-01 07:50:00,6,3,1,1,8,2,0,21
2024-04-01 08:00:00,10,3,0,2,6,5,0,26
2024-04-01 08:10:00,7,3,0,0,6,1,0,17
2024-04-01 08:20:00,10,2,1,0,9,2,0,24
2024-04-01 08:30:00,9,3,1,0,16,3,0,32
2024-04-01 08:40:00,17,4,0,0,11,1,0,33
2024-04-01 08:50:00,17,7,0,0,19,6,0,49
2024-04-01 09:00:00,16,6,0,1,11,2,0,36
2024-04-01 09:10:00,17,7,0,1,20,5,0,50
2024-04-01 09:20:00,13,2,0,2,9,5,0,31
2024-04-01 09:30:00,14,5,0,1,19,6,0,45
2024-04-01 09:40:00,20,3,1,1,23,4,0,52
2024-04-01 09:50:00,32,3,0,3,18,4,0,60
2024-04-01 10:00:00,18,3,0,0,24,1,0,46
2024-04-01 10:10:00,28,5,1,1,16,2,0,53
2024-04-01 10:20:00,28,5,3,2,23,9,0,70
2024-04-01 10:30:00,37,12,2,2,28,5,0,86
2024-04-01 10:40:00,33,4,1,3,32,5,0,78
2024-04-01 10:50:00,38,3,2,2,40,6,0,91
2024-04-01 11:00:00,27,3,0,1,31,4,0,66
2024-04-01 11:10:00,45,5,0,1,31,7,0,89
2024-04-01 11:20:00,34,6,0,1,32,5,0,78
2024-04-01 11:30:00,24,6,0,2,34,11,0,77
2024-04-01 11:40:00,31,4,1,2,44,2,0,84
2024-04-01 11:50:00,38,5,0,1,56,6,0,106
2024-04-01 12:00:00,25,5,1,2,29,1,0,63
2024-04-01 12:10:00,36,7,2,5,42,14,0,106
2024-04-01 12:20:00,25,7,1,1,47,8,0,89
2024-04-01 12:30:00,33,8,6,3,31,7,0,88
2024-04-01 12:40:00,30,3,0,3,39,2,0,77
2024-04-01 12:50:00,44,6,5,2,34,5,0,96
2024-04-01 13:00:00,44,4,0,4,46,3,0,101
2024-04-01 13:10:00,49,9,0,3,35,6,0,102
2024-04-01 13:20:00,40,9,1,2,33,5,0,90
2024-04-01 13:30:00,51,8,1,4,45,4,0,113
2024-04-01 13:40:00,50,7,3,1,38,6,0,105
2024-04-01 13:50:00,51,5,2,3,43,4,0,108
2024-04-01 14:00:00,41,10,0,4,31,7,0,93
2024-04-01 14:10:00,43,9,3,2,59,2,0,118
2024-04-01 14:20:00,43,3,2,2,58,3,0,111
2024-04-01 14:30:00,36,9,0,2,50,8,0,105
2024-04-01 14:40:00,36,4,1,3,56,7,0,107
2024-04-01 14:50:00,46,5,4,4,48,9,0,116
2024-04-01 15:00:00,42,9,1,2,43,6,0,103
2024-04-01 15:10:00,43,10,1,3,43,10,0,110
2024-04-01 15:20:00,66,11,2,1,40,6,0,126
2024-04-01 15:30:00,43,9,1,5,30,8,0,96
2024-04-01 15:40:00,49,8,1,2,46,8,0,114
2024-04-01 15:50:00,39,4,3,1,55,8,0,110
2024-04-01 16:00:00,35,6,0,2,50,9,0,102
2024-04-01 16:10:00,33,9,1,2,43,4,0,92
2024-04-01 16:20:00,37,4,1,1,38,9,0,90
2024-04-01 16:30:00,43,7,2,4,43,5,0,104
2024-04-01 16:40:00,40,9,0,1,43,10,0,103
2024-04-01 16:50:00,36,4,1,3,57,6,0,107
2024-04-01 17:00:00,41,4,3,4,50,10,0,112
2024-04-01 17:10:00,36,6,2,3,44,6,0,97
2024-04-01 17:20:00,62,7,1,1,53,7,0,131
2024-04-01 17:30:00,58,13,1,0,48,8,0,128
2024-04-01 17:40:00,39,10,2,1,53,6,0,111
2024-04-01 17:50:00,42,6,2,2,42,8,0,102
2024-04-01 18:00:00,35,7,0,5,48,6,0,101
2024-04-01 18:10:00,48,8,1,3,45,2,0,107
2024-04-01 18:20:00,27,7,0,7,53,7,0,101
2024-04-01 18:30:00,38,4,3,5,41,9,0,100
2024-04-01 18:40:00,33,6,1,4,40,6,0,90
2024-04-01 18:50:00,48,9,1,2,44,6,0,110
2024-04-01 19:00:00,32,3,3,1,40,4,0,83
2024-04-01 19:10:00,34,3,1,2,33,4,0,77
2024-04-01 19:20:00,25,3,1,2,40,9,0,80
2024-04-01 19:30:00,35,6,0,3,40,7,0,91
2024-04-01 19:40:00,41,5,1,1,34,4,0,86
2024-04-01 19:50:00,31,4,1,1,38,7,0,82
2024-04-01 20:00:00,36,9,2,1,28,7,0,83
2024-04-01 20:10:00,28,4,2,1,31,5,0,71
2024-04-01 20:20:00,20,5,1,1,35,5,0,67
2024-04-01 20:30:00,20,4,1,2,29,3,0,59
2024-04-01 20:40:00,22,3,0,0,30,6,0,61
2024-04-01 20:50:00,23,5,1,1,35,4,0,69
2024-04-01 21:00:00,30,6,1,0,36,4,0,77
2024-04-01 21:10:00,38,4,1,0,26,3,0,72
2024-04-01 21:20:00,17,1,2,1,30,0,0,51
2024-04-01 21:30:00,20,7,1,1,36,4,0,69
2024-04-01 21:40:00,14,5,0,2,20,4,0,45
2024-04-01 21:50:00,24,4,0,1,24,7,0,60
2024-04-01 22:00:00,24,8,1,0,14,4,0,51
2024-04-01 22:10:00,21,5,1,0,26,5,0,58
2024-04-01 22:20:00,16,4,0,0,26,3,0,49
2024-04-01 22:30:00,10,8,0,0,24,8,0,50
2024-04-01 22:40:00,8,5,1,3,19,5,0,41
2024-04-01 22:50:00,8,2,0,1,20,7,0,38
2024-04-01 23:00:00,8,8,0,0,8,2,0,26
2024-04-01 23:10:00,10,5,1,0,16,6,0,38
2024-04-01 23:20:00,10,2,0,1,12,4,0,29
2024-04-01 23:30:00,5,1,0,0,10,3,0,19
2024-04-01 23:40:00,8,1,0,0,8,1,0,18
2024-04-01 23:50:00,6,1,0,1,8,2,0,18
2024-04-02 00:00:00,4,1,1,0,4,1,0,11
2024-04-02 00:10:00,6,2,0,0,11,2,0,21
2024-04-02 00:20:00,8,5,0,0,6,0,0,19
2024-04-02 00:30:00,3,0,0,0,7,1,0,11
2024-04-02 00:40:00,4,3,1,4,8,1,0,21
2024-04-02 00:50:00,3,0,0,0,3,0,0,6
2024-04-02 01:00:00,11,3,0,0,9,4,0,27
2024-04-02 01:10:00,6,4,1,1,4,3,0,19
2024-04-02 01:20:00,3,1,0,0,4,2,0,10
2024-04-02 01:30:00,3,3,1,0,3,4,0,14
2024-04-02 01:40:00,4,1,0,0,5,0,0,10
2024-04-02 01:50:00,1,0,0,0,2,1,0,4
2024-04-02 02:00:00,2,1,0,0,6,2,0,11
2024-04-02 02:10:00,2,0,0,0,2,0,0,4
2024-04-02 02:20:00,5,2,0,0,2,1,0,10
2024-04-02 02:30:00,2,2,0,1,4,1,0,10
2024-04-02 02:40:00,2,2,0,0,2,2,0,8
2024-04-02 02:50:00,0,0,0,0,5,1,0,6
2024-04-02 03:00:00,2,0,0,0,2,1,0,5
2024-04-02 03:10:00,1,0,0,0,3,2,0,6
2024-04-02 03:20:00,3,3,1,0,5,1,0,13
2024-04-02 03:30:00,3,5,1,0,5,2,0,16
2024-04-02 03:40:00,2,1,0,0,2,1,0,6
2024-04-02 03:50:00,3,3,0,0,0,1,0,7
2024-04-02 04:00:00,2,2,0,0,3,1,0,8
2024-04-02 04:10:00,1,0,0,0,3,0,0,4
2024-04-02 04:20:00,8,2,0,0,4,1,0,15
2024-04-02 04:30:00,2,1,0,0,3,1,0,7
2024-04-02 04:40:00,10,4,0,0,7,4,0,25
2024-04-02 04:50:00,8,3,0,1,11,8,0,31
2024-04-02 05:00:00,12,5,0,0,10,7,0,34
2024-04-02 05:10:00,24,11,1,0,13,4,0,53
2024-04-02 05:20:00,22,7,0,0,18,8,0,55
2024-04-02 05:30:00,33,6,0,0,21,3,0,63
2024-04-02 05:40:00,43,7,1,0,13,3,0,67
2024-04-02 05:50:00,37,5,0,0,47,4,0,93
2024-04-02 06:00:00,36,6,1,3,24,3,0,73
2024-04-02 06:10:00,47,8,0,1,28,3,0,87
2024-04-02 06:20:00,63,11,0,0,33,8,0,115
2024-04-02 06:30:00,62,12,0,2,44,7,0,127
2024-04-02 06:40:00,55,14,0,2,39,4,0,114
2024-04-02 06:50:00,56,8,2,2,45,5,0,118
2024-04-02 07:00:00,78,6,0,3,41,4,0,132
2024-04-02 07:10:00,76,7,0,4,66,3,0,156
2024-04-02 07:20:00,78,12,1,3,66,6,0,166
2024-04-02 07:30:00,69,7,0,2,56,7,0,141
2024-04-02 07:40:00,61,9,4,4,67,8,0,153
2024-04-02 07:50:00,52,4,2,5,59,7,0,129
2024-04-02 08:00:00,54,5,6,2,52,5,0,124
2024-04-02 08:10:00,70,11,4,8,63,14,0,170
2024-04-02 08:20:00,74,9,4,3,68,9,0,167
2024-04-02 08:30:00,72,8,4,13,78,8,0,183
2024-04-02 08:40:00,69,9,1,2,76,14,0,171
2024-04-02 08:50:00,63,13,7,5,61,3,0,152
2024-04-02 09:00:00,59,7,8,4,53,11,0,142
2024-04-02 09:10:00,54,10,3,2,53,10,0,132
2024-04-02 09:20:00,63,3,5,7,59,11,0,148
2024-04-02 09:30:00,68,11,4,4,57,11,0,155
2024-04-02 09:40:00,56,13,7,5,35,12,0,128
2024-04-02 09:50:00,51,11,2,3,48,11,0,126
2024-04-02 10:00:00,58,9,1,4,46,12,0,130
2024-04-02 10:10:00,45,4,2,4,61,11,0,127
2024-04-02 10:20:00,40,4,4,3,53,7,0,111
2024-04-02 10:30:00,45,6,2,2,64,23,0,142
2024-04-02 10:40:00,51,10,2,5,43,8,0,119
2024-04-02 10:50:00,56,7,2,3,42,7,0,117
2024-04-02 11:00:00,52,7,0,7,50,11,0,127
2024-04-02 11:10:00,57,6,3,3,68,7,0,144
2024-04-02 11:20:00,61,13,1,5,59,11,0,150
2024-04-02 11:30:00,42,10,0,7,63,9,0,131
2024-04-02 11:40:00,47,7,4,3,71,9,0,141
2024-04-02 11:50:00,52,6,4,5,63,9,0,139
2024-04-02 12:00:00,48,9,4,9,61,10,0,141
2024-04-02 12:10:00,48,3,3,8,70,12,0,144
2024-04-02 12:20:00,64,9,5,6,76,12,0,172
2024-04-02 12:30:00,65,9,3,4,65,11,0,157
2024-04-02 12:40:00,71,7,1,7,61,10,0,157
2024-04-02 12:50:00,55,8,4,5,51,14,0,137
2024-04-02 13:00:00,67,13,2,4,72,7,0,165
2024-04-02 13:10:00,60,6,2,3,78,6,0,155
2024-04-02 13:20:00,55,8,6,5,52,13,0,139
2024-04-02 13:30:00,79,13,2,6,50,9,0,159
2024-04-02 13:40:00,58,10,0,1,56,6,0,131
2024-04-02 13:50:00,61,6,4,2,56,8,0,137
2024-04-02 14:00:00,52,8,4,6,60,7,0,137
2024-04-02 14:10:00,74,7,3,3,77,9,0,173
2024-04-02 14:20:00,69,9,2,2,79,12,0,173
2024-04-02 14:30:00,54,8,6,5,71,10,0,154
2024-04-02 14:40:00,82,7,2,7,86,11,0,195
2024-04-02 14:50:00,84,7,4,9,64,12,0,180
2024-04-02 15:00:00,64,9,1,7,85,12,0,178
2024-04-02 15:10:00,74,10,9,8,73,6,0,180
2024-04-02 15:20:00,66,9,5,5,79,8,0,172
2024-04-02 15:30:00,72,7,4,6,79,14,0,182
2024-04-02 15:40:00,75,8,6,7,105,13,0,214
2024-04-02 15:50:00,58,14,3,5,114,17,0,211
2024-04-02 16:00:00,63,5,4,9,70,13,0,164
2024-04-02 16:10:00,85,14,1,10,102,13,0,225
2024-04-02 16:20:00,70,8,5,4,88,12,0,187
2024-04-02 16:30:00,66,6,4,2,107,16,0,201
2024-04-02 16:40:00,81,7,3,9,91,7,0,198
2024-04-02 16:50:00,64,8,2,3,89,10,0,176
2024-04-02 17:00:00,62,8,3,6,99,11,0,189
2024-04-02 17:10:00,64,11,1,4,111,8,0,199
2024-04-02 17:20:00,87,9,2,1,101,13,0,213
2024-04-02 17:30:00,65,14,2,4,86,22,0,193
2024-04-02 17:40:00,72,9,2,4,88,8,0,183
2024-04-02 17:50:00,55,11,6,5,98,8,0,183
2024-04-02 18:00:00,51,9,2,7,85,9,0,163
2024-04-02 18:10:00,55,5,3,10,84,8,0,165
2024-04-02 18:20:00,51,11,1,6,56,5,0,130
2024-04-02 18:30:00,52,6,5,3,76,8,0,150
2024-04-02 18:40:00,56,12,2,2,79,15,0,166
2024-04-02 18:50:00,60,8,3,4,66,9,0,150
2024-04-02 19:00:00,42,6,2,1,76,12,0,139
2024-04-02 19:10:00,45,4,0,2,54,6,0,111
2024-04-02 19:20:00,29,4,1,2,66,6,0,108
2024-04-02 19:30:00,40,8,2,0,56,7,0,113
2024-04-02 19:40:00,24,4,0,2,51,6,0,87
2024-04-02 19:50:00,26,6,0,1,45,4,0,82
2024-04-02 20:00:00,25,5,0,2,40,3,0,75
2024-04-02 20:10:00,32,8,0,4,34,7,0,85
2024-04-02 20:20:00,23,2,0,2,36,7,0,70
2024-04-02 20:30:00,25,9,1,1,38,6,0,80
2024-04-02 20:40:00,22,8,1,0,32,9,0,72
2024-04-02 20:50:00,25,3,1,0,25,4,0,58
2024-04-02 21:00:00,34,11,2,1,27,8,0,83
2024-04-02 21:10:00,30,4,1,2,25,2,0,64
2024-04-02 21:20:00,32,4,0,0,33,5,0,74
2024-04-02 21:30:00,26,4,0,1,21,2,0,54
2024-04-02 21:40:00,14,3,0,2,20,3,0,42
2024-04-02 21:50:00,19,5,0,1,27,8,0,60
2024-04-02 22:00:00,16,2,0,1,25,7,0,51
2024-04-02 22:10:00,19,11,5,1,21,1,0,58
2024-04-02 22:20:00,18,7,4,1,25,5,0,60
2024-04-02 22:30:00,10,3,3,1,20,5,0,42
2024-04-02 22:40:00,6,4,3,2,17,2,0,34
2024-04-02 22:50:00,11,4,0,1,13,6,0,35
2024-04-02 23:00:00,11,2,0,0,11,1,0,25
2024-04-02 23:10:00,12,2,0,0,15,4,0,33
2024-04-02 23:20:00,10,4,0,0,18,3,0,35
2024-04-02 23:30:00,8,1,1,0,6,0,0,16
2024-04-02 23:40:00,7,6,0,0,9,4,0,26
2024-04-02 23:50:00,3,2,0,1,9,3,0,18
2024-04-03 00:00:00,6,0,0,0,6,3,0,15
2024-04-03 00:10:00,6,1,0,0,7,3,0,17
2024-04-03 00:20:00,6,3,0,0,4,1,0,14
2024-04-03 00:30:00,1,1,1,0,6,3,0,12
2024-04-03 00:40:00,7,7,1,1,3,3,0,22
2024-04-03 00:50:00,2,0,0,0,2,1,0,5
2024-04-03 01:00:00,3,0,0,0,2,0,0,5
2024-04-03 01:10:00,8,4,1,0,1,3,0,17
2024-04-03 01:20:00,4,2,1,0,3,4,0,14
2024-04-03 01:30:00,3,2,1,0,2,2,0,10
2024-04-03 01:40:00,5,5,0,1,1,5,0,17
2024-04-03 01:50:00,4,2,0,0,3,3,0,12
2024-04-03 02:00:00,2,2,0,0,3,4,0,11
2024-04-03 02:10:00,3,2,0,0,0,1,0,6
2024-04-03 02:20:00,6,5,0,0,3,3,0,17
2024-04-03 02:30:00,3,3,0,0,3,3,0,12
2024-04-03 02:40:00,0,0,0,0,0,0,0,0
2024-04-03 02:50:00,3,2,0,0,7,6,0,18
2024-04-03 03:00:00,5,5,0,0,2,3,0,15
2024-04-03 03:10:00,4,3,0,0,5,6,0,18
2024-04-03 03:20:00,2,2,0,0,3,2,0,9
2024-04-03 03:30:00,2,1,0,0,3,1,0,7
2024-04-03 03:40:00,3,2,3,0,2,2,0,12
2024-04-03 03:50:00,0,0,0,0,2,0,0,2
2024-04-03 04:00:00,5,4,0,0,5,2,0,16
2024-04-03 04:10:00,2,2,0,0,5,2,0,11
2024-04-03 04:20:00,4,0,0,0,8,3,0,15
2024-04-03 04:30:00,7,4,0,0,9,5,0,25
2024-04-03 04:40:00,4,2,0,0,6,1,0,13
2024-04-03 04:50:00,8,4,0,0,5,2,0,19
2024-04-03 05:00:00,13,8,0,0,9,3,0,33
2024-04-03 05:10:00,26,9,0,0,8,10,0,53
2024-04-03 05:20:00,23,9,0,0,19,5,0,56
2024-04-03 05:30:00,34,8,0,0,24,7,0,73
2024-04-03 05:40:00,42,7,0,0,33,6,0,88
2024-04-03 05:50:00,38,8,0,2,39,8,0,95
2024-04-03 06:00:00,38,6,1,1,24,5,0,75
2024-04-03 06:10:00,46,5,0,1,25,2,0,79
2024-04-03 06:20:00,64,7,1,1,36,1,0,110
2024-04-03 06:30:00,55,12,0,3,47,10,0,127
2024-04-03 06:40:00,69,11,0,1,55,9,0,145
2024-04-03 06:50:00,80,8,1,4,36,8,0,137
2024-04-03 07:00:00,67,8,1,6,50,5,0,137
2024-04-03 07:10:00,84,7,0,3,64,7,0,165
2024-04-03 07:20:00,70,5,1,2,54,5,0,137
2024-04-03 07:30:00,79,13,0,2,59,6,0,159
2024-04-03 07:40:00,79,7,1,4,82,10,0,183
2024-04-03 07:50:00,60,10,1,3,63,6,0,143
2024-04-03 08:00:00,52,10,7,6,58,12,0,145
2024-04-03 08:10:00,57,8,2,6,58,8,0,139
2024-04-03 08:20:00,66,6,6,7,50,9,0,144
2024-04-03 08:30:00,74,14,7,9,60,6,0,170
2024-04-03 08:40:00,73,8,4,6,72,11,0,174
2024-04-03 08:50:00,66,9,10,7,68,9,0,169
2024-04-03 09:00:00,81,12,3,5,49,6,0,156
2024-04-03 09:10:00,60,14,5,6,49,15,0,149
2024-04-03 09:20:00,62,10,3,2,64,11,0,152
2024-04-03 09:30:00,60,7,2,9,46,10,0,134
2024-04-03 09:40:00,71,6,6,5,67,15,0,170
2024-04-03 09:50:00,60,8,1,4,48,9,0,130
2024-04-03 10:00:00,47,10,2,2,58,11,0,130
2024-04-03 10:10:00,49,3,5,7,49,7,0,120
2024-04-03 10:20:00,57,14,3,2,54,15,0,145
2024-04-03 10:30:00,51,12,5,3,51,6,0,128
2024-04-03 10:40:00,56,9,7,11,51,9,0,143
2024-04-03 10:50:00,62,5,5,4,61,5,0,142
2024-04-03 11:00:00,50,9,4,1,54,9,0,127
2024-04-03 11:10:00,58,5,1,4,54,5,0,127
2024-04-03 11:20:00,59,11,6,4,69,9,0,158
2024-04-03 11:30:00,34,5,0,5,59,8,0,111
2024-04-03 11:40:00,56,12,1,4,64,17,0,154
2024-04-03 11:50:00,54,6,6,5,56,5,0,132
2024-04-03 12:00:00,37,9,5,5,63,8,0,127
2024-04-03 12:10:00,66,7,4,2,83,6,0,168
2024-04-03 12:20:00,55,8,2,5,63,10,0,143
2024-04-03 12:30:00,47,5,1,1,55,7,0,116
2024-04-03 12:40:00,67,6,4,8,53,7,0,145
2024-04-03 12:50:00,57,6,0,6,51,10,0,130
2024-04-03 13:00:00,59,13,2,2,47,5,0,128
2024-04-03 13:10:00,55,8,3,7,77,13,0,163
2024-04-03 13:20:00,52,10,5,5,65,5,0,142
2024-04-03 13:30:00,40,8,4,7,54,7,0,120
2024-04-03 13:40:00,59,8,5,12,75,10,0,169
2024-04-03 13:50:00,48,5,6,4,55,10,0,128
2024-04-03 14:00:00,45,5,4,4,66,11,0,135
2024-04-03 14:10:00,52,10,2,5,73,9,0,151
2024-04-03 14:20:00,76,9,3,7,85,8,0,188
2024-04-03 14:30:00,63,9,3,3,88,12,0,178
2024-04-03 14:40:00,71,5,0,4,81,11,0,172
2024-04-03 14:50:00,83,10,5,8,87,8,0,201
2024-04-03 15:00:00,68,10,4,12,67,6,0,167
2024-04-03 15:10:00,52,9,2,5,73,15,0,156
2024-04-03 15:20:00,73,9,3,4,82,11,0,182
2024-04-03 15:30:00,74,12,2,5,80,8,0,181
2024-04-03 15:40:00,68,9,5,6,96,17,0,201
2024-04-03 15:50:00,72,8,3,5,80,8,0,176
2024-04-03 16:00:00,65,9,3,9,89,10,0,185
2024-04-03 16:10:00,60,9,3,9,87,11,0,179
2024-04-03 16:20:00,59,11,2,7,97,13,0,189
2024-04-03 16:30:00,78,5,4,7,83,7,0,184
2024-04-03 16:40:00,90,8,4,2,117,6,0,227
2024-04-03 16:50:00,64,5,3,5,121,12,0,210
2024-04-03 17:00:00,78,10,2,5,100,12,0,207
2024-04-03 17:10:00,58,7,2,9,94,14,0,184
2024-04-03 17:20:00,78,6,4,8,117,7,0,220
2024-04-03 17:30:00,65,5,1,4,110,14,0,199
2024-04-03 17:40:00,77,11,2,11,110,11,0,222
2024-04-03 17:50:00,56,11,4,6,81,13,0,171
2024-04-03 18:00:00,55,10,3,4,81,10,0,163
2024-04-03 18:10:00,53,7,3,8,84,9,0,164
2024-04-03 18:20:00,60,8,1,4,88,10,0,171
2024-04-03 18:30:00,50,11,1,8,85,13,0,168
2024-04-03 18:40:00,59,4,4,2,88,14,0,171
2024-04-03 18:50:00,49,9,1,2,67,7,0,135
2024-04-03 19:00:00,45,7,3,2,63,15,0,135
2024-04-03 19:10:00,30,5,0,3,61,8,0,107
2024-04-03 19:20:00,43,7,2,1,43,7,0,103
2024-04-03 19:30:00,35,8,1,1,45,10,0,100
2024-04-03 19:40:00,30,5,0,2,57,7,0,101
2024-04-03 19:50:00,26,5,3,3,37,11,0,85
2024-04-03 20:00:00,24,8,2,4,42,7,0,87
2024-04-03 20:10:00,26,5,4,5,41,8,0,89
2024-04-03 20:20:00,38,6,2,1,39,6,0,92
2024-04-03 20:30:00,22,6,2,0,37,10,0,77
2024-04-03 20:40:00,27,9,2,4,23,9,0,74
2024-04-03 20:50:00,24,6,2,3,39,7,0,81
2024-04-03 21:00:00,35,9,0,2,31,7,0,84
2024-04-03 21:10:00,21,5,0,0,38,9,0,73
2024-04-03 21:20:00,36,10,1,0,30,9,0,86
2024-04-03 21:30:00,26,7,1,0,34,7,0,75
2024-04-03 21:40:00,18,1,5,1,18,0,0,43
2024-04-03 21:50:00,14,1,0,2,27,7,0,51
2024-04-03 22:00:00,14,3,1,1,28,4,0,51
2024-04-03 22:10:00,23,4,6,4,37,4,0,78
2024-04-03 22:20:00,19,6,7,1,26,4,0,63
2024-04-03 22:30:00,17,3,1,0,18,6,0,45
2024-04-03 22:40:00,19,8,0,2,18,5,0,52
2024-04-03 22:50:00,16,4,1,2,29,8,0,60
2024-04-03 23:00:00,12,4,0,1,15,4,0,36
2024-04-03 23:10:00,10,7,0,1,12,1,0,31
2024-04-03 23:20:00,9,1,0,0,14,3,0,27
2024-04-03 23:30:00,17,4,0,0,13,4,0,38
2024-04-03 23:40:00,9,4,1,0,8,5,0,27
2024-04-03 23:50:00,3,1,0,0,7,3,0,14
2024-04-04 00:00:00,5,2,0,0,5,0,0,12
2024-04-04 00:10:00,9,5,0,0,7,4,0,25
2024-04-04 00:20:00,7,4,1,1,7,3,0,23
2024-04-04 00:30:00,7,2,1,0,6,3,0,19
2024-04-04 00:40:00,6,4,1,1,7,6,0,25
2024-04-04 00:50:00,4,2,0,1,6,6,0,19
2024-04-04 01:00:00,5,2,0,0,7,2,0,16
2024-04-04 01:10:00,6,4,1,1,6,1,0,19
2024-04-04 01:20:00,3,1,1,0,7,3,0,15
2024-04-04 01:30:00,3,0,0,0,1,0,0,4
2024-04-04 01:40:00,1,0,0,0,2,1,0,4
2024-04-04 01:50:00,3,1,0,0,3,0,0,7
2024-04-04 02:00:00,2,1,0,0,0,0,0,3
2024-04-04 02:10:00,2,0,1,0,2,0,0,5
2024-04-04 02:20:00,3,4,0,0,5,5,0,17
2024-04-04 02:30:00,2,0,0,0,4,2,0,8
2024-04-04 02:40:00,3,2,0,0,1,0,0,6
2024-04-04 02:50:00,2,2,0,0,2,3,0,9
2024-04-04 03:00:00,2,0,0,0,6,3,0,11
2024-04-04 03:10:00,2,3,0,0,2,0,0,7
2024-04-04 03:20:00,3,3,1,0,6,3,0,16
2024-04-04 03:30:00,4,1,0,0,2,0,0,7
2024-04-04 03:40:00,1,3,0,0,6,2,0,12
2024-04-04 03:50:00,4,2,1,0,9,3,0,19
2024-04-04 04:00:00,3,3,0,2,2,0,0,10
2024-04-04 04:10:00,3,1,0,0,4,2,0,10
2024-04-04 04:20:00,4,1,0,0,4,3,0,12
2024-04-04 04:30:00,5,4,0,0,5,5,0,19
2024-04-04 04:40:00,5,4,0,0,4,2,0,15
2024-04-04 04:50:00,9,8,1,0,5,4,0,27
2024-04-04 05:00:00,10,5,0,0,5,6,0,26
2024-04-04 05:10:00,17,8,0,0,11,4,0,40
2024-04-04 05:20:00,31,12,0,0,11,9,0,63
2024-04-04 05:30:00,27,3,0,0,25,5,0,60
2024-04-04 05:40:00,45,11,0,0,29,7,0,92
2024-04-04 05:50:00,37,10,0,0,38,3,0,88
2024-04-04 06:00:00,32,7,1,2,22,8,0,72
2024-04-04 06:10:00,57,8,0,0,30,6,0,101
2024-04-04 06:20:00,60,7,0,2,39,5,0,113
2024-04-04 06:30:00,53,9,2,1,43,5,0,113
2024-04-04 06:40:00,65,10,0,0,59,4,0,138
2024-04-04 06:50:00,71,12,3,1,45,9,0,141
2024-04-04 07:00:00,60,3,1,0,39,3,0,106
2024-04-04 07:10:00,76,6,3,6,62,7,0,160
2024-04-04 07:20:00,79,6,2,2,52,4,0,145
2024-04-04 07:30:00,58,12,2,2,54,13,0,141
2024-04-04 07:40:00,60,5,4,3,90,12,0,174
2024-04-04 07:50:00,77,15,3,8,78,11,0,192
2024-04-04 08:00:00,58,4,1,4,49,9,0,125
2024-04-04 08:10:00,65,9,4,7,65,9,0,159
2024-04-04 08:20:00,72,11,1,9,48,12,0,153
2024-04-04 08:30:00,79,8,4,7,60,7,0,165
2024-04-04 08:40:00,70,10,6,7,63,8,0,164
2024-04-04 08:50:00,63,21,6,5,50,9,0,154
2024-04-04 09:00:00,75,10,5,10,51,15,0,166
2024-04-04 09:10:00,55,17,4,6,42,12,0,136
2024-04-04 09:20:00,66,9,1,7,42,11,0,136
2024-04-04 09:30:00,54,6,3,5,52,6,0,126
2024-04-04 09:40:00,68,2,4,3,73,6,0,156
2024-04-04 09:50:00,67,4,3,7,37,5,0,123
2024-04-04 10:00:00,60,11,4,5,61,13,0,154
2024-04-04 10:10:00,53,14,2,3,51,6,0,129
2024-04-04 10:20:00,54,11,3,7,50,9,0,134
2024-04-04 10:30:00,52,6,2,3,56,9,0,128
2024-04-04 10:40:00,64,7,0,5,23,45,0,144
2024-04-04 10:50:00,57,2,4,4,55,9,0,131
2024-04-04 11:00:00,48,5,5,2,53,9,0,122
2024-04-04 11:10:00,53,12,1,1,57,3,0,127
2024-04-04 11:20:00,46,7,4,2,59,11,0,129
2024-04-04 11:30:00,60,14,0,7,49,6,0,136
2024-04-04 11:40:00,60,7,3,5,48,15,0,138
2024-04-04 11:50:00,68,8,4,4,73,12,0,169
2024-04-04 12:00:00,46,5,4,8,55,12,0,130
2024-04-04 12:10:00,40,7,5,6,70,7,0,135
2024-04-04 12:20:00,42,11,3,2,62,12,0,132
2024-04-04 12:30:00,49,6,0,5,75,13,0,148
2024-04-04 12:40:00,56,9,2,5,65,11,0,148
2024-04-04 12:50:00,55,5,1,8,57,9,0,135
2024-04-04 13:00:00,45,7,4,2,54,13,0,125
2024-04-04 13:10:00,54,4,2,4,46,6,0,116
2024-04-04 13:20:00,51,6,1,1,78,6,0,143
2024-04-04 13:30:00,70,7,2,4,73,11,0,167
2024-04-04 13:40:00,58,10,4,4,52,13,0,141
2024-04-04 13:50:00,46,8,3,7,54,10,0,128
2024-04-04 14:00:00,56,10,3,8,67,8,0,152
2024-04-04 14:10:00,63,10,7,7,72,5,0,164
2024-04-04 14:20:00,65,14,1,5,81,12,0,178
2024-04-04 14:30:00,76,10,3,7,63,9,0,168
2024-04-04 14:40:00,63,5,5,6,77,9,0,165
2024-04-04 14:50:00,61,12,1,9,76,9,0,168
2024-04-04 15:00:00,55,5,8,11,77,8,0,164
2024-04-04 15:10:00,72,13,3,5,85,10,0,188
2024-04-04 15:20:00,66,11,6,3,81,14,0,181
2024-04-04 15:30:00,69,6,2,7,75,15,0,174
2024-04-04 15:40:00,71,11,5,11,87,8,0,193
2024-04-04 15:50:00,89,7,1,7,76,17,0,197
2024-04-04 16:00:00,88,5,3,12,101,12,0,221
2024-04-04 16:10:00,84,14,5,4,67,8,0,182
2024-04-04 16:20:00,85,7,3,3,120,13,0,231
2024-04-04 16:30:00,73,7,1,3,97,12,0,193
2024-04-04 16:40:00,65,14,2,2,119,15,0,217
2024-04-04 16:50:00,62,10,7,7,87,10,0,183
2024-04-04 17:00:00,74,6,3,3,81,8,0,175
2024-04-04 17:10:00,54,4,3,3,81,7,0,152
2024-04-04 17:20:00,69,10,3,3,123,9,0,217
2024-04-04 17:30:00,67,11,5,2,95,9,0,189
2024-04-04 17:40:00,66,8,3,7,102,12,0,198
2024-04-04 17:50:00,58,6,4,4,87,14,0,173
2024-04-04 18:00:00,45,6,3,6,86,13,0,159
2024-04-04 18:10:00,66,7,1,5,112,13,0,204
2024-04-04 18:20:00,71,8,0,3,87,9,0,178
2024-04-04 18:30:00,66,8,3,1,79,10,0,167
2024-04-04 18:40:00,39,9,3,1,81,9,0,142
2024-04-04 18:50:00,49,8,2,0,76,12,0,147
2024-04-04 19:00:00,43,6,2,9,66,6,0,132
2024-04-04 19:10:00,41,7,4,6,67,9,0,134
2024-04-04 19:20:00,47,8,1,1,64,15,0,136
2024-04-04 19:30:00,38,7,3,6,49,15,0,118
2024-04-04 19:40:00,34,4,1,1,51,5,0,96
2024-04-04 19:50:00,28,5,0,0,36,6,0,75
2024-04-04 20:00:00,32,8,1,2,63,6,0,112
2024-04-04 20:10:00,24,3,2,1,44,5,0,79
2024-04-04 20:20:00,23,9,7,6,44,6,0,95
2024-04-04 20:30:00,31,8,4,1,27,5,0,76
2024-04-04 20:40:00,26,6,3,3,39,7,0,84
2024-04-04 20:50:00,32,4,0,1,34,8,0,79
2024-04-04 21:00:00,29,10,2,2,32,6,0,81
2024-04-04 21:10:00,34,8,1,3,33,13,0,92
2024-04-04 21:20:00,29,7,1,0,27,8,0,72
2024-04-04 21:30:00,32,8,2,2,32,5,0,81
2024-04-04 21:40:00,27,4,0,1,23,4,0,59
2024-04-04 21:50:00,23,10,1,3,18,5,0,60
2024-04-04 22:00:00,22,8,2,5,29,15,0,81
2024-04-04 22:10:00,26,6,1,0,36,3,0,72
2024-04-04 22:20:00,23,6,2,3,31,5,0,70
2024-04-04 22:30:00,20,6,1,3,23,5,0,58
2024-04-04 22:40:00,26,10,1,1,17,5,0,60
2024-04-04 22:50:00,20,5,0,1,20,8,0,54
2024-04-04 23:00:00,13,2,0,2,16,4,0,37
2024-04-04 23:10:00,10,3,0,1,27,5,0,46
2024-04-04 23:20:00,9,1,0,0,12,2,0,24
2024-04-04 23:30:00,16,4,0,3,14,7,0,44
2024-04-04 23:40:00,6,1,0,0,9,3,0,19
2024-04-04 23:50:00,4,3,0,0,12,5,0,24
2024-04-05 00:00:00,7,2,3,0,10,3,0,25
2024-04-05 00:10:00,4,2,0,0,7,1,0,14
2024-04-05 00:20:00,7,3,0,0,5,2,0,17
2024-04-05 00:30:00,4,1,0,0,5,3,0,13
2024-04-05 00:40:00,10,3,0,0,6,3,0,22
2024-04-05 00:50:00,5,4,0,0,13,4,0,26
2024-04-05 01:00:00,5,0,0,0,3,1,0,9
2024-04-05 01:10:00,8,3,1,1,6,0,0,19
2024-04-05 01:20:00,2,2,0,0,4,1,0,9
2024-04-05 01:30:00,3,1,1,0,3,2,0,10
2024-04-05 01:40:00,2,1,0,0,3,1,0,7
2024-04-05 01:50:00,1,0,0,0,2,1,0,4
2024-04-05 02:00:00,0,0,0,0,0,0,0,0
