datetime,V51Z,V52Z,V53Z,V111Z,V112Z,Total
2024-03-01 01:00:00,2,7,0,5,4,18
2024-03-01 01:10:00,3,4,6,3,8,24
2024-03-01 01:20:00,1,1,1,1,3,7
2024-03-01 01:30:00,0,7,4,4,3,18
2024-03-01 01:40:00,3,3,0,2,2,10
2024-03-01 01:50:00,2,2,0,4,0,8
2024-03-01 02:00:00,0,2,0,2,0,4
2024-03-01 02:10:00,5,7,2,10,2,26
2024-03-01 02:20:00,0,4,1,4,2,11
2024-03-01 02:30:00,3,1,1,6,0,11
2024-03-01 02:40:00,0,3,0,1,0,4
2024-03-01 02:50:00,0,1,0,0,1,2
2024-03-01 03:00:00,0,3,5,2,3,13
2024-03-01 03:10:00,1,1,2,2,2,8
2024-03-01 03:20:00,3,1,0,3,1,8
2024-03-01 03:30:00,1,5,1,5,3,15
2024-03-01 03:40:00,3,3,0,4,0,10
2024-03-01 03:50:00,0,3,0,2,0,5
2024-03-01 04:00:00,2,2,3,3,0,10
2024-03-01 04:10:00,8,7,7,4,4,30
2024-03-01 04:20:00,7,1,0,7,1,16
2024-03-01 04:30:00,4,3,3,3,1,14
2024-03-01 04:40:00,4,8,4,5,6,27
2024-03-01 04:50:00,11,4,0,5,9,29
2024-03-01 05:00:00,12,7,6,9,8,42
2024-03-01 05:10:00,22,9,8,10,11,60
2024-03-01 05:20:00,17,17,9,12,10,65
2024-03-01 05:30:00,16,21,3,14,18,72
2024-03-01 05:40:00,35,20,8,12,27,102
2024-03-01 05:50:00,32,22,5,8,20,87
2024-03-01 06:00:00,28,17,8,17,8,78
2024-03-01 06:10:00,35,35,28,9,12,119
2024-03-01 06:20:00,20,29,14,20,16,99
2024-03-01 06:30:00,41,31,12,29,16,129
2024-03-01 06:40:00,32,26,15,20,20,113
2024-03-01 06:50:00,25,26,15,19,27,112
2024-03-01 07:00:00,28,29,9,17,25,108
2024-03-01 07:10:00,23,25,17,22,21,108
2024-03-01 07:20:00,19,29,15,28,22,113
2024-03-01 07:30:00,28,34,21,27,27,137
2024-03-01 07:40:00,22,25,22,42,41,152
2024-03-01 07:50:00,25,27,26,31,24,133
2024-03-01 08:00:00,18,27,23,26,26,120
2024-03-01 08:10:00,23,26,12,27,24,112
2024-03-01 08:20:00,17,28,9,35,25,114
2024-03-01 08:30:00,22,26,15,27,18,108
2024-03-01 08:40:00,23,23,29,29,24,128
2024-03-01 08:50:00,19,30,15,24,31,119
2024-03-01 09:00:00,26,21,16,28,17,108
2024-03-01 09:10:00,16,21,11,25,28,101
2024-03-01 09:20:00,22,26,23,30,22,123
2024-03-01 09:30:00,16,26,14,29,18,103
2024-03-01 09:40:00,27,30,15,27,29,128
2024-03-01 09:50:00,21,19,17,18,20,95
2024-03-01 10:00:00,19,32,18,24,14,107
2024-03-01 10:10:00,18,22,13,29,23,105
2024-03-01 10:20:00,26,29,13,27,20,115
2024-03-01 10:30:00,32,24,16,30,20,122
2024-03-01 10:40:00,26,39,16,37,27,145
2024-03-01 10:50:00,17,28,14,20,26,105
2024-03-01 11:00:00,17,19,13,32,27,108
2024-03-01 11:10:00,16,22,12,22,16,88
2024-03-01 11:20:00,21,33,22,33,30,139
2024-03-01 11:30:00,16,23,19,24,21,103
2024-03-01 11:40:00,17,22,16,26,19,100
2024-03-01 11:50:00,24,22,24,26,29,125
2024-03-01 12:00:00,18,21,22,31,29,121
2024-03-01 12:10:00,19,22,13,33,28,115
2024-03-01 12:20:00,17,25,24,34,30,130
2024-03-01 12:30:00,28,27,25,31,26,137
2024-03-01 12:40:00,25,27,20,25,27,124
2024-03-01 12:50:00,20,27,20,29,27,123
2024-03-01 13:00:00,23,26,21,30,34,134
2024-03-01 13:10:00,10,15,12,16,17,70
2024-03-01 13:20:00,22,26,20,23,26,117
2024-03-01 13:30:00,21,22,21,31,27,122
2024-03-01 13:40:00,17,26,14,27,24,108
2024-03-01 13:50:00,25,28,22,18,26,119
2024-03-01 14:00:00,23,28,26,38,33,148
2024-03-01 14:10:00,19,26,26,26,28,125
2024-03-01 14:20:00,22,17,22,32,33,126
2024-03-01 14:30:00,23,29,23,39,37,151
2024-03-01 14:40:00,19,25,24,32,24,124
2024-03-01 14:50:00,19,22,23,23,30,117
2024-03-01 15:00:00,21,26,20,36,23,126
2024-03-01 15:10:00,24,32,18,36,35,145
2024-03-01 15:20:00,25,34,28,31,26,144
2024-03-01 15:30:00,27,30,22,25,32,136
2024-03-01 15:40:00,26,23,22,32,28,131
2024-03-01 15:50:00,13,17,14,21,21,86
2024-03-01 16:00:00,15,30,21,23,20,109
2024-03-01 16:10:00,21,22,23,29,26,121
2024-03-01 16:20:00,20,26,25,28,28,127
2024-03-01 16:30:00,25,25,26,33,28,137
2024-03-01 16:40:00,30,25,15,24,26,120
2024-03-01 16:50:00,24,30,20,27,29,130
2024-03-01 17:00:00,24,30,28,25,30,137
2024-03-01 17:10:00,24,26,18,30,34,132
2024-03-01 17:20:00,25,19,12,16,20,92
2024-03-01 17:30:00,22,27,22,25,29,125
2024-03-01 17:40:00,26,32,18,22,23,121
2024-03-01 17:50:00,25,25,18,25,21,114
2024-03-01 18:00:00,11,26,14,31,23,105
2024-03-01 18:10:00,25,32,14,24,24,119
2024-03-01 18:20:00,23,33,12,29,28,125
2024-03-01 18:30:00,30,40,33,25,34,162
2024-03-01 18:40:00,22,43,18,35,45,163
2024-03-01 18:50:00,26,34,22,29,40,151
2024-03-01 19:00:00,37,26,17,34,40,154
2024-03-01 19:10:00,30,49,18,26,28,151
2024-03-01 19:20:00,16,29,29,28,26,128
2024-03-01 19:30:00,37,25,21,39,31,153
2024-03-01 19:40:00,29,23,21,23,28,124
2024-03-01 19:50:00,17,27,24,44,31,143
2024-03-01 20:00:00,21,20,7,26,37,111
2024-03-01 20:10:00,22,32,28,33,35,150
2024-03-01 20:20:00,25,39,30,40,36,170
2024-03-01 20:30:00,23,20,18,30,28,119
2024-03-01 20:40:00,22,23,24,27,26,122
2024-03-01 20:50:00,20,26,5,26,29,106
2024-03-01 21:00:00,20,18,12,26,23,99
2024-03-01 21:10:00,18,31,5,34,30,118
2024-03-01 21:20:00,16,31,13,23,24,107
2024-03-01 21:30:00,21,29,15,30,18,113
2024-03-01 21:40:00,9,27,16,32,31,115
2024-03-01 21:50:00,18,29,19,21,36,123
2024-03-01 22:00:00,10,27,11,21,29,98
2024-03-01 22:10:00,11,32,13,21,20,97
2024-03-01 22:20:00,18,33,6,24,28,109
2024-03-01 22:30:00,15,20,11,23,22,91
2024-03-01 22:40:00,28,29,13,20,12,102
2024-03-01 22:50:00,7,15,9,21,16,68
2024-03-01 23:00:00,13,19,7,28,20,87
2024-03-01 23:10:00,10,23,16,13,15,77
2024-03-01 23:20:00,14,9,7,18,25,73
2024-03-01 23:30:00,5,10,9,28,15,67
2024-03-01 23:40:00,4,9,5,16,23,57
2024-03-01 23:50:00,15,19,7,14,9,64
2024-03-02 00:00:00,14,13,6,17,17,67
2024-03-02 00:10:00,9,12,2,13,16,52
2024-03-02 00:20:00,8,17,7,13,13,58
2024-03-02 00:30:00,5,18,7,5,15,50
2024-03-02 00:40:00,10,5,2,6,6,29
2024-03-02 00:50:00,5,8,6,9,15,43
2024-03-02 01:00:00,2,5,3,6,9,25
2024-03-02 01:10:00,8,5,0,8,9,30
2024-03-02 01:20:00,7,6,3,11,5,32
2024-03-02 01:30:00,1,4,0,6,8,19
2024-03-02 01:40:00,2,13,0,4,10,29
2024-03-02 01:50:00,1,7,3,3,6,20
2024-03-02 02:00:00,5,7,0,6,6,24
2024-03-02 02:10:00,1,7,1,8,3,20
2024-03-02 02:20:00,4,3,0,3,6,16
2024-03-02 02:30:00,0,9,4,8,3,24
2024-03-02 02:40:00,0,2,3,6,4,15
2024-03-02 02:50:00,4,2,0,9,2,17
2024-03-02 03:00:00,5,5,3,3,5,21
2024-03-02 03:10:00,2,2,2,5,7,18
2024-03-02 03:20:00,0,7,0,6,3,16
2024-03-02 03:30:00,0,7,4,3,3,17
2024-03-02 03:40:00,0,4,0,7,6,17
2024-03-02 03:50:00,6,9,0,4,3,22
2024-03-02 04:00:00,5,1,0,5,5,16
2024-03-02 04:10:00,0,5,3,9,2,19
2024-03-02 04:20:00,9,2,4,6,3,24
2024-03-02 04:30:00,2,3,0,2,0,7
2024-03-02 04:40:00,1,4,0,6,10,21
2024-03-02 04:50:00,5,3,0,2,1,11
2024-03-02 05:00:00,6,3,2,7,7,25
2024-03-02 05:10:00,12,5,8,4,6,35
2024-03-02 05:20:00,11,3,0,5,9,28
2024-03-02 05:30:00,9,13,3,3,9,37
2024-03-02 05:40:00,5,5,1,2,6,19
2024-03-02 05:50:00,8,12,6,9,14,49
2024-03-02 06:00:00,9,13,8,5,5,40
2024-03-02 06:10:00,11,8,0,5,6,30
2024-03-02 06:20:00,9,11,2,11,11,44
2024-03-02 06:30:00,11,8,4,5,3,31
2024-03-02 06:40:00,10,9,1,13,12,45
2024-03-02 06:50:00,13,3,1,16,4,37
2024-03-02 07:00:00,5,1,0,7,5,18
2024-03-02 07:10:00,7,8,0,7,6,28
2024-03-02 07:20:00,14,7,5,12,5,43
2024-03-02 07:30:00,12,11,0,7,3,33
2024-03-02 07:40:00,12,14,3,7,4,40
2024-03-02 07:50:00,9,11,7,12,9,48
2024-03-02 08:00:00,10,8,0,14,6,38
2024-03-02 08:10:00,14,13,2,14,10,53
2024-03-02 08:20:00,17,11,4,15,10,57
2024-03-02 08:30:00,13,13,4,11,12,53
2024-03-02 08:40:00,16,16,6,23,13,74
2024-03-02 08:50:00,16,12,6,24,9,67
2024-03-02 09:00:00,10,24,10,17,10,71
2024-03-02 09:10:00,20,29,5,26,15,95
2024-03-02 09:20:00,13,12,10,25,12,72
2024-03-02 09:30:00,16,15,9,21,12,73
2024-03-02 09:40:00,15,13,10,20,17,75
2024-03-02 09:50:00,22,22,11,30,17,102
2024-03-02 10:00:00,25,24,13,22,20,104
2024-03-02 10:10:00,21,22,19,26,22,110
2024-03-02 10:20:00,13,20,15,21,15,84
2024-03-02 10:30:00,28,29,7,22,24,110
2024-03-02 10:40:00,18,24,13,23,18,96
2024-03-02 10:50:00,26,27,12,33,26,124
2024-03-02 11:00:00,18,16,11,24,21,90
2024-03-02 11:10:00,16,19,10,28,22,95
2024-03-02 11:20:00,15,21,16,23,21,96
2024-03-02 11:30:00,30,20,12,21,20,103
2024-03-02 11:40:00,23,23,9,23,25,103
2024-03-02 11:50:00,12,21,8,28,28,97
2024-03-02 12:00:00,21,28,11,38,24,122
2024-03-02 12:10:00,26,24,12,27,25,114
2024-03-02 12:20:00,21,23,9,29,31,113
2024-03-02 12:30:00,20,25,17,35,24,121
2024-03-02 12:40:00,21,24,8,27,24,104
2024-03-02 12:50:00,19,25,18,25,22,109
2024-03-02 13:00:00,22,31,16,17,23,109
2024-03-02 13:10:00,15,23,12,32,27,109
2024-03-02 13:20:00,24,27,15,38,31,135
2024-03-02 13:30:00,23,24,10,25,31,113
2024-03-02 13:40:00,15,31,21,31,37,135
2024-03-02 13:50:00,18,29,13,34,34,128
2024-03-02 14:00:00,17,24,17,27,26,111
2024-03-02 14:10:00,12,22,26,28,20,108
2024-03-02 14:20:00,25,23,10,27,23,108
2024-03-02 14:30:00,20,27,12,25,26,110
2024-03-02 14:40:00,15,29,15,28,26,113
2024-03-02 14:50:00,24,25,16,31,30,126
2024-03-02 15:00:00,14,21,12,28,23,98
2024-03-02 15:10:00,18,30,17,32,29,126
2024-03-02 15:20:00,23,29,16,40,21,129
2024-03-02 15:30:00,20,25,11,35,26,117
2024-03-02 15:40:00,24,42,16,25,27,134
2024-03-02 15:50:00,29,26,15,26,26,122
2024-03-02 16:00:00,12,26,16,24,21,99
2024-03-02 16:10:00,18,27,12,31,24,112
2024-03-02 16:20:00,18,24,10,30,25,107
2024-03-02 16:30:00,24,24,15,27,28,118
2024-03-02 16:40:00,20,21,13,29,27,110
2024-03-02 16:50:00,15,24,12,24,24,99
2024-03-02 17:00:00,17,23,11,28,22,101
2024-03-02 17:10:00,19,19,15,24,17,94
2024-03-02 17:20:00,15,28,12,31,19,105
2024-03-02 17:30:00,18,24,13,28,20,103
2024-03-02 17:40:00,19,24,12,28,24,107
2024-03-02 17:50:00,12,24,13,26,26,101
2024-03-02 18:00:00,15,27,15,23,22,102
2024-03-02 18:10:00,15,29,18,29,33,124
2024-03-02 18:20:00,24,24,17,34,19,118
2024-03-02 18:30:00,24,41,14,25,30,134
2024-03-02 18:40:00,28,37,20,36,34,155
2024-03-02 18:50:00,33,32,27,30,33,155
2024-03-02 19:00:00,26,34,15,29,26,130
2024-03-02 19:10:00,35,35,22,30,28,150
2024-03-02 19:20:00,27,51,20,26,20,144
2024-03-02 19:30:00,20,34,16,28,19,117
2024-03-02 19:40:00,25,35,21,29,34,144
2024-03-02 19:50:00,20,37,20,28,28,133
2024-03-02 20:00:00,22,26,7,29,36,120
2024-03-02 20:10:00,21,27,20,37,31,136
2024-03-02 20:20:00,21,28,16,26,26,117
2024-03-02 20:30:00,19,25,9,27,21,101
2024-03-02 20:40:00,29,16,12,18,28,103
2024-03-02 20:50:00,20,24,9,24,26,103
2024-03-02 21:00:00,11,19,13,22,19,84
2024-03-02 21:10:00,19,30,11,21,26,107
2024-03-02 21:20:00,10,35,21,26,26,118
2024-03-02 21:30:00,19,24,15,39,26,123
2024-03-02 21:40:00,15,28,6,24,15,88
2024-03-02 21:50:00,11,17,2,24,27,81
2024-03-02 22:00:00,10,23,6,26,12,77
2024-03-02 22:10:00,24,25,9,27,22,107
2024-03-02 22:20:00,14,26,14,20,19,93
2024-03-02 22:30:00,11,27,21,18,26,103
2024-03-02 22:40:00,15,21,10,21,30,97
2024-03-02 22:50:00,17,30,11,13,22,93
2024-03-02 23:00:00,13,21,5,24,23,86
2024-03-02 23:10:00,17,13,6,19,25,80
2024-03-02 23:20:00,17,16,6,13,20,72
2024-03-02 23:30:00,7,13,10,12,14,56
2024-03-02 23:40:00,7,16,7,16,24,70
2024-03-02 23:50:00,8,19,5,21,31,84
2024-03-03 00:00:00,11,8,4,11,23,57
2024-03-03 00:10:00,6,13,4,12,16,51
2024-03-03 00:20:00,7,14,2,14,15,52
2024-03-03 00:30:00,9,17,8,13,14,61
2024-03-03 00:40:00,3,8,11,8,12,42
2024-03-03 00:50:00,8,5,2,14,19,48
2024-03-03 01:00:00,8,4,4,14,9,39
2024-03-03 01:10:00,5,12,2,17,8,44
2024-03-03 01:20:00,7,9,6,12,12,46
2024-03-03 01:30:00,2,10,0,8,4,24
2024-03-03 01:40:00,2,7,1,10,6,26
2024-03-03 01:50:00,8,7,0,6,7,28
2024-03-03 02:00:00,4,11,4,8,9,36
2024-03-03 02:10:00,0,2,4,3,5,14
2024-03-03 02:20:00,6,8,5,7,5,31
2024-03-03 02:30:00,2,7,0,0,3,12
2024-03-03 02:40:00,0,4,1,9,6,20
2024-03-03 02:50:00,2,7,5,7,5,26
2024-03-03 03:00:00,0,9,6,9,1,25
2024-03-03 03:10:00,1,4,3,7,2,17
2024-03-03 03:20:00,0,3,4,6,1,14
2024-03-03 03:30:00,0,5,1,2,5,13
2024-03-03 03:40:00,2,6,0,3,3,14
2024-03-03 03:50:00,0,10,1,9,6,26
2024-03-03 04:00:00,0,5,1,2,2,10
2024-03-03 04:10:00,3,6,2,7,4,22
2024-03-03 04:20:00,3,3,0,5,7,18
2024-03-03 04:30:00,4,4,5,5,6,24
2024-03-03 04:40:00,8,5,0,5,4,22
2024-03-03 04:50:00,6,9,0,3,7,25
2024-03-03 05:00:00,9,5,3,10,10,37
2024-03-03 05:10:00,10,5,3,7,10,35
2024-03-03 05:20:00,5,5,3,10,2,25
2024-03-03 05:30:00,0,9,3,6,12,30
2024-03-03 05:40:00,3,4,0,5,3,15
2024-03-03 05:50:00,1,10,2,6,7,26
2024-03-03 06:00:00,0,11,1,4,1,17
2024-03-03 06:10:00,0,7,5,1,5,18
2024-03-03 06:20:00,6,7,3,3,10,29
2024-03-03 06:30:00,0,11,0,5,3,19
2024-03-03 06:40:00,8,6,0,11,12,37
2024-03-03 06:50:00,1,6,0,4,5,16
2024-03-03 07:00:00,2,6,0,3,6,17
2024-03-03 07:10:00,5,4,0,9,2,20
2024-03-03 07:20:00,2,3,1,2,2,10
2024-03-03 07:30:00,4,6,0,6,3,19
2024-03-03 07:40:00,1,3,3,8,4,19
2024-03-03 07:50:00,4,6,1,7,7,25
2024-03-03 08:00:00,0,8,1,6,1,16
2024-03-03 08:10:00,2,3,1,9,3,18
2024-03-03 08:20:00,7,3,3,10,2,25
2024-03-03 08:30:00,2,8,3,10,7,30
2024-03-03 08:40:00,2,9,3,12,6,32
2024-03-03 08:50:00,8,17,2,11,10,48
2024-03-03 09:00:00,6,11,5,19,7,48
2024-03-03 09:10:00,10,12,10,14,11,57
2024-03-03 09:20:00,11,19,4,19,16,69
2024-03-03 09:30:00,14,20,10,15,16,75
2024-03-03 09:40:00,12,19,4,15,11,61
2024-03-03 09:50:00,11,18,10,19,17,75
2024-03-03 10:00:00,10,13,9,24,18,74
2024-03-03 10:10:00,10,20,7,18,13,68
2024-03-03 10:20:00,9,19,8,19,19,74
2024-03-03 10:30:00,9,28,8,22,13,80
2024-03-03 10:40:00,13,25,7,23,15,83
2024-03-03 10:50:00,10,23,7,24,15,79
2024-03-03 11:00:00,6,14,8,26,14,68
2024-03-03 11:10:00,15,25,10,28,14,92
2024-03-03 11:20:00,9,19,7,27,18,80
2024-03-03 11:30:00,10,31,10,20,18,89
2024-03-03 11:40:00,8,20,9,32,23,92
2024-03-03 11:50:00,14,22,11,21,17,85
2024-03-03 12:00:00,18,34,11,26,17,106
2024-03-03 12:10:00,19,42,15,31,19,126
2024-03-03 12:20:00,14,30,14,29,18,105
2024-03-03 12:30:00,14,26,13,33,23,109
2024-03-03 12:40:00,14,25,14,27,14,94
2024-03-03 12:50:00,13,28,14,30,21,106
2024-03-03 13:00:00,14,29,12,27,22,104
2024-03-03 13:10:00,13,26,16,27,20,102
2024-03-03 13:20:00,11,29,18,25,14,97
2024-03-03 13:30:00,17,29,12,30,19,107
2024-03-03 13:40:00,15,30,11,38,18,112
2024-03-03 13:50:00,18,32,11,29,23,113
2024-03-03 14:00:00,12,25,12,28,18,95
2024-03-03 14:10:00,17,31,9,32,22,111
2024-03-03 14:20:00,11,24,7,37,21,100
2024-03-03 14:30:00,16,27,10,31,19,103
2024-03-03 14:40:00,17,34,13,37,20,121
2024-03-03 14:50:00,16,27,12,27,22,104
2024-03-03 15:00:00,16,30,11,29,16,102
2024-03-03 15:10:00,17,30,13,31,22,113
2024-03-03 15:20:00,16,26,10,29,18,99
2024-03-03 15:30:00,13,26,5,27,27,98
2024-03-03 15:40:00,13,29,9,30,29,110
2024-03-03 15:50:00,21,24,7,29,27,108
2024-03-03 16:00:00,22,27,12,31,22,114
2024-03-03 16:10:00,17,24,18,26,23,108
2024-03-03 16:20:00,20,29,14,27,20,110
2024-03-03 16:30:00,16,31,13,28,22,110
2024-03-03 16:40:00,20,31,9,23,20,103
2024-03-03 16:50:00,17,24,9,28,20,98
2024-03-03 17:00:00,20,28,17,23,21,109
2024-03-03 17:10:00,12,29,26,29,23,119
2024-03-03 17:20:00,14,22,14,32,24,106
2024-03-03 17:30:00,16,32,10,37,26,121
2024-03-03 17:40:00,21,28,20,30,22,121
2024-03-03 17:50:00,16,28,11,31,24,110
2024-03-03 18:00:00,21,25,11,28,26,111
2024-03-03 18:10:00,12,28,11,24,20,95
2024-03-03 18:20:00,17,30,7,24,17,95
2024-03-03 18:30:00,27,35,14,24,19,119
2024-03-03 18:40:00,16,50,12,25,29,132
2024-03-03 18:50:00,17,47,15,31,29,139
2024-03-03 19:00:00,17,31,8,26,29,111
2024-03-03 19:10:00,33,28,14,28,28,131
2024-03-03 19:20:00,26,23,10,31,25,115
2024-03-03 19:30:00,21,28,9,30,22,110
2024-03-03 19:40:00,22,25,6,22,36,111
2024-03-03 19:50:00,28,34,18,25,29,134
2024-03-03 20:00:00,19,20,10,24,24,97
2024-03-03 20:10:00,14,25,25,31,22,117
2024-03-03 20:20:00,18,22,12,21,22,95
2024-03-03 20:30:00,13,25,10,31,20,99
2024-03-03 20:40:00,13,20,9,25,21,88
2024-03-03 20:50:00,16,20,9,17,21,83
2024-03-03 21:00:00,12,19,16,25,16,88
2024-03-03 21:10:00,19,25,8,15,20,87
2024-03-03 21:20:00,10,30,6,21,16,83
2024-03-03 21:30:00,16,22,14,21,23,96
2024-03-03 21:40:00,10,11,13,21,13,68
2024-03-03 21:50:00,12,16,4,16,25,73
2024-03-03 22:00:00,21,20,12,19,14,86
2024-03-03 22:10:00,5,17,12,19,19,72
2024-03-03 22:20:00,12,14,7,10,13,56
2024-03-03 22:30:00,17,11,4,13,13,58
2024-03-03 22:40:00,4,12,10,15,17,58
2024-03-03 22:50:00,2,13,0,14,28,57
2024-03-03 23:00:00,8,15,4,12,10,49
2024-03-03 23:10:00,8,9,3,15,7,42
2024-03-03 23:20:00,6,10,0,9,18,43
2024-03-03 23:30:00,11,6,7,13,16,53
2024-03-03 23:40:00,3,7,7,7,13,37
2024-03-03 23:50:00,5,6,0,9,10,30
2024-03-04 00:00:00,3,5,6,7,7,28
2024-03-04 00:10:00,2,10,0,3,10,25
2024-03-04 00:20:00,7,11,3,7,10,38
2024-03-04 00:30:00,5,0,3,7,14,29
2024-03-04 00:40:00,12,1,3,5,13,34
2024-03-04 00:50:00,0,8,4,3,4,19
2024-03-04 01:00:00,3,1,4,3,4,15
2024-03-04 01:10:00,1,2,2,4,3,12
2024-03-04 01:20:00,4,7,0,3,1,15
2024-03-04 01:30:00,2,5,0,3,3,13
2024-03-04 01:40:00,4,1,1,0,3,9
2024-03-04 01:50:00,0,4,0,4,0,8
2024-03-04 02:00:00,0,2,0,3,2,7
2024-03-04 02:10:00,5,1,2,4,2,14
2024-03-04 02:20:00,0,4,2,3,2,11
2024-03-04 02:30:00,6,3,0,6,2,17
2024-03-04 02:40:00,1,5,0,0,3,9
2024-03-04 02:50:00,0,7,1,1,3,12
2024-03-04 03:00:00,0,3,1,5,3,12
2024-03-04 03:10:00,0,1,0,1,1,3
2024-03-04 03:20:00,2,0,0,3,3,8
2024-03-04 03:30:00,2,1,0,2,3,8
2024-03-04 03:40:00,3,3,0,3,1,10
2024-03-04 03:50:00,2,2,3,11,2,20
2024-03-04 04:00:00,1,2,0,2,1,6
2024-03-04 04:10:00,3,6,1,6,1,17
2024-03-04 04:20:00,8,1,0,5,0,14
2024-03-04 04:30:00,10,4,0,7,1,22
2024-03-04 04:40:00,5,3,0,3,8,19
2024-03-04 04:50:00,8,12,1,7,10,38
2024-03-04 05:00:00,11,10,6,9,7,43
2024-03-04 05:10:00,20,10,5,10,16,61
2024-03-04 05:20:00,14,9,7,14,12,56
2024-03-04 05:30:00,25,24,7,10,27,93
2024-03-04 05:40:00,34,16,22,13,21,106
2024-03-04 05:50:00,51,24,6,17,22,120
2024-03-04 06:00:00,48,30,16,9,12,115
2024-03-04 06:10:00,25,27,15,14,24,105
2024-03-04 06:20:00,31,27,12,18,13,101
2024-03-04 06:30:00,29,30,15,25,21,120
2024-03-04 06:40:00,39,31,24,26,31,151
2024-03-04 06:50:00,19,31,8,29,24,111
2024-03-04 07:00:00,23,34,11,18,17,103
2024-03-04 07:10:00,19,27,13,19,25,103
2024-03-04 07:20:00,18,19,14,29,29,109
2024-03-04 07:30:00,21,36,26,27,22,132
2024-03-04 07:40:00,25,29,25,32,28,139
2024-03-04 07:50:00,21,22,23,33,23,122
2024-03-04 08:00:00,33,30,20,35,29,147
2024-03-04 08:10:00,20,28,16,30,31,125
2024-03-04 08:20:00,21,35,24,24,31,135
2024-03-04 08:30:00,21,32,19,28,24,124
2024-03-04 08:40:00,26,30,32,34,27,149
2024-03-04 08:50:00,22,33,27,23,24,129
2024-03-04 09:00:00,21,28,18,27,24,118
2024-03-04 09:10:00,17,29,16,21,17,100
2024-03-04 09:20:00,19,24,20,27,24,114
2024-03-04 09:30:00,21,20,13,34,27,115
2024-03-04 09:40:00,21,26,13,28,21,109
2024-03-04 09:50:00,19,30,11,29,24,113
2024-03-04 10:00:00,17,26,15,33,25,116
2024-03-04 10:10:00,27,34,13,25,22,121
2024-03-04 10:20:00,17,22,12,25,18,94
2024-03-04 10:30:00,17,20,11,25,22,95
2024-03-04 10:40:00,24,29,14,24,18,109
2024-03-04 10:50:00,13,21,8,29,23,94
2024-03-04 11:00:00,22,29,15,23,19,108
2024-03-04 11:10:00,22,24,16,26,24,112
2024-03-04 11:20:00,12,27,7,22,21,89
2024-03-04 11:30:00,20,24,16,26,19,105
2024-03-04 11:40:00,22,19,12,23,18,94
2024-03-04 11:50:00,25,25,15,23,26,114
2024-03-04 12:00:00,20,27,16,26,24,113
2024-03-04 12:10:00,23,24,13,26,17,103
2024-03-04 12:20:00,14,28,11,36,32,121
2024-03-04 12:30:00,28,26,14,23,24,115
2024-03-04 12:40:00,18,20,15,31,17,101
2024-03-04 12:50:00,21,26,19,27,21,114
2024-03-04 13:00:00,17,26,25,24,24,116
2024-03-04 13:10:00,23,29,20,38,28,138
2024-03-04 13:20:00,20,28,21,27,27,123
2024-03-04 13:30:00,24,24,13,27,25,113
2024-03-04 13:40:00,22,23,15,28,22,110
2024-03-04 13:50:00,16,27,11,29,22,105
2024-03-04 14:00:00,20,30,9,30,31,120
2024-03-04 14:10:00,16,29,21,36,20,122
2024-03-04 14:20:00,26,28,19,40,30,143
2024-03-04 14:30:00,16,27,13,21,16,93
2024-03-04 14:40:00,26,25,12,29,24,116
2024-03-04 14:50:00,20,41,19,31,27,138
2024-03-04 15:00:00,21,32,21,26,21,121
2024-03-04 15:10:00,25,37,21,30,35,148
2024-03-04 15:20:00,23,39,24,32,33,151
2024-03-04 15:30:00,14,27,19,30,29,119
2024-03-04 15:40:00,27,34,16,33,23,133
2024-03-04 15:50:00,20,30,17,38,25,130
2024-03-04 16:00:00,23,31,15,29,30,128
2024-03-04 16:10:00,29,30,18,33,29,139
2024-03-04 16:20:00,24,34,24,31,37,150
2024-03-04 16:30:00,25,24,26,26,35,136
2024-03-04 16:40:00,25,29,24,21,20,119
2024-03-04 16:50:00,29,36,25,29,33,152
2024-03-04 17:00:00,20,34,24,26,26,130
2024-03-04 17:10:00,21,19,19,24,20,103
2024-03-04 17:20:00,25,26,22,26,29,128
2024-03-04 17:30:00,21,31,19,29,34,134
2024-03-04 17:40:00,23,20,19,22,35,119
2024-03-04 17:50:00,23,24,13,32,39,131
2024-03-04 18:00:00,23,27,14,28,24,116
2024-03-04 18:10:00,25,37,21,24,33,140
2024-03-04 18:20:00,27,29,19,25,39,139
2024-03-04 18:30:00,28,39,43,49,48,207
2024-03-04 18:40:00,25,34,21,38,34,152
2024-03-04 18:50:00,37,34,21,30,31,153
2024-03-04 19:00:00,18,35,22,28,42,145
2024-03-04 19:10:00,29,36,17,22,34,138
2024-03-04 19:20:00,21,33,22,33,42,151
2024-03-04 19:30:00,26,31,26,18,29,130
2024-03-04 19:40:00,20,36,14,25,23,118
2024-03-04 19:50:00,19,27,19,21,30,116
2024-03-04 20:00:00,26,21,14,17,32,110
2024-03-04 20:10:00,12,26,16,25,22,101
2024-03-04 20:20:00,29,34,12,31,23,129
2024-03-04 20:30:00,9,30,16,32,28,115
2024-03-04 20:40:00,24,34,12,36,35,141
2024-03-04 20:50:00,23,20,7,27,32,109
2024-03-04 21:00:00,19,22,8,21,20,90
2024-03-04 21:10:00,16,21,13,19,24,93
2024-03-04 21:20:00,13,16,7,23,28,87
2024-03-04 21:30:00,8,24,4,18,24,78
2024-03-04 21:40:00,15,18,7,16,23,79
2024-03-04 21:50:00,15,19,13,22,16,85
2024-03-04 22:00:00,11,13,10,29,26,89
2024-03-04 22:10:00,16,14,4,27,21,82
2024-03-04 22:20:00,12,28,15,16,21,92
2024-03-04 22:30:00,21,16,14,26,23,100
2024-03-04 22:40:00,11,10,3,23,11,58
2024-03-04 22:50:00,6,6,5,23,13,53
2024-03-04 23:00:00,8,14,4,17,13,56
2024-03-04 23:10:00,13,15,5,7,15,55
2024-03-04 23:20:00,10,9,6,12,15,52
2024-03-04 23:30:00,12,5,1,10,8,36
2024-03-04 23:40:00,2,9,0,12,9,32
2024-03-04 23:50:00,8,2,5,6,11,32
2024-03-05 00:00:00,2,5,8,5,7,27
2024-03-05 00:10:00,3,4,4,9,10,30
2024-03-05 00:20:00,4,1,0,1,10,16
2024-03-05 00:30:00,8,4,0,9,7,28
2024-03-05 00:40:00,9,4,1,4,3,21
2024-03-05 00:50:00,0,3,0,6,3,12
2024-03-05 01:00:00,1,2,1,3,2,9
2024-03-05 01:10:00,2,4,0,6,6,18
2024-03-05 01:20:00,2,3,3,4,3,15
2024-03-05 01:30:00,0,1,1,4,8,14
2024-03-05 01:40:00,0,5,0,1,2,8
2024-03-05 01:50:00,0,2,1,2,1,6
2024-03-05 02:00:00,0,1,0,2,2,5
2024-03-05 02:10:00,0,6,0,3,3,12
2024-03-05 02:20:00,3,2,0,2,1,8
2024-03-05 02:30:00,0,5,0,5,0,10
2024-03-05 02:40:00,2,4,0,0,1,7
2024-03-05 02:50:00,2,3,0,1,1,7
2024-03-05 03:00:00,0,2,0,1,0,3
2024-03-05 03:10:00,2,0,0,1,0,3
2024-03-05 03:20:00,3,6,3,4,2,18
2024-03-05 03:30:00,0,1,0,5,1,7
2024-03-05 03:40:00,4,4,0,1,4,13
2024-03-05 03:50:00,1,3,0,5,0,9
2024-03-05 04:00:00,0,6,3,4,2,15
2024-03-05 04:10:00,4,0,0,7,0,11
2024-03-05 04:20:00,6,2,0,5,1,14
2024-03-05 04:30:00,7,8,3,1,7,26
2024-03-05 04:40:00,12,3,1,3,9,28
2024-03-05 04:50:00,4,10,5,7,11,37
2024-03-05 05:00:00,19,3,5,13,8,48
2024-03-05 05:10:00,12,14,8,9,11,54
2024-03-05 05:20:00,16,14,13,10,23,76
2024-03-05 05:30:00,20,11,10,15,19,75
2024-03-05 05:40:00,43,25,10,12,24,114
2024-03-05 05:50:00,29,21,13,12,19,94
2024-03-05 06:00:00,25,23,16,12,14,90
2024-03-05 06:10:00,27,19,14,20,22,102
2024-03-05 06:20:00,29,27,18,20,20,114
2024-03-05 06:30:00,35,31,12,24,14,116
2024-03-05 06:40:00,23,36,11,35,37,142
2024-03-05 06:50:00,37,33,11,20,23,124
2024-03-05 07:00:00,15,22,11,24,26,98
2024-03-05 07:10:00,24,33,21,30,21,129
2024-03-05 07:20:00,21,32,14,35,31,133
2024-03-05 07:30:00,21,30,18,28,24,121
2024-03-05 07:40:00,18,35,21,32,32,138
2024-03-05 07:50:00,24,33,19,37,29,142
2024-03-05 08:00:00,21,26,26,23,30,126
2024-03-05 08:10:00,15,23,16,24,22,100
2024-03-05 08:20:00,26,29,17,24,29,125
2024-03-05 08:30:00,28,31,25,29,26,139
2024-03-05 08:40:00,19,34,21,35,31,140
2024-03-05 08:50:00,21,31,22,24,19,117
2024-03-05 09:00:00,26,25,19,33,28,131
2024-03-05 09:10:00,27,28,9,27,28,119
2024-03-05 09:20:00,16,23,23,28,22,112
2024-03-05 09:30:00,23,28,23,32,23,129
2024-03-05 09:40:00,22,35,18,26,21,122
2024-03-05 09:50:00,22,25,17,24,19,107
2024-03-05 10:00:00,22,28,15,30,25,120
2024-03-05 10:10:00,28,32,9,29,25,123
2024-03-05 10:20:00,20,21,13,29,23,106
2024-03-05 10:30:00,16,28,11,30,20,105
2024-03-05 10:40:00,24,30,15,25,19,113
2024-03-05 10:50:00,17,28,10,40,25,120
2024-03-05 11:00:00,16,27,12,27,29,111
2024-03-05 11:10:00,18,27,20,30,22,117
2024-03-05 11:20:00,19,31,13,24,29,116
2024-03-05 11:30:00,19,22,10,31,38,120
2024-03-05 11:40:00,27,28,15,27,25,122
2024-03-05 11:50:00,23,32,19,25,32,131
2024-03-05 12:00:00,19,30,14,28,24,115
2024-03-05 12:10:00,14,21,8,31,20,94
2024-03-05 12:20:00,30,32,13,31,18,124
2024-03-05 12:30:00,24,22,8,21,32,107
2024-03-05 12:40:00,25,26,20,32,25,128
2024-03-05 12:50:00,21,28,18,30,34,131
2024-03-05 13:00:00,20,35,27,29,23,134
2024-03-05 13:10:00,17,28,16,24,21,106
2024-03-05 13:20:00,16,26,19,23,23,107
2024-03-05 13:30:00,24,30,19,29,20,122
2024-03-05 13:40:00,18,34,16,40,36,144
2024-03-05 13:50:00,18,26,14,36,26,120
2024-03-05 14:00:00,17,28,15,35,25,120
2024-03-05 14:10:00,22,26,12,30,31,121
2024-03-05 14:20:00,22,28,19,28,24,121
2024-03-05 14:30:00,16,34,15,31,28,124
2024-03-05 14:40:00,24,29,22,33,27,135
2024-03-05 14:50:00,23,31,18,40,22,134
2024-03-05 15:00:00,17,36,21,24,31,129
2024-03-05 15:10:00,23,37,24,30,32,146
2024-03-05 15:20:00,18,26,22,28,19,113
2024-03-05 15:30:00,20,29,16,32,22,119
2024-03-05 15:40:00,22,33,16,30,23,124
2024-03-05 15:50:00,21,38,22,30,39,150
2024-03-05 16:00:00,27,30,21,21,25,124
2024-03-05 16:10:00,30,34,29,31,29,153
2024-03-05 16:20:00,35,34,32,25,29,155
2024-03-05 16:30:00,30,30,22,38,28,148
2024-03-05 16:40:00,27,33,19,23,27,129
2024-03-05 16:50:00,24,28,16,28,22,118
2024-03-05 17:00:00,16,28,22,30,26,122
2024-03-05 17:10:00,24,31,18,24,32,129
2024-03-05 17:20:00,21,27,23,25,30,126
2024-03-05 17:30:00,28,27,22,33,30,140
2024-03-05 17:40:00,26,30,20,21,26,123
2024-03-05 17:50:00,24,32,15,25,25,121
2024-03-05 18:00:00,23,30,12,33,33,131
2024-03-05 18:10:00,24,27,23,30,34,138
2024-03-05 18:20:00,15,31,13,32,25,116
2024-03-05 18:30:00,29,48,14,24,28,143
2024-03-05 18:40:00,32,36,28,36,40,172
2024-03-05 18:50:00,37,39,24,27,25,152
2024-03-05 19:00:00,31,36,30,36,28,161
2024-03-05 19:10:00,29,34,17,39,32,151
2024-03-05 19:20:00,20,19,17,36,36,128
2024-03-05 19:30:00,27,30,22,36,34,149
2024-03-05 19:40:00,19,37,20,21,30,127
2024-03-05 19:50:00,31,24,20,21,32,128
2024-03-05 20:00:00,13,14,14,29,26,96
2024-03-05 20:10:00,21,33,18,34,22,128
2024-03-05 20:20:00,14,27,17,23,29,110
2024-03-05 20:30:00,13,13,17,30,26,99
2024-03-05 20:40:00,17,30,20,28,22,117
2024-03-05 20:50:00,27,30,15,21,33,126
2024-03-05 21:00:00,21,26,17,22,25,111
2024-03-05 21:10:00,10,29,17,30,25,111
2024-03-05 21:20:00,11,24,7,29,28,99
2024-03-05 21:30:00,27,38,7,23,27,122
2024-03-05 21:40:00,19,21,11,22,16,89
2024-03-05 21:50:00,13,26,7,20,16,82
2024-03-05 22:00:00,6,30,16,21,28,101
2024-03-05 22:10:00,11,32,5,24,22,94
2024-03-05 22:20:00,14,35,15,25,23,112
2024-03-05 22:30:00,14,39,10,16,13,92
2024-03-05 22:40:00,15,23,13,20,25,96
2024-03-05 22:50:00,9,15,8,21,16,69
2024-03-05 23:00:00,8,11,9,19,28,75
2024-03-05 23:10:00,9,12,6,14,18,59
2024-03-05 23:20:00,6,16,11,21,6,60
2024-03-05 23:30:00,0,11,3,10,11,35
2024-03-05 23:40:00,3,11,5,6,14,39
2024-03-05 23:50:00,4,11,1,8,13,37
2024-03-06 00:00:00,1,8,1,8,5,23
2024-03-06 00:10:00,14,9,0,6,6,35
2024-03-06 00:20:00,8,8,5,3,6,30
2024-03-06 00:30:00,6,2,0,8,3,19
2024-03-06 00:40:00,3,7,2,3,6,21
2024-03-06 00:50:00,5,3,1,11,7,27
2024-03-06 01:00:00,3,6,0,3,2,14
2024-03-06 01:10:00,2,2,7,11,3,25
2024-03-06 01:20:00,3,0,0,1,0,4
2024-03-06 01:30:00,1,7,0,0,5,13
2024-03-06 01:40:00,1,1,6,3,0,11
2024-03-06 01:50:00,0,2,0,0,3,5
2024-03-06 02:00:00,3,4,0,5,2,14
2024-03-06 02:10:00,6,4,0,2,1,13
2024-03-06 02:20:00,0,0,2,4,0,6
2024-03-06 02:30:00,2,1,0,3,3,9
2024-03-06 02:40:00,4,0,0,6,5,15
2024-03-06 02:50:00,1,3,0,3,6,13
2024-03-06 03:00:00,2,3,0,0,0,5
2024-03-06 03:10:00,4,2,0,2,0,8
2024-03-06 03:20:00,5,7,0,4,1,17
2024-03-06 03:30:00,3,4,0,3,2,12
2024-03-06 03:40:00,0,4,0,4,1,9
2024-03-06 03:50:00,4,1,3,3,0,11
2024-03-06 04:00:00,2,3,0,8,1,14
2024-03-06 04:10:00,2,3,0,10,1,16
2024-03-06 04:20:00,7,3,2,1,0,13
2024-03-06 04:30:00,11,5,4,6,2,28
2024-03-06 04:40:00,6,4,3,5,4,22
2024-03-06 04:50:00,10,6,1,6,7,30
2024-03-06 05:00:00,12,14,4,10,12,52
2024-03-06 05:10:00,20,5,6,7,13,51
2024-03-06 05:20:00,14,16,8,11,8,57
2024-03-06 05:30:00,19,12,9,18,16,74
2024-03-06 05:40:00,19,23,14,16,23,95
2024-03-06 05:50:00,27,19,4,9,18,77
2024-03-06 06:00:00,41,32,7,21,14,115
2024-03-06 06:10:00,12,31,15,17,14,89
2024-03-06 06:20:00,3,19,11,22,18,73
2024-03-06 06:30:00,31,27,13,25,20,116
2024-03-06 06:40:00,28,27,18,25,30,128
2024-03-06 06:50:00,18,23,6,20,20,87
2024-03-06 07:00:00,25,28,15,25,19,112
2024-03-06 07:10:00,18,22,14,30,27,111
2024-03-06 07:20:00,25,29,18,36,32,140
2024-03-06 07:30:00,24,34,21,25,18,122
2024-03-06 07:40:00,29,30,18,31,33,141
2024-03-06 07:50:00,19,28,39,27,34,147
2024-03-06 08:00:00,27,24,19,34,32,136
2024-03-06 08:10:00,25,31,24,29,32,141
2024-03-06 08:20:00,22,31,18,24,35,130
2024-03-06 08:30:00,21,38,24,31,28,142
2024-03-06 08:40:00,18,25,17,34,30,124
2024-03-06 08:50:00,18,25,24,26,27,120
2024-03-06 09:00:00,25,29,18,25,29,126
2024-03-06 09:10:00,26,35,16,36,27,140
2024-03-06 09:20:00,22,27,18,24,22,113
2024-03-06 09:30:00,18,25,13,29,24,109
2024-03-06 09:40:00,20,29,13,29,31,122
2024-03-06 09:50:00,17,30,13,30,20,110
2024-03-06 10:00:00,35,23,18,28,20,124
2024-03-06 10:10:00,16,26,7,34,24,107
2024-03-06 10:20:00,26,27,12,23,18,106
2024-03-06 10:30:00,17,28,11,27,18,101
2024-03-06 10:40:00,26,24,14,24,23,111
2024-03-06 10:50:00,19,22,9,30,27,107
2024-03-06 11:00:00,19,22,9,26,21,97
2024-03-06 11:10:00,19,41,14,29,20,123
2024-03-06 11:20:00,23,34,17,34,24,132
2024-03-06 11:30:00,27,23,12,27,22,111
2024-03-06 11:40:00,24,36,13,29,21,123
2024-03-06 11:50:00,22,31,11,26,21,111
2024-03-06 12:00:00,27,29,15,29,26,126
2024-03-06 12:10:00,23,21,14,27,25,110
2024-03-06 12:20:00,17,33,15,38,25,128
2024-03-06 12:30:00,21,23,12,29,24,109
2024-03-06 12:40:00,20,26,15,30,18,109
2024-03-06 12:50:00,20,24,14,22,21,101
2024-03-06 13:00:00,18,23,23,27,19,110
2024-03-06 13:10:00,19,37,19,29,20,124
2024-03-06 13:20:00,20,20,18,28,26,112
2024-03-06 13:30:00,21,25,13,35,27,121
2024-03-06 13:40:00,28,19,11,23,18,99
2024-03-06 13:50:00,12,27,13,47,18,117
2024-03-06 14:00:00,17,28,15,34,26,120
2024-03-06 14:10:00,24,34,23,32,27,140
2024-03-06 14:20:00,17,22,18,31,30,118
2024-03-06 14:30:00,17,30,15,25,17,104
2024-03-06 14:40:00,22,30,16,35,27,130
2024-03-06 14:50:00,23,27,21,31,28,130
2024-03-06 15:00:00,23,28,18,27,33,129
2024-03-06 15:10:00,18,32,17,30,24,121
2024-03-06 15:20:00,17,37,18,26,25,123
2024-03-06 15:30:00,23,27,21,31,30,132
2024-03-06 15:40:00,22,32,20,25,32,131
2024-03-06 15:50:00,24,43,21,25,32,145
2024-03-06 16:00:00,20,35,14,33,29,131
2024-03-06 16:10:00,28,35,22,27,33,145
2024-03-06 16:20:00,26,34,22,35,26,143
2024-03-06 16:30:00,26,38,21,38,37,160
2024-03-06 16:40:00,38,39,27,32,29,165
2024-03-06 16:50:00,22,31,22,22,21,118
2024-03-06 17:00:00,24,27,24,31,29,135
2024-03-06 17:10:00,25,36,26,32,26,145
2024-03-06 17:20:00,24,35,27,25,32,143
2024-03-06 17:30:00,22,40,23,39,38,162
2024-03-06 17:40:00,21,31,14,31,28,125
2024-03-06 17:50:00,16,39,17,31,30,133
2024-03-06 18:00:00,18,25,19,30,33,125
2024-03-06 18:10:00,21,22,15,26,34,118
2024-03-06 18:20:00,20,33,15,31,28,127
2024-03-06 18:30:00,32,44,29,22,30,157
2024-03-06 18:40:00,29,38,32,27,31,157
2024-03-06 18:50:00,42,39,19,39,28,167
2024-03-06 19:00:00,30,22,26,33,33,144
2024-03-06 19:10:00,33,40,16,28,25,142
2024-03-06 19:20:00,26,27,25,32,28,138
2024-03-06 19:30:00,21,25,23,28,45,142
2024-03-06 19:40:00,24,26,25,37,32,144
2024-03-06 19:50:00,15,27,15,33,27,117
2024-03-06 20:00:00,17,23,20,30,30,120
2024-03-06 20:10:00,16,17,13,31,21,98
2024-03-06 20:20:00,25,30,26,30,23,134
2024-03-06 20:30:00,15,16,22,24,26,103
2024-03-06 20:40:00,30,19,9,31,21,110
2024-03-06 20:50:00,11,21,9,25,30,96
2024-03-06 21:00:00,12,30,10,37,27,116
2024-03-06 21:10:00,14,32,11,25,29,111
2024-03-06 21:20:00,21,29,24,20,26,120
2024-03-06 21:30:00,8,16,16,24,20,84
2024-03-06 21:40:00,23,21,13,18,16,91
2024-03-06 21:50:00,7,32,14,20,28,101
2024-03-06 22:00:00,6,32,13,27,24,102
2024-03-06 22:10:00,7,29,15,18,32,101
2024-03-06 22:20:00,6,18,7,25,19,75
2024-03-06 22:30:00,11,25,4,23,21,84
2024-03-06 22:40:00,8,15,2,15,19,59
2024-03-06 22:50:00,6,10,7,21,21,65
2024-03-06 23:00:00,8,8,5,21,19,61
2024-03-06 23:10:00,12,9,4,20,19,64
2024-03-06 23:20:00,8,17,5,14,6,50
2024-03-06 23:30:00,6,13,5,11,15,50
2024-03-06 23:40:00,5,8,2,5,21,41
2024-03-06 23:50:00,3,3,8,9,14,37
2024-03-07 00:00:00,4,10,3,8,12,37
2024-03-07 00:10:00,5,12,4,5,7,33
2024-03-07 00:20:00,2,10,2,3,6,23
2024-03-07 00:30:00,9,1,0,4,7,21
2024-03-07 00:40:00,3,5,5,7,4,24
2024-03-07 00:50:00,1,3,0,3,9,16
2024-03-07 01:00:00,0,4,3,6,4,17
2024-03-07 01:10:00,0,3,0,5,7,15
2024-03-07 01:20:00,2,1,0,4,3,10
2024-03-07 01:30:00,1,6,0,3,5,15
2024-03-07 01:40:00,2,4,0,5,4,15
2024-03-07 01:50:00,3,2,0,1,5,11
2024-03-07 02:00:00,0,8,0,0,2,10
2024-03-07 02:10:00,0,1,0,4,1,6
2024-03-07 02:20:00,0,2,0,3,1,6
2024-03-07 02:30:00,5,1,0,2,1,9
2024-03-07 02:40:00,3,4,0,2,1,10
2024-03-07 02:50:00,2,3,0,2,0,7
2024-03-07 03:00:00,3,0,0,7,0,10
2024-03-07 03:10:00,0,0,1,2,3,6
2024-03-07 03:20:00,2,0,0,3,3,8
2024-03-07 03:30:00,0,4,0,3,1,8
2024-03-07 03:40:00,2,1,0,2,0,5
2024-03-07 03:50:00,0,1,0,4,1,6
2024-03-07 04:00:00,3,4,0,4,1,12
2024-03-07 04:10:00,1,0,0,7,1,9
2024-03-07 04:20:00,6,1,0,4,3,14
2024-03-07 04:30:00,2,5,0,2,1,10
2024-03-07 04:40:00,6,6,3,2,10,27
2024-03-07 04:50:00,6,7,0,6,11,30
2024-03-07 05:00:00,17,10,3,5,11,46
2024-03-07 05:10:00,11,9,10,17,18,65
2024-03-07 05:20:00,14,10,9,12,12,57
2024-03-07 05:30:00,14,17,10,12,19,72
2024-03-07 05:40:00,41,25,7,13,22,108
2024-03-07 05:50:00,20,18,12,13,21,84
2024-03-07 06:00:00,30,35,6,12,9,92
2024-03-07 06:10:00,30,26,13,22,23,114
2024-03-07 06:20:00,40,19,3,17,15,94
2024-03-07 06:30:00,34,19,13,19,19,104
2024-03-07 06:40:00,19,26,10,20,25,100
2024-03-07 06:50:00,21,26,13,25,25,110
2024-03-07 07:00:00,14,16,11,17,12,70
2024-03-07 07:10:00,0,0,0,0,0,0
2024-03-07 07:20:00,3,5,3,4,4,19
2024-03-07 07:30:00,21,26,17,23,19,106
2024-03-07 07:40:00,23,33,21,32,22,131
2024-03-07 07:50:00,25,27,19,31,31,133
2024-03-07 08:00:00,23,30,26,32,27,138
2024-03-07 08:10:00,16,37,18,29,28,128
2024-03-07 08:20:00,24,26,20,30,33,133
2024-03-07 08:30:00,27,24,17,27,23,118
2024-03-07 08:40:00,28,24,15,35,27,129
2024-03-07 08:50:00,18,27,15,25,18,103
2024-03-07 09:00:00,21,28,17,21,30,117
2024-03-07 09:10:00,13,33,18,26,28,118
2024-03-07 09:20:00,23,31,18,23,20,115
2024-03-07 09:30:00,24,23,15,30,29,121
2024-03-07 09:40:00,25,38,21,27,25,136
2024-03-07 09:50:00,24,29,17,27,22,119
2024-03-07 10:00:00,20,22,11,29,21,103
2024-03-07 10:10:00,23,30,17,29,24,123
2024-03-07 10:20:00,19,27,18,27,20,111
2024-03-07 10:30:00,28,23,10,26,20,107
2024-03-07 10:40:00,20,23,12,24,20,99
2024-03-07 10:50:00,18,29,12,30,20,109
2024-03-07 11:00:00,15,30,15,24,21,105
2024-03-07 11:10:00,17,25,12,29,26,109
2024-03-07 11:20:00,19,27,17,29,23,115
2024-03-07 11:30:00,15,27,15,26,29,112
2024-03-07 11:40:00,23,30,14,32,29,128
2024-03-07 11:50:00,20,22,13,28,20,103
2024-03-07 12:00:00,23,36,21,13,28,121
2024-03-07 12:10:00,20,28,15,29,21,113
2024-03-07 12:20:00,26,29,14,31,25,125
2024-03-07 12:30:00,24,24,19,30,25,122
2024-03-07 12:40:00,20,32,14,28,22,116
2024-03-07 12:50:00,16,21,23,34,26,120
2024-03-07 13:00:00,25,28,15,38,28,134
2024-03-07 13:10:00,25,35,21,35,24,140
2024-03-07 13:20:00,18,30,16,30,35,129
2024-03-07 13:30:00,22,25,12,29,23,111
2024-03-07 13:40:00,16,26,16,27,29,114
2024-03-07 13:50:00,23,28,20,30,23,124
2024-03-07 14:00:00,14,18,7,31,19,89
2024-03-07 14:10:00,22,34,21,25,28,130
2024-03-07 14:20:00,21,22,40,30,31,144
2024-03-07 14:30:00,23,45,20,29,34,151
2024-03-07 14:40:00,23,47,19,30,21,140
2024-03-07 14:50:00,19,38,17,46,33,153
2024-03-07 15:00:00,26,27,17,37,31,138
2024-03-07 15:10:00,27,30,18,26,23,124
2024-03-07 15:20:00,28,23,22,22,21,116
2024-03-07 15:30:00,22,29,27,34,28,140
2024-03-07 15:40:00,21,32,15,32,29,129
2024-03-07 15:50:00,28,34,20,28,26,136
2024-03-07 16:00:00,25,37,18,28,22,130
2024-03-07 16:10:00,24,24,29,28,24,129
2024-03-07 16:20:00,18,32,23,32,30,135
2024-03-07 16:30:00,23,34,20,28,28,133
2024-03-07 16:40:00,25,35,18,32,32,142
2024-03-07 16:50:00,29,27,20,29,33,138
2024-03-07 17:00:00,27,32,25,39,36,159
2024-03-07 17:10:00,24,32,18,31,29,134
2024-03-07 17:20:00,25,32,23,35,35,150
2024-03-07 17:30:00,27,30,19,35,28,139
2024-03-07 17:40:00,31,29,21,25,25,131
2024-03-07 17:50:00,24,30,12,23,34,123
2024-03-07 18:00:00,21,23,15,32,33,124
2024-03-07 18:10:00,19,30,15,31,29,124
2024-03-07 18:20:00,25,35,17,34,31,142
2024-03-07 18:30:00,26,37,19,26,30,138
2024-03-07 18:40:00,29,36,30,34,27,156
2024-03-07 18:50:00,27,35,22,31,37,152
2024-03-07 19:00:00,18,36,25,37,30,146
2024-03-07 19:10:00,37,43,21,36,29,166
2024-03-07 19:20:00,24,34,27,33,27,145
2024-03-07 19:30:00,21,30,22,31,32,136
2024-03-07 19:40:00,23,30,15,34,41,143
2024-03-07 19:50:00,33,26,25,24,25,133
2024-03-07 20:00:00,27,29,15,33,25,129
2024-03-07 20:10:00,12,33,16,31,28,120
2024-03-07 20:20:00,34,24,9,26,34,127
2024-03-07 20:30:00,17,23,6,36,21,103
2024-03-07 20:40:00,23,26,18,30,30,127
2024-03-07 20:50:00,16,23,12,26,31,108
2024-03-07 21:00:00,27,14,9,32,29,111
2024-03-07 21:10:00,23,16,16,35,25,115
2024-03-07 21:20:00,37,22,10,28,15,112
2024-03-07 21:30:00,22,15,11,20,26,94
2024-03-07 21:40:00,7,14,11,23,22,77
2024-03-07 21:50:00,18,24,11,17,27,97
2024-03-07 22:00:00,18,27,16,22,28,111
2024-03-07 22:10:00,10,24,9,34,21,98
2024-03-07 22:20:00,10,28,1,15,17,71
2024-03-07 22:30:00,7,26,6,21,20,80
2024-03-07 22:40:00,12,18,11,20,10,71
2024-03-07 22:50:00,16,12,3,12,16,59
2024-03-07 23:00:00,3,13,10,20,17,63
2024-03-07 23:10:00,14,10,7,22,12,65
2024-03-07 23:20:00,9,22,3,9,21,64
2024-03-07 23:30:00,7,10,0,10,24,51
2024-03-07 23:40:00,1,18,3,12,5,39
2024-03-07 23:50:00,5,7,0,5,12,29
2024-03-08 00:00:00,8,7,5,7,14,41
2024-03-08 00:10:00,7,7,1,13,8,36
2024-03-08 00:20:00,13,3,10,8,13,47
2024-03-08 00:30:00,3,9,2,4,5,23
2024-03-08 00:40:00,2,2,4,6,10,24
2024-03-08 00:50:00,1,7,0,2,7,17
2024-03-08 01:00:00,0,8,3,4,4,19
2024-03-08 01:10:00,0,10,3,3,6,22
2024-03-08 01:20:00,3,0,0,5,4,12
2024-03-08 01:30:00,0,1,1,7,3,12
2024-03-08 01:40:00,2,4,2,1,2,11
2024-03-08 01:50:00,1,4,3,8,3,19
2024-03-08 02:00:00,2,6,0,4,1,13
2024-03-08 02:10:00,0,1,0,2,3,6
2024-03-08 02:20:00,2,2,3,2,1,10
2024-03-08 02:30:00,6,2,0,0,1,9
2024-03-08 02:40:00,3,1,0,1,1,6
2024-03-08 02:50:00,1,2,0,2,2,7
2024-03-08 03:00:00,3,2,1,3,1,10
2024-03-08 03:10:00,0,2,0,2,8,12
2024-03-08 03:20:00,2,1,1,0,0,4
2024-03-08 03:30:00,2,0,0,3,0,5
2024-03-08 03:40:00,4,1,1,1,5,12
2024-03-08 03:50:00,0,3,1,5,0,9
2024-03-08 04:00:00,3,2,0,7,2,14
2024-03-08 04:10:00,1,0,0,4,2,7
2024-03-08 04:20:00,5,10,2,3,0,20
2024-03-08 04:30:00,6,3,0,8,7,24
2024-03-08 04:40:00,14,4,5,4,8,35
2024-03-08 04:50:00,9,4,1,2,10,26
2024-03-08 05:00:00,7,19,4,8,7,45
2024-03-08 05:10:00,14,12,6,11,19,62
2024-03-08 05:20:00,25,5,16,6,11,63
2024-03-08 05:30:00,13,14,14,14,19,74
2024-03-08 05:40:00,28,19,12,9,11,79
2024-03-08 05:50:00,35,18,4,18,27,102
2024-03-08 06:00:00,47,20,9,12,12,100
2024-03-08 06:10:00,32,15,10,18,24,99
2024-03-08 06:20:00,41,24,10,17,11,103
2024-03-08 06:30:00,26,18,12,28,28,112
2024-03-08 06:40:00,23,21,10,22,24,100
2024-03-08 06:50:00,20,21,19,19,23,102
2024-03-08 07:00:00,25,29,13,25,25,117
2024-03-08 07:10:00,16,22,10,26,18,92
2024-03-08 07:20:00,23,32,16,31,25,127
2024-03-08 07:30:00,21,35,14,32,32,134
2024-03-08 07:40:00,17,31,21,25,34,128
2024-03-08 07:50:00,17,27,15,33,37,129
2024-03-08 08:00:00,30,27,18,28,19,122
2024-03-08 08:10:00,20,24,14,26,19,103
2024-03-08 08:20:00,16,26,17,24,32,115
2024-03-08 08:30:00,21,22,15,27,31,116
2024-03-08 08:40:00,16,33,19,24,29,121
2024-03-08 08:50:00,19,34,18,30,27,128
2024-03-08 09:00:00,21,26,15,25,18,105
2024-03-08 09:10:00,25,23,14,26,24,112
2024-03-08 09:20:00,26,29,11,25,21,112
2024-03-08 09:30:00,17,30,14,24,24,109
2024-03-08 09:40:00,23,25,22,29,29,128
2024-03-08 09:50:00,24,24,17,18,27,110
2024-03-08 10:00:00,22,35,14,29,27,127
2024-03-08 10:10:00,18,28,9,36,20,111
2024-03-08 10:20:00,18,28,15,31,25,117
2024-03-08 10:30:00,24,30,18,29,27,128
2024-03-08 10:40:00,27,35,18,34,33,147
2024-03-08 10:50:00,18,31,18,34,17,118
2024-03-08 11:00:00,25,32,18,30,21,126
2024-03-08 11:10:00,20,20,11,23,19,93
2024-03-08 11:20:00,22,21,9,34,25,111
2024-03-08 11:30:00,15,35,14,27,23,114
2024-03-08 11:40:00,13,29,24,26,31,123
2024-03-08 11:50:00,17,26,21,32,31,127
2024-03-08 12:00:00,22,25,18,24,24,113
2024-03-08 12:10:00,19,33,18,35,26,131
2024-03-08 12:20:00,18,30,10,29,29,116
2024-03-08 12:30:00,24,35,19,27,22,127
2024-03-08 12:40:00,22,37,23,32,29,143
2024-03-08 12:50:00,18,30,22,30,28,128
2024-03-08 13:00:00,23,29,21,27,27,127
2024-03-08 13:10:00,17,29,22,30,28,126
2024-03-08 13:20:00,24,34,19,29,25,131
2024-03-08 13:30:00,17,37,16,33,34,137
2024-03-08 13:40:00,28,33,22,27,24,134
2024-03-08 13:50:00,32,33,21,18,33,137
2024-03-08 14:00:00,32,35,20,31,41,159
2024-03-08 14:10:00,28,32,23,31,35,149
2024-03-08 14:20:00,28,28,25,31,24,136
2024-03-08 14:30:00,22,34,17,28,28,129
2024-03-08 14:40:00,27,31,24,33,25,140
2024-03-08 14:50:00,28,31,21,24,29,133
2024-03-08 15:00:00,27,34,32,28,31,152
2024-03-08 15:10:00,29,40,19,22,33,143
2024-03-08 15:20:00,26,33,12,33,32,136
2024-03-08 15:30:00,21,32,22,33,27,135
2024-03-08 15:40:00,36,34,19,27,34,150
2024-03-08 15:50:00,27,24,21,32,25,129
2024-03-08 16:00:00,21,36,18,33,33,141
2024-03-08 16:10:00,25,28,17,25,22,117
2024-03-08 16:20:00,19,38,29,30,30,146
2024-03-08 16:30:00,24,33,19,29,29,134
2024-03-08 16:40:00,21,26,15,22,25,109
2024-03-08 16:50:00,18,27,12,31,25,113
2024-03-08 17:00:00,29,28,18,26,26,127
2024-03-08 17:10:00,26,30,18,32,27,133
2024-03-08 17:20:00,17,27,15,23,31,113
2024-03-08 17:30:00,23,29,15,35,30,132
2024-03-08 17:40:00,17,29,16,31,32,125
2024-03-08 17:50:00,25,30,17,28,26,126
2024-03-08 18:00:00,21,30,17,25,33,126
2024-03-08 18:10:00,25,20,21,34,23,123
2024-03-08 18:20:00,21,30,11,36,28,126
2024-03-08 18:30:00,31,32,27,36,30,156
2024-03-08 18:40:00,27,37,23,37,25,149
2024-03-08 18:50:00,36,29,20,22,46,153
2024-03-08 19:00:00,25,30,24,35,44,158
2024-03-08 19:10:00,24,35,11,33,30,133
2024-03-08 19:20:00,32,35,22,31,41,161
2024-03-08 19:30:00,16,38,17,27,42,140
2024-03-08 19:40:00,24,34,27,32,36,153
2024-03-08 19:50:00,26,34,18,34,32,144
2024-03-08 20:00:00,24,28,12,26,18,108
2024-03-08 20:10:00,29,35,24,24,34,146
2024-03-08 20:20:00,23,28,20,26,21,118
2024-03-08 20:30:00,18,24,17,29,28,116
2024-03-08 20:40:00,19,17,4,37,33,110
2024-03-08 20:50:00,21,23,20,28,27,119
2024-03-08 21:00:00,31,27,9,31,32,130
2024-03-08 21:10:00,16,27,8,23,30,104
2024-03-08 21:20:00,15,21,17,29,28,110
2024-03-08 21:30:00,15,22,14,27,30,108
2024-03-08 21:40:00,15,22,13,27,23,100
2024-03-08 21:50:00,21,21,14,28,26,110
2024-03-08 22:00:00,18,27,12,24,25,106
2024-03-08 22:10:00,13,21,12,21,28,95
2024-03-08 22:20:00,19,32,15,16,23,105
2024-03-08 22:30:00,19,22,4,20,23,88
2024-03-08 22:40:00,14,26,12,21,29,102
2024-03-08 22:50:00,14,19,4,26,26,89
2024-03-08 23:00:00,16,22,9,25,33,105
2024-03-08 23:10:00,6,25,12,17,16,76
2024-03-08 23:20:00,20,19,13,20,19,91
2024-03-08 23:30:00,9,14,7,15,14,59
2024-03-08 23:40:00,6,7,8,24,23,68
2024-03-08 23:50:00,10,22,7,16,15,70
2024-03-09 00:00:00,15,17,3,14,21,70
2024-03-09 00:10:00,18,13,8,14,21,74
2024-03-09 00:20:00,5,17,9,16,14,61
2024-03-09 00:30:00,13,14,8,12,13,60
2024-03-09 00:40:00,9,11,7,13,14,54
2024-03-09 00:50:00,7,9,5,15,9,45
2024-03-09 01:00:00,0,6,5,8,15,34
2024-03-09 01:10:00,11,9,3,4,13,40
2024-03-09 01:20:00,4,13,6,11,9,43
2024-03-09 01:30:00,5,6,4,7,8,30
2024-03-09 01:40:00,6,12,10,8,11,47
2024-03-09 01:50:00,5,6,1,8,7,27
2024-03-09 02:00:00,0,5,1,3,9,18
2024-03-09 02:10:00,10,4,1,6,8,29
2024-03-09 02:20:00,6,3,2,4,2,17
2024-03-09 02:30:00,2,6,0,3,5,16
2024-03-09 02:40:00,3,8,0,11,3,25
2024-03-09 02:50:00,5,3,0,8,6,22
2024-03-09 03:00:00,1,2,0,9,9,21
2024-03-09 03:10:00,1,7,2,2,5,17
2024-03-09 03:20:00,0,6,0,4,1,11
2024-03-09 03:30:00,1,7,2,4,5,19
2024-03-09 03:40:00,0,1,0,6,1,8
2024-03-09 03:50:00,1,3,0,2,2,8
2024-03-09 04:00:00,2,6,1,9,3,21
2024-03-09 04:10:00,1,1,1,2,3,8
2024-03-09 04:20:00,0,0,0,0,0,0
2024-03-09 04:30:00,3,3,2,3,3,14
2024-03-09 04:40:00,2,5,1,6,4,18
2024-03-09 04:50:00,0,0,0,0,0,0
2024-03-09 05:00:00,1,1,1,1,1,5
2024-03-09 05:10:00,2,3,2,7,7,21
2024-03-09 05:20:00,5,12,3,4,6,30
2024-03-09 05:30:00,9,11,8,6,7,41
2024-03-09 05:40:00,9,10,3,13,7,42
2024-03-09 05:50:00,15,5,5,2,3,30
2024-03-09 06:00:00,3,6,3,10,3,25
2024-03-09 06:10:00,5,12,2,10,9,38
2024-03-09 06:20:00,13,10,5,8,4,40
2024-03-09 06:30:00,6,6,2,6,6,26
2024-03-09 06:40:00,9,6,1,10,9,35
2024-03-09 06:50:00,6,9,2,6,6,29
2024-03-09 07:00:00,8,10,2,9,3,32
2024-03-09 07:10:00,11,7,2,10,5,35
2024-03-09 07:20:00,7,5,3,13,2,30
2024-03-09 07:30:00,11,12,3,9,10,45
2024-03-09 07:40:00,13,17,2,15,10,57
2024-03-09 07:50:00,17,12,4,17,9,59
2024-03-09 08:00:00,11,14,3,19,10,57
2024-03-09 08:10:00,11,14,3,14,13,55
2024-03-09 08:20:00,20,15,16,21,9,81
2024-03-09 08:30:00,21,14,8,22,11,76
2024-03-09 08:40:00,17,16,7,19,11,70
2024-03-09 08:50:00,13,15,7,22,14,71
2024-03-09 09:00:00,13,22,8,19,16,78
2024-03-09 09:10:00,11,22,12,25,17,87
2024-03-09 09:20:00,19,19,7,21,19,85
2024-03-09 09:30:00,23,26,10,21,16,96
2024-03-09 09:40:00,21,25,9,26,24,105
2024-03-09 09:50:00,16,24,7,31,25,103
2024-03-09 10:00:00,18,31,11,25,25,110
2024-03-09 10:10:00,22,21,18,21,18,100
2024-03-09 10:20:00,12,21,13,23,19,88
2024-03-09 10:30:00,25,27,13,19,32,116
2024-03-09 10:40:00,20,27,17,30,28,122
2024-03-09 10:50:00,23,24,16,29,19,111
2024-03-09 11:00:00,18,23,13,19,23,96
2024-03-09 11:10:00,23,32,14,24,24,117
2024-03-09 11:20:00,16,22,8,28,28,102
2024-03-09 11:30:00,17,22,12,26,29,106
2024-03-09 11:40:00,18,27,12,26,25,108
2024-03-09 11:50:00,17,27,14,33,30,121
2024-03-09 12:00:00,28,29,16,29,22,124
2024-03-09 12:10:00,21,32,18,29,28,128
2024-03-09 12:20:00,22,28,11,25,19,105
2024-03-09 12:30:00,14,25,13,27,33,112
2024-03-09 12:40:00,17,26,14,26,20,103
2024-03-09 12:50:00,23,24,16,28,29,120
2024-03-09 13:00:00,23,27,14,28,23,115
2024-03-09 13:10:00,27,33,16,30,31,137
2024-03-09 13:20:00,14,27,11,29,25,106
2024-03-09 13:30:00,18,34,16,27,23,118
2024-03-09 13:40:00,22,31,13,34,27,127
2024-03-09 13:50:00,24,27,11,35,34,131
2024-03-09 14:00:00,28,23,15,33,23,122
2024-03-09 14:10:00,17,30,15,32,23,117
2024-03-09 14:20:00,17,21,15,25,26,104
2024-03-09 14:30:00,23,37,16,23,27,126
2024-03-09 14:40:00,22,32,15,28,23,120
2024-03-09 14:50:00,14,32,14,20,21,101
2024-03-09 15:00:00,18,27,15,27,25,112
2024-03-09 15:10:00,24,23,12,37,24,120
2024-03-09 15:20:00,12,21,17,22,27,99
2024-03-09 15:30:00,15,25,12,33,25,110
2024-03-09 15:40:00,14,24,12,35,30,115
2024-03-09 15:50:00,17,27,9,31,27,111
2024-03-09 16:00:00,22,25,10,36,20,113
2024-03-09 16:10:00,18,30,12,27,25,112
2024-03-09 16:20:00,26,29,18,31,28,132
2024-03-09 16:30:00,16,20,12,21,17,86
2024-03-09 16:40:00,21,23,10,25,13,92
2024-03-09 16:50:00,19,28,10,26,24,107
2024-03-09 17:00:00,19,22,12,38,21,112
2024-03-09 17:10:00,22,26,11,26,26,111
2024-03-09 17:20:00,16,28,13,33,25,115
2024-03-09 17:30:00,14,24,12,29,27,106
2024-03-09 17:40:00,21,23,9,24,19,96
2024-03-09 17:50:00,14,27,15,26,29,111
2024-03-09 18:00:00,25,25,14,35,24,123
2024-03-09 18:10:00,20,22,15,29,17,103
2024-03-09 18:20:00,20,28,14,24,26,112
2024-03-09 18:30:00,24,36,15,23,30,128
2024-03-09 18:40:00,21,36,16,19,40,132
2024-03-09 18:50:00,29,30,22,37,34,152
2024-03-09 19:00:00,41,21,11,33,30,136
2024-03-09 19:10:00,35,29,12,38,34,148
2024-03-09 19:20:00,28,33,15,26,26,128
2024-03-09 19:30:00,25,27,22,29,21,124
2024-03-09 19:40:00,28,33,10,19,27,117
2024-03-09 19:50:00,21,37,24,34,33,149
2024-03-09 20:00:00,21,19,15,28,27,110
2024-03-09 20:10:00,23,18,24,38,27,130
2024-03-09 20:20:00,19,30,20,28,28,125
2024-03-09 20:30:00,22,24,5,26,32,109
2024-03-09 20:40:00,16,24,7,19,27,93
2024-03-09 20:50:00,21,21,15,22,32,111
2024-03-09 21:00:00,18,18,17,25,29,107
2024-03-09 21:10:00,8,21,11,25,13,78
2024-03-09 21:20:00,12,23,7,38,30,110
2024-03-09 21:30:00,11,18,15,31,16,91
2024-03-09 21:40:00,9,30,13,24,13,89
2024-03-09 21:50:00,11,20,8,27,18,84
2024-03-09 22:00:00,20,24,9,19,26,98
2024-03-09 22:10:00,16,30,7,14,35,102
2024-03-09 22:20:00,13,19,18,22,20,92
2024-03-09 22:30:00,11,21,10,26,24,92
2024-03-09 22:40:00,9,25,5,21,24,84
2024-03-09 22:50:00,13,18,7,18,27,83
2024-03-09 23:00:00,8,24,9,15,21,77
2024-03-09 23:10:00,2,17,9,20,16,64
2024-03-09 23:20:00,14,17,7,15,17,70
2024-03-09 23:30:00,12,19,5,17,17,70
2024-03-09 23:40:00,4,13,8,16,18,59
2024-03-09 23:50:00,6,21,8,16,23,74
2024-03-10 00:00:00,9,21,5,16,22,73
2024-03-10 00:10:00,5,20,1,15,15,56
2024-03-10 00:20:00,5,10,5,12,20,52
2024-03-10 00:30:00,7,10,8,8,12,45
2024-03-10 00:40:00,13,10,4,14,6,47
2024-03-10 00:50:00,6,17,9,7,19,58
2024-03-10 01:00:00,2,17,12,7,12,50
2024-03-10 01:10:00,6,11,11,7,5,40
2024-03-10 01:20:00,12,13,1,11,16,53
2024-03-10 01:30:00,2,14,1,10,11,38
2024-03-10 01:40:00,6,13,5,3,5,32
2024-03-10 01:50:00,3,9,3,8,5,28
2024-03-10 02:00:00,5,7,3,8,5,28
2024-03-10 02:10:00,2,7,0,9,2,20
2024-03-10 02:20:00,1,5,0,9,4,19
2024-03-10 02:30:00,3,13,1,7,1,25
2024-03-10 02:40:00,2,5,1,10,7,25
2024-03-10 02:50:00,0,8,3,1,1,13
2024-03-10 03:00:00,1,2,7,5,5,20
2024-03-10 03:10:00,1,3,0,7,0,11
2024-03-10 03:20:00,3,3,1,2,3,12
2024-03-10 03:30:00,3,3,0,10,5,21
2024-03-10 03:40:00,8,7,2,3,4,24
2024-03-10 03:50:00,1,1,4,5,7,18
2024-03-10 04:00:00,1,8,0,9,2,20
2024-03-10 04:10:00,0,5,3,3,3,14
2024-03-10 04:20:00,4,1,0,6,3,14
2024-03-10 04:30:00,6,4,3,6,1,20
2024-03-10 04:40:00,7,4,0,6,2,19
2024-03-10 04:50:00,5,4,1,4,5,19
2024-03-10 05:00:00,0,7,4,0,3,14
2024-03-10 05:10:00,5,4,0,2,11,22
2024-03-10 05:20:00,2,11,0,1,10,24
2024-03-10 05:30:00,6,2,5,5,6,24
2024-03-10 05:40:00,7,13,3,6,2,31
2024-03-10 05:50:00,4,18,3,6,2,33
2024-03-10 06:00:00,5,4,3,4,7,23
2024-03-10 06:10:00,2,9,1,2,6,20
2024-03-10 06:20:00,6,10,3,5,1,25
2024-03-10 06:30:00,1,11,3,6,5,26
2024-03-10 06:40:00,2,10,0,6,2,20
2024-03-10 06:50:00,1,2,1,10,5,19
2024-03-10 07:00:00,2,7,2,4,1,16
2024-03-10 07:10:00,1,4,0,6,3,14
2024-03-10 07:20:00,1,1,1,6,1,10
2024-03-10 07:30:00,2,3,1,6,4,16
2024-03-10 07:40:00,2,6,1,8,6,23
2024-03-10 07:50:00,4,3,2,7,4,20
2024-03-10 08:00:00,4,5,3,7,3,22
2024-03-10 08:10:00,2,6,1,7,7,23
2024-03-10 08:20:00,0,6,1,6,2,15
2024-03-10 08:30:00,1,3,1,11,8,24
2024-03-10 08:40:00,1,5,4,11,8,29
2024-03-10 08:50:00,6,14,5,7,3,35
2024-03-10 09:00:00,7,9,4,14,8,42
2024-03-10 09:10:00,13,11,3,15,7,49
2024-03-10 09:20:00,9,18,3,13,11,54
2024-03-10 09:30:00,15,11,8,19,13,66
2024-03-10 09:40:00,10,17,6,13,14,60
2024-03-10 09:50:00,13,13,7,21,16,70
2024-03-10 10:00:00,8,20,9,18,9,64
2024-03-10 10:10:00,12,23,7,20,15,77
2024-03-10 10:20:00,7,18,3,25,9,62
2024-03-10 10:30:00,12,17,11,14,11,65
2024-03-10 10:40:00,12,17,11,27,12,79
2024-03-10 10:50:00,11,24,8,19,6,68
2024-03-10 11:00:00,9,21,6,26,10,72
2024-03-10 11:10:00,13,26,6,27,15,87
2024-03-10 11:20:00,15,20,8,23,10,76
2024-03-10 11:30:00,11,24,12,23,16,86
2024-03-10 11:40:00,12,22,9,33,16,92
2024-03-10 11:50:00,11,29,11,23,17,91
2024-03-10 12:00:00,17,23,10,23,20,93
2024-03-10 12:10:00,16,29,10,25,16,96
2024-03-10 12:20:00,12,25,12,29,19,97
2024-03-10 12:30:00,17,25,8,29,27,106
2024-03-10 12:40:00,7,28,12,23,22,92
2024-03-10 12:50:00,14,23,14,27,21,99
2024-03-10 13:00:00,13,28,10,24,22,97
2024-03-10 13:10:00,18,28,7,21,19,93
2024-03-10 13:20:00,13,24,11,23,20,91
2024-03-10 13:30:00,10,27,12,33,20,102
2024-03-10 13:40:00,15,30,8,22,15,90
2024-03-10 13:50:00,9,28,14,27,21,99
2024-03-10 14:00:00,10,29,14,30,19,102
2024-03-10 14:10:00,10,31,12,30,21,104
2024-03-10 14:20:00,9,21,14,25,23,92
2024-03-10 14:30:00,15,27,11,29,27,109
2024-03-10 14:40:00,12,30,16,27,19,104
2024-03-10 14:50:00,14,20,10,30,24,98
2024-03-10 15:00:00,23,31,10,29,23,116
2024-03-10 15:10:00,24,24,14,29,23,114
2024-03-10 15:20:00,11,32,16,26,25,110
2024-03-10 15:30:00,13,29,12,32,22,108
2024-03-10 15:40:00,12,25,10,29,23,99
2024-03-10 15:50:00,13,20,10,29,25,97
2024-03-10 16:00:00,19,26,13,33,34,125
2024-03-10 16:10:00,23,26,13,31,19,112
2024-03-10 16:20:00,23,28,14,29,24,118
2024-03-10 16:30:00,27,28,19,23,16,113
2024-03-10 16:40:00,21,30,16,29,17,113
2024-03-10 16:50:00,18,25,12,25,24,104
2024-03-10 17:00:00,16,24,9,24,22,95
2024-03-10 17:10:00,13,22,12,31,23,101
2024-03-10 17:20:00,11,29,17,32,24,113
2024-03-10 17:30:00,13,25,19,30,19,106
2024-03-10 17:40:00,8,23,11,25,20,87
2024-03-10 17:50:00,11,34,16,28,19,108
2024-03-10 18:00:00,20,19,7,25,22,93
2024-03-10 18:10:00,12,26,10,27,25,100
2024-03-10 18:20:00,10,26,16,23,20,95
2024-03-10 18:30:00,22,33,15,38,32,140
2024-03-10 18:40:00,20,26,22,30,34,132
2024-03-10 18:50:00,15,31,11,32,28,117
2024-03-10 19:00:00,14,34,9,25,24,106
2024-03-10 19:10:00,19,40,15,26,20,120
2024-03-10 19:20:00,25,33,17,24,30,129
2024-03-10 19:30:00,16,30,15,26,23,110
2024-03-10 19:40:00,22,30,22,22,23,119
2024-03-10 19:50:00,29,34,20,14,31,128
2024-03-10 20:00:00,19,22,20,22,30,113
2024-03-10 20:10:00,22,23,19,26,23,113
2024-03-10 20:20:00,10,30,18,16,17,91
2024-03-10 20:30:00,15,24,10,15,19,83
2024-03-10 20:40:00,20,24,17,23,21,105
2024-03-10 20:50:00,16,30,12,19,27,104
2024-03-10 21:00:00,19,20,7,25,24,95
2024-03-10 21:10:00,21,18,14,26,19,98
2024-03-10 21:20:00,22,19,11,19,33,104
2024-03-10 21:30:00,6,17,12,30,24,89
2024-03-10 21:40:00,14,17,9,24,20,84
2024-03-10 21:50:00,16,17,3,20,26,82
2024-03-10 22:00:00,3,17,14,11,22,67
2024-03-10 22:10:00,16,6,8,11,26,67
2024-03-10 22:20:00,13,18,7,16,14,68
2024-03-10 22:30:00,8,11,2,17,21,59
2024-03-10 22:40:00,5,13,2,13,11,44
2024-03-10 22:50:00,2,9,3,16,10,40
2024-03-10 23:00:00,2,9,2,15,7,35
2024-03-10 23:10:00,3,9,0,13,10,35
2024-03-10 23:20:00,4,11,1,13,11,40
2024-03-10 23:30:00,3,9,1,7,8,28
2024-03-10 23:40:00,3,5,3,14,16,41
2024-03-10 23:50:00,4,7,1,7,4,23
2024-03-11 00:00:00,3,5,1,7,5,21
2024-03-11 00:10:00,2,4,1,14,6,27
2024-03-11 00:20:00,3,7,2,12,8,32
2024-03-11 00:30:00,1,6,0,8,4,19
2024-03-11 00:40:00,4,6,1,11,6,28
2024-03-11 00:50:00,2,3,0,10,8,23
2024-03-11 01:00:00,0,5,1,10,6,22
2024-03-11 01:10:00,3,7,0,4,6,20
2024-03-11 01:20:00,1,5,2,3,4,15
2024-03-11 01:30:00,2,4,0,4,4,14
2024-03-11 01:40:00,2,4,0,1,2,9
2024-03-11 01:50:00,1,1,0,4,3,9
2024-03-11 02:00:00,4,3,0,0,0,7
2024-03-11 02:10:00,0,0,1,5,3,9
2024-03-11 02:20:00,0,2,0,1,1,4
2024-03-11 02:30:00,1,1,1,1,2,6
2024-03-11 02:40:00,2,2,1,2,2,9
2024-03-11 02:50:00,1,2,0,3,3,9
2024-03-11 03:00:00,1,1,0,4,0,6
2024-03-11 03:10:00,0,1,0,2,0,3
2024-03-11 03:20:00,1,2,0,3,2,8
2024-03-11 03:30:00,2,6,1,0,0,9
2024-03-11 03:40:00,1,1,0,3,1,6
2024-03-11 03:50:00,1,2,0,3,3,9
2024-03-11 04:00:00,3,4,0,3,3,13
2024-03-11 04:10:00,4,7,1,6,3,21
2024-03-11 04:20:00,3,6,1,5,0,15
2024-03-11 04:30:00,1,7,0,5,3,16
2024-03-11 04:40:00,4,8,1,7,6,26
2024-03-11 04:50:00,4,12,1,10,4,31
2024-03-11 05:00:00,4,11,3,14,9,41
2024-03-11 05:10:00,10,21,5,18,13,67
2024-03-11 05:20:00,11,18,6,12,12,59
2024-03-11 05:30:00,10,22,4,21,13,70
2024-03-11 05:40:00,14,26,9,21,14,84
2024-03-11 05:50:00,16,24,5,18,14,77
2024-03-11 06:00:00,21,22,7,17,12,79
2024-03-11 06:10:00,17,21,9,19,7,73
2024-03-11 06:20:00,16,31,4,17,13,81
2024-03-11 06:30:00,14,30,7,15,10,76
2024-03-11 06:40:00,14,18,13,24,28,97
2024-03-11 06:50:00,14,39,11,30,26,120
2024-03-11 07:00:00,17,29,14,22,23,105
2024-03-11 07:10:00,34,31,23,25,19,132
2024-03-11 07:20:00,21,31,14,26,20,112
2024-03-11 07:30:00,26,26,25,29,30,136
2024-03-11 07:40:00,20,36,21,33,30,140
2024-03-11 07:50:00,18,37,21,36,35,147
2024-03-11 08:00:00,23,31,25,31,33,143
2024-03-11 08:10:00,20,34,19,31,25,129
2024-03-11 08:20:00,25,27,20,22,21,115
2024-03-11 08:30:00,30,34,21,20,25,130
2024-03-11 08:40:00,30,35,29,34,36,164
2024-03-11 08:50:00,23,24,21,30,31,129
2024-03-11 09:00:00,20,23,21,24,30,118
2024-03-11 09:10:00,24,25,14,33,19,115
2024-03-11 09:20:00,19,27,20,35,30,131
2024-03-11 09:30:00,18,30,23,32,23,126
2024-03-11 09:40:00,17,35,17,30,26,125
2024-03-11 09:50:00,20,30,18,27,23,118
2024-03-11 10:00:00,21,29,13,22,19,104
2024-03-11 10:10:00,16,17,13,31,24,101
2024-03-11 10:20:00,22,24,15,26,28,115
2024-03-11 10:30:00,16,24,8,27,20,95
2024-03-11 10:40:00,19,27,18,28,24,116
2024-03-11 10:50:00,21,33,16,33,26,129
2024-03-11 11:00:00,14,29,8,26,18,95
2024-03-11 11:10:00,24,29,16,32,26,127
2024-03-11 11:20:00,14,22,16,25,22,99
2024-03-11 11:30:00,19,26,17,26,25,113
2024-03-11 11:40:00,21,29,19,24,22,115
2024-03-11 11:50:00,20,22,10,30,48,130
2024-03-11 12:00:00,14,29,8,19,15,85
2024-03-11 12:10:00,23,31,19,22,28,123
2024-03-11 12:20:00,13,30,9,27,24,103
2024-03-11 12:30:00,25,22,9,25,22,103
2024-03-11 12:40:00,20,30,18,32,21,121
2024-03-11 12:50:00,21,30,22,30,20,123
2024-03-11 13:00:00,15,33,14,19,24,105
2024-03-11 13:10:00,18,21,18,32,24,113
2024-03-11 13:20:00,23,29,24,28,28,132
2024-03-11 13:30:00,16,26,13,26,23,104
2024-03-11 13:40:00,16,23,14,26,27,106
2024-03-11 13:50:00,22,25,16,35,29,127
2024-03-11 14:00:00,15,19,13,32,32,111
2024-03-11 14:10:00,22,30,16,16,21,105
2024-03-11 14:20:00,24,28,20,36,29,137
2024-03-11 14:30:00,19,23,21,32,31,126
2024-03-11 14:40:00,14,25,26,29,24,118
2024-03-11 14:50:00,12,35,19,32,24,122
2024-03-11 15:00:00,25,26,16,20,21,108
2024-03-11 15:10:00,28,28,23,25,22,126
2024-03-11 15:20:00,23,25,21,28,26,123
2024-03-11 15:30:00,30,35,30,35,31,161
2024-03-11 15:40:00,17,24,19,26,31,117
2024-03-11 15:50:00,20,30,17,19,19,105
2024-03-11 16:00:00,27,30,19,21,29,126
2024-03-11 16:10:00,30,36,23,35,25,149
2024-03-11 16:20:00,19,32,23,28,19,121
2024-03-11 16:30:00,22,35,23,34,37,151
2024-03-11 16:40:00,16,26,20,25,26,113
2024-03-11 16:50:00,21,31,12,21,21,106
2024-03-11 17:00:00,32,24,27,29,34,146
2024-03-11 17:10:00,25,36,20,34,21,136
2024-03-11 17:20:00,29,27,21,29,28,134
2024-03-11 17:30:00,26,25,24,27,25,127
2024-03-11 17:40:00,23,24,16,23,23,109
2024-03-11 17:50:00,22,33,19,27,29,130
2024-03-11 18:00:00,16,29,23,23,27,118
2024-03-11 18:10:00,18,25,19,34,24,120
2024-03-11 18:20:00,18,27,19,27,24,115
2024-03-11 18:30:00,13,22,16,21,27,99
2024-03-11 18:40:00,28,35,29,22,27,141
2024-03-11 18:50:00,33,31,20,26,32,142
2024-03-11 19:00:00,23,31,23,28,28,133
2024-03-11 19:10:00,18,25,23,31,28,125
2024-03-11 19:20:00,28,42,16,28,34,148
2024-03-11 19:30:00,27,28,18,28,27,128
2024-03-11 19:40:00,26,34,20,27,29,136
2024-03-11 19:50:00,17,37,20,26,36,136
2024-03-11 20:00:00,31,36,15,27,29,138
2024-03-11 20:10:00,18,29,16,25,32,120
2024-03-11 20:20:00,23,21,13,23,20,100
2024-03-11 20:30:00,36,38,11,27,26,138
2024-03-11 20:40:00,18,34,4,23,22,101
2024-03-11 20:50:00,10,25,17,28,35,115
2024-03-11 21:00:00,14,22,19,24,31,110
2024-03-11 21:10:00,29,30,31,23,30,143
2024-03-11 21:20:00,18,38,16,31,34,137
2024-03-11 21:30:00,18,25,5,24,34,106
2024-03-11 21:40:00,18,22,8,24,26,98
2024-03-11 21:50:00,3,12,10,24,37,86
2024-03-11 22:00:00,3,20,16,21,15,75
2024-03-11 22:10:00,7,15,2,25,15,64
2024-03-11 22:20:00,17,23,10,27,25,102
2024-03-11 22:30:00,14,19,6,15,13,67
2024-03-11 22:40:00,12,4,6,15,13,50
2024-03-11 22:50:00,2,10,1,9,13,35
2024-03-11 23:00:00,4,12,6,16,17,55
2024-03-11 23:10:00,5,7,4,13,8,37
2024-03-11 23:20:00,2,12,2,12,9,37
2024-03-11 23:30:00,3,9,4,9,4,29
2024-03-11 23:40:00,7,7,2,3,8,27
2024-03-11 23:50:00,4,3,4,8,12,31
2024-03-12 00:00:00,6,6,3,8,6,29
2024-03-12 00:10:00,0,14,0,5,14,33
2024-03-12 00:20:00,1,3,1,3,7,15
2024-03-12 00:30:00,5,5,0,5,7,22
2024-03-12 00:40:00,8,7,2,5,3,25
2024-03-12 00:50:00,2,4,1,5,3,15
2024-03-12 01:00:00,1,2,1,6,6,16
2024-03-12 01:10:00,0,0,0,0,0,0
2024-03-12 01:20:00,3,1,0,2,1,7
2024-03-12 01:30:00,1,6,3,3,1,14
2024-03-12 01:40:00,1,0,0,1,1,3
2024-03-12 01:50:00,0,1,3,3,0,7
2024-03-12 02:00:00,4,2,1,5,3,15
2024-03-12 02:10:00,3,6,2,3,2,16
2024-03-12 02:20:00,0,7,2,0,1,10
2024-03-12 02:30:00,3,0,0,2,1,6
2024-03-12 02:40:00,0,2,0,1,1,4
2024-03-12 02:50:00,3,3,3,0,0,9
2024-03-12 03:00:00,1,2,0,2,2,7
2024-03-12 03:10:00,0,3,0,2,5,10
2024-03-12 03:20:00,7,0,0,1,2,10
2024-03-12 03:30:00,4,3,0,4,4,15
2024-03-12 03:40:00,1,1,0,2,2,6
2024-03-12 03:50:00,0,4,0,2,3,9
2024-03-12 04:00:00,0,2,0,10,1,13
2024-03-12 04:10:00,4,1,3,3,3,14
2024-03-12 04:20:00,8,0,1,4,1,14
2024-03-12 04:30:00,5,6,0,2,6,19
2024-03-12 04:40:00,6,5,4,5,6,26
2024-03-12 04:50:00,8,3,2,5,6,24
2024-03-12 05:00:00,17,4,8,3,8,40
2024-03-12 05:10:00,17,9,7,10,12,55
2024-03-12 05:20:00,18,6,14,12,11,61
2024-03-12 05:30:00,29,26,7,15,21,98
2024-03-12 05:40:00,27,25,12,14,21,99
2024-03-12 05:50:00,23,24,7,10,26,90
2024-03-12 06:00:00,32,28,2,20,14,96
2024-03-12 06:10:00,36,20,7,17,15,95
2024-03-12 06:20:00,15,20,9,21,28,93
2024-03-12 06:30:00,29,40,16,19,18,122
2024-03-12 06:40:00,17,25,10,29,30,111
2024-03-12 06:50:00,14,23,15,19,27,98
2024-03-12 07:00:00,18,24,12,22,28,104
2024-03-12 07:10:00,19,35,17,27,41,139
2024-03-12 07:20:00,16,31,14,26,34,121
2024-03-12 07:30:00,22,23,20,27,25,117
2024-03-12 07:40:00,25,26,24,31,32,138
2024-03-12 07:50:00,25,28,28,28,39,148
2024-03-12 08:00:00,26,34,13,29,27,129
2024-03-12 08:10:00,21,25,23,34,37,140
2024-03-12 08:20:00,17,29,16,29,22,113
2024-03-12 08:30:00,28,33,21,21,32,135
2024-03-12 08:40:00,22,37,17,32,30,138
2024-03-12 08:50:00,20,33,19,30,23,125
2024-03-12 09:00:00,19,31,25,29,24,128
2024-03-12 09:10:00,18,31,22,31,31,133
2024-03-12 09:20:00,24,42,20,25,29,140
2024-03-12 09:30:00,10,14,13,16,21,74
2024-03-12 09:40:00,14,27,11,21,21,94
2024-03-12 09:50:00,14,15,11,21,18,79
2024-03-12 10:00:00,28,37,22,34,15,136
2024-03-12 10:10:00,16,22,10,18,16,82
2024-03-12 10:20:00,20,26,19,30,20,115
2024-03-12 10:30:00,25,23,18,31,24,121
2024-03-12 10:40:00,26,20,15,24,28,113
2024-03-12 10:50:00,23,24,16,31,29,123
2024-03-12 11:00:00,21,24,14,27,28,114
2024-03-12 11:10:00,20,17,16,24,24,101
2024-03-12 11:20:00,27,28,14,32,25,126
2024-03-12 11:30:00,21,26,17,33,24,121
2024-03-12 11:40:00,21,25,16,25,26,113
2024-03-12 11:50:00,24,25,14,23,15,101
2024-03-12 12:00:00,0,0,0,0,0,0
2024-03-12 12:10:00,2,2,2,2,2,10
2024-03-12 12:20:00,15,18,7,22,27,89
2024-03-12 12:30:00,19,35,11,29,16,110
2024-03-12 12:40:00,17,24,20,30,20,111
2024-03-12 12:50:00,22,26,18,31,25,122
2024-03-12 13:00:00,20,29,16,25,22,112
2024-03-12 13:10:00,17,22,23,44,27,133
2024-03-12 13:20:00,15,29,16,28,26,114
2024-03-12 13:30:00,22,31,16,34,27,130
2024-03-12 13:40:00,22,29,13,34,23,121
2024-03-12 13:50:00,22,38,14,22,19,115
2024-03-12 14:00:00,16,17,14,33,33,113
2024-03-12 14:10:00,19,21,15,30,23,108
2024-03-12 14:20:00,21,31,18,32,28,130
2024-03-12 14:30:00,19,29,15,28,24,115
2024-03-12 14:40:00,22,30,19,21,26,118
2024-03-12 14:50:00,22,33,22,35,24,136
2024-03-12 15:00:00,17,27,21,29,31,125
2024-03-12 15:10:00,30,33,24,29,14,130
2024-03-12 15:20:00,26,38,22,27,27,140
2024-03-12 15:30:00,32,30,21,33,24,140
2024-03-12 15:40:00,21,31,20,32,25,129
2024-03-12 15:50:00,25,36,19,28,27,135
2024-03-12 16:00:00,28,36,15,30,34,143
2024-03-12 16:10:00,25,26,19,32,27,129
2024-03-12 16:20:00,25,34,18,29,26,132
2024-03-12 16:30:00,24,29,21,34,33,141
2024-03-12 16:40:00,18,40,28,29,30,145
2024-03-12 16:50:00,19,34,21,30,32,136
2024-03-12 17:00:00,26,31,26,31,37,151
2024-03-12 17:10:00,20,34,23,35,32,144
2024-03-12 17:20:00,29,38,14,32,32,145
2024-03-12 17:30:00,22,25,15,35,36,133
2024-03-12 17:40:00,19,37,18,32,34,140
2024-03-12 17:50:00,18,34,18,22,27,119
2024-03-12 18:00:00,21,26,21,30,34,132
2024-03-12 18:10:00,22,26,21,33,26,128
2024-03-12 18:20:00,15,27,15,24,27,108
2024-03-12 18:30:00,31,39,25,30,29,154
2024-03-12 18:40:00,29,40,31,34,33,167
2024-03-12 18:50:00,39,33,18,25,30,145
2024-03-12 19:00:00,25,30,20,32,32,139
2024-03-12 19:10:00,18,35,24,28,39,144
2024-03-12 19:20:00,22,35,17,24,25,123
2024-03-12 19:30:00,26,33,31,23,23,136
2024-03-12 19:40:00,28,40,38,32,35,173
2024-03-12 19:50:00,32,29,16,20,37,134
2024-03-12 20:00:00,19,24,20,19,33,115
2024-03-12 20:10:00,22,28,15,30,23,118
2024-03-12 20:20:00,15,19,8,24,31,97
2024-03-12 20:30:00,16,22,5,20,22,85
2024-03-12 20:40:00,17,15,11,20,21,84
2024-03-12 20:50:00,8,23,1,25,22,79
2024-03-12 21:00:00,10,24,7,21,22,84
2024-03-12 21:10:00,12,29,7,18,19,85
2024-03-12 21:20:00,21,32,5,28,32,118
2024-03-12 21:30:00,9,27,10,19,14,79
2024-03-12 21:40:00,7,18,7,26,15,73
2024-03-12 21:50:00,11,16,5,25,19,76
2024-03-12 22:00:00,3,22,8,20,18,71
2024-03-12 22:10:00,9,21,6,24,20,80
2024-03-12 22:20:00,6,12,6,20,15,59
2024-03-12 22:30:00,8,14,2,14,11,49
2024-03-12 22:40:00,3,12,2,15,14,46
2024-03-12 22:50:00,2,13,5,18,13,51
2024-03-12 23:00:00,3,10,8,14,8,43
2024-03-12 23:10:00,2,10,2,15,10,39
2024-03-12 23:20:00,2,9,2,10,6,29
2024-03-12 23:30:00,3,9,2,5,6,25
2024-03-12 23:40:00,2,8,1,9,6,26
2024-03-12 23:50:00,0,3,3,14,11,31
2024-03-13 00:00:00,4,6,0,10,6,26
2024-03-13 00:10:00,3,7,0,7,1,18
2024-03-13 00:20:00,0,3,0,8,5,16
2024-03-13 00:30:00,4,5,1,5,3,18
2024-03-13 00:40:00,2,6,1,6,4,19
2024-03-13 00:50:00,2,2,1,4,3,12
2024-03-13 01:00:00,3,7,0,6,2,18
2024-03-13 01:10:00,0,2,0,2,1,5
2024-03-13 01:20:00,2,5,1,2,2,12
2024-03-13 01:30:00,2,7,1,3,0,13
2024-03-13 01:40:00,1,4,1,2,2,10
2024-03-13 01:50:00,3,4,1,5,1,14
2024-03-13 02:00:00,0,1,0,1,2,4
2024-03-13 02:10:00,0,3,1,5,2,11
2024-03-13 02:20:00,0,2,1,0,0,3
2024-03-13 02:30:00,3,4,0,2,1,10
2024-03-13 02:40:00,1,2,0,1,2,6
2024-03-13 02:50:00,0,0,0,2,0,2
2024-03-13 03:00:00,0,0,0,1,2,3
2024-03-13 03:10:00,1,3,1,4,1,10
2024-03-13 03:20:00,3,5,0,4,1,13
2024-03-13 03:30:00,1,1,0,5,1,8
2024-03-13 03:40:00,2,4,1,3,2,12
2024-03-13 03:50:00,3,5,0,6,1,15
2024-03-13 04:00:00,0,4,1,6,2,13
2024-03-13 04:10:00,1,3,1,3,1,9
2024-03-13 04:20:00,2,6,0,1,1,10
2024-03-13 04:30:00,4,7,1,4,2,18
2024-03-13 04:40:00,5,8,0,5,7,25
2024-03-13 04:50:00,5,12,1,6,7,31
2024-03-13 05:00:00,5,4,1,11,13,34
2024-03-13 05:10:00,8,12,4,11,8,43
2024-03-13 05:20:00,9,16,5,8,8,46
2024-03-13 05:30:00,12,22,4,7,12,57
2024-03-13 05:40:00,17,21,8,13,10,69
2024-03-13 05:50:00,23,16,7,11,13,70
2024-03-13 06:00:00,21,20,4,11,10,66
2024-03-13 06:10:00,21,12,8,14,13,68
2024-03-13 06:20:00,8,22,6,17,12,65
2024-03-13 06:30:00,10,22,12,19,14,77
2024-03-13 06:40:00,14,22,14,20,27,97
2024-03-13 06:50:00,18,25,12,25,26,106
2024-03-13 07:00:00,15,30,14,25,27,111
2024-03-13 07:10:00,26,25,24,24,22,121
2024-03-13 07:20:00,17,31,19,25,21,113
2024-03-13 07:30:00,23,22,18,25,26,114
2024-03-13 07:40:00,20,30,18,34,35,137
2024-03-13 07:50:00,30,28,19,39,29,145
2024-03-13 08:00:00,27,21,18,33,37,136
2024-03-13 08:10:00,21,29,23,34,32,139
2024-03-13 08:20:00,26,31,17,30,26,130
2024-03-13 08:30:00,22,30,21,26,27,126
2024-03-13 08:40:00,22,33,16,24,21,116
2024-03-13 08:50:00,22,37,16,31,25,131
2024-03-13 09:00:00,28,31,15,29,25,128
2024-03-13 09:10:00,22,29,14,37,31,133
2024-03-13 09:20:00,17,23,12,32,22,106
2024-03-13 09:30:00,16,30,19,33,26,124
2024-03-13 09:40:00,21,25,18,23,16,103
2024-03-13 09:50:00,17,23,14,29,19,102
2024-03-13 10:00:00,22,32,13,30,18,115
2024-03-13 10:10:00,19,26,12,25,23,105
2024-03-13 10:20:00,18,25,20,24,22,109
2024-03-13 10:30:00,14,26,12,27,29,108
2024-03-13 10:40:00,21,22,12,39,22,116
2024-03-13 10:50:00,20,25,7,35,19,106
2024-03-13 11:00:00,20,28,10,29,25,112
2024-03-13 11:10:00,18,23,10,24,14,89
2024-03-13 11:20:00,14,20,13,24,22,93
2024-03-13 11:30:00,18,27,19,29,23,116
2024-03-13 11:40:00,25,27,16,24,17,109
2024-03-13 11:50:00,29,28,13,33,20,123
2024-03-13 12:00:00,29,32,17,34,25,137
2024-03-13 12:10:00,23,26,15,32,24,120
2024-03-13 12:20:00,19,34,15,30,27,125
2024-03-13 12:30:00,26,28,11,24,24,113
2024-03-13 12:40:00,20,24,12,26,19,101
2024-03-13 12:50:00,17,21,16,35,23,112
2024-03-13 13:00:00,22,32,21,29,23,127
2024-03-13 13:10:00,22,33,17,27,25,124
2024-03-13 13:20:00,16,20,15,25,18,94
2024-03-13 13:30:00,18,25,15,27,30,115
2024-03-13 13:40:00,13,30,15,36,18,112
2024-03-13 13:50:00,20,26,15,27,24,112
2024-03-13 14:00:00,24,29,13,37,34,137
2024-03-13 14:10:00,21,31,21,28,19,120
2024-03-13 14:20:00,17,26,23,28,29,123
2024-03-13 14:30:00,19,32,14,31,26,122
2024-03-13 14:40:00,12,31,16,35,27,121
2024-03-13 14:50:00,27,25,14,32,29,127
2024-03-13 15:00:00,15,33,18,30,30,126
2024-03-13 15:10:00,24,36,22,27,30,139
2024-03-13 15:20:00,15,35,19,25,22,116
2024-03-13 15:30:00,18,35,20,38,33,144
2024-03-13 15:40:00,21,22,27,25,26,121
2024-03-13 15:50:00,33,41,26,37,33,170
2024-03-13 16:00:00,22,31,16,32,31,132
2024-03-13 16:10:00,23,34,22,31,27,137
2024-03-13 16:20:00,23,31,24,30,28,136
2024-03-13 16:30:00,18,40,16,31,29,134
2024-03-13 16:40:00,22,30,23,25,30,130
2024-03-13 16:50:00,18,24,19,28,28,117
2024-03-13 17:00:00,28,36,25,26,24,139
2024-03-13 17:10:00,25,28,23,23,27,126
2024-03-13 17:20:00,26,31,20,29,23,129
2024-03-13 17:30:00,27,34,18,25,31,135
2024-03-13 17:40:00,23,33,25,23,18,122
2024-03-13 17:50:00,20,37,23,28,31,139
2024-03-13 18:00:00,16,25,19,32,31,123
2024-03-13 18:10:00,24,25,19,30,26,124
2024-03-13 18:20:00,19,32,21,23,23,118
2024-03-13 18:30:00,23,27,24,29,35,138
2024-03-13 18:40:00,40,25,21,23,27,136
2024-03-13 18:50:00,16,34,34,20,26,130
2024-03-13 19:00:00,24,37,23,30,38,152
2024-03-13 19:10:00,20,37,22,34,31,144
2024-03-13 19:20:00,37,36,28,34,30,165
2024-03-13 19:30:00,25,38,16,31,42,152
2024-03-13 19:40:00,20,39,15,25,38,137
2024-03-13 19:50:00,39,39,20,26,28,152
2024-03-13 20:00:00,29,28,18,27,34,136
2024-03-13 20:10:00,21,31,13,29,25,119
2024-03-13 20:20:00,16,22,21,49,23,131
2024-03-13 20:30:00,21,27,12,35,23,118
2024-03-13 20:40:00,23,29,16,27,30,125
2024-03-13 20:50:00,14,23,16,23,26,102
2024-03-13 21:00:00,22,24,9,35,33,123
2024-03-13 21:10:00,12,30,16,33,34,125
2024-03-13 21:20:00,18,30,30,22,37,137
2024-03-13 21:30:00,13,28,10,28,25,104
2024-03-13 21:40:00,12,19,8,26,28,93
2024-03-13 21:50:00,8,22,10,20,26,86
2024-03-13 22:00:00,3,19,11,19,16,68
2024-03-13 22:10:00,10,19,7,20,29,85
2024-03-13 22:20:00,11,15,18,23,26,93
2024-03-13 22:30:00,20,16,5,21,17,79
2024-03-13 22:40:00,9,16,6,16,24,71
2024-03-13 22:50:00,5,8,3,16,23,55
2024-03-13 23:00:00,8,10,5,22,18,63
2024-03-13 23:10:00,6,4,5,10,16,41
2024-03-13 23:20:00,6,6,3,13,15,43
2024-03-13 23:30:00,2,4,1,11,9,27
2024-03-13 23:40:00,1,11,2,10,9,33
2024-03-13 23:50:00,2,9,0,10,10,31
2024-03-14 00:00:00,4,10,3,7,14,38
2024-03-14 00:10:00,5,5,4,12,6,32
2024-03-14 00:20:00,5,7,1,6,2,21
2024-03-14 00:30:00,0,2,4,8,7,21
2024-03-14 00:40:00,8,6,0,7,7,28
2024-03-14 00:50:00,1,4,0,2,4,11
2024-03-14 01:00:00,0,1,2,5,2,10
2024-03-14 01:10:00,3,6,0,2,4,15
2024-03-14 01:20:00,3,2,0,5,2,12
2024-03-14 01:30:00,2,2,1,3,4,12
2024-03-14 01:40:00,0,2,6,2,5,15
2024-03-14 01:50:00,5,5,0,3,1,14
2024-03-14 02:00:00,0,12,0,2,0,14
2024-03-14 02:10:00,1,1,0,3,0,5
2024-03-14 02:20:00,3,2,0,6,3,14
2024-03-14 02:30:00,0,2,0,3,2,7
2024-03-14 02:40:00,3,0,0,1,0,4
2024-03-14 02:50:00,1,6,0,2,4,13
2024-03-14 03:00:00,1,1,2,2,0,6
2024-03-14 03:10:00,0,0,1,1,0,2
2024-03-14 03:20:00,2,1,0,8,2,13
2024-03-14 03:30:00,0,2,3,1,0,6
2024-03-14 03:40:00,3,0,0,4,2,9
2024-03-14 03:50:00,0,3,0,3,1,7
2024-03-14 04:00:00,0,2,2,4,5,13
2024-03-14 04:10:00,6,2,0,5,4,17
2024-03-14 04:20:00,7,2,0,3,5,17
2024-03-14 04:30:00,5,10,0,1,5,21
2024-03-14 04:40:00,6,6,0,2,12,26
2024-03-14 04:50:00,3,9,2,6,11,31
2024-03-14 05:00:00,13,14,5,5,18,55
2024-03-14 05:10:00,13,11,2,9,22,57
2024-03-14 05:20:00,18,11,16,9,6,60
2024-03-14 05:30:00,21,9,7,15,17,69
2024-03-14 05:40:00,34,23,5,19,17,98
2024-03-14 05:50:00,31,15,3,13,20,82
2024-03-14 06:00:00,25,18,6,13,12,74
2024-03-14 06:10:00,23,29,15,23,23,113
2024-03-14 06:20:00,50,28,12,19,19,128
2024-03-14 06:30:00,21,25,12,18,18,94
2024-03-14 06:40:00,13,24,14,24,22,97
2024-03-14 06:50:00,16,28,9,20,24,97
2024-03-14 07:00:00,17,29,14,28,22,110
2024-03-14 07:10:00,16,31,18,26,21,112
2024-03-14 07:20:00,22,22,22,27,39,132
2024-03-14 07:30:00,17,30,24,28,28,127
2024-03-14 07:40:00,19,27,26,32,27,131
2024-03-14 07:50:00,18,33,13,29,31,124
2024-03-14 08:00:00,18,34,19,25,26,122
2024-03-14 08:10:00,18,27,15,33,27,120
2024-03-14 08:20:00,18,32,20,36,26,132
2024-03-14 08:30:00,26,34,25,28,28,141
2024-03-14 08:40:00,6,6,7,11,11,41
2024-03-14 08:50:00,0,0,0,0,0,0
2024-03-14 09:00:00,10,15,6,10,8,49
2024-03-14 09:10:00,19,31,19,28,24,121
2024-03-14 09:20:00,22,29,24,27,23,125
2024-03-14 09:30:00,14,24,16,24,24,102
2024-03-14 09:40:00,24,25,16,32,26,123
2024-03-14 09:50:00,20,23,15,33,30,121
2024-03-14 10:00:00,21,29,10,27,19,106
2024-03-14 10:10:00,16,17,11,28,17,89
2024-03-14 10:20:00,18,22,14,22,27,103
2024-03-14 10:30:00,17,30,12,32,25,116
2024-03-14 10:40:00,21,28,18,22,23,112
2024-03-14 10:50:00,25,26,15,30,19,115
2024-03-14 11:00:00,24,21,13,28,14,100
2024-03-14 11:10:00,16,29,14,31,19,109
2024-03-14 11:20:00,21,33,19,30,17,120
2024-03-14 11:30:00,19,24,16,34,25,118
2024-03-14 11:40:00,17,34,21,22,20,114
2024-03-14 11:50:00,20,32,16,32,24,124
2024-03-14 12:00:00,18,38,15,31,31,133
2024-03-14 12:10:00,24,27,13,37,31,132
2024-03-14 12:20:00,13,27,12,38,26,116
2024-03-14 12:30:00,17,20,15,36,19,107
2024-03-14 12:40:00,10,15,13,27,26,91
2024-03-14 12:50:00,25,29,21,27,22,124
2024-03-14 13:00:00,18,23,21,24,23,109
2024-03-14 13:10:00,29,28,22,38,22,139
2024-03-14 13:20:00,15,24,16,28,25,108
2024-03-14 13:30:00,26,34,15,25,25,125
2024-03-14 13:40:00,17,21,9,36,34,117
2024-03-14 13:50:00,19,19,20,35,20,113
2024-03-14 14:00:00,15,32,17,35,32,131
2024-03-14 14:10:00,15,20,16,29,24,104
2024-03-14 14:20:00,24,27,17,35,26,129
2024-03-14 14:30:00,17,31,17,33,27,125
2024-03-14 14:40:00,18,27,16,25,27,113
2024-03-14 14:50:00,16,23,16,28,28,111
2024-03-14 15:00:00,24,36,13,26,32,131
2024-03-14 15:10:00,20,39,25,31,25,140
2024-03-14 15:20:00,27,34,23,29,29,142
2024-03-14 15:30:00,29,35,21,32,22,139
2024-03-14 15:40:00,26,29,14,27,22,118
2024-03-14 15:50:00,25,32,24,30,24,135
2024-03-14 16:00:00,20,33,26,25,25,129
2024-03-14 16:10:00,21,30,20,25,27,123
2024-03-14 16:20:00,35,37,18,31,32,153
2024-03-14 16:30:00,20,31,25,31,22,129
2024-03-14 16:40:00,22,28,23,29,28,130
2024-03-14 16:50:00,17,26,19,27,24,113
2024-03-14 17:00:00,18,35,25,24,30,132
2024-03-14 17:10:00,18,25,24,27,23,117
2024-03-14 17:20:00,27,29,17,27,34,134
2024-03-14 17:30:00,23,25,29,37,34,148
2024-03-14 17:40:00,32,29,15,25,25,126
2024-03-14 17:50:00,28,25,24,29,29,135
2024-03-14 18:00:00,20,30,16,26,29,121
2024-03-14 18:10:00,24,23,18,32,29,126
2024-03-14 18:20:00,20,35,15,30,28,128
2024-03-14 18:30:00,18,27,16,35,32,128
2024-03-14 18:40:00,29,36,17,25,25,132
2024-03-14 18:50:00,33,32,20,40,28,153
2024-03-14 19:00:00,31,33,21,29,36,150
2024-03-14 19:10:00,32,34,13,28,27,134
2024-03-14 19:20:00,25,25,13,30,33,126
2024-03-14 19:30:00,24,42,30,28,33,157
2024-03-14 19:40:00,34,31,17,22,30,134
2024-03-14 19:50:00,38,37,27,33,29,164
2024-03-14 20:00:00,27,38,18,26,33,142
2024-03-14 20:10:00,18,30,20,38,20,126
2024-03-14 20:20:00,23,33,11,30,20,117
2024-03-14 20:30:00,23,23,17,30,33,126
2024-03-14 20:40:00,21,21,10,24,28,104
2024-03-14 20:50:00,20,23,19,24,34,120
2024-03-14 21:00:00,20,31,5,35,30,121
2024-03-14 21:10:00,12,25,9,22,30,98
2024-03-14 21:20:00,18,38,27,27,37,147
2024-03-14 21:30:00,10,30,14,37,25,116
2024-03-14 21:40:00,21,25,2,24,17,89
2024-03-14 21:50:00,6,21,8,23,24,82
2024-03-14 22:00:00,14,25,11,24,17,91
2024-03-14 22:10:00,20,21,14,25,18,98
2024-03-14 22:20:00,15,21,18,30,30,114
2024-03-14 22:30:00,9,31,12,22,22,96
2024-03-14 22:40:00,4,21,7,22,15,69
2024-03-14 22:50:00,3,19,4,15,20,61
2024-03-14 23:00:00,12,10,5,15,11,53
2024-03-14 23:10:00,13,19,6,23,24,85
2024-03-14 23:20:00,14,8,1,14,16,53
2024-03-14 23:30:00,1,15,0,14,14,44
2024-03-14 23:40:00,6,12,4,12,3,37
2024-03-14 23:50:00,2,6,2,15,12,37
2024-03-15 00:00:00,0,4,0,10,9,23
2024-03-15 00:10:00,4,9,3,8,14,38
2024-03-15 00:20:00,3,4,0,7,9,23
2024-03-15 00:30:00,15,7,3,13,6,44
2024-03-15 00:40:00,9,10,3,6,10,38
2024-03-15 00:50:00,0,7,2,3,2,14
2024-03-15 01:00:00,0,6,2,5,2,15
2024-03-15 01:10:00,4,6,6,7,7,30
2024-03-15 01:20:00,4,2,1,3,6,16
2024-03-15 01:30:00,0,2,5,4,1,12
2024-03-15 01:40:00,1,2,0,4,3,10
2024-03-15 01:50:00,0,0,4,6,3,13
2024-03-15 02:00:00,3,4,5,2,2,16
2024-03-15 02:10:00,3,5,0,3,0,11
2024-03-15 02:20:00,2,2,0,2,1,7
2024-03-15 02:30:00,3,1,0,1,2,7
2024-03-15 02:40:00,3,2,0,2,3,10
2024-03-15 02:50:00,0,0,0,2,1,3
2024-03-15 03:00:00,3,0,0,2,0,5
2024-03-15 03:10:00,0,0,0,0,2,2
2024-03-15 03:20:00,2,0,0,3,1,6
2024-03-15 03:30:00,0,5,0,3,3,11
2024-03-15 03:40:00,1,6,2,1,2,12
2024-03-15 03:50:00,5,3,0,2,4,14
2024-03-15 04:00:00,4,3,0,5,3,15
2024-03-15 04:10:00,3,8,0,4,2,17
2024-03-15 04:20:00,13,3,1,3,6,26
2024-03-15 04:30:00,2,3,0,4,2,11
2024-03-15 04:40:00,6,5,5,7,5,28
2024-03-15 04:50:00,16,0,1,2,9,28
2024-03-15 05:00:00,9,12,2,7,20,50
2024-03-15 05:10:00,22,5,6,6,10,49
2024-03-15 05:20:00,22,12,8,12,12,66
2024-03-15 05:30:00,19,23,9,9,16,76
2024-03-15 05:40:00,39,23,12,17,20,111
2024-03-15 05:50:00,25,22,13,5,17,82
2024-03-15 06:00:00,36,24,6,16,11,93
2024-03-15 06:10:00,25,15,16,20,15,91
2024-03-15 06:20:00,25,20,7,15,19,86
2024-03-15 06:30:00,19,19,12,22,23,95
2024-03-15 06:40:00,20,19,11,21,20,91
2024-03-15 06:50:00,17,29,9,16,19,90
2024-03-15 07:00:00,20,29,9,23,29,110
2024-03-15 07:10:00,18,28,16,24,30,116
2024-03-15 07:20:00,23,32,14,30,22,121
2024-03-15 07:30:00,15,22,13,24,29,103
2024-03-15 07:40:00,19,30,16,37,31,133
2024-03-15 07:50:00,26,27,20,37,32,142
2024-03-15 08:00:00,10,22,19,31,39,121
2024-03-15 08:10:00,21,21,20,26,17,105
2024-03-15 08:20:00,23,26,14,34,21,118
2024-03-15 08:30:00,19,25,17,29,23,113
2024-03-15 08:40:00,18,28,14,33,31,124
2024-03-15 08:50:00,25,20,15,25,22,107
2024-03-15 09:00:00,29,24,12,24,21,110
2024-03-15 09:10:00,13,24,10,29,20,96
2024-03-15 09:20:00,15,29,17,26,18,105
2024-03-15 09:30:00,21,31,15,31,23,121
2024-03-15 09:40:00,25,21,23,21,21,111
2024-03-15 09:50:00,23,30,20,27,18,118
2024-03-15 10:00:00,17,21,10,21,22,91
2024-03-15 10:10:00,22,21,12,27,23,105
2024-03-15 10:20:00,17,20,13,31,26,107
2024-03-15 10:30:00,23,33,14,22,18,110
2024-03-15 10:40:00,19,26,12,27,24,108
2024-03-15 10:50:00,17,34,26,34,24,135
2024-03-15 11:00:00,22,28,14,27,24,115
2024-03-15 11:10:00,19,27,16,19,26,107
2024-03-15 11:20:00,21,32,17,25,26,121
2024-03-15 11:30:00,17,30,13,30,17,107
2024-03-15 11:40:00,15,25,15,29,36,120
2024-03-15 11:50:00,27,33,19,28,20,127
2024-03-15 12:00:00,36,25,19,30,26,136
2024-03-15 12:10:00,20,27,16,25,24,112
2024-03-15 12:20:00,21,33,15,32,27,128
2024-03-15 12:30:00,20,26,17,26,22,111
2024-03-15 12:40:00,30,34,15,30,26,135
2024-03-15 12:50:00,18,33,16,31,36,134
2024-03-15 13:00:00,20,30,29,29,34,142
2024-03-15 13:10:00,28,29,23,24,22,126
2024-03-15 13:20:00,23,24,17,24,25,113
2024-03-15 13:30:00,26,32,24,25,32,139
2024-03-15 13:40:00,26,29,16,22,32,125
2024-03-15 13:50:00,23,31,20,26,27,127
2024-03-15 14:00:00,25,24,24,37,25,135
2024-03-15 14:10:00,22,29,18,29,31,129
2024-03-15 14:20:00,22,31,20,26,29,128
2024-03-15 14:30:00,27,31,23,37,35,153
2024-03-15 14:40:00,18,31,22,21,26,118
2024-03-15 14:50:00,26,29,19,29,22,125
2024-03-15 15:00:00,24,70,17,27,34,172
2024-03-15 15:10:00,25,43,24,30,35,157
2024-03-15 15:20:00,33,34,20,20,26,133
2024-03-15 15:30:00,21,38,20,30,24,133
2024-03-15 15:40:00,34,31,20,20,22,127
2024-03-15 15:50:00,23,25,16,21,26,111
2024-03-15 16:00:00,25,24,15,24,26,114
2024-03-15 16:10:00,25,40,22,32,28,147
2024-03-15 16:20:00,21,32,14,25,29,121
2024-03-15 16:30:00,19,32,14,26,28,119
2024-03-15 16:40:00,18,24,12,30,26,110
2024-03-15 16:50:00,24,25,13,37,26,125
2024-03-15 17:00:00,16,32,17,32,20,117
2024-03-15 17:10:00,16,24,20,25,31,116
2024-03-15 17:20:00,24,29,20,28,24,125
2024-03-15 17:30:00,20,29,16,22,21,108
2024-03-15 17:40:00,22,33,12,30,31,128
2024-03-15 17:50:00,18,28,22,24,38,130
2024-03-15 18:00:00,23,28,21,28,31,131
2024-03-15 18:10:00,22,31,19,29,32,133
2024-03-15 18:20:00,26,24,18,26,23,117
2024-03-15 18:30:00,19,34,18,25,36,132
2024-03-15 18:40:00,21,43,24,31,26,145
2024-03-15 18:50:00,28,40,29,31,32,160
2024-03-15 19:00:00,21,26,24,26,33,130
2024-03-15 19:10:00,29,34,32,39,18,152
2024-03-15 19:20:00,34,24,25,33,28,144
2024-03-15 19:30:00,25,24,20,23,30,122
2024-03-15 19:40:00,32,31,26,25,37,151
2024-03-15 19:50:00,38,24,13,32,33,140
2024-03-15 20:00:00,33,36,25,31,29,154
2024-03-15 20:10:00,18,29,17,26,35,125
2024-03-15 20:20:00,12,23,12,22,27,96
2024-03-15 20:30:00,9,12,7,15,23,66
2024-03-15 20:40:00,5,19,7,24,21,76
2024-03-15 20:50:00,12,20,8,29,27,96
2024-03-15 21:00:00,15,12,7,23,30,87
2024-03-15 21:10:00,11,24,8,20,23,86
2024-03-15 21:20:00,8,19,8,25,24,84
2024-03-15 21:30:00,8,31,15,24,23,101
2024-03-15 21:40:00,21,25,9,24,27,106
2024-03-15 21:50:00,6,30,10,28,28,102
2024-03-15 22:00:00,10,26,9,19,17,81
2024-03-15 22:10:00,16,23,11,18,25,93
2024-03-15 22:20:00,16,19,11,18,23,87
2024-03-15 22:30:00,12,30,19,22,22,105
2024-03-15 22:40:00,21,14,7,22,31,95
2024-03-15 22:50:00,11,10,10,21,20,72
2024-03-15 23:00:00,6,20,9,16,14,65
2024-03-15 23:10:00,14,22,4,18,24,82
2024-03-15 23:20:00,14,20,8,22,23,87
2024-03-15 23:30:00,17,19,3,23,18,80
2024-03-15 23:40:00,6,13,2,20,20,61
2024-03-15 23:50:00,11,10,7,13,12,53
2024-03-16 00:00:00,11,17,4,18,17,67
2024-03-16 00:10:00,19,16,0,15,11,61
2024-03-16 00:20:00,3,20,1,18,19,61
2024-03-16 00:30:00,11,23,4,14,19,71
2024-03-16 00:40:00,10,14,5,5,9,43
2024-03-16 00:50:00,2,12,10,4,8,36
2024-03-16 01:00:00,4,16,4,6,15,45
2024-03-16 01:10:00,2,5,6,6,11,30
2024-03-16 01:20:00,5,1,3,5,15,29
2024-03-16 01:30:00,2,7,5,5,4,23
2024-03-16 01:40:00,0,7,3,7,11,28
2024-03-16 01:50:00,5,8,4,7,10,34
2024-03-16 02:00:00,5,7,1,7,5,25
2024-03-16 02:10:00,4,16,2,9,8,39
2024-03-16 02:20:00,0,6,6,3,5,20
2024-03-16 02:30:00,7,2,3,7,3,22
2024-03-16 02:40:00,0,12,2,6,3,23
2024-03-16 02:50:00,4,5,3,5,1,18
2024-03-16 03:00:00,0,8,4,7,3,22
2024-03-16 03:10:00,4,3,0,7,9,23
2024-03-16 03:20:00,4,3,1,4,4,16
2024-03-16 03:30:00,1,2,1,2,4,10
2024-03-16 03:40:00,2,7,2,5,4,20
2024-03-16 03:50:00,0,2,1,6,4,13
2024-03-16 04:00:00,3,8,0,3,1,15
2024-03-16 04:10:00,4,8,1,4,2,19
2024-03-16 04:20:00,4,6,1,4,2,17
2024-03-16 04:30:00,0,1,1,3,1,6
2024-03-16 04:40:00,3,9,1,7,2,22
2024-03-16 04:50:00,1,4,0,8,6,19
2024-03-16 05:00:00,2,9,0,4,7,22
2024-03-16 05:10:00,1,11,6,3,3,24
2024-03-16 05:20:00,2,6,0,4,6,18
2024-03-16 05:30:00,5,11,3,4,3,26
2024-03-16 05:40:00,6,14,3,6,2,31
2024-03-16 05:50:00,5,6,2,6,7,26
2024-03-16 06:00:00,2,4,0,6,6,18
2024-03-16 06:10:00,5,5,2,7,7,26
2024-03-16 06:20:00,7,14,2,7,9,39
2024-03-16 06:30:00,4,8,3,5,7,27
2024-03-16 06:40:00,5,5,1,4,5,20
2024-03-16 06:50:00,7,6,1,7,7,28
2024-03-16 07:00:00,8,4,4,9,3,28
2024-03-16 07:10:00,6,6,1,5,7,25
2024-03-16 07:20:00,6,7,3,15,7,38
2024-03-16 07:30:00,16,12,1,15,9,53
2024-03-16 07:40:00,9,17,4,25,17,72
2024-03-16 07:50:00,12,8,4,23,16,63
2024-03-16 08:00:00,13,7,3,18,10,51
2024-03-16 08:10:00,13,16,5,19,12,65
2024-03-16 08:20:00,14,13,3,16,7,53
2024-03-16 08:30:00,18,12,5,15,21,71
2024-03-16 08:40:00,11,16,6,22,15,70
2024-03-16 08:50:00,15,16,5,24,11,71
2024-03-16 09:00:00,18,20,5,15,13,71
2024-03-16 09:10:00,20,17,11,22,12,82
2024-03-16 09:20:00,11,9,6,8,6,40
2024-03-16 09:30:00,14,20,11,25,14,84
2024-03-16 09:40:00,16,20,10,21,21,88
2024-03-16 09:50:00,14,19,10,20,18,81
2024-03-16 10:00:00,21,25,10,23,14,93
2024-03-16 10:10:00,21,20,18,17,16,92
2024-03-16 10:20:00,23,19,10,23,20,95
2024-03-16 10:30:00,19,19,10,25,17,90
2024-03-16 10:40:00,24,26,13,21,15,99
2024-03-16 10:50:00,13,24,12,25,21,95
2024-03-16 11:00:00,32,32,13,22,17,116
2024-03-16 11:10:00,22,20,13,25,23,103
2024-03-16 11:20:00,16,30,9,33,12,100
2024-03-16 11:30:00,22,33,11,27,23,116
2024-03-16 11:40:00,23,26,10,22,26,107
2024-03-16 11:50:00,17,24,12,22,23,98
2024-03-16 12:00:00,20,24,14,27,24,109
2024-03-16 12:10:00,24,26,16,27,30,123
2024-03-16 12:20:00,27,30,13,31,22,123
2024-03-16 12:30:00,20,27,12,37,24,120
2024-03-16 12:40:00,14,28,15,30,23,110
2024-03-16 12:50:00,20,25,10,31,22,108
2024-03-16 13:00:00,16,19,16,21,26,98
2024-03-16 13:10:00,17,26,18,22,31,114
2024-03-16 13:20:00,24,22,11,29,19,105
2024-03-16 13:30:00,12,28,14,26,29,109
2024-03-16 13:40:00,15,23,15,27,31,111
2024-03-16 13:50:00,15,22,9,26,26,98
2024-03-16 14:00:00,20,26,9,33,29,117
2024-03-16 14:10:00,14,26,9,31,23,103
2024-03-16 14:20:00,15,23,15,25,28,106
2024-03-16 14:30:00,18,29,15,32,28,122
2024-03-16 14:40:00,16,27,15,26,27,111
2024-03-16 14:50:00,19,27,10,24,18,98
2024-03-16 15:00:00,21,31,16,23,21,112
2024-03-16 15:10:00,17,29,10,25,29,110
2024-03-16 15:20:00,16,26,7,33,23,105
2024-03-16 15:30:00,16,23,8,28,18,93
2024-03-16 15:40:00,17,26,18,25,31,117
2024-03-16 15:50:00,18,30,9,28,30,115
2024-03-16 16:00:00,20,30,4,22,23,99
2024-03-16 16:10:00,19,28,14,27,22,110
2024-03-16 16:20:00,21,29,11,32,27,120
2024-03-16 16:30:00,16,28,15,28,21,108
2024-03-16 16:40:00,15,23,7,31,20,96
2024-03-16 16:50:00,19,26,19,27,25,116
2024-03-16 17:00:00,14,23,8,26,24,95
2024-03-16 17:10:00,18,36,13,24,21,112
2024-03-16 17:20:00,19,24,9,29,24,105
2024-03-16 17:30:00,22,34,22,30,27,135
2024-03-16 17:40:00,21,23,12,34,24,114
2024-03-16 17:50:00,13,23,16,24,27,103
2024-03-16 18:00:00,15,27,16,31,25,114
2024-03-16 18:10:00,20,21,16,19,30,106
2024-03-16 18:20:00,13,23,14,31,26,107
2024-03-16 18:30:00,13,25,15,30,18,101
2024-03-16 18:40:00,14,27,19,32,29,121
2024-03-16 18:50:00,28,36,23,34,33,154
2024-03-16 19:00:00,21,29,22,28,30,130
2024-03-16 19:10:00,25,29,18,33,34,139
2024-03-16 19:20:00,30,43,20,29,26,148
2024-03-16 19:30:00,14,25,7,31,22,99
2024-03-16 19:40:00,23,43,13,30,25,134
2024-03-16 19:50:00,26,41,21,30,40,158
2024-03-16 20:00:00,35,25,27,29,37,153
2024-03-16 20:10:00,31,36,16,39,45,167
2024-03-16 20:20:00,25,28,18,33,21,125
2024-03-16 20:30:00,12,30,9,32,41,124
2024-03-16 20:40:00,16,22,12,22,19,91
2024-03-16 20:50:00,17,27,5,26,25,100
2024-03-16 21:00:00,19,22,8,25,27,101
2024-03-16 21:10:00,18,28,8,21,27,102
2024-03-16 21:20:00,24,26,14,21,27,112
2024-03-16 21:30:00,23,34,12,23,34,126
2024-03-16 21:40:00,17,22,10,22,33,104
2024-03-16 21:50:00,23,23,1,30,27,104
2024-03-16 22:00:00,20,29,18,26,27,120
2024-03-16 22:10:00,18,30,8,22,26,104
2024-03-16 22:20:00,19,20,7,31,13,90
2024-03-16 22:30:00,11,20,8,24,22,85
2024-03-16 22:40:00,21,23,11,16,20,91
2024-03-16 22:50:00,7,16,3,22,21,69
2024-03-16 23:00:00,12,24,13,20,20,89
2024-03-16 23:10:00,10,24,4,26,15,79
2024-03-16 23:20:00,16,20,8,24,19,87
2024-03-16 23:30:00,14,15,9,13,14,65
2024-03-16 23:40:00,7,21,4,15,12,59
2024-03-16 23:50:00,14,16,4,16,20,70
2024-03-17 00:00:00,18,12,5,17,28,80
2024-03-17 00:10:00,7,19,4,11,24,65
2024-03-17 00:20:00,7,19,4,17,23,70
2024-03-17 00:30:00,9,16,2,15,25,67
2024-03-17 00:40:00,12,17,12,13,25,79
2024-03-17 00:50:00,6,13,12,15,25,71
2024-03-17 01:00:00,3,15,3,14,15,50
2024-03-17 01:10:00,0,5,2,11,19,37
2024-03-17 01:20:00,2,6,3,9,17,37
2024-03-17 01:30:00,6,13,0,10,15,44
2024-03-17 01:40:00,0,9,2,10,14,35
2024-03-17 01:50:00,4,8,9,12,15,48
2024-03-17 02:00:00,10,12,7,9,7,45
2024-03-17 02:10:00,4,14,3,10,15,46
2024-03-17 02:20:00,1,13,8,5,6,33
2024-03-17 02:30:00,3,1,0,12,7,23
2024-03-17 02:40:00,0,4,0,4,2,10
2024-03-17 02:50:00,0,4,2,13,6,25
2024-03-17 03:00:00,0,8,3,8,2,21
2024-03-17 03:10:00,3,6,0,4,1,14
2024-03-17 03:20:00,0,3,2,8,5,18
2024-03-17 03:30:00,1,2,0,4,2,9
2024-03-17 03:40:00,0,0,0,3,1,4
2024-03-17 03:50:00,1,5,3,8,3,20
2024-03-17 04:00:00,0,3,2,3,3,11
2024-03-17 04:10:00,1,0,0,3,1,5
2024-03-17 04:20:00,3,5,0,8,2,18
2024-03-17 04:30:00,6,4,0,0,1,11
2024-03-17 04:40:00,11,3,3,2,3,22
2024-03-17 04:50:00,10,4,0,2,4,20
2024-03-17 05:00:00,8,2,4,3,4,21
2024-03-17 05:10:00,0,4,0,2,3,9
2024-03-17 05:20:00,5,5,3,4,6,23
2024-03-17 05:30:00,4,9,6,3,1,23
2024-03-17 05:40:00,7,8,2,6,5,28
2024-03-17 05:50:00,4,10,2,1,3,20
2024-03-17 06:00:00,2,5,0,5,6,18
2024-03-17 06:10:00,0,4,2,2,4,12
2024-03-17 06:20:00,3,8,0,4,4,19
2024-03-17 06:30:00,4,12,3,2,4,25
2024-03-17 06:40:00,0,4,1,5,7,17
2024-03-17 06:50:00,1,3,1,3,1,9
2024-03-17 07:00:00,3,4,1,3,2,13
2024-03-17 07:10:00,2,7,0,5,3,17
2024-03-17 07:20:00,5,6,0,9,7,27
2024-03-17 07:30:00,2,4,1,11,7,25
2024-03-17 07:40:00,2,7,1,11,9,30
2024-03-17 07:50:00,1,5,1,21,10,38
2024-03-17 08:00:00,6,10,3,12,11,42
2024-03-17 08:10:00,11,12,2,12,5,42
2024-03-17 08:20:00,3,5,4,9,6,27
2024-03-17 08:30:00,2,12,2,16,7,39
2024-03-17 08:40:00,7,8,1,19,7,42
2024-03-17 08:50:00,9,15,1,6,5,36
2024-03-17 09:00:00,4,12,3,21,13,53
2024-03-17 09:10:00,7,20,3,9,12,51
2024-03-17 09:20:00,11,18,3,18,7,57
2024-03-17 09:30:00,8,6,5,17,11,47
2024-03-17 09:40:00,10,21,8,19,10,68
2024-03-17 09:50:00,4,17,5,26,16,68
2024-03-17 10:00:00,7,15,13,19,15,69
2024-03-17 10:10:00,8,13,5,22,10,58
2024-03-17 10:20:00,11,17,11,19,11,69
2024-03-17 10:30:00,10,12,9,22,13,66
2024-03-17 10:40:00,9,23,10,24,16,82
2024-03-17 10:50:00,10,26,7,17,12,72
2024-03-17 11:00:00,13,25,7,29,19,93
2024-03-17 11:10:00,13,15,9,25,16,78
2024-03-17 11:20:00,10,21,11,25,19,86
2024-03-17 11:30:00,17,17,8,18,21,81
2024-03-17 11:40:00,15,23,10,27,17,92
2024-03-17 11:50:00,11,21,13,22,17,84
2024-03-17 12:00:00,19,22,10,41,18,110
2024-03-17 12:10:00,15,23,19,34,24,115
2024-03-17 12:20:00,14,27,18,24,17,100
2024-03-17 12:30:00,8,34,11,30,19,102
2024-03-17 12:40:00,20,27,9,27,20,103
2024-03-17 12:50:00,18,26,10,26,14,94
2024-03-17 13:00:00,20,23,19,22,23,107
2024-03-17 13:10:00,12,28,10,32,20,102
2024-03-17 13:20:00,17,23,17,30,14,101
2024-03-17 13:30:00,13,24,8,42,15,102
2024-03-17 13:40:00,10,29,14,26,19,98
2024-03-17 13:50:00,12,28,11,21,20,92
2024-03-17 14:00:00,14,29,11,31,20,105
2024-03-17 14:10:00,10,20,8,31,23,92
2024-03-17 14:20:00,12,32,17,27,21,109
2024-03-17 14:30:00,12,25,9,33,19,98
2024-03-17 14:40:00,8,24,11,24,19,86
2024-03-17 14:50:00,12,30,7,26,22,97
2024-03-17 15:00:00,18,27,16,27,20,108
2024-03-17 15:10:00,10,23,7,28,21,89
2024-03-17 15:20:00,13,21,11,29,26,100
2024-03-17 15:30:00,19,29,11,25,28,112
2024-03-17 15:40:00,14,25,18,23,24,104
2024-03-17 15:50:00,12,29,9,18,15,83
2024-03-17 16:00:00,11,30,12,23,20,96
2024-03-17 16:10:00,16,20,13,29,24,102
2024-03-17 16:20:00,20,27,11,28,20,106
2024-03-17 16:30:00,15,22,14,34,22,107
2024-03-17 16:40:00,17,31,14,17,17,96
2024-03-17 16:50:00,13,22,17,20,22,94
2024-03-17 17:00:00,13,25,14,29,13,94
2024-03-17 17:10:00,17,27,17,28,22,111
2024-03-17 17:20:00,21,30,16,30,27,124
2024-03-17 17:30:00,8,29,20,29,20,106
2024-03-17 17:40:00,14,36,12,28,25,115
2024-03-17 17:50:00,17,37,14,28,22,118
2024-03-17 18:00:00,14,25,9,24,23,95
2024-03-17 18:10:00,18,27,12,25,16,98
2024-03-17 18:20:00,12,25,12,24,28,101
2024-03-17 18:30:00,17,19,14,25,17,92
2024-03-17 18:40:00,15,26,8,26,23,98
2024-03-17 18:50:00,16,35,16,28,23,118
2024-03-17 19:00:00,17,26,14,26,16,99
2024-03-17 19:10:00,25,39,8,28,40,140
2024-03-17 19:20:00,18,27,10,19,29,103
2024-03-17 19:30:00,23,26,19,28,25,121
2024-03-17 19:40:00,23,28,22,23,31,127
2024-03-17 19:50:00,35,26,16,35,22,134
2024-03-17 20:00:00,14,31,21,27,27,120
2024-03-17 20:10:00,7,34,19,20,19,99
2024-03-17 20:20:00,16,28,15,17,26,102
2024-03-17 20:30:00,19,24,9,40,24,116
2024-03-17 20:40:00,10,24,8,23,19,84
2024-03-17 20:50:00,8,28,15,23,23,97
2024-03-17 21:00:00,17,19,4,21,20,81
2024-03-17 21:10:00,14,17,11,19,19,80
2024-03-17 21:20:00,23,29,12,22,26,112
2024-03-17 21:30:00,8,28,21,24,29,110
2024-03-17 21:40:00,17,23,10,19,25,94
2024-03-17 21:50:00,5,14,5,18,14,56
2024-03-17 22:00:00,7,17,7,18,10,59
2024-03-17 22:10:00,7,17,5,20,21,70
2024-03-17 22:20:00,7,15,7,12,23,64
2024-03-17 22:30:00,11,16,7,19,18,71
2024-03-17 22:40:00,4,16,7,16,17,60
2024-03-17 22:50:00,9,13,12,12,13,59
2024-03-17 23:00:00,5,22,2,11,8,48
2024-03-17 23:10:00,2,19,2,15,13,51
2024-03-17 23:20:00,3,9,2,7,14,35
2024-03-17 23:30:00,13,7,2,8,12,42
2024-03-17 23:40:00,6,10,8,6,9,39
2024-03-17 23:50:00,1,4,0,4,7,16
2024-03-18 00:00:00,3,5,0,8,5,21
2024-03-18 00:10:00,4,5,2,2,5,18
2024-03-18 00:20:00,6,3,0,5,3,17
2024-03-18 00:30:00,2,2,1,2,5,12
2024-03-18 00:40:00,3,1,0,6,2,12
2024-03-18 00:50:00,1,2,3,4,2,12
2024-03-18 01:00:00,2,4,0,5,4,15
2024-03-18 01:10:00,0,1,0,4,7,12
2024-03-18 01:20:00,2,0,0,2,3,7
2024-03-18 01:30:00,0,0,0,2,2,4
2024-03-18 01:40:00,0,2,1,2,3,8
2024-03-18 01:50:00,2,2,2,0,2,8
2024-03-18 02:00:00,1,2,2,2,4,11
2024-03-18 02:10:00,0,1,3,0,1,5
2024-03-18 02:20:00,0,2,0,2,1,5
2024-03-18 02:30:00,4,1,0,1,2,8
2024-03-18 02:40:00,0,1,1,0,1,3
2024-03-18 02:50:00,1,2,0,1,0,4
2024-03-18 03:00:00,2,0,0,1,4,7
2024-03-18 03:10:00,0,0,0,4,3,7
2024-03-18 03:20:00,1,2,0,1,0,4
2024-03-18 03:30:00,1,3,1,2,2,9
2024-03-18 03:40:00,2,3,1,2,1,9
2024-03-18 03:50:00,0,2,0,3,1,6
2024-03-18 04:00:00,2,2,1,4,3,12
2024-03-18 04:10:00,1,3,0,2,2,8
2024-03-18 04:20:00,0,3,2,3,3,11
2024-03-18 04:30:00,0,3,0,4,3,10
2024-03-18 04:40:00,5,4,1,1,7,18
2024-03-18 04:50:00,2,5,1,6,7,21
2024-03-18 05:00:00,7,12,6,4,7,36
2024-03-18 05:10:00,11,12,4,11,9,47
2024-03-18 05:20:00,15,11,1,8,7,42
2024-03-18 05:30:00,22,18,9,11,14,74
2024-03-18 05:40:00,26,16,4,11,25,82
2024-03-18 05:50:00,37,22,14,17,22,112
2024-03-18 06:00:00,31,16,9,12,11,79
2024-03-18 06:10:00,25,20,10,28,19,102
2024-03-18 06:20:00,20,17,10,22,23,92
2024-03-18 06:30:00,17,29,2,21,19,88
2024-03-18 06:40:00,21,25,12,16,28,102
2024-03-18 06:50:00,14,27,15,26,23,105
2024-03-18 07:00:00,27,27,9,23,23,109
2024-03-18 07:10:00,32,29,18,28,27,134
2024-03-18 07:20:00,21,29,20,23,21,114
2024-03-18 07:30:00,21,31,19,29,22,122
2024-03-18 07:40:00,25,34,32,23,27,141
2024-03-18 07:50:00,17,32,19,33,34,135
2024-03-18 08:00:00,19,40,24,34,31,148
2024-03-18 08:10:00,16,22,9,31,35,113
2024-03-18 08:20:00,28,27,18,35,29,137
2024-03-18 08:30:00,25,31,19,22,27,124
2024-03-18 08:40:00,17,25,13,25,29,109
2024-03-18 08:50:00,27,24,20,26,22,119
2024-03-18 09:00:00,25,26,12,20,18,101
2024-03-18 09:10:00,23,30,13,29,20,115
2024-03-18 09:20:00,19,31,18,27,24,119
2024-03-18 09:30:00,16,35,19,33,28,131
2024-03-18 09:40:00,19,29,16,32,19,115
2024-03-18 09:50:00,27,23,24,24,22,120
2024-03-18 10:00:00,23,29,13,24,22,111
2024-03-18 10:10:00,20,21,8,33,23,105
2024-03-18 10:20:00,21,26,15,23,17,102
2024-03-18 10:30:00,16,25,9,30,33,113
2024-03-18 10:40:00,24,27,15,18,23,107
2024-03-18 10:50:00,23,28,13,29,21,114
2024-03-18 11:00:00,18,21,23,21,19,102
2024-03-18 11:10:00,21,23,17,25,24,110
2024-03-18 11:20:00,16,20,18,28,20,102
2024-03-18 11:30:00,25,27,17,28,33,130
2024-03-18 11:40:00,25,20,12,29,24,110
2024-03-18 11:50:00,25,31,15,30,26,127
2024-03-18 12:00:00,20,32,14,27,25,118
2024-03-18 12:10:00,14,20,18,29,23,104
2024-03-18 12:20:00,20,19,14,28,24,105
2024-03-18 12:30:00,16,31,19,29,22,117
2024-03-18 12:40:00,14,23,11,30,23,101
2024-03-18 12:50:00,21,23,19,34,38,135
2024-03-18 13:00:00,20,23,20,27,27,117
2024-03-18 13:10:00,22,24,17,21,29,113
2024-03-18 13:20:00,22,31,25,33,14,125
2024-03-18 13:30:00,21,32,14,31,26,124
2024-03-18 13:40:00,20,28,12,22,19,101
2024-03-18 13:50:00,17,35,16,26,20,114
2024-03-18 14:00:00,24,25,13,28,21,111
2024-03-18 14:10:00,24,30,17,31,23,125
2024-03-18 14:20:00,20,37,16,34,25,132
2024-03-18 14:30:00,18,17,13,28,18,94
2024-03-18 14:40:00,17,23,18,32,31,121
2024-03-18 14:50:00,18,41,24,30,32,145
2024-03-18 15:00:00,18,31,21,34,30,134
2024-03-18 15:10:00,22,35,26,34,32,149
2024-03-18 15:20:00,24,32,20,24,31,131
2024-03-18 15:30:00,33,33,17,28,36,147
2024-03-18 15:40:00,29,31,20,28,28,136
2024-03-18 15:50:00,19,34,19,24,24,120
2024-03-18 16:00:00,33,33,23,27,30,146
2024-03-18 16:10:00,27,28,12,34,29,130
2024-03-18 16:20:00,33,27,23,29,26,138
2024-03-18 16:30:00,17,35,19,29,30,130
2024-03-18 16:40:00,27,35,21,22,33,138
2024-03-18 16:50:00,23,27,14,23,27,114
2024-03-18 17:00:00,26,32,19,21,21,119
2024-03-18 17:10:00,30,35,22,30,25,142
2024-03-18 17:20:00,26,33,21,34,27,141
2024-03-18 17:30:00,20,29,15,32,28,124
2024-03-18 17:40:00,17,27,18,25,23,110
2024-03-18 17:50:00,21,26,18,34,21,120
2024-03-18 18:00:00,21,29,18,22,25,115
2024-03-18 18:10:00,23,23,20,24,30,120
2024-03-18 18:20:00,17,27,14,28,23,109
2024-03-18 18:30:00,18,24,12,28,26,108
2024-03-18 18:40:00,17,29,12,28,25,111
2024-03-18 18:50:00,22,19,21,24,24,110
2024-03-18 19:00:00,28,32,17,26,34,137
2024-03-18 19:10:00,23,30,17,30,39,139
2024-03-18 19:20:00,20,31,19,24,32,126
2024-03-18 19:30:00,21,31,20,28,30,130
2024-03-18 19:40:00,19,33,21,24,26,123
2024-03-18 19:50:00,27,34,24,28,28,141
2024-03-18 20:00:00,19,30,24,31,27,131
2024-03-18 20:10:00,17,37,15,27,38,134
2024-03-18 20:20:00,13,25,11,24,20,93
2024-03-18 20:30:00,31,27,6,28,29,121
2024-03-18 20:40:00,14,25,11,20,17,87
2024-03-18 20:50:00,19,18,16,26,27,106
2024-03-18 21:00:00,25,23,11,17,22,98
2024-03-18 21:10:00,9,19,7,19,19,73
2024-03-18 21:20:00,12,44,9,21,23,109
2024-03-18 21:30:00,6,19,12,20,20,77
2024-03-18 21:40:00,15,15,1,16,26,73
2024-03-18 21:50:00,5,14,6,16,18,59
2024-03-18 22:00:00,5,19,10,24,23,81
2024-03-18 22:10:00,6,9,9,12,17,53
2024-03-18 22:20:00,9,10,10,15,22,66
2024-03-18 22:30:00,7,14,8,12,14,55
2024-03-18 22:40:00,4,8,2,14,17,45
2024-03-18 22:50:00,4,8,2,11,11,36
2024-03-18 23:00:00,4,10,2,15,11,42
2024-03-18 23:10:00,2,8,3,11,12,36
2024-03-18 23:20:00,8,10,3,11,12,44
2024-03-18 23:30:00,8,10,3,12,9,42
2024-03-18 23:40:00,7,6,3,10,11,37
2024-03-18 23:50:00,5,6,10,4,11,36
2024-03-19 00:00:00,0,11,0,17,10,38
2024-03-19 00:10:00,8,5,0,4,8,25
2024-03-19 00:20:00,7,7,11,2,3,30
2024-03-19 00:30:00,3,0,1,6,8,18
2024-03-19 00:40:00,2,3,1,4,3,13
2024-03-19 00:50:00,1,4,3,3,4,15
2024-03-19 01:00:00,0,5,2,4,3,14
2024-03-19 01:10:00,0,2,1,5,1,9
2024-03-19 01:20:00,9,3,0,2,2,16
2024-03-19 01:30:00,0,7,3,0,1,11
2024-03-19 01:40:00,1,7,0,3,1,12
2024-03-19 01:50:00,3,1,0,2,0,6
2024-03-19 02:00:00,0,6,3,7,0,16
2024-03-19 02:10:00,1,1,0,2,1,5
2024-03-19 02:20:00,1,6,2,2,2,13
2024-03-19 02:30:00,3,4,5,4,0,16
2024-03-19 02:40:00,0,3,1,5,5,14
2024-03-19 02:50:00,2,0,0,1,1,4
2024-03-19 03:00:00,0,4,3,1,2,10
2024-03-19 03:10:00,0,0,1,5,1,7
2024-03-19 03:20:00,0,1,0,3,0,4
2024-03-19 03:30:00,3,1,0,2,1,7
2024-03-19 03:40:00,1,1,1,5,4,12
2024-03-19 03:50:00,2,0,1,6,11,20
2024-03-19 04:00:00,0,6,0,3,2,11
2024-03-19 04:10:00,4,6,0,5,2,17
2024-03-19 04:20:00,5,5,0,2,2,14
2024-03-19 04:30:00,0,2,0,5,4,11
2024-03-19 04:40:00,8,5,0,2,5,20
2024-03-19 04:50:00,9,15,5,7,10,46
2024-03-19 05:00:00,13,9,4,8,13,47
2024-03-19 05:10:00,20,11,8,8,19,66
2024-03-19 05:20:00,23,12,13,11,9,68
2024-03-19 05:30:00,22,15,13,14,19,83
2024-03-19 05:40:00,35,22,5,9,16,87
2024-03-19 05:50:00,31,22,6,11,34,104
2024-03-19 06:00:00,31,26,6,22,25,110
2024-03-19 06:10:00,41,24,15,17,15,112
2024-03-19 06:20:00,25,20,7,20,13,85
2024-03-19 06:30:00,16,16,13,23,27,95
2024-03-19 06:40:00,23,24,14,23,26,110
2024-03-19 06:50:00,19,27,8,28,31,113
2024-03-19 07:00:00,18,30,15,28,29,120
2024-03-19 07:10:00,24,29,16,34,29,132
2024-03-19 07:20:00,18,32,14,31,20,115
2024-03-19 07:30:00,19,20,13,24,27,103
2024-03-19 07:40:00,15,22,21,29,32,119
2024-03-19 07:50:00,16,32,21,29,22,120
2024-03-19 08:00:00,23,33,23,30,31,140
2024-03-19 08:10:00,16,24,21,24,24,109
2024-03-19 08:20:00,20,28,18,31,32,129
2024-03-19 08:30:00,21,32,20,23,19,115
2024-03-19 08:40:00,24,33,21,26,25,129
2024-03-19 08:50:00,28,31,20,27,28,134
2024-03-19 09:00:00,25,23,15,24,21,108
2024-03-19 09:10:00,36,30,28,27,32,153
2024-03-19 09:20:00,23,28,28,35,30,144
2024-03-19 09:30:00,21,30,25,26,21,123
2024-03-19 09:40:00,22,27,27,24,25,125
2024-03-19 09:50:00,17,25,19,30,26,117
2024-03-19 10:00:00,21,26,14,31,23,115
2024-03-19 10:10:00,23,25,13,32,24,117
2024-03-19 10:20:00,25,30,13,27,23,118
2024-03-19 10:30:00,22,31,14,30,20,117
2024-03-19 10:40:00,17,32,16,25,23,113
2024-03-19 10:50:00,21,25,14,26,22,108
2024-03-19 11:00:00,24,30,12,29,24,119
2024-03-19 11:10:00,19,30,12,32,19,112
2024-03-19 11:20:00,17,28,18,28,24,115
2024-03-19 11:30:00,24,32,16,28,23,123
2024-03-19 11:40:00,18,23,12,32,23,108
2024-03-19 11:50:00,22,18,13,21,19,93
2024-03-19 12:00:00,22,23,16,29,20,110
2024-03-19 12:10:00,20,34,11,35,25,125
2024-03-19 12:20:00,20,20,16,26,24,106
2024-03-19 12:30:00,25,27,11,33,30,126
2024-03-19 12:40:00,17,31,10,29,25,112
2024-03-19 12:50:00,27,35,18,31,32,143
2024-03-19 13:00:00,23,20,12,27,27,109
2024-03-19 13:10:00,25,36,25,26,27,139
2024-03-19 13:20:00,26,26,24,31,25,132
2024-03-19 13:30:00,19,27,16,33,24,119
2024-03-19 13:40:00,18,26,9,27,24,104
2024-03-19 13:50:00,19,25,16,38,35,133
2024-03-19 14:00:00,22,30,13,31,25,121
2024-03-19 14:10:00,19,34,16,32,27,128
2024-03-19 14:20:00,23,25,18,33,24,123
2024-03-19 14:30:00,21,32,15,32,20,120
2024-03-19 14:40:00,22,33,14,28,22,119
2024-03-19 14:50:00,19,28,24,22,23,116
2024-03-19 15:00:00,28,33,27,34,25,147
2024-03-19 15:10:00,35,32,23,28,26,144
2024-03-19 15:20:00,22,34,24,29,25,134
2024-03-19 15:30:00,25,30,24,37,38,154
2024-03-19 15:40:00,36,49,23,32,26,166
2024-03-19 15:50:00,32,37,29,31,22,151
2024-03-19 16:00:00,23,36,26,38,38,161
2024-03-19 16:10:00,19,40,25,27,32,143
2024-03-19 16:20:00,22,46,17,30,29,144
2024-03-19 16:30:00,26,31,22,27,36,142
2024-03-19 16:40:00,27,29,19,22,24,121
2024-03-19 16:50:00,30,36,20,34,27,147
2024-03-19 17:00:00,29,41,24,29,27,150
2024-03-19 17:10:00,23,39,21,27,32,142
2024-03-19 17:20:00,25,31,19,36,25,136
2024-03-19 17:30:00,22,33,15,33,38,141
2024-03-19 17:40:00,27,34,22,24,34,141
2024-03-19 17:50:00,20,24,23,34,33,134
2024-03-19 18:00:00,20,32,24,36,24,136
2024-03-19 18:10:00,21,31,21,25,28,126
2024-03-19 18:20:00,23,28,21,26,26,124
2024-03-19 18:30:00,22,28,19,34,28,131
2024-03-19 18:40:00,23,25,14,26,19,107
2024-03-19 18:50:00,25,31,13,24,20,113
2024-03-19 19:00:00,25,23,16,25,28,117
2024-03-19 19:10:00,22,33,27,21,21,124
2024-03-19 19:20:00,20,34,14,30,37,135
2024-03-19 19:30:00,16,26,18,19,30,109
2024-03-19 19:40:00,18,41,19,33,28,139
2024-03-19 19:50:00,32,27,18,27,32,136
2024-03-19 20:00:00,34,46,28,37,42,187
2024-03-19 20:10:00,29,26,14,28,30,127
2024-03-19 20:20:00,31,31,15,27,30,134
2024-03-19 20:30:00,17,25,22,21,26,111
2024-03-19 20:40:00,21,18,8,29,37,113
2024-03-19 20:50:00,20,41,9,26,35,131
2024-03-19 21:00:00,15,30,15,14,34,108
2024-03-19 21:10:00,23,19,6,27,37,112
2024-03-19 21:20:00,12,33,30,21,48,144
2024-03-19 21:30:00,25,24,14,19,47,129
2024-03-19 21:40:00,17,31,4,22,37,111
2024-03-19 21:50:00,7,20,15,23,46,111
2024-03-19 22:00:00,5,30,11,17,20,83
2024-03-19 22:10:00,9,30,14,22,27,102
2024-03-19 22:20:00,17,28,9,16,24,94
2024-03-19 22:30:00,13,18,16,22,32,101
2024-03-19 22:40:00,6,11,6,19,25,67
2024-03-19 22:50:00,10,9,6,13,21,59
2024-03-19 23:00:00,5,18,7,15,25,70
2024-03-19 23:10:00,6,16,5,13,22,62
2024-03-19 23:20:00,1,21,12,9,23,66
2024-03-19 23:30:00,10,14,4,10,9,47
2024-03-19 23:40:00,7,16,1,8,4,36
2024-03-19 23:50:00,8,12,6,7,4,37
2024-03-20 00:00:00,1,5,0,11,10,27
2024-03-20 00:10:00,5,4,2,6,8,25
2024-03-20 00:20:00,5,10,1,6,6,28
2024-03-20 00:30:00,4,9,2,6,4,25
2024-03-20 00:40:00,8,5,0,4,10,27
2024-03-20 00:50:00,0,4,1,3,3,11
2024-03-20 01:00:00,2,1,3,6,7,19
2024-03-20 01:10:00,1,7,4,4,9,25
2024-03-20 01:20:00,0,2,0,1,3,6
2024-03-20 01:30:00,4,3,0,3,2,12
2024-03-20 01:40:00,0,2,2,5,1,10
2024-03-20 01:50:00,1,3,0,2,1,7
2024-03-20 02:00:00,6,5,0,2,3,16
2024-03-20 02:10:00,0,1,0,3,6,10
2024-03-20 02:20:00,0,3,0,4,3,10
2024-03-20 02:30:00,3,1,0,0,3,7
2024-03-20 02:40:00,0,1,0,0,3,4
2024-03-20 02:50:00,0,0,1,5,2,8
2024-03-20 03:00:00,3,1,1,1,1,7
2024-03-20 03:10:00,5,0,1,2,1,9
2024-03-20 03:20:00,3,5,0,5,6,19
2024-03-20 03:30:00,0,4,3,0,0,7
2024-03-20 03:40:00,4,0,0,1,2,7
2024-03-20 03:50:00,1,2,0,5,2,10
2024-03-20 04:00:00,0,2,0,1,0,3
2024-03-20 04:10:00,4,4,3,6,2,19
2024-03-20 04:20:00,5,5,0,4,3,17
2024-03-20 04:30:00,1,0,2,4,7,14
2024-03-20 04:40:00,5,9,2,3,8,27
2024-03-20 04:50:00,8,4,4,8,9,33
2024-03-20 05:00:00,10,7,6,9,10,42
2024-03-20 05:10:00,15,16,11,10,18,70
2024-03-20 05:20:00,23,11,8,9,6,57
2024-03-20 05:30:00,18,11,8,10,21,68
2024-03-20 05:40:00,22,28,9,17,14,90
2024-03-20 05:50:00,34,14,11,13,33,105
2024-03-20 06:00:00,30,22,11,8,16,87
2024-03-20 06:10:00,22,20,12,25,19,98
2024-03-20 06:20:00,10,15,5,20,18,68
2024-03-20 06:30:00,17,17,12,20,16,82
2024-03-20 06:40:00,16,21,16,27,27,107
2024-03-20 06:50:00,14,16,11,22,30,93
2024-03-20 07:00:00,18,34,15,31,21,119
2024-03-20 07:10:00,19,28,24,24,28,123
2024-03-20 07:20:00,19,29,20,25,23,116
2024-03-20 07:30:00,13,29,14,33,21,110
2024-03-20 07:40:00,30,35,31,32,28,156
2024-03-20 07:50:00,19,37,18,35,32,141
2024-03-20 08:00:00,23,27,18,33,31,132
2024-03-20 08:10:00,20,29,17,39,29,134
2024-03-20 08:20:00,17,31,13,31,26,118
2024-03-20 08:30:00,23,27,26,29,21,126
2024-03-20 08:40:00,21,28,33,30,37,149
2024-03-20 08:50:00,21,34,14,28,22,119
2024-03-20 09:00:00,25,31,24,27,27,134
2024-03-20 09:10:00,18,29,25,30,21,123
2024-03-20 09:20:00,19,24,22,29,25,119
2024-03-20 09:30:00,15,27,13,30,23,108
2024-03-20 09:40:00,22,33,20,28,29,132
2024-03-20 09:50:00,25,28,15,32,30,130
2024-03-20 10:00:00,19,29,13,28,15,104
2024-03-20 10:10:00,21,19,13,25,25,103
2024-03-20 10:20:00,20,26,9,22,16,93
2024-03-20 10:30:00,20,30,8,27,18,103
2024-03-20 10:40:00,20,27,11,32,23,113
2024-03-20 10:50:00,26,29,15,28,17,115
2024-03-20 11:00:00,16,22,13,29,20,100
2024-03-20 11:10:00,20,30,15,27,22,114
2024-03-20 11:20:00,24,29,14,29,32,128
2024-03-20 11:30:00,18,22,14,36,26,116
2024-03-20 11:40:00,18,23,13,27,25,106
2024-03-20 11:50:00,23,26,17,30,28,124
2024-03-20 12:00:00,23,34,17,29,23,126
2024-03-20 12:10:00,25,39,20,25,17,126
2024-03-20 12:20:00,25,32,16,28,31,132
2024-03-20 12:30:00,17,19,18,33,20,107
2024-03-20 12:40:00,20,23,15,30,18,106
2024-03-20 12:50:00,24,30,17,29,34,134
2024-03-20 13:00:00,13,21,18,29,15,96
2024-03-20 13:10:00,18,30,19,30,30,127
2024-03-20 13:20:00,26,25,20,26,29,126
2024-03-20 13:30:00,23,31,16,27,26,123
2024-03-20 13:40:00,17,22,18,33,22,112
2024-03-20 13:50:00,25,36,20,29,16,126
2024-03-20 14:00:00,24,38,22,33,28,145
2024-03-20 14:10:00,21,34,16,25,25,121
2024-03-20 14:20:00,21,25,22,29,24,121
2024-03-20 14:30:00,17,26,17,36,23,119
2024-03-20 14:40:00,16,32,22,34,31,135
2024-03-20 14:50:00,21,34,22,31,26,134
2024-03-20 15:00:00,26,32,21,23,32,134
2024-03-20 15:10:00,21,33,27,26,29,136
2024-03-20 15:20:00,25,37,22,27,29,140
2024-03-20 15:30:00,22,38,21,37,28,146
2024-03-20 15:40:00,29,42,20,32,38,161
2024-03-20 15:50:00,28,34,22,40,31,155
2024-03-20 16:00:00,22,30,22,41,36,151
2024-03-20 16:10:00,18,41,32,33,35,159
2024-03-20 16:20:00,25,46,27,30,30,158
2024-03-20 16:30:00,24,29,29,34,31,147
2024-03-20 16:40:00,19,40,25,32,30,146
2024-03-20 16:50:00,27,42,27,29,28,153
2024-03-20 17:00:00,19,36,19,34,30,138
2024-03-20 17:10:00,25,37,19,28,34,143
2024-03-20 17:20:00,28,38,22,25,25,138
2024-03-20 17:30:00,25,31,20,36,27,139
2024-03-20 17:40:00,27,31,30,25,21,134
2024-03-20 17:50:00,22,35,27,30,37,151
2024-03-20 18:00:00,14,28,16,39,34,131
2024-03-20 18:10:00,27,32,20,23,24,126
2024-03-20 18:20:00,21,30,13,19,25,108
2024-03-20 18:30:00,22,26,16,25,30,119
2024-03-20 18:40:00,18,27,18,30,24,117
2024-03-20 18:50:00,25,24,19,31,24,123
2024-03-20 19:00:00,9,36,10,36,33,124
2024-03-20 19:10:00,25,28,30,28,29,140
2024-03-20 19:20:00,21,33,22,32,18,126
2024-03-20 19:30:00,18,37,16,26,41,138
2024-03-20 19:40:00,27,30,36,30,22,145
2024-03-20 19:50:00,31,25,17,28,33,134
2024-03-20 20:00:00,35,37,24,28,30,154
2024-03-20 20:10:00,26,36,25,29,23,139
2024-03-20 20:20:00,17,40,14,26,25,122
2024-03-20 20:30:00,24,25,17,31,29,126
2024-03-20 20:40:00,26,26,10,26,33,121
2024-03-20 20:50:00,22,24,14,32,29,121
2024-03-20 21:00:00,19,25,5,30,31,110
2024-03-20 21:10:00,18,34,11,22,20,105
2024-03-20 21:20:00,21,24,14,28,22,109
2024-03-20 21:30:00,13,37,21,24,34,129
2024-03-20 21:40:00,16,24,23,29,29,121
2024-03-20 21:50:00,14,31,15,33,34,127
2024-03-20 22:00:00,10,23,15,12,19,79
2024-03-20 22:10:00,9,26,18,21,22,96
2024-03-20 22:20:00,6,22,24,14,31,97
2024-03-20 22:30:00,16,16,12,18,24,86
2024-03-20 22:40:00,6,19,2,12,18,57
2024-03-20 22:50:00,5,10,0,13,13,41
2024-03-20 23:00:00,10,15,6,12,18,61
2024-03-20 23:10:00,4,11,2,11,10,38
2024-03-20 23:20:00,11,11,5,12,17,56
2024-03-20 23:30:00,2,11,8,12,12,45
2024-03-20 23:40:00,6,7,8,13,7,41
2024-03-20 23:50:00,8,6,5,11,9,39
2024-03-21 00:00:00,2,7,2,8,9,28
2024-03-21 00:10:00,2,8,1,4,5,20
2024-03-21 00:20:00,1,3,0,7,6,17
2024-03-21 00:30:00,6,5,0,7,12,30
2024-03-21 00:40:00,5,3,0,5,9,22
2024-03-21 00:50:00,4,6,0,7,7,24
2024-03-21 01:00:00,0,5,6,4,6,21
2024-03-21 01:10:00,0,0,2,9,3,14
2024-03-21 01:20:00,1,3,4,0,6,14
2024-03-21 01:30:00,0,1,0,1,4,6
2024-03-21 01:40:00,0,1,3,6,1,11
2024-03-21 01:50:00,1,1,1,3,8,14
2024-03-21 02:00:00,2,4,0,6,3,15
2024-03-21 02:10:00,0,4,2,0,3,9
2024-03-21 02:20:00,0,2,0,1,0,3
2024-03-21 02:30:00,3,4,0,1,2,10
2024-03-21 02:40:00,0,1,0,3,3,7
2024-03-21 02:50:00,0,4,6,0,1,11
2024-03-21 03:00:00,0,0,3,5,2,10
2024-03-21 03:10:00,0,1,2,5,0,8
2024-03-21 03:20:00,2,2,0,2,0,6
2024-03-21 03:30:00,0,1,0,2,0,3
2024-03-21 03:40:00,2,1,0,4,2,9
2024-03-21 03:50:00,0,3,0,3,1,7
2024-03-21 04:00:00,4,4,0,1,2,11
2024-03-21 04:10:00,5,3,0,3,4,15
2024-03-21 04:20:00,2,6,0,4,4,16
2024-03-21 04:30:00,2,4,0,3,3,12
2024-03-21 04:40:00,15,8,0,3,6,32
2024-03-21 04:50:00,4,1,3,2,9,19
2024-03-21 05:00:00,11,10,5,13,10,49
2024-03-21 05:10:00,9,13,6,8,11,47
2024-03-21 05:20:00,24,11,4,9,8,56
2024-03-21 05:30:00,22,17,14,10,20,83
2024-03-21 05:40:00,34,19,8,14,18,93
2024-03-21 05:50:00,27,19,6,15,30,97
2024-03-21 06:00:00,23,18,15,12,18,86
2024-03-21 06:10:00,25,17,7,24,15,88
2024-03-21 06:20:00,15,19,8,16,17,75
2024-03-21 06:30:00,22,25,3,25,24,99
2024-03-21 06:40:00,19,22,17,18,26,102
2024-03-21 06:50:00,19,20,11,18,27,95
2024-03-21 07:00:00,28,29,16,21,30,124
2024-03-21 07:10:00,16,25,25,28,23,117
2024-03-21 07:20:00,25,27,18,31,26,127
2024-03-21 07:30:00,21,32,16,31,21,121
2024-03-21 07:40:00,19,37,24,33,41,154
2024-03-21 07:50:00,13,29,19,30,33,124
2024-03-21 08:00:00,19,24,18,35,33,129
2024-03-21 08:10:00,20,24,19,28,22,113
2024-03-21 08:20:00,24,33,14,37,35,143
2024-03-21 08:30:00,21,28,16,30,33,128
2024-03-21 08:40:00,22,28,21,33,33,137
2024-03-21 08:50:00,27,31,24,22,24,128
2024-03-21 09:00:00,32,30,20,27,30,139
2024-03-21 09:10:00,24,27,16,25,20,112
2024-03-21 09:20:00,23,29,21,22,22,117
2024-03-21 09:30:00,25,39,19,34,29,146
2024-03-21 09:40:00,19,22,16,26,24,107
2024-03-21 09:50:00,15,22,11,34,28,110
2024-03-21 10:00:00,21,32,15,22,20,110
2024-03-21 10:10:00,13,36,14,28,23,114
2024-03-21 10:20:00,11,23,11,17,10,72
2024-03-21 10:30:00,28,29,18,31,23,129
2024-03-21 10:40:00,21,29,16,33,24,123
2024-03-21 10:50:00,25,22,15,28,23,113
2024-03-21 11:00:00,19,31,18,32,22,122
2024-03-21 11:10:00,21,26,31,31,18,127
2024-03-21 11:20:00,19,28,20,31,18,116
2024-03-21 11:30:00,22,24,20,34,30,130
2024-03-21 11:40:00,24,25,17,28,29,123
2024-03-21 11:50:00,24,30,17,25,21,117
2024-03-21 12:00:00,18,23,10,32,25,108
2024-03-21 12:10:00,18,33,14,26,30,121
2024-03-21 12:20:00,21,25,15,28,16,105
2024-03-21 12:30:00,17,26,13,29,29,114
2024-03-21 12:40:00,21,25,14,25,28,113
2024-03-21 12:50:00,17,30,12,32,27,118
2024-03-21 13:00:00,20,29,18,27,23,117
2024-03-21 13:10:00,21,30,19,27,22,119
2024-03-21 13:20:00,22,22,20,31,27,122
2024-03-21 13:30:00,17,31,17,31,25,121
2024-03-21 13:40:00,14,21,13,29,17,94
2024-03-21 13:50:00,19,20,17,27,24,107
2024-03-21 14:00:00,21,25,20,34,30,130
2024-03-21 14:10:00,17,29,15,33,18,112
2024-03-21 14:20:00,24,30,22,38,30,144
2024-03-21 14:30:00,27,27,20,29,31,134
2024-03-21 14:40:00,23,26,20,23,26,118
2024-03-21 14:50:00,22,32,26,31,28,139
2024-03-21 15:00:00,23,27,29,31,30,140
2024-03-21 15:10:00,20,30,20,31,21,122
2024-03-21 15:20:00,19,35,19,30,24,127
2024-03-21 15:30:00,26,36,14,28,26,130
2024-03-21 15:40:00,32,30,22,28,24,136
2024-03-21 15:50:00,22,32,26,27,32,139
2024-03-21 16:00:00,21,34,17,36,31,139
2024-03-21 16:10:00,36,35,30,28,23,152
2024-03-21 16:20:00,22,37,21,36,35,151
2024-03-21 16:30:00,30,38,22,33,28,151
2024-03-21 16:40:00,25,34,24,25,32,140
2024-03-21 16:50:00,23,24,15,26,20,108
2024-03-21 17:00:00,14,38,18,32,29,131
2024-03-21 17:10:00,31,37,21,34,31,154
2024-03-21 17:20:00,25,33,23,23,24,128
2024-03-21 17:30:00,26,24,24,29,29,132
2024-03-21 17:40:00,14,23,20,22,18,97
2024-03-21 17:50:00,16,26,23,31,21,117
2024-03-21 18:00:00,26,33,22,37,34,152
2024-03-21 18:10:00,30,40,15,30,34,149
2024-03-21 18:20:00,18,33,21,26,26,124
2024-03-21 18:30:00,22,20,15,28,21,106
2024-03-21 18:40:00,21,29,16,24,22,112
2024-03-21 18:50:00,23,34,16,26,30,129
2024-03-21 19:00:00,22,28,20,35,26,131
2024-03-21 19:10:00,25,41,17,26,28,137
2024-03-21 19:20:00,23,30,25,32,26,136
2024-03-21 19:30:00,24,36,19,31,31,141
2024-03-21 19:40:00,28,31,32,35,25,151
2024-03-21 19:50:00,20,39,26,26,41,152
2024-03-21 20:00:00,16,36,10,30,15,107
2024-03-21 20:10:00,17,25,26,26,29,123
2024-03-21 20:20:00,15,34,11,28,25,113
2024-03-21 20:30:00,28,33,14,22,30,127
2024-03-21 20:40:00,18,27,10,27,22,104
2024-03-21 20:50:00,22,34,22,32,24,134
2024-03-21 21:00:00,14,29,11,35,31,120
2024-03-21 21:10:00,19,22,20,32,23,116
2024-03-21 21:20:00,5,24,29,27,36,121
2024-03-21 21:30:00,18,16,12,18,27,91
2024-03-21 21:40:00,18,18,13,31,19,99
2024-03-21 21:50:00,20,19,12,20,24,95
2024-03-21 22:00:00,14,25,11,31,16,97
2024-03-21 22:10:00,18,27,2,18,31,96
2024-03-21 22:20:00,15,20,2,21,20,78
2024-03-21 22:30:00,18,24,10,18,24,94
2024-03-21 22:40:00,12,27,14,17,25,95
2024-03-21 22:50:00,16,19,9,23,20,87
2024-03-21 23:00:00,10,17,5,15,18,65
2024-03-21 23:10:00,14,19,14,13,15,75
2024-03-21 23:20:00,10,12,10,12,16,60
2024-03-21 23:30:00,5,17,8,15,10,55
2024-03-21 23:40:00,2,10,9,11,7,39
2024-03-21 23:50:00,3,10,6,11,15,45
2024-03-22 00:00:00,0,11,0,14,7,32
2024-03-22 00:10:00,2,10,3,9,10,34
2024-03-22 00:20:00,7,7,0,6,3,23
2024-03-22 00:30:00,9,5,6,5,14,39
2024-03-22 00:40:00,1,7,0,5,10,23
2024-03-22 00:50:00,0,6,1,7,6,20
2024-03-22 01:00:00,2,6,0,5,3,16
2024-03-22 01:10:00,8,5,0,3,0,16
2024-03-22 01:20:00,3,7,3,1,2,16
2024-03-22 01:30:00,0,1,0,3,5,9
2024-03-22 01:40:00,3,4,1,4,8,20
2024-03-22 01:50:00,3,5,1,4,3,16
2024-03-22 02:00:00,0,0,0,2,2,4
2024-03-22 02:10:00,0,4,0,2,2,8
2024-03-22 02:20:00,0,0,0,3,3,6
2024-03-22 02:30:00,3,0,0,0,0,3
2024-03-22 02:40:00,1,5,0,4,3,13
2024-03-22 02:50:00,0,6,0,2,0,8
2024-03-22 03:00:00,0,0,0,2,0,2
2024-03-22 03:10:00,0,2,3,5,2,12
2024-03-22 03:20:00,3,4,1,2,1,11
2024-03-22 03:30:00,1,3,0,4,1,9
2024-03-22 03:40:00,4,1,0,1,3,9
2024-03-22 03:50:00,1,4,1,6,2,14
2024-03-22 04:00:00,1,5,0,3,3,12
2024-03-22 04:10:00,6,6,0,6,3,21
2024-03-22 04:20:00,12,1,0,3,4,20
2024-03-22 04:30:00,3,3,0,5,6,17
2024-03-22 04:40:00,6,4,2,10,11,33
2024-03-22 04:50:00,7,6,2,2,12,29
2024-03-22 05:00:00,17,13,8,9,6,53
2024-03-22 05:10:00,14,16,5,11,7,53
2024-03-22 05:20:00,25,26,10,7,6,74
2024-03-22 05:30:00,29,18,8,6,11,72
2024-03-22 05:40:00,24,15,12,18,36,105
2024-03-22 05:50:00,35,13,7,10,21,86
2024-03-22 06:00:00,33,8,5,23,13,82
2024-03-22 06:10:00,21,17,7,17,13,75
2024-03-22 06:20:00,20,19,7,15,13,74
2024-03-22 06:30:00,22,29,12,14,19,96
2024-03-22 06:40:00,20,19,9,20,23,91
2024-03-22 06:50:00,18,23,11,25,24,101
2024-03-22 07:00:00,13,30,9,25,20,97
2024-03-22 07:10:00,21,25,15,27,22,110
2024-03-22 07:20:00,20,24,14,36,26,120
2024-03-22 07:30:00,15,26,21,27,27,116
2024-03-22 07:40:00,18,31,19,41,30,139
2024-03-22 07:50:00,28,28,22,33,31,142
2024-03-22 08:00:00,25,21,24,26,21,117
2024-03-22 08:10:00,17,23,13,28,32,113
2024-03-22 08:20:00,23,29,16,30,20,118
2024-03-22 08:30:00,21,33,19,33,27,133
2024-03-22 08:40:00,21,20,14,31,32,118
2024-03-22 08:50:00,15,24,15,32,20,106
2024-03-22 09:00:00,30,29,16,23,21,119
2024-03-22 09:10:00,17,20,20,18,19,94
2024-03-22 09:20:00,21,27,22,28,16,114
2024-03-22 09:30:00,21,24,24,31,20,120
2024-03-22 09:40:00,22,29,18,29,19,117
2024-03-22 09:50:00,18,24,12,26,23,103
2024-03-22 10:00:00,15,22,13,26,21,97
2024-03-22 10:10:00,21,22,15,32,25,115
2024-03-22 10:20:00,15,22,17,25,26,105
2024-03-22 10:30:00,21,22,16,30,29,118
2024-03-22 10:40:00,18,28,17,23,14,100
2024-03-22 10:50:00,17,32,13,28,29,119
2024-03-22 11:00:00,19,27,19,27,28,120
2024-03-22 11:10:00,25,30,8,36,27,126
2024-03-22 11:20:00,22,22,14,22,23,103
2024-03-22 11:30:00,19,26,16,23,18,102
2024-03-22 11:40:00,20,23,16,33,30,122
2024-03-22 11:50:00,19,29,15,25,24,112
2024-03-22 12:00:00,27,28,17,31,22,125
2024-03-22 12:10:00,23,28,12,32,28,123
2024-03-22 12:20:00,24,27,17,27,34,129
2024-03-22 12:30:00,28,34,16,25,24,127
2024-03-22 12:40:00,29,37,21,23,29,139
2024-03-22 12:50:00,21,32,15,26,28,122
2024-03-22 13:00:00,28,34,25,33,27,147
2024-03-22 13:10:00,21,27,25,28,25,126
2024-03-22 13:20:00,26,27,19,31,33,136
2024-03-22 13:30:00,18,25,23,30,22,118
2024-03-22 13:40:00,31,24,16,24,36,131
2024-03-22 13:50:00,21,30,13,43,30,137
2024-03-22 14:00:00,27,23,19,28,28,125
2024-03-22 14:10:00,27,27,23,24,28,129
2024-03-22 14:20:00,33,32,22,26,34,147
2024-03-22 14:30:00,24,40,21,36,38,159
2024-03-22 14:40:00,18,37,18,25,31,129
2024-03-22 14:50:00,17,30,19,35,30,131
2024-03-22 15:00:00,25,33,20,29,28,135
2024-03-22 15:10:00,24,41,17,25,29,136
2024-03-22 15:20:00,16,39,22,24,36,137
2024-03-22 15:30:00,22,34,26,32,35,149
2024-03-22 15:40:00,26,34,26,40,30,156
2024-03-22 15:50:00,23,32,22,23,28,128
2024-03-22 16:00:00,29,37,19,37,38,160
2024-03-22 16:10:00,24,32,15,24,26,121
2024-03-22 16:20:00,28,31,17,26,27,129
2024-03-22 16:30:00,19,25,12,27,24,107
2024-03-22 16:40:00,21,30,18,23,30,122
2024-03-22 16:50:00,23,30,12,25,33,123
2024-03-22 17:00:00,17,32,14,29,34,126
2024-03-22 17:10:00,21,34,19,23,25,122
2024-03-22 17:20:00,25,21,19,25,15,105
2024-03-22 17:30:00,17,37,22,30,28,134
2024-03-22 17:40:00,22,22,14,24,20,102
2024-03-22 17:50:00,25,25,18,25,27,120
2024-03-22 18:00:00,10,27,10,27,24,98
2024-03-22 18:10:00,24,23,14,34,28,123
2024-03-22 18:20:00,17,20,31,23,21,112
2024-03-22 18:30:00,9,17,6,14,11,57
2024-03-22 18:40:00,5,7,5,8,8,33
2024-03-22 18:50:00,7,8,13,17,11,56
2024-03-22 19:00:00,26,33,16,27,36,138
2024-03-22 19:10:00,27,30,19,39,29,144
2024-03-22 19:20:00,17,38,14,25,44,138
2024-03-22 19:30:00,27,18,12,31,28,116
2024-03-22 19:40:00,24,34,15,25,36,134
2024-03-22 19:50:00,45,32,25,26,35,163
2024-03-22 20:00:00,44,32,31,35,35,177
2024-03-22 20:10:00,26,37,25,24,27,139
2024-03-22 20:20:00,20,31,32,22,30,135
2024-03-22 20:30:00,25,26,14,22,21,108
2024-03-22 20:40:00,25,29,8,30,31,123
2024-03-22 20:50:00,24,33,7,20,30,114
2024-03-22 21:00:00,23,23,10,23,25,104
2024-03-22 21:10:00,9,23,3,32,27,94
2024-03-22 21:20:00,10,28,16,35,27,116
2024-03-22 21:30:00,29,24,13,23,26,115
2024-03-22 21:40:00,12,28,17,31,34,122
2024-03-22 21:50:00,27,16,15,21,27,106
2024-03-22 22:00:00,4,23,11,24,26,88
2024-03-22 22:10:00,9,30,5,27,17,88
2024-03-22 22:20:00,11,13,14,25,26,89
2024-03-22 22:30:00,20,14,12,21,26,93
2024-03-22 22:40:00,13,25,11,19,33,101
2024-03-22 22:50:00,14,9,9,20,18,70
2024-03-22 23:00:00,12,17,8,12,23,72
2024-03-22 23:10:00,5,22,4,20,11,62
2024-03-22 23:20:00,18,22,9,11,18,78
2024-03-22 23:30:00,13,21,5,19,14,72
2024-03-22 23:40:00,5,14,7,17,18,61
2024-03-22 23:50:00,4,10,10,11,13,48
2024-03-23 00:00:00,5,14,7,11,11,48
2024-03-23 00:10:00,12,28,8,16,21,85
2024-03-23 00:20:00,14,21,7,10,15,67
2024-03-23 00:30:00,6,14,14,16,13,63
2024-03-23 00:40:00,3,15,6,12,15,51
2024-03-23 00:50:00,7,9,0,5,8,29
2024-03-23 01:00:00,4,15,0,7,12,38
2024-03-23 01:10:00,0,11,0,10,21,42
2024-03-23 01:20:00,2,7,2,11,9,31
2024-03-23 01:30:00,1,4,2,10,7,24
2024-03-23 01:40:00,7,13,2,5,12,39
2024-03-23 01:50:00,6,11,6,5,4,32
2024-03-23 02:00:00,4,3,2,4,7,20
2024-03-23 02:10:00,5,10,0,7,3,25
2024-03-23 02:20:00,2,4,0,7,1,14
2024-03-23 02:30:00,1,4,0,8,3,16
2024-03-23 02:40:00,2,2,6,7,2,19
2024-03-23 02:50:00,0,3,3,6,3,15
2024-03-23 03:00:00,7,10,0,11,0,28
2024-03-23 03:10:00,1,5,1,3,5,15
2024-03-23 03:20:00,0,6,4,8,4,22
2024-03-23 03:30:00,0,7,2,4,5,18
2024-03-23 03:40:00,6,7,0,3,7,23
2024-03-23 03:50:00,3,4,3,10,2,22
2024-03-23 04:00:00,0,1,0,11,4,16
2024-03-23 04:10:00,3,5,0,2,5,15
2024-03-23 04:20:00,1,0,2,4,6,13
2024-03-23 04:30:00,5,3,0,2,3,13
2024-03-23 04:40:00,8,4,7,3,4,26
2024-03-23 04:50:00,10,2,4,0,10,26
2024-03-23 05:00:00,9,3,2,6,6,26
2024-03-23 05:10:00,10,7,5,6,2,30
2024-03-23 05:20:00,9,8,6,3,8,34
2024-03-23 05:30:00,5,6,3,7,5,26
2024-03-23 05:40:00,3,9,1,10,9,32
2024-03-23 05:50:00,5,17,2,12,6,42
2024-03-23 06:00:00,8,15,3,9,3,38
2024-03-23 06:10:00,6,9,1,8,11,35
2024-03-23 06:20:00,3,9,3,7,11,33
2024-03-23 06:30:00,4,9,1,6,5,25
2024-03-23 06:40:00,3,10,1,6,8,28
2024-03-23 06:50:00,9,10,1,9,10,39
2024-03-23 07:00:00,10,3,1,7,6,27
2024-03-23 07:10:00,11,9,3,5,7,35
2024-03-23 07:20:00,15,9,0,10,2,36
2024-03-23 07:30:00,7,14,4,8,3,36
2024-03-23 07:40:00,17,10,7,14,9,57
2024-03-23 07:50:00,12,10,4,15,11,52
2024-03-23 08:00:00,17,10,8,15,14,64
2024-03-23 08:10:00,11,8,7,12,7,45
2024-03-23 08:20:00,13,12,1,16,11,53
2024-03-23 08:30:00,23,42,5,15,7,92
2024-03-23 08:40:00,18,23,4,18,9,72
2024-03-23 08:50:00,14,16,5,13,9,57
2024-03-23 09:00:00,17,20,6,20,12,75
2024-03-23 09:10:00,16,19,6,20,11,72
2024-03-23 09:20:00,16,23,8,20,14,81
2024-03-23 09:30:00,18,22,5,125,18,188
2024-03-23 09:40:00,24,24,13,26,16,103
2024-03-23 09:50:00,18,19,8,27,16,88
2024-03-23 10:00:00,19,33,10,20,15,97
2024-03-23 10:10:00,19,24,6,18,16,83
2024-03-23 10:20:00,18,29,12,19,17,95
2024-03-23 10:30:00,16,19,12,21,23,91
2024-03-23 10:40:00,21,28,11,23,24,107
2024-03-23 10:50:00,19,20,12,24,18,93
2024-03-23 11:00:00,21,28,11,24,20,104
2024-03-23 11:10:00,25,34,16,28,18,121
2024-03-23 11:20:00,17,15,18,19,15,84
2024-03-23 11:30:00,12,28,12,23,22,97
2024-03-23 11:40:00,19,29,12,25,24,109
2024-03-23 11:50:00,23,24,9,45,26,127
2024-03-23 12:00:00,26,31,11,30,27,125
2024-03-23 12:10:00,17,27,17,25,26,112
2024-03-23 12:20:00,20,31,15,27,21,114
2024-03-23 12:30:00,19,20,10,30,23,102
2024-03-23 12:40:00,13,25,15,33,29,115
2024-03-23 12:50:00,12,28,11,24,24,99
2024-03-23 13:00:00,17,27,17,26,23,110
2024-03-23 13:10:00,26,23,16,31,24,120
2024-03-23 13:20:00,23,26,9,29,20,107
2024-03-23 13:30:00,23,38,11,33,22,127
2024-03-23 13:40:00,18,23,18,20,31,110
2024-03-23 13:50:00,18,21,16,34,32,121
2024-03-23 14:00:00,12,19,13,28,31,103
2024-03-23 14:10:00,22,28,14,21,27,112
2024-03-23 14:20:00,16,26,16,24,24,106
2024-03-23 14:30:00,16,26,19,22,27,110
2024-03-23 14:40:00,23,25,14,32,22,116
2024-03-23 14:50:00,22,26,14,30,26,118
2024-03-23 15:00:00,17,21,17,25,21,101
2024-03-23 15:10:00,18,25,10,27,26,106
2024-03-23 15:20:00,14,23,7,26,28,98
2024-03-23 15:30:00,19,25,11,28,22,105
2024-03-23 15:40:00,16,23,15,31,17,102
2024-03-23 15:50:00,22,23,15,32,25,117
2024-03-23 16:00:00,16,22,15,26,24,103
2024-03-23 16:10:00,18,22,15,35,22,112
2024-03-23 16:20:00,17,29,12,26,23,107
2024-03-23 16:30:00,11,26,14,32,25,108
2024-03-23 16:40:00,16,30,20,24,29,119
2024-03-23 16:50:00,15,25,16,27,24,107
2024-03-23 17:00:00,19,23,10,27,23,102
2024-03-23 17:10:00,15,19,12,26,25,97
2024-03-23 17:20:00,13,22,17,25,24,101
2024-03-23 17:30:00,19,15,12,29,24,99
2024-03-23 17:40:00,13,25,13,21,25,97
2024-03-23 17:50:00,13,30,11,35,22,111
2024-03-23 18:00:00,11,25,12,27,18,93
2024-03-23 18:10:00,17,50,12,34,24,137
2024-03-23 18:20:00,18,25,12,27,27,109
2024-03-23 18:30:00,20,21,7,34,29,111
2024-03-23 18:40:00,16,16,14,19,22,87
2024-03-23 18:50:00,21,27,10,26,19,103
2024-03-23 19:00:00,20,18,9,29,22,98
2024-03-23 19:10:00,20,30,12,34,33,129
2024-03-23 19:20:00,17,26,15,30,32,120
2024-03-23 19:30:00,24,32,19,27,19,121
2024-03-23 19:40:00,27,23,21,26,30,127
2024-03-23 19:50:00,34,26,18,38,31,147
2024-03-23 20:00:00,39,42,12,30,32,155
2024-03-23 20:10:00,23,54,20,22,29,148
2024-03-23 20:20:00,17,21,9,28,37,112
2024-03-23 20:30:00,19,26,7,33,19,104
2024-03-23 20:40:00,11,17,12,23,31,94
2024-03-23 20:50:00,14,17,8,18,18,75
2024-03-23 21:00:00,13,18,8,21,23,83
2024-03-23 21:10:00,17,18,13,22,25,95
2024-03-23 21:20:00,22,14,4,16,24,80
2024-03-23 21:30:00,16,14,7,26,21,84
2024-03-23 21:40:00,13,36,7,24,19,99
2024-03-23 21:50:00,17,31,15,16,24,103
2024-03-23 22:00:00,27,22,6,19,15,89
2024-03-23 22:10:00,14,27,13,18,29,101
2024-03-23 22:20:00,14,31,4,18,12,79
2024-03-23 22:30:00,20,22,11,18,17,88
2024-03-23 22:40:00,18,23,10,25,26,102
2024-03-23 22:50:00,14,21,10,14,23,82
2024-03-23 23:00:00,11,18,3,36,31,99
2024-03-23 23:10:00,15,36,3,13,23,90
2024-03-23 23:20:00,12,15,3,23,27,80
2024-03-23 23:30:00,15,13,7,10,15,60
2024-03-23 23:40:00,10,15,10,21,18,74
2024-03-23 23:50:00,7,10,5,16,26,64
2024-03-24 00:00:00,6,19,9,13,12,59
2024-03-24 00:10:00,10,17,7,10,11,55
2024-03-24 00:20:00,6,8,6,8,13,41
2024-03-24 00:30:00,3,10,1,9,7,30
2024-03-24 00:40:00,2,1,6,11,11,31
2024-03-24 00:50:00,3,11,2,10,13,39
2024-03-24 01:00:00,3,12,3,7,8,33
2024-03-24 01:10:00,7,6,1,7,7,28
2024-03-24 01:20:00,3,4,5,8,6,26
2024-03-24 01:30:00,7,7,2,18,8,42
2024-03-24 01:40:00,9,6,2,9,16,42
2024-03-24 01:50:00,3,5,0,6,10,24
2024-03-24 02:00:00,7,11,3,6,9,36
2024-03-24 02:10:00,4,11,6,3,3,27
2024-03-24 02:20:00,4,4,5,5,7,25
2024-03-24 02:30:00,5,12,2,7,5,31
2024-03-24 02:40:00,0,4,6,4,15,29
2024-03-24 02:50:00,0,3,0,6,5,14
2024-03-24 03:00:00,2,6,4,3,1,16
2024-03-24 03:10:00,1,6,0,4,5,16
2024-03-24 03:20:00,1,6,0,8,8,23
2024-03-24 03:30:00,0,4,1,5,8,18
2024-03-24 03:40:00,0,10,0,0,5,15
2024-03-24 03:50:00,3,0,1,1,2,7
2024-03-24 04:00:00,6,5,4,2,1,18
2024-03-24 04:10:00,7,2,0,5,0,14
2024-03-24 04:20:00,0,6,5,4,3,18
2024-03-24 04:30:00,0,9,3,0,5,17
2024-03-24 04:40:00,0,1,0,3,4,8
2024-03-24 04:50:00,9,7,0,3,7,26
2024-03-24 05:00:00,6,3,0,3,4,16
2024-03-24 05:10:00,4,6,5,5,3,23
2024-03-24 05:20:00,4,5,7,11,1,28
2024-03-24 05:30:00,2,8,9,4,1,24
2024-03-24 05:40:00,1,2,0,3,8,14
2024-03-24 05:50:00,8,6,6,6,3,29
2024-03-24 06:00:00,3,18,6,10,4,41
2024-03-24 06:10:00,5,7,3,3,1,19
2024-03-24 06:20:00,5,9,3,8,5,30
2024-03-24 06:30:00,2,8,0,1,2,13
2024-03-24 06:40:00,4,6,1,9,3,23
2024-03-24 06:50:00,2,1,1,11,8,23
2024-03-24 07:00:00,1,9,1,8,1,20
2024-03-24 07:10:00,0,6,1,5,1,13
2024-03-24 07:20:00,0,2,0,3,2,7
2024-03-24 07:30:00,4,4,1,6,4,19
2024-03-24 07:40:00,4,7,1,10,2,24
2024-03-24 07:50:00,2,4,1,9,6,22
2024-03-24 08:00:00,2,5,1,5,5,18
2024-03-24 08:10:00,3,8,3,6,4,24
2024-03-24 08:20:00,2,4,1,8,2,17
2024-03-24 08:30:00,5,8,2,11,5,31
2024-03-24 08:40:00,7,7,1,13,6,34
2024-03-24 08:50:00,4,8,4,12,10,38
2024-03-24 09:00:00,8,14,4,10,5,41
2024-03-24 09:10:00,8,12,4,14,11,49
2024-03-24 09:20:00,16,14,3,17,8,58
2024-03-24 09:30:00,12,7,4,16,12,51
2024-03-24 09:40:00,8,17,3,16,11,55
2024-03-24 09:50:00,11,21,4,16,7,59
2024-03-24 10:00:00,5,20,6,21,5,57
2024-03-24 10:10:00,10,21,5,20,15,71
2024-03-24 10:20:00,8,21,9,15,9,62
2024-03-24 10:30:00,3,25,4,15,16,63
2024-03-24 10:40:00,10,20,6,21,11,68
2024-03-24 10:50:00,14,24,9,20,12,79
2024-03-24 11:00:00,13,24,3,23,15,78
2024-03-24 11:10:00,12,19,6,25,12,74
2024-03-24 11:20:00,13,23,9,18,9,72
2024-03-24 11:30:00,10,22,9,21,10,72
2024-03-24 11:40:00,8,15,7,33,25,88
2024-03-24 11:50:00,12,28,7,24,15,86
2024-03-24 12:00:00,8,30,10,24,13,85
2024-03-24 12:10:00,16,16,10,21,16,79
2024-03-24 12:20:00,8,26,13,27,20,94
2024-03-24 12:30:00,12,14,7,25,16,74
2024-03-24 12:40:00,10,22,10,15,14,71
2024-03-24 12:50:00,8,20,13,26,15,82
2024-03-24 13:00:00,15,21,13,29,15,93
2024-03-24 13:10:00,14,28,8,32,15,97
2024-03-24 13:20:00,8,27,10,18,14,77
2024-03-24 13:30:00,11,25,6,22,16,80
2024-03-24 13:40:00,14,27,10,25,15,91
2024-03-24 13:50:00,13,28,5,27,21,94
2024-03-24 14:00:00,12,22,10,28,23,95
2024-03-24 14:10:00,14,35,12,25,24,110
2024-03-24 14:20:00,12,25,8,28,10,83
2024-03-24 14:30:00,15,30,5,24,24,98
2024-03-24 14:40:00,10,21,7,32,16,86
2024-03-24 14:50:00,13,20,10,27,20,90
2024-03-24 15:00:00,16,28,4,26,22,96
2024-03-24 15:10:00,12,22,12,30,22,98
2024-03-24 15:20:00,16,19,7,24,21,87
2024-03-24 15:30:00,15,23,8,31,16,93
2024-03-24 15:40:00,13,28,12,22,15,90
2024-03-24 15:50:00,16,20,8,26,20,90
2024-03-24 16:00:00,13,25,11,33,17,99
2024-03-24 16:10:00,12,25,9,23,17,86
2024-03-24 16:20:00,22,29,6,34,18,109
2024-03-24 16:30:00,16,15,10,30,18,89
2024-03-24 16:40:00,16,34,12,22,16,100
2024-03-24 16:50:00,13,28,11,17,22,91
2024-03-24 17:00:00,11,28,9,26,15,89
2024-03-24 17:10:00,12,31,16,25,19,103
2024-03-24 17:20:00,11,26,11,25,18,91
2024-03-24 17:30:00,13,20,10,20,23,86
2024-03-24 17:40:00,14,27,15,29,20,105
2024-03-24 17:50:00,15,18,13,30,23,99
2024-03-24 18:00:00,16,30,13,20,26,105
2024-03-24 18:10:00,8,23,5,26,22,84
2024-03-24 18:20:00,11,23,13,26,17,90
2024-03-24 18:30:00,9,23,11,28,19,90
2024-03-24 18:40:00,9,18,8,24,17,76
2024-03-24 18:50:00,11,19,10,20,17,77
2024-03-24 19:00:00,19,27,11,32,17,106
2024-03-24 19:10:00,17,20,7,25,26,95
2024-03-24 19:20:00,18,29,5,24,22,98
2024-03-24 19:30:00,18,27,10,26,22,103
2024-03-24 19:40:00,17,23,10,23,19,92
2024-03-24 19:50:00,22,28,15,33,28,126
2024-03-24 20:00:00,25,32,15,25,35,132
2024-03-24 20:10:00,36,26,17,26,29,134
2024-03-24 20:20:00,12,31,16,26,26,111
2024-03-24 20:30:00,20,20,15,23,27,105
2024-03-24 20:40:00,14,25,10,16,17,82
2024-03-24 20:50:00,17,22,6,20,23,88
2024-03-24 21:00:00,20,30,16,21,19,106
2024-03-24 21:10:00,16,21,10,13,30,90
2024-03-24 21:20:00,26,29,14,23,21,113
2024-03-24 21:30:00,17,38,7,25,27,114
2024-03-24 21:40:00,13,26,4,20,34,97
2024-03-24 21:50:00,7,26,12,17,18,80
2024-03-24 22:00:00,18,12,6,23,28,87
2024-03-24 22:10:00,7,30,14,21,25,97
2024-03-24 22:20:00,6,30,8,21,22,87
2024-03-24 22:30:00,20,17,10,17,14,78
2024-03-24 22:40:00,10,24,8,17,8,67
2024-03-24 22:50:00,5,12,8,13,15,53
2024-03-24 23:00:00,5,15,5,9,16,50
2024-03-24 23:10:00,12,9,11,11,12,55
2024-03-24 23:20:00,3,16,2,11,10,42
2024-03-24 23:30:00,2,10,0,7,20,39
2024-03-24 23:40:00,11,13,4,16,14,58
2024-03-24 23:50:00,3,9,3,9,14,38
2024-03-25 00:00:00,4,3,0,5,11,23
2024-03-25 00:10:00,3,17,4,2,10,36
2024-03-25 00:20:00,6,12,6,7,8,39
2024-03-25 00:30:00,9,8,0,5,7,29
2024-03-25 00:40:00,12,2,3,6,15,38
2024-03-25 00:50:00,1,4,3,4,6,18
2024-03-25 01:00:00,1,1,0,9,5,16
2024-03-25 01:10:00,0,5,1,3,7,16
2024-03-25 01:20:00,0,3,7,1,5,16
2024-03-25 01:30:00,0,0,0,6,3,9
2024-03-25 01:40:00,0,5,0,4,3,12
2024-03-25 01:50:00,0,4,3,6,6,19
2024-03-25 02:00:00,1,6,0,5,4,16
2024-03-25 02:10:00,0,5,1,3,0,9
2024-03-25 02:20:00,0,5,0,5,2,12
2024-03-25 02:30:00,7,0,4,2,2,15
2024-03-25 02:40:00,5,4,0,1,1,11
2024-03-25 02:50:00,2,5,0,1,0,8
2024-03-25 03:00:00,3,4,0,0,0,7
2024-03-25 03:10:00,0,3,0,1,5,9
2024-03-25 03:20:00,3,2,0,3,0,8
2024-03-25 03:30:00,0,1,0,1,2,4
2024-03-25 03:40:00,2,3,2,2,0,9
2024-03-25 03:50:00,1,1,3,4,0,9
2024-03-25 04:00:00,6,4,0,2,2,14
2024-03-25 04:10:00,3,3,0,5,5,16
2024-03-25 04:20:00,8,7,0,2,2,19
2024-03-25 04:30:00,4,7,1,2,6,20
2024-03-25 04:40:00,2,10,2,3,12,29
2024-03-25 04:50:00,6,6,0,5,11,28
2024-03-25 05:00:00,12,8,4,5,14,43
2024-03-25 05:10:00,19,10,5,7,9,50
2024-03-25 05:20:00,12,12,1,13,7,45
2024-03-25 05:30:00,24,14,15,8,17,78
2024-03-25 05:40:00,32,18,14,16,19,99
2024-03-25 05:50:00,31,14,3,12,19,79
2024-03-25 06:00:00,15,16,5,10,12,58
2024-03-25 06:10:00,19,19,9,16,16,79
2024-03-25 06:20:00,14,13,7,12,12,58
2024-03-25 06:30:00,19,24,13,22,19,97
2024-03-25 06:40:00,21,20,9,24,28,102
2024-03-25 06:50:00,15,25,11,19,26,96
2024-03-25 07:00:00,24,23,13,26,28,114
2024-03-25 07:10:00,24,28,11,22,17,102
2024-03-25 07:20:00,20,24,15,21,22,102
2024-03-25 07:30:00,19,28,16,20,21,104
2024-03-25 07:40:00,20,30,17,23,24,114
2024-03-25 07:50:00,22,31,14,22,18,107
2024-03-25 08:00:00,25,27,17,27,20,116
2024-03-25 08:10:00,18,30,20,30,21,119
2024-03-25 08:20:00,19,24,17,23,19,102
2024-03-25 08:30:00,25,35,16,28,23,127
2024-03-25 08:40:00,23,32,17,34,28,134
2024-03-25 08:50:00,22,36,18,31,28,135
2024-03-25 09:00:00,26,27,16,23,20,112
2024-03-25 09:10:00,23,27,15,26,23,114
2024-03-25 09:20:00,21,31,17,29,21,119
2024-03-25 09:30:00,23,25,20,21,23,112
2024-03-25 09:40:00,20,31,21,28,25,125
2024-03-25 09:50:00,24,31,13,32,27,127
2024-03-25 10:00:00,24,26,11,32,22,115
2024-03-25 10:10:00,27,24,14,30,26,121
2024-03-25 10:20:00,21,23,18,28,23,113
2024-03-25 10:30:00,21,31,14,29,23,118
2024-03-25 10:40:00,16,23,16,26,26,107
2024-03-25 10:50:00,25,34,12,28,33,132
2024-03-25 11:00:00,14,24,8,26,23,95
2024-03-25 11:10:00,16,15,18,29,20,98
2024-03-25 11:20:00,17,29,13,22,25,106
2024-03-25 11:30:00,21,23,12,35,23,114
2024-03-25 11:40:00,25,32,19,22,18,116
2024-03-25 11:50:00,19,23,16,28,21,107
2024-03-25 12:00:00,25,30,15,31,26,127
2024-03-25 12:10:00,16,27,10,25,25,103
2024-03-25 12:20:00,32,29,12,23,18,114
2024-03-25 12:30:00,19,22,12,28,26,107
2024-03-25 12:40:00,18,25,11,30,22,106
2024-03-25 12:50:00,16,25,13,27,22,103
2024-03-25 13:00:00,18,31,13,29,24,115
2024-03-25 13:10:00,20,24,13,27,27,111
2024-03-25 13:20:00,16,18,10,28,18,90
2024-03-25 13:30:00,26,24,17,36,21,124
2024-03-25 13:40:00,20,25,21,20,17,103
2024-03-25 13:50:00,22,24,16,22,27,111
2024-03-25 14:00:00,20,24,11,29,24,108
2024-03-25 14:10:00,23,26,20,31,29,129
2024-03-25 14:20:00,25,30,22,33,27,137
2024-03-25 14:30:00,19,27,18,33,33,130
2024-03-25 14:40:00,19,29,22,36,25,131
2024-03-25 14:50:00,20,23,11,23,26,103
2024-03-25 15:00:00,28,32,20,31,31,142
2024-03-25 15:10:00,31,38,18,25,33,145
2024-03-25 15:20:00,36,37,21,19,34,147
2024-03-25 15:30:00,23,41,19,30,26,139
2024-03-25 15:40:00,21,32,18,31,28,130
2024-03-25 15:50:00,22,39,20,26,29,136
2024-03-25 16:00:00,23,29,16,33,26,127
2024-03-25 16:10:00,32,32,16,26,32,138
2024-03-25 16:20:00,28,23,15,33,26,125
2024-03-25 16:30:00,27,34,20,33,28,142
2024-03-25 16:40:00,18,35,21,28,36,138
2024-03-25 16:50:00,27,37,16,26,31,137
2024-03-25 17:00:00,25,17,16,39,27,124
2024-03-25 17:10:00,24,30,14,20,28,116
2024-03-25 17:20:00,22,44,20,22,27,135
2024-03-25 17:30:00,24,29,13,27,28,121
2024-03-25 17:40:00,20,28,19,20,25,112
2024-03-25 17:50:00,19,31,21,28,29,128
2024-03-25 18:00:00,19,30,22,33,26,130
2024-03-25 18:10:00,23,24,17,30,34,128
2024-03-25 18:20:00,22,31,17,25,24,119
2024-03-25 18:30:00,16,29,10,28,20,103
2024-03-25 18:40:00,20,36,13,28,20,117
2024-03-25 18:50:00,20,23,10,30,23,106
2024-03-25 19:00:00,15,30,19,18,15,97
2024-03-25 19:10:00,20,29,15,29,23,116
2024-03-25 19:20:00,20,24,10,36,24,114
2024-03-25 19:30:00,15,31,17,21,22,106
2024-03-25 19:40:00,23,27,7,29,24,110
2024-03-25 19:50:00,21,36,17,29,34,137
2024-03-25 20:00:00,24,30,25,28,31,138
2024-03-25 20:10:00,21,33,18,29,20,121
2024-03-25 20:20:00,33,31,11,25,29,129
2024-03-25 20:30:00,20,32,10,25,21,108
2024-03-25 20:40:00,23,18,10,30,24,105
2024-03-25 20:50:00,27,17,3,22,17,86
2024-03-25 21:00:00,9,22,10,19,25,85
2024-03-25 21:10:00,28,18,11,22,25,104
2024-03-25 21:20:00,15,22,12,30,25,104
2024-03-25 21:30:00,16,19,10,18,23,86
2024-03-25 21:40:00,17,18,14,27,21,97
2024-03-25 21:50:00,15,21,11,30,25,102
2024-03-25 22:00:00,17,25,12,23,23,100
2024-03-25 22:10:00,11,15,8,22,23,79
2024-03-25 22:20:00,14,23,4,23,13,77
2024-03-25 22:30:00,10,19,4,19,27,79
2024-03-25 22:40:00,4,18,6,19,14,61
2024-03-25 22:50:00,4,10,7,25,24,70
2024-03-25 23:00:00,7,11,5,17,13,53
2024-03-25 23:10:00,14,18,11,7,3,53
2024-03-25 23:20:00,9,11,5,10,8,43
2024-03-25 23:30:00,3,5,0,9,9,26
2024-03-25 23:40:00,3,8,3,11,15,40
2024-03-25 23:50:00,4,4,2,4,9,23
2024-03-26 00:00:00,2,5,0,11,10,28
2024-03-26 00:10:00,4,4,1,5,9,23
2024-03-26 00:20:00,2,3,4,7,14,30
2024-03-26 00:30:00,7,10,2,2,6,27
2024-03-26 00:40:00,12,6,5,4,7,34
2024-03-26 00:50:00,0,3,0,4,6,13
2024-03-26 01:00:00,10,4,0,5,4,23
2024-03-26 01:10:00,3,4,5,2,0,14
2024-03-26 01:20:00,0,0,0,3,5,8
2024-03-26 01:30:00,2,4,0,5,8,19
2024-03-26 01:40:00,1,3,2,4,1,11
2024-03-26 01:50:00,0,1,4,2,6,13
2024-03-26 02:00:00,2,3,0,7,1,13
2024-03-26 02:10:00,2,4,3,5,2,16
2024-03-26 02:20:00,0,4,0,3,2,9
2024-03-26 02:30:00,3,2,2,1,0,8
2024-03-26 02:40:00,0,0,0,2,4,6
2024-03-26 02:50:00,0,4,1,2,4,11
2024-03-26 03:00:00,1,0,0,0,0,1
2024-03-26 03:10:00,0,0,0,7,0,7
2024-03-26 03:20:00,0,0,0,3,3,6
2024-03-26 03:30:00,1,0,0,2,0,3
2024-03-26 03:40:00,1,3,0,3,2,9
2024-03-26 03:50:00,1,2,0,1,1,5
2024-03-26 04:00:00,2,3,0,3,1,9
2024-03-26 04:10:00,4,2,2,5,2,15
2024-03-26 04:20:00,11,1,0,6,2,20
2024-03-26 04:30:00,4,8,0,2,7,21
2024-03-26 04:40:00,9,5,3,3,10,30
2024-03-26 04:50:00,6,9,0,8,12,35
2024-03-26 05:00:00,12,5,0,8,13,38
2024-03-26 05:10:00,18,6,5,15,11,55
2024-03-26 05:20:00,24,10,8,14,8,64
2024-03-26 05:30:00,21,19,11,11,13,75
2024-03-26 05:40:00,37,19,5,15,11,87
2024-03-26 05:50:00,24,22,3,19,19,87
2024-03-26 06:00:00,21,20,7,15,13,76
2024-03-26 06:10:00,15,16,11,15,17,74
2024-03-26 06:20:00,17,18,5,20,16,76
2024-03-26 06:30:00,18,18,11,21,23,91
2024-03-26 06:40:00,14,23,13,20,23,93
2024-03-26 06:50:00,23,25,10,26,23,107
2024-03-26 07:00:00,16,23,14,22,16,91
2024-03-26 07:10:00,21,32,13,21,22,109
2024-03-26 07:20:00,15,30,8,22,31,106
2024-03-26 07:30:00,30,34,14,29,30,137
2024-03-26 07:40:00,20,22,25,29,26,122
2024-03-26 07:50:00,18,25,17,33,23,116
2024-03-26 08:00:00,17,23,13,27,29,109
2024-03-26 08:10:00,20,22,17,20,19,98
2024-03-26 08:20:00,22,21,11,34,25,113
2024-03-26 08:30:00,23,30,21,26,18,118
2024-03-26 08:40:00,25,27,19,23,24,118
2024-03-26 08:50:00,20,27,15,26,23,111
2024-03-26 09:00:00,23,32,16,25,24,120
2024-03-26 09:10:00,17,19,8,24,26,94
2024-03-26 09:20:00,23,29,16,22,25,115
2024-03-26 09:30:00,24,37,17,23,18,119
2024-03-26 09:40:00,28,29,21,26,19,123
2024-03-26 09:50:00,19,31,11,24,23,108
2024-03-26 10:00:00,18,27,16,26,27,114
2024-03-26 10:10:00,21,31,16,22,25,115
2024-03-26 10:20:00,28,27,20,31,25,131
2024-03-26 10:30:00,17,29,14,29,22,111
2024-03-26 10:40:00,14,24,9,21,17,85
2024-03-26 10:50:00,23,25,14,29,25,116
2024-03-26 11:00:00,24,25,14,28,29,120
2024-03-26 11:10:00,22,30,20,33,17,122
2024-03-26 11:20:00,22,22,11,33,22,110
2024-03-26 11:30:00,25,20,18,25,28,116
2024-03-26 11:40:00,18,32,12,38,27,127
2024-03-26 11:50:00,15,22,8,32,23,100
2024-03-26 12:00:00,21,27,9,30,18,105
2024-03-26 12:10:00,17,20,13,25,26,101
2024-03-26 12:20:00,20,29,15,26,23,113
2024-03-26 12:30:00,19,29,17,34,25,124
2024-03-26 12:40:00,14,29,15,26,25,109
2024-03-26 12:50:00,21,28,17,38,28,132
2024-03-26 13:00:00,16,22,15,31,20,104
2024-03-26 13:10:00,17,28,9,27,31,112
2024-03-26 13:20:00,18,28,12,36,24,118
2024-03-26 13:30:00,30,27,15,43,26,141
2024-03-26 13:40:00,19,23,14,29,27,112
2024-03-26 13:50:00,20,26,19,27,27,119
2024-03-26 14:00:00,17,26,14,28,32,117
2024-03-26 14:10:00,22,33,18,34,31,138
2024-03-26 14:20:00,18,25,16,24,19,102
2024-03-26 14:30:00,24,32,18,23,25,122
2024-03-26 14:40:00,19,28,19,29,24,119
2024-03-26 14:50:00,16,30,25,30,30,131
2024-03-26 15:00:00,21,25,18,29,20,113
2024-03-26 15:10:00,25,33,12,34,28,132
2024-03-26 15:20:00,35,37,26,29,25,152
2024-03-26 15:30:00,29,33,26,32,33,153
2024-03-26 15:40:00,25,31,20,29,27,132
2024-03-26 15:50:00,22,37,14,31,27,131
2024-03-26 16:00:00,16,36,17,35,28,132
2024-03-26 16:10:00,27,35,20,27,24,133
2024-03-26 16:20:00,27,33,17,26,24,127
2024-03-26 16:30:00,19,27,29,31,21,127
2024-03-26 16:40:00,28,35,21,29,27,140
2024-03-26 16:50:00,16,31,16,24,29,116
2024-03-26 17:00:00,24,34,22,33,28,141
2024-03-26 17:10:00,25,33,12,25,29,124
2024-03-26 17:20:00,26,29,17,24,21,117
2024-03-26 17:30:00,28,31,17,30,30,136
2024-03-26 17:40:00,17,29,15,26,29,116
2024-03-26 17:50:00,19,29,14,32,29,123
2024-03-26 18:00:00,16,39,13,34,27,129
2024-03-26 18:10:00,22,30,9,22,17,100
2024-03-26 18:20:00,20,26,17,19,16,98
2024-03-26 18:30:00,19,24,13,33,34,123
2024-03-26 18:40:00,18,22,8,25,28,101
2024-03-26 18:50:00,13,29,15,28,18,103
2024-03-26 19:00:00,27,26,13,21,27,114
2024-03-26 19:10:00,31,30,10,20,20,111
2024-03-26 19:20:00,30,24,15,24,29,122
2024-03-26 19:30:00,35,37,9,23,33,137
2024-03-26 19:40:00,31,24,16,25,23,119
2024-03-26 19:50:00,31,30,11,32,21,125
2024-03-26 20:00:00,31,30,17,23,27,128
2024-03-26 20:10:00,30,20,8,23,37,118
2024-03-26 20:20:00,23,24,15,31,24,117
2024-03-26 20:30:00,23,23,16,28,25,115
2024-03-26 20:40:00,28,18,4,21,20,91
2024-03-26 20:50:00,17,21,11,28,25,102
2024-03-26 21:00:00,10,25,13,24,15,87
2024-03-26 21:10:00,18,34,10,18,22,102
2024-03-26 21:20:00,22,19,12,24,22,99
2024-03-26 21:30:00,20,26,22,28,27,123
2024-03-26 21:40:00,10,19,15,25,34,103
2024-03-26 21:50:00,14,28,6,18,21,87
2024-03-26 22:00:00,12,26,11,24,20,93
2024-03-26 22:10:00,5,19,10,29,24,87
2024-03-26 22:20:00,16,16,15,21,19,87
2024-03-26 22:30:00,5,28,2,22,19,76
2024-03-26 22:40:00,5,17,6,16,18,62
2024-03-26 22:50:00,3,17,1,20,19,60
2024-03-26 23:00:00,2,11,6,15,13,47
2024-03-26 23:10:00,6,10,0,17,21,54
2024-03-26 23:20:00,10,11,8,11,11,51
2024-03-26 23:30:00,1,18,3,17,15,54
2024-03-26 23:40:00,5,9,3,6,11,34
2024-03-26 23:50:00,10,13,6,7,12,48
2024-03-27 00:00:00,13,12,0,7,12,44
2024-03-27 00:10:00,3,5,4,10,8,30
2024-03-27 00:20:00,11,7,0,11,6,35
2024-03-27 00:30:00,16,7,1,6,10,40
2024-03-27 00:40:00,8,4,0,3,11,26
2024-03-27 00:50:00,1,3,3,5,2,14
2024-03-27 01:00:00,5,4,0,5,4,18
2024-03-27 01:10:00,3,8,3,5,3,22
2024-03-27 01:20:00,1,9,3,3,1,17
2024-03-27 01:30:00,0,1,0,6,1,8
2024-03-27 01:40:00,3,6,0,3,3,15
2024-03-27 01:50:00,1,3,2,3,1,10
2024-03-27 02:00:00,0,5,1,3,4,13
2024-03-27 02:10:00,5,5,0,5,1,16
2024-03-27 02:20:00,0,5,1,5,4,15
2024-03-27 02:30:00,3,1,0,3,0,7
2024-03-27 02:40:00,0,6,0,2,3,11
2024-03-27 02:50:00,0,1,1,4,0,6
2024-03-27 03:00:00,1,8,3,1,1,14
2024-03-27 03:10:00,0,0,0,3,6,9
2024-03-27 03:20:00,0,0,0,1,0,1
2024-03-27 03:30:00,3,6,0,4,1,14
2024-03-27 03:40:00,0,0,2,6,1,9
2024-03-27 03:50:00,0,1,0,4,3,8
2024-03-27 04:00:00,6,6,2,2,1,17
2024-03-27 04:10:00,6,3,2,7,1,19
2024-03-27 04:20:00,8,6,0,4,3,21
2024-03-27 04:30:00,0,4,4,3,7,18
2024-03-27 04:40:00,14,10,0,3,9,36
2024-03-27 04:50:00,9,4,0,4,7,24
2024-03-27 05:00:00,15,9,1,4,9,38
2024-03-27 05:10:00,13,15,4,9,8,49
2024-03-27 05:20:00,22,11,1,8,7,49
2024-03-27 05:30:00,23,21,5,10,6,65
2024-03-27 05:40:00,28,17,6,13,14,78
2024-03-27 05:50:00,32,22,0,11,26,91
2024-03-27 06:00:00,18,19,6,15,14,72
2024-03-27 06:10:00,18,13,8,17,19,75
2024-03-27 06:20:00,15,32,8,13,15,83
2024-03-27 06:30:00,14,21,9,18,17,79
2024-03-27 06:40:00,20,24,13,24,26,107
2024-03-27 06:50:00,18,18,9,24,25,94
2024-03-27 07:00:00,21,29,9,23,24,106
2024-03-27 07:10:00,17,32,18,28,20,115
2024-03-27 07:20:00,25,27,13,22,20,107
2024-03-27 07:30:00,22,23,15,27,22,109
2024-03-27 07:40:00,0,0,0,0,0,0
2024-03-27 07:50:00,0,0,0,0,0,0
2024-03-27 08:00:00,27,24,8,22,26,107
2024-03-27 08:10:00,15,28,15,34,34,126
2024-03-27 08:20:00,19,27,18,30,31,125
2024-03-27 08:30:00,21,27,16,27,25,116
2024-03-27 08:40:00,17,32,20,26,25,120
2024-03-27 08:50:00,24,29,21,27,19,120
2024-03-27 09:00:00,15,26,11,18,24,94
2024-03-27 09:10:00,19,28,14,30,26,117
2024-03-27 09:20:00,19,26,13,20,20,98
2024-03-27 09:30:00,14,23,14,28,19,98
2024-03-27 09:40:00,18,24,19,28,18,107
2024-03-27 09:50:00,22,25,17,22,23,109
2024-03-27 10:00:00,13,25,15,32,22,107
2024-03-27 10:10:00,17,26,14,22,19,98
2024-03-27 10:20:00,29,34,21,31,28,143
2024-03-27 10:30:00,14,29,13,30,20,106
2024-03-27 10:40:00,19,27,23,26,23,118
2024-03-27 10:50:00,22,21,16,35,21,115
2024-03-27 11:00:00,25,32,15,23,28,123
2024-03-27 11:10:00,15,29,12,25,22,103
2024-03-27 11:20:00,15,24,11,27,21,98
2024-03-27 11:30:00,19,21,10,24,19,93
2024-03-27 11:40:00,21,27,13,29,25,115
2024-03-27 11:50:00,20,26,17,35,20,118
2024-03-27 12:00:00,20,29,15,37,23,124
2024-03-27 12:10:00,19,25,13,25,25,107
2024-03-27 12:20:00,20,29,18,31,27,125
2024-03-27 12:30:00,16,30,14,29,26,115
2024-03-27 12:40:00,17,25,12,38,23,115
2024-03-27 12:50:00,19,27,18,31,35,130
2024-03-27 13:00:00,17,24,13,25,23,102
2024-03-27 13:10:00,22,23,14,32,16,107
2024-03-27 13:20:00,14,19,17,26,27,103
2024-03-27 13:30:00,19,30,12,30,25,116
2024-03-27 13:40:00,13,20,12,31,20,96
2024-03-27 13:50:00,25,18,15,31,20,109
2024-03-27 14:00:00,17,31,13,33,32,126
2024-03-27 14:10:00,16,36,18,24,25,119
2024-03-27 14:20:00,22,27,16,28,29,122
2024-03-27 14:30:00,18,31,17,27,29,122
2024-03-27 14:40:00,18,22,20,29,25,114
2024-03-27 14:50:00,28,35,19,26,25,133
2024-03-27 15:00:00,26,28,15,34,25,128
2024-03-27 15:10:00,22,37,16,28,28,131
2024-03-27 15:20:00,26,30,19,29,26,130
2024-03-27 15:30:00,25,32,24,26,26,133
2024-03-27 15:40:00,21,23,19,27,30,120
2024-03-27 15:50:00,28,38,24,33,30,153
2024-03-27 16:00:00,30,30,13,25,39,137
2024-03-27 16:10:00,30,29,19,17,27,122
2024-03-27 16:20:00,29,35,19,32,30,145
2024-03-27 16:30:00,28,27,21,27,34,137
2024-03-27 16:40:00,17,29,20,25,28,119
2024-03-27 16:50:00,20,30,17,29,30,126
2024-03-27 17:00:00,22,27,11,29,36,125
2024-03-27 17:10:00,31,35,20,19,24,129
2024-03-27 17:20:00,29,24,18,24,27,122
2024-03-27 17:30:00,25,28,18,22,35,128
2024-03-27 17:40:00,22,27,20,18,34,121
2024-03-27 17:50:00,20,31,16,26,33,126
2024-03-27 18:00:00,17,24,15,27,33,116
2024-03-27 18:10:00,18,25,18,21,32,114
2024-03-27 18:20:00,19,32,24,27,27,129
2024-03-27 18:30:00,20,25,17,23,38,123
2024-03-27 18:40:00,18,34,15,21,30,118
2024-03-27 18:50:00,20,26,19,16,20,101
2024-03-27 19:00:00,13,23,15,28,28,107
2024-03-27 19:10:00,2,1,1,1,3,8
2024-03-27 19:20:00,0,2,0,0,1,3
2024-03-27 19:30:00,11,20,5,22,24,82
2024-03-27 19:40:00,2,2,2,2,3,11
2024-03-27 19:50:00,0,0,0,0,0,0
2024-03-27 20:00:00,16,22,7,14,15,74
2024-03-27 20:10:00,11,17,11,25,28,92
2024-03-27 20:20:00,19,23,11,22,33,108
2024-03-27 20:30:00,24,25,11,19,22,101
2024-03-27 20:40:00,13,21,12,22,19,87
2024-03-27 20:50:00,17,18,8,15,23,81
2024-03-27 21:00:00,18,17,10,22,20,87
2024-03-27 21:10:00,17,34,6,17,29,103
2024-03-27 21:20:00,16,19,8,22,25,90
2024-03-27 21:30:00,11,14,18,27,23,93
2024-03-27 21:40:00,26,22,15,24,40,127
2024-03-27 21:50:00,16,26,12,21,19,94
2024-03-27 22:00:00,17,13,16,25,29,100
2024-03-27 22:10:00,10,23,17,23,24,97
2024-03-27 22:20:00,8,20,19,23,17,87
2024-03-27 22:30:00,8,27,12,23,23,93
2024-03-27 22:40:00,9,10,10,15,14,58
2024-03-27 22:50:00,3,20,5,15,21,64
2024-03-27 23:00:00,16,20,5,13,13,67
2024-03-27 23:10:00,5,9,16,15,18,63
2024-03-27 23:20:00,3,11,4,13,12,43
2024-03-27 23:30:00,4,13,2,7,18,44
2024-03-27 23:40:00,6,13,4,7,10,40
2024-03-27 23:50:00,7,10,4,9,11,41
2024-03-28 00:00:00,8,9,2,13,7,39
2024-03-28 00:10:00,3,13,3,2,7,28
2024-03-28 00:20:00,9,7,3,5,4,28
2024-03-28 00:30:00,7,11,2,10,10,40
2024-03-28 00:40:00,8,3,3,6,6,26
2024-03-28 00:50:00,4,2,0,2,6,14
2024-03-28 01:00:00,3,8,3,8,4,26
2024-03-28 01:10:00,0,3,2,6,4,15
2024-03-28 01:20:00,2,10,5,4,5,26
2024-03-28 01:30:00,0,4,0,3,5,12
2024-03-28 01:40:00,2,2,1,6,2,13
2024-03-28 01:50:00,2,1,0,2,2,7
2024-03-28 02:00:00,3,6,0,1,9,19
2024-03-28 02:10:00,0,7,0,3,0,10
2024-03-28 02:20:00,6,0,0,1,3,10
2024-03-28 02:30:00,2,3,0,7,5,17
2024-03-28 02:40:00,4,3,2,5,0,14
2024-03-28 02:50:00,1,0,3,2,4,10
2024-03-28 03:00:00,1,1,2,3,1,8
2024-03-28 03:10:00,1,7,0,2,2,12
2024-03-28 03:20:00,0,1,0,2,0,3
2024-03-28 03:30:00,1,1,0,3,1,6
2024-03-28 03:40:00,2,3,0,3,1,9
2024-03-28 03:50:00,0,2,0,6,2,10
2024-03-28 04:00:00,3,1,0,6,0,10
2024-03-28 04:10:00,5,2,0,1,3,11
2024-03-28 04:20:00,6,2,1,2,3,14
2024-03-28 04:30:00,7,4,0,3,3,17
2024-03-28 04:40:00,3,8,0,4,7,22
2024-03-28 04:50:00,16,3,2,7,9,37
2024-03-28 05:00:00,14,12,5,7,10,48
2024-03-28 05:10:00,17,11,1,7,11,47
2024-03-28 05:20:00,16,10,13,12,12,63
2024-03-28 05:30:00,28,13,12,10,10,73
2024-03-28 05:40:00,23,15,0,14,17,69
2024-03-28 05:50:00,24,12,5,6,18,65
2024-03-28 06:00:00,14,8,5,11,8,46
2024-03-28 06:10:00,16,16,2,13,18,65
2024-03-28 06:20:00,15,22,3,14,22,76
2024-03-28 06:30:00,14,19,8,16,14,71
2024-03-28 06:40:00,17,21,9,19,20,86
2024-03-28 06:50:00,23,27,14,23,22,109
2024-03-28 07:00:00,27,28,14,26,20,115
2024-03-28 07:10:00,18,27,12,26,24,107
2024-03-28 07:20:00,23,28,10,19,15,95
2024-03-28 07:30:00,26,24,14,24,32,120
2024-03-28 07:40:00,24,25,12,24,29,114
2024-03-28 07:50:00,29,23,18,33,27,130
2024-03-28 08:00:00,20,24,8,25,20,97
2024-03-28 08:10:00,24,21,14,25,19,103
2024-03-28 08:20:00,17,21,19,23,20,100
2024-03-28 08:30:00,13,24,18,25,29,109
2024-03-28 08:40:00,17,29,11,26,21,104
2024-03-28 08:50:00,23,28,13,23,21,108
2024-03-28 09:00:00,26,32,18,24,23,123
2024-03-28 09:10:00,16,30,11,24,20,101
2024-03-28 09:20:00,22,25,20,20,14,101
2024-03-28 09:30:00,16,23,13,23,27,102
2024-03-28 09:40:00,19,24,19,31,25,118
2024-03-28 09:50:00,19,34,14,24,27,118
2024-03-28 10:00:00,21,23,15,35,20,114
2024-03-28 10:10:00,22,30,9,29,17,107
2024-03-28 10:20:00,21,27,18,27,20,113
2024-03-28 10:30:00,18,22,14,23,21,98
2024-03-28 10:40:00,18,27,22,33,29,129
2024-03-28 10:50:00,22,32,15,30,22,121
2024-03-28 11:00:00,28,25,18,33,22,126
2024-03-28 11:10:00,18,29,11,36,24,118
2024-03-28 11:20:00,17,29,21,21,25,113
2024-03-28 11:30:00,28,25,17,19,24,113
2024-03-28 11:40:00,19,27,15,32,24,117
2024-03-28 11:50:00,22,29,18,27,26,122
2024-03-28 12:00:00,26,39,19,36,33,153
2024-03-28 12:10:00,23,29,13,44,29,138
2024-03-28 12:20:00,20,40,16,32,34,142
2024-03-28 12:30:00,20,29,14,31,29,123
2024-03-28 12:40:00,21,37,20,26,22,126
2024-03-28 12:50:00,21,26,18,30,33,128
2024-03-28 13:00:00,23,25,14,31,28,121
2024-03-28 13:10:00,23,26,14,28,26,117
2024-03-28 13:20:00,17,22,18,33,24,114
2024-03-28 13:30:00,22,29,17,35,34,137
2024-03-28 13:40:00,22,24,14,32,23,115
2024-03-28 13:50:00,19,21,14,36,28,118
2024-03-28 14:00:00,24,31,12,28,19,114
2024-03-28 14:10:00,24,28,13,25,23,113
2024-03-28 14:20:00,24,30,19,42,29,144
2024-03-28 14:30:00,19,36,21,31,30,137
2024-03-28 14:40:00,23,26,20,21,29,119
2024-03-28 14:50:00,20,24,17,31,28,120
2024-03-28 15:00:00,18,23,18,31,31,121
2024-03-28 15:10:00,26,33,16,26,30,131
2024-03-28 15:20:00,23,25,15,29,21,113
2024-03-28 15:30:00,26,37,19,33,31,146
2024-03-28 15:40:00,25,26,16,34,32,133
2024-03-28 15:50:00,20,30,23,23,29,125
2024-03-28 16:00:00,17,32,16,33,31,129
2024-03-28 16:10:00,26,26,18,23,24,117
2024-03-28 16:20:00,23,28,19,30,26,126
2024-03-28 16:30:00,22,29,23,39,30,143
2024-03-28 16:40:00,30,34,22,29,27,142
2024-03-28 16:50:00,20,23,22,31,31,127
2024-03-28 17:00:00,25,27,10,31,33,126
2024-03-28 17:10:00,20,33,22,29,30,134
2024-03-28 17:20:00,25,29,19,23,23,119
2024-03-28 17:30:00,19,20,18,29,22,108
2024-03-28 17:40:00,18,27,19,31,26,121
2024-03-28 17:50:00,24,23,17,28,31,123
2024-03-28 18:00:00,23,26,14,22,32,117
2024-03-28 18:10:00,20,21,20,29,34,124
2024-03-28 18:20:00,16,22,10,19,26,93
2024-03-28 18:30:00,21,22,19,34,31,127
2024-03-28 18:40:00,19,25,15,25,23,107
2024-03-28 18:50:00,17,23,16,32,23,111
2024-03-28 19:00:00,21,23,9,27,29,109
2024-03-28 19:10:00,29,25,18,28,23,123
2024-03-28 19:20:00,16,29,22,28,32,127
2024-03-28 19:30:00,26,33,14,22,29,124
2024-03-28 19:40:00,35,20,12,32,37,136
2024-03-28 19:50:00,26,22,18,21,29,116
2024-03-28 20:00:00,20,26,8,29,39,122
2024-03-28 20:10:00,32,33,30,32,33,160
2024-03-28 20:20:00,43,46,19,27,34,169
2024-03-28 20:30:00,25,23,17,35,33,133
2024-03-28 20:40:00,39,27,15,21,22,124
2024-03-28 20:50:00,23,40,11,34,31,139
2024-03-28 21:00:00,13,26,7,29,28,103
2024-03-28 21:10:00,20,27,12,23,31,113
2024-03-28 21:20:00,29,41,15,36,35,156
2024-03-28 21:30:00,24,14,14,19,34,105
2024-03-28 21:40:00,8,23,8,29,20,88
2024-03-28 21:50:00,15,23,18,24,32,112
2024-03-28 22:00:00,14,25,15,20,32,106
2024-03-28 22:10:00,13,32,13,31,30,119
2024-03-28 22:20:00,17,26,9,32,18,102
2024-03-28 22:30:00,10,20,10,18,23,81
2024-03-28 22:40:00,10,29,13,22,13,87
2024-03-28 22:50:00,10,24,11,21,16,82
2024-03-28 23:00:00,15,18,3,19,20,75
2024-03-28 23:10:00,10,13,9,10,19,61
2024-03-28 23:20:00,10,22,8,15,24,79
2024-03-28 23:30:00,16,16,10,19,18,79
2024-03-28 23:40:00,12,16,3,12,16,59
2024-03-28 23:50:00,7,16,4,13,19,59
2024-03-29 00:00:00,9,11,6,14,18,58
2024-03-29 00:10:00,9,14,3,8,11,45
2024-03-29 00:20:00,4,14,3,8,12,41
2024-03-29 00:30:00,6,11,6,10,13,46
2024-03-29 00:40:00,7,9,6,14,15,51
2024-03-29 00:50:00,5,7,9,12,15,48
2024-03-29 01:00:00,8,12,0,10,8,38
2024-03-29 01:10:00,1,5,6,7,15,34
2024-03-29 01:20:00,9,7,5,8,10,39
2024-03-29 01:30:00,12,5,4,14,6,41
2024-03-29 01:40:00,2,5,2,11,10,30
2024-03-29 01:50:00,1,3,1,3,4,12
2024-03-29 02:00:00,0,9,0,13,8,30
2024-03-29 02:10:00,2,18,1,7,4,32
2024-03-29 02:20:00,1,8,2,2,1,14
2024-03-29 02:30:00,8,5,1,3,7,24
2024-03-29 02:40:00,2,4,3,7,3,19
2024-03-29 02:50:00,1,9,5,2,8,25
2024-03-29 03:00:00,3,1,0,7,2,13
2024-03-29 03:10:00,1,3,0,11,4,19
2024-03-29 03:20:00,7,2,2,7,3,21
2024-03-29 03:30:00,0,4,0,7,12,23
2024-03-29 03:40:00,1,6,2,8,4,21
2024-03-29 03:50:00,2,2,2,3,0,9
2024-03-29 04:00:00,0,3,1,4,0,8
2024-03-29 04:10:00,6,2,3,6,2,19
2024-03-29 04:20:00,0,3,1,0,4,8
2024-03-29 04:30:00,8,4,0,3,2,17
2024-03-29 04:40:00,3,2,0,3,4,12
2024-03-29 04:50:00,4,4,0,3,5,16
2024-03-29 05:00:00,4,8,2,6,5,25
2024-03-29 05:10:00,5,5,2,7,9,28
2024-03-29 05:20:00,6,4,6,5,5,26
2024-03-29 05:30:00,4,6,1,6,2,19
2024-03-29 05:40:00,4,7,1,4,4,20
2024-03-29 05:50:00,2,7,0,6,6,21
2024-03-29 06:00:00,2,5,1,7,0,15
2024-03-29 06:10:00,0,3,3,5,5,16
2024-03-29 06:20:00,2,8,1,5,7,23
2024-03-29 06:30:00,0,4,0,8,4,16
2024-03-29 06:40:00,0,4,2,5,4,15
2024-03-29 06:50:00,2,4,1,4,2,13
2024-03-29 07:00:00,1,2,0,6,2,11
2024-03-29 07:10:00,2,0,2,6,1,11
2024-03-29 07:20:00,0,6,2,3,3,14
2024-03-29 07:30:00,2,8,2,12,0,24
2024-03-29 07:40:00,4,6,2,4,6,22
2024-03-29 07:50:00,2,7,1,2,6,18
2024-03-29 08:00:00,4,6,0,3,5,18
2024-03-29 08:10:00,3,8,1,5,4,21
2024-03-29 08:20:00,4,6,1,7,2,20
2024-03-29 08:30:00,4,7,1,7,3,22
2024-03-29 08:40:00,3,9,2,6,6,26
2024-03-29 08:50:00,5,7,0,13,5,30
2024-03-29 09:00:00,8,10,3,7,7,35
2024-03-29 09:10:00,11,9,4,7,7,38
2024-03-29 09:20:00,12,8,6,10,11,47
2024-03-29 09:30:00,17,17,2,11,8,55
2024-03-29 09:40:00,15,14,4,19,10,62
2024-03-29 09:50:00,2,12,3,17,11,45
2024-03-29 10:00:00,8,11,4,9,10,42
2024-03-29 10:10:00,5,10,6,13,9,43
2024-03-29 10:20:00,9,17,6,11,6,49
2024-03-29 10:30:00,4,14,3,18,5,44
2024-03-29 10:40:00,8,19,7,15,12,61
2024-03-29 10:50:00,7,18,6,18,13,62
2024-03-29 11:00:00,6,16,8,12,12,54
2024-03-29 11:10:00,8,15,4,17,8,52
2024-03-29 11:20:00,11,25,6,19,16,77
2024-03-29 11:30:00,9,24,7,11,11,62
2024-03-29 11:40:00,7,25,7,20,13,72
2024-03-29 11:50:00,13,19,4,24,15,75
2024-03-29 12:00:00,14,21,11,20,11,77
2024-03-29 12:10:00,8,21,12,29,14,84
2024-03-29 12:20:00,14,21,18,25,15,93
2024-03-29 12:30:00,13,15,11,25,16,80
2024-03-29 12:40:00,14,26,9,18,16,83
2024-03-29 12:50:00,16,24,9,23,22,94
2024-03-29 13:00:00,24,19,12,20,13,88
2024-03-29 13:10:00,21,16,14,23,17,91
2024-03-29 13:20:00,22,26,11,23,20,102
2024-03-29 13:30:00,23,18,6,25,17,89
2024-03-29 13:40:00,16,22,6,24,23,91
2024-03-29 13:50:00,11,25,13,29,25,103
2024-03-29 14:00:00,12,21,14,31,20,98
2024-03-29 14:10:00,12,22,11,27,28,100
2024-03-29 14:20:00,12,31,19,25,27,114
2024-03-29 14:30:00,10,32,15,24,21,102
2024-03-29 14:40:00,7,22,9,19,28,85
2024-03-29 14:50:00,5,25,10,32,18,90
2024-03-29 15:00:00,10,17,8,27,23,85
2024-03-29 15:10:00,12,19,5,23,25,84
2024-03-29 15:20:00,10,21,6,25,19,81
2024-03-29 15:30:00,7,18,7,29,16,77
2024-03-29 15:40:00,13,19,15,20,8,75
2024-03-29 15:50:00,8,14,6,16,18,62
2024-03-29 16:00:00,11,18,9,26,14,78
2024-03-29 16:10:00,13,18,5,25,18,79
2024-03-29 16:20:00,12,16,8,27,17,80
2024-03-29 16:30:00,10,23,14,27,20,94
2024-03-29 16:40:00,8,21,14,28,17,88
2024-03-29 16:50:00,14,30,15,24,16,99
2024-03-29 17:00:00,7,22,13,24,20,86
2024-03-29 17:10:00,9,26,10,25,19,89
2024-03-29 17:20:00,9,19,8,23,17,76
2024-03-29 17:30:00,10,13,7,28,12,70
2024-03-29 17:40:00,12,19,8,18,18,75
2024-03-29 17:50:00,16,26,11,28,11,92
2024-03-29 18:00:00,17,23,6,17,18,81
2024-03-29 18:10:00,12,21,7,16,14,70
2024-03-29 18:20:00,10,15,5,21,15,66
2024-03-29 18:30:00,9,21,10,22,12,74
2024-03-29 18:40:00,13,23,12,23,17,88
2024-03-29 18:50:00,21,21,9,22,22,95
2024-03-29 19:00:00,6,18,10,17,17,68
2024-03-29 19:10:00,12,17,7,20,31,87
2024-03-29 19:20:00,8,18,10,14,21,71
2024-03-29 19:30:00,7,23,6,21,18,75
2024-03-29 19:40:00,12,16,9,17,16,70
2024-03-29 19:50:00,10,18,6,22,18,74
2024-03-29 20:00:00,18,22,7,15,21,83
2024-03-29 20:10:00,14,24,7,18,23,86
2024-03-29 20:20:00,21,18,8,21,26,94
2024-03-29 20:30:00,18,16,12,23,20,89
2024-03-29 20:40:00,20,22,7,21,19,89
2024-03-29 20:50:00,8,14,6,15,12,55
2024-03-29 21:00:00,12,8,6,18,22,66
2024-03-29 21:10:00,9,13,8,17,13,60
2024-03-29 21:20:00,11,19,8,12,19,69
2024-03-29 21:30:00,4,15,4,18,22,63
2024-03-29 21:40:00,3,13,4,13,20,53
2024-03-29 21:50:00,5,17,9,16,25,72
2024-03-29 22:00:00,16,18,9,18,22,83
2024-03-29 22:10:00,6,24,2,23,19,74
2024-03-29 22:20:00,7,19,6,15,17,64
2024-03-29 22:30:00,3,16,6,10,11,46
2024-03-29 22:40:00,3,14,8,17,18,60
2024-03-29 22:50:00,3,12,3,13,11,42
2024-03-29 23:00:00,4,10,4,15,17,50
2024-03-29 23:10:00,5,13,3,12,13,46
2024-03-29 23:20:00,8,13,7,12,10,50
2024-03-29 23:30:00,6,10,5,14,19,54
2024-03-29 23:40:00,13,15,5,8,10,51
2024-03-29 23:50:00,4,7,3,8,17,39
2024-03-30 00:00:00,7,10,3,13,19,52
2024-03-30 00:10:00,7,7,7,12,12,45
2024-03-30 00:20:00,1,5,0,11,11,28
2024-03-30 00:30:00,8,5,6,12,11,42
2024-03-30 00:40:00,5,9,5,8,7,34
2024-03-30 00:50:00,3,5,3,9,9,29
2024-03-30 01:00:00,4,10,6,5,7,32
2024-03-30 01:10:00,8,7,0,8,8,31
2024-03-30 01:20:00,0,5,2,4,4,15
2024-03-30 01:30:00,3,6,0,4,7,20
2024-03-30 01:40:00,1,6,1,7,10,25
2024-03-30 01:50:00,2,4,0,6,4,16
2024-03-30 02:00:00,2,7,0,2,1,12
2024-03-30 02:10:00,2,7,1,6,4,20
2024-03-30 02:20:00,1,7,5,4,4,21
2024-03-30 02:30:00,0,5,1,6,3,15
2024-03-30 02:40:00,1,5,4,3,3,16
2024-03-30 02:50:00,0,1,1,3,7,12
2024-03-30 03:00:00,0,1,2,1,2,6
2024-03-30 03:10:00,1,4,1,7,4,17
2024-03-30 03:20:00,1,4,1,3,3,12
2024-03-30 03:30:00,1,2,0,7,3,13
2024-03-30 03:40:00,0,2,0,6,3,11
2024-03-30 03:50:00,2,2,1,3,2,10
2024-03-30 04:00:00,2,6,3,3,1,15
2024-03-30 04:10:00,3,4,0,1,5,13
2024-03-30 04:20:00,4,7,1,2,7,21
2024-03-30 04:30:00,0,3,2,5,7,17
2024-03-30 04:40:00,1,4,1,3,1,10
2024-03-30 04:50:00,1,6,0,1,5,13
2024-03-30 05:00:00,6,7,2,6,8,29
2024-03-30 05:10:00,7,7,0,2,5,21
2024-03-30 05:20:00,4,3,3,6,4,20
2024-03-30 05:30:00,4,7,2,2,4,19
2024-03-30 05:40:00,8,5,0,4,7,24
2024-03-30 05:50:00,6,5,2,8,5,26
2024-03-30 06:00:00,4,4,2,3,3,16
2024-03-30 06:10:00,6,5,0,5,5,21
2024-03-30 06:20:00,3,6,2,3,5,19
2024-03-30 06:30:00,7,7,0,5,9,28
2024-03-30 06:40:00,6,10,1,3,9,29
2024-03-30 06:50:00,7,5,1,16,4,33
2024-03-30 07:00:00,9,7,3,5,4,28
2024-03-30 07:10:00,9,8,1,3,7,28
2024-03-30 07:20:00,16,11,3,4,7,41
2024-03-30 07:30:00,8,12,3,12,9,44
2024-03-30 07:40:00,12,6,1,5,5,29
2024-03-30 07:50:00,16,8,4,12,7,47
2024-03-30 08:00:00,15,9,4,15,6,49
2024-03-30 08:10:00,13,4,5,19,9,50
2024-03-30 08:20:00,13,7,1,19,9,49
2024-03-30 08:30:00,16,5,2,15,12,50
2024-03-30 08:40:00,17,13,5,17,3,55
2024-03-30 08:50:00,15,13,7,14,11,60
2024-03-30 09:00:00,17,12,6,18,8,61
2024-03-30 09:10:00,20,17,7,22,14,80
2024-03-30 09:20:00,15,19,5,24,15,78
2024-03-30 09:30:00,30,25,11,22,18,106
2024-03-30 09:40:00,19,24,10,25,15,93
2024-03-30 09:50:00,18,26,14,21,16,95
2024-03-30 10:00:00,24,33,6,21,17,101
2024-03-30 10:10:00,23,22,14,27,14,100
2024-03-30 10:20:00,14,19,8,22,22,85
2024-03-30 10:30:00,18,22,8,23,13,84
2024-03-30 10:40:00,21,26,10,31,20,108
2024-03-30 10:50:00,26,22,12,25,16,101
2024-03-30 11:00:00,17,27,12,23,23,102
2024-03-30 11:10:00,17,24,4,27,23,95
2024-03-30 11:20:00,23,24,10,21,30,108
2024-03-30 11:30:00,27,28,16,28,21,120
2024-03-30 11:40:00,14,26,9,31,34,114
2024-03-30 11:50:00,23,18,8,28,20,97
2024-03-30 12:00:00,22,24,15,24,24,109
2024-03-30 12:10:00,15,26,17,26,19,103
2024-03-30 12:20:00,22,24,13,22,22,103
2024-03-30 12:30:00,26,33,17,26,27,129
2024-03-30 12:40:00,17,23,13,30,24,107
2024-03-30 12:50:00,20,26,11,38,24,119
2024-03-30 13:00:00,16,28,19,35,26,124
2024-03-30 13:10:00,27,27,17,22,20,113
2024-03-30 13:20:00,17,18,11,33,29,108
2024-03-30 13:30:00,23,25,6,29,34,117
2024-03-30 13:40:00,17,30,11,33,31,122
2024-03-30 13:50:00,26,25,13,26,21,111
2024-03-30 14:00:00,16,26,11,32,22,107
2024-03-30 14:10:00,19,26,10,33,31,119
2024-03-30 14:20:00,22,21,18,36,26,123
2024-03-30 14:30:00,14,24,9,25,33,105
2024-03-30 14:40:00,16,26,13,26,23,104
2024-03-30 14:50:00,15,27,13,31,23,109
2024-03-30 15:00:00,20,19,11,29,23,102
2024-03-30 15:10:00,17,12,10,26,23,88
2024-03-30 15:20:00,14,26,13,30,28,111
2024-03-30 15:30:00,15,21,14,23,18,91
2024-03-30 15:40:00,22,28,9,26,25,110
2024-03-30 15:50:00,22,20,11,28,19,100
2024-03-30 16:00:00,14,15,10,27,20,86
2024-03-30 16:10:00,17,21,8,24,20,90
2024-03-30 16:20:00,19,27,12,31,20,109
2024-03-30 16:30:00,18,31,12,31,18,110
2024-03-30 16:40:00,10,22,11,24,26,93
2024-03-30 16:50:00,18,24,17,28,24,111
2024-03-30 17:00:00,12,18,11,29,24,94
2024-03-30 17:10:00,15,20,8,27,22,92
2024-03-30 17:20:00,19,27,15,27,26,114
2024-03-30 17:30:00,13,13,7,44,18,95
2024-03-30 17:40:00,20,21,12,30,27,110
2024-03-30 17:50:00,12,21,6,28,23,90
2024-03-30 18:00:00,15,19,9,25,20,88
2024-03-30 18:10:00,16,22,13,29,15,95
2024-03-30 18:20:00,21,25,7,23,24,100
2024-03-30 18:30:00,13,19,17,25,24,98
2024-03-30 18:40:00,14,24,12,35,28,113
2024-03-30 18:50:00,14,20,15,27,17,93
2024-03-30 19:00:00,15,21,7,25,15,83
2024-03-30 19:10:00,18,30,17,32,27,124
2024-03-30 19:20:00,19,29,8,32,24,112
2024-03-30 19:30:00,24,22,12,24,23,105
2024-03-30 19:40:00,18,20,12,23,21,94
2024-03-30 19:50:00,22,41,23,32,20,138
2024-03-30 20:00:00,12,33,18,25,24,112
2024-03-30 20:10:00,33,27,30,27,34,151
2024-03-30 20:20:00,20,33,25,31,31,140
2024-03-30 20:30:00,21,28,13,22,26,110
2024-03-30 20:40:00,28,27,7,23,35,120
2024-03-30 20:50:00,18,17,8,22,21,86
2024-03-30 21:00:00,27,8,6,20,26,87
2024-03-30 21:10:00,12,13,8,12,21,66
2024-03-30 21:20:00,12,28,19,28,25,112
2024-03-30 21:30:00,8,29,4,19,19,79
2024-03-30 21:40:00,11,27,14,21,20,93
2024-03-30 21:50:00,14,18,12,18,19,81
2024-03-30 22:00:00,21,23,18,22,28,112
2024-03-30 22:10:00,13,27,12,24,26,102
2024-03-30 22:20:00,16,35,24,18,19,112
2024-03-30 22:30:00,12,23,7,18,17,77
2024-03-30 22:40:00,14,16,16,14,21,81
2024-03-30 22:50:00,13,15,6,16,16,66
2024-03-30 23:00:00,16,25,6,16,21,84
2024-03-30 23:10:00,5,25,9,19,19,77
2024-03-30 23:20:00,10,20,9,16,19,74
2024-03-30 23:30:00,15,19,9,20,13,76
2024-03-30 23:40:00,15,14,10,6,14,59
2024-03-30 23:50:00,10,17,2,9,18,56
2024-03-31 00:00:00,5,16,6,14,10,51
2024-03-31 00:10:00,4,12,6,10,11,43
2024-03-31 00:20:00,9,17,10,11,13,60
2024-03-31 00:30:00,10,9,3,11,10,43
2024-03-31 00:40:00,5,9,8,11,9,42
2024-03-31 00:50:00,8,10,0,8,13,39
2024-03-31 01:00:00,2,13,6,10,9,40
2024-03-31 01:10:00,4,8,0,10,14,36
2024-03-31 01:20:00,4,9,3,8,8,32
2024-03-31 01:30:00,6,9,2,11,6,34
2024-03-31 01:40:00,3,12,0,10,6,31
2024-03-31 01:50:00,0,5,1,15,7,28
2024-03-31 02:00:00,0,0,0,0,0,0
2024-03-31 02:10:00,0,0,0,0,0,0
2024-03-31 02:20:00,0,0,0,0,0,0
2024-03-31 02:30:00,0,0,0,0,0,0
2024-03-31 02:40:00,0,0,0,0,0,0
2024-03-31 02:50:00,0,0,0,0,0,0
2024-03-31 03:00:00,0,0,0,0,0,0
2024-03-31 03:10:00,0,0,0,0,0,0
2024-03-31 03:20:00,0,0,0,0,0,0
2024-03-31 03:30:00,0,0,0,0,0,0
2024-03-31 03:40:00,0,0,0,0,0,0
2024-03-31 03:50:00,0,0,0,0,0,0
2024-03-31 04:00:00,1,5,2,11,3,22
2024-03-31 04:10:00,1,5,1,6,6,19
2024-03-31 04:20:00,2,3,1,8,6,20
2024-03-31 04:30:00,1,6,0,9,8,24
2024-03-31 04:40:00,3,5,1,6,3,18
2024-03-31 04:50:00,0,4,2,3,3,12
2024-03-31 05:00:00,2,7,1,7,4,21
2024-03-31 05:10:00,3,7,3,5,4,22
2024-03-31 05:20:00,2,5,2,14,7,30
2024-03-31 05:30:00,4,15,4,7,3,33
2024-03-31 05:40:00,5,9,2,11,5,32
2024-03-31 05:50:00,1,6,0,11,5,23
2024-03-31 06:00:00,3,14,6,4,2,29
2024-03-31 06:10:00,0,7,3,9,3,22
2024-03-31 06:20:00,2,7,3,3,5,20
2024-03-31 06:30:00,0,5,1,6,4,16
2024-03-31 06:40:00,2,6,0,4,4,16
2024-03-31 06:50:00,1,5,2,6,6,20
2024-03-31 07:00:00,2,3,0,4,1,10
2024-03-31 07:10:00,3,5,1,2,3,14
2024-03-31 07:20:00,2,7,2,6,1,18
2024-03-31 07:30:00,2,4,3,5,2,16
2024-03-31 07:40:00,3,2,2,9,2,18
2024-03-31 07:50:00,0,5,1,6,2,14
2024-03-31 08:00:00,2,2,1,5,7,17
2024-03-31 08:10:00,3,4,3,4,4,18
2024-03-31 08:20:00,2,5,0,8,1,16
2024-03-31 08:30:00,6,5,1,9,5,26
2024-03-31 08:40:00,6,6,0,10,5,27
2024-03-31 08:50:00,5,6,3,8,4,26
2024-03-31 09:00:00,2,5,1,11,7,26
2024-03-31 09:10:00,12,13,4,11,4,44
2024-03-31 09:20:00,19,10,1,8,11,49
2024-03-31 09:30:00,17,12,4,13,12,58
2024-03-31 09:40:00,9,17,5,17,9,57
2024-03-31 09:50:00,8,12,3,14,10,47
2024-03-31 10:00:00,8,13,1,15,4,41
2024-03-31 10:10:00,7,19,4,10,8,48
2024-03-31 10:20:00,10,22,5,25,14,76
2024-03-31 10:30:00,6,20,1,16,8,51
2024-03-31 10:40:00,7,18,3,16,11,55
2024-03-31 10:50:00,8,17,4,22,7,58
2024-03-31 11:00:00,6,19,4,14,10,53
2024-03-31 11:10:00,7,16,7,20,12,62
2024-03-31 11:20:00,16,13,9,21,14,73
2024-03-31 11:30:00,6,19,6,22,15,68
2024-03-31 11:40:00,14,22,11,25,15,87
2024-03-31 11:50:00,9,25,11,27,21,93
2024-03-31 12:00:00,10,24,8,22,15,79
2024-03-31 12:10:00,5,27,9,26,18,85
2024-03-31 12:20:00,9,15,5,25,16,70
2024-03-31 12:30:00,16,22,11,30,22,101
2024-03-31 12:40:00,9,12,10,23,24,78
2024-03-31 12:50:00,11,13,7,27,18,76
2024-03-31 13:00:00,10,17,8,17,13,65
2024-03-31 13:10:00,11,26,13,21,12,83
2024-03-31 13:20:00,11,24,9,29,13,86
2024-03-31 13:30:00,10,19,6,27,14,76
2024-03-31 13:40:00,8,28,9,25,17,87
2024-03-31 13:50:00,12,24,9,26,17,88
2024-03-31 14:00:00,14,16,5,27,21,83
2024-03-31 14:10:00,10,28,10,26,15,89
2024-03-31 14:20:00,11,20,2,21,20,74
2024-03-31 14:30:00,14,21,8,32,25,100
2024-03-31 14:40:00,9,22,6,23,16,76
2024-03-31 14:50:00,8,30,12,27,17,94
2024-03-31 15:00:00,10,20,9,27,18,84
2024-03-31 15:10:00,15,25,7,26,16,89
2024-03-31 15:20:00,13,23,11,25,18,90
2024-03-31 15:30:00,15,27,7,24,15,88
2024-03-31 15:40:00,7,22,9,21,16,75
2024-03-31 15:50:00,12,26,12,25,17,92
2024-03-31 16:00:00,15,20,8,29,14,86
2024-03-31 16:10:00,9,21,4,26,17,77
2024-03-31 16:20:00,16,25,6,21,16,84
2024-03-31 16:30:00,22,26,7,18,19,92
2024-03-31 16:40:00,19,22,8,25,21,95
2024-03-31 16:50:00,15,25,17,23,23,103
2024-03-31 17:00:00,9,30,7,24,17,87
2024-03-31 17:10:00,13,25,13,27,12,90
2024-03-31 17:20:00,8,24,7,24,22,85
2024-03-31 17:30:00,14,23,12,27,16,92
2024-03-31 17:40:00,12,24,17,27,17,97
2024-03-31 17:50:00,12,27,10,30,19,98
2024-03-31 18:00:00,12,18,10,19,13,72
2024-03-31 18:10:00,18,25,12,26,24,105
2024-03-31 18:20:00,9,23,9,31,22,94
2024-03-31 18:30:00,16,23,11,27,18,95
2024-03-31 18:40:00,9,25,14,33,20,101
2024-03-31 18:50:00,15,27,8,37,21,108
2024-03-31 19:00:00,15,25,7,27,18,92
2024-03-31 19:10:00,20,28,9,25,12,94
2024-03-31 19:20:00,7,26,16,24,22,95
2024-03-31 19:30:00,8,19,11,22,13,73
2024-03-31 19:40:00,18,25,14,26,25,108
2024-03-31 19:50:00,13,19,7,22,16,77
2024-03-31 20:00:00,14,27,11,16,14,82
2024-03-31 20:10:00,15,22,12,22,15,86
2024-03-31 20:20:00,17,18,7,21,25,88
2024-03-31 20:30:00,13,11,24,27,27,102
2024-03-31 20:40:00,17,25,10,26,29,107
2024-03-31 20:50:00,19,18,14,18,16,85
2024-03-31 21:00:00,24,36,5,26,22,113
2024-03-31 21:10:00,31,36,24,29,36,156
2024-03-31 21:20:00,28,35,23,20,29,135
2024-03-31 21:30:00,23,21,14,28,26,112
2024-03-31 21:40:00,21,28,13,25,19,106
2024-03-31 21:50:00,19,23,11,15,20,88
2024-03-31 22:00:00,14,19,14,21,16,84
2024-03-31 22:10:00,12,15,6,20,21,74
2024-03-31 22:20:00,2,23,6,16,13,60
2024-03-31 22:30:00,9,26,20,21,19,95
2024-03-31 22:40:00,7,22,9,23,25,86
2024-03-31 22:50:00,15,28,17,24,21,105
2024-03-31 23:00:00,13,18,8,19,12,70
2024-03-31 23:10:00,12,15,4,19,22,72
2024-03-31 23:20:00,11,16,3,13,18,61
2024-03-31 23:30:00,8,10,6,10,10,44
2024-03-31 23:40:00,2,10,1,12,10,35
2024-03-31 23:50:00,5,12,3,16,12,48
2024-04-01 00:00:00,1,5,2,13,10,31
2024-04-01 00:10:00,5,12,2,14,13,46
2024-04-01 00:20:00,3,12,2,19,18,54
2024-04-01 00:30:00,1,4,3,8,9,25
2024-04-01 00:40:00,6,10,3,21,9,49
2024-04-01 00:50:00,5,12,1,8,8,34
2024-04-01 01:00:00,0,14,2,11,7,34
2024-04-01 01:10:00,5,11,2,10,10,38
2024-04-01 01:20:00,2,4,4,8,5,23
2024-04-01 01:30:00,3,11,3,9,2,28
2024-04-01 01:40:00,4,6,2,7,5,24
2024-04-01 01:50:00,1,2,0,2,9,14
2024-04-01 02:00:00,3,7,1,7,5,23
2024-04-01 02:10:00,2,8,0,1,3,14
2024-04-01 02:20:00,1,4,3,4,6,18
2024-04-01 02:30:00,1,2,1,7,2,13
2024-04-01 02:40:00,2,5,1,5,7,20
2024-04-01 02:50:00,1,6,0,3,6,16
2024-04-01 03:00:00,1,0,0,7,3,11
2024-04-01 03:10:00,1,5,1,7,3,17
2024-04-01 03:20:00,0,3,0,7,3,13
2024-04-01 03:30:00,2,6,1,6,4,19
2024-04-01 03:40:00,1,6,1,7,1,16
2024-04-01 03:50:00,1,7,2,4,3,17
2024-04-01 04:00:00,3,6,0,4,4,17
2024-04-01 04:10:00,1,2,1,8,3,15
2024-04-01 04:20:00,0,3,1,5,3,12
2024-04-01 04:30:00,0,4,2,9,4,19
2024-04-01 04:40:00,3,7,1,2,2,15
2024-04-01 04:50:00,5,7,0,3,1,16
2024-04-01 05:00:00,1,6,1,4,5,17
2024-04-01 05:10:00,2,10,3,5,2,22
2024-04-01 05:20:00,2,8,1,10,7,28
2024-04-01 05:30:00,8,10,1,6,5,30
2024-04-01 05:40:00,0,6,1,8,2,17
2024-04-01 05:50:00,5,11,0,9,7,32
2024-04-01 06:00:00,4,12,6,7,5,34
2024-04-01 06:10:00,2,13,2,9,7,33
2024-04-01 06:20:00,1,9,1,10,7,28
2024-04-01 06:30:00,1,5,0,5,4,15
2024-04-01 06:40:00,3,14,2,5,4,28
2024-04-01 06:50:00,1,5,2,9,5,22
2024-04-01 07:00:00,1,3,0,6,2,12
2024-04-01 07:10:00,2,6,0,3,2,13
2024-04-01 07:20:00,0,2,1,4,4,11
2024-04-01 07:30:00,3,6,2,5,5,21
2024-04-01 07:40:00,1,4,2,5,3,15
2024-04-01 07:50:00,2,5,0,3,4,14
2024-04-01 08:00:00,1,2,0,5,4,12
2024-04-01 08:10:00,2,8,0,3,0,13
2024-04-01 08:20:00,1,4,0,8,4,17
2024-04-01 08:30:00,3,7,2,7,3,22
2024-04-01 08:40:00,6,2,2,5,1,16
2024-04-01 08:50:00,5,5,2,9,0,21
2024-04-01 09:00:00,9,11,1,5,4,30
2024-04-01 09:10:00,2,6,6,4,3,21
2024-04-01 09:20:00,12,10,1,8,2,33
2024-04-01 09:30:00,13,9,5,7,7,41
2024-04-01 09:40:00,9,11,5,12,4,41
2024-04-01 09:50:00,8,12,2,9,6,37
2024-04-01 10:00:00,5,7,6,13,10,41
2024-04-01 10:10:00,7,12,4,15,7,45
2024-04-01 10:20:00,9,13,7,10,7,46
2024-04-01 10:30:00,5,16,2,12,11,46
2024-04-01 10:40:00,9,16,3,14,11,53
2024-04-01 10:50:00,10,21,5,12,9,57
2024-04-01 11:00:00,11,15,8,15,16,65
2024-04-01 11:10:00,9,13,4,14,13,53
2024-04-01 11:20:00,10,19,4,21,11,65
2024-04-01 11:30:00,8,17,7,17,13,62
2024-04-01 11:40:00,10,19,4,19,14,66
2024-04-01 11:50:00,13,19,4,28,13,77
2024-04-01 12:00:00,13,23,3,27,30,96
2024-04-01 12:10:00,10,13,5,29,14,71
2024-04-01 12:20:00,10,23,7,27,17,84
2024-04-01 12:30:00,8,21,6,28,16,79
2024-04-01 12:40:00,6,20,8,21,21,76
2024-04-01 12:50:00,10,22,11,18,16,77
2024-04-01 13:00:00,13,16,5,27,18,79
2024-04-01 13:10:00,13,15,12,21,17,78
2024-04-01 13:20:00,7,21,5,24,20,77
2024-04-01 13:30:00,11,20,10,19,16,76
2024-04-01 13:40:00,7,25,8,21,20,81
2024-04-01 13:50:00,16,19,5,24,12,76
2024-04-01 14:00:00,11,26,13,24,21,95
2024-04-01 14:10:00,14,26,13,24,14,91
2024-04-01 14:20:00,12,26,10,25,21,94
2024-04-01 14:30:00,11,22,7,25,20,85
2024-04-01 14:40:00,16,32,15,27,18,108
2024-04-01 14:50:00,10,21,8,30,25,94
2024-04-01 15:00:00,9,21,8,28,23,89
2024-04-01 15:10:00,11,18,10,27,22,88
2024-04-01 15:20:00,9,22,9,23,19,82
2024-04-01 15:30:00,8,21,5,22,16,72
2024-04-01 15:40:00,15,24,12,22,17,90
2024-04-01 15:50:00,6,21,10,20,15,72
2024-04-01 16:00:00,6,27,9,26,19,87
2024-04-01 16:10:00,12,24,10,21,19,86
2024-04-01 16:20:00,14,24,9,24,19,90
2024-04-01 16:30:00,19,23,9,26,18,95
2024-04-01 16:40:00,15,24,8,25,20,92
2024-04-01 16:50:00,12,24,7,32,18,93
2024-04-01 17:00:00,9,27,11,25,23,95
2024-04-01 17:10:00,7,28,9,26,18,88
2024-04-01 17:20:00,16,28,13,21,23,101
2024-04-01 17:30:00,15,27,7,21,18,88
2024-04-01 17:40:00,10,25,12,19,17,83
2024-04-01 17:50:00,13,25,13,27,19,97
2024-04-01 18:00:00,10,24,7,26,22,89
2024-04-01 18:10:00,11,26,7,29,18,91
2024-04-01 18:20:00,8,24,4,27,23,86
2024-04-01 18:30:00,12,26,8,38,18,102
2024-04-01 18:40:00,13,22,12,34,15,96
2024-04-01 18:50:00,10,26,9,24,16,85
2024-04-01 19:00:00,11,21,13,30,19,94
2024-04-01 19:10:00,14,16,6,28,17,81
2024-04-01 19:20:00,7,26,17,26,22,98
2024-04-01 19:30:00,12,22,9,24,23,90
2024-04-01 19:40:00,17,21,5,27,22,92
2024-04-01 19:50:00,12,18,6,19,23,78
2024-04-01 20:00:00,10,13,8,21,18,70
2024-04-01 20:10:00,14,26,8,32,24,104
2024-04-01 20:20:00,15,17,8,19,18,77
2024-04-01 20:30:00,20,15,8,21,10,74
2024-04-01 20:40:00,18,22,14,17,15,86
2024-04-01 20:50:00,14,23,9,19,18,83
2024-04-01 21:00:00,27,29,7,31,22,116
2024-04-01 21:10:00,32,28,10,28,31,129
2024-04-01 21:20:00,24,31,24,16,39,134
2024-04-01 21:30:00,21,27,21,17,21,107
2024-04-01 21:40:00,17,15,9,25,26,92
2024-04-01 21:50:00,18,24,7,18,23,90
2024-04-01 22:00:00,8,24,7,28,13,80
2024-04-01 22:10:00,7,15,7,31,16,76
2024-04-01 22:20:00,19,27,17,21,15,99
2024-04-01 22:30:00,12,26,12,20,19,89
2024-04-01 22:40:00,11,22,6,14,19,72
2024-04-01 22:50:00,14,12,11,25,29,91
2024-04-01 23:00:00,20,22,18,24,21,105
2024-04-01 23:10:00,9,15,4,23,23,74
2024-04-01 23:20:00,10,8,7,14,20,59
2024-04-01 23:30:00,10,15,0,21,20,66
2024-04-01 23:40:00,6,19,0,13,21,59
2024-04-01 23:50:00,10,14,6,7,10,47
2024-04-02 00:00:00,9,11,0,7,13,40
2024-04-02 00:10:00,2,20,6,12,12,52
2024-04-02 00:20:00,5,5,10,9,12,41
2024-04-02 00:30:00,9,5,2,4,12,32
2024-04-02 00:40:00,6,12,1,6,8,33
2024-04-02 00:50:00,2,10,0,6,4,22
2024-04-02 01:00:00,3,12,2,11,7,35
2024-04-02 01:10:00,9,5,0,6,2,22
2024-04-02 01:20:00,1,6,3,3,5,18
2024-04-02 01:30:00,5,3,7,6,2,23
2024-04-02 01:40:00,2,4,3,6,4,19
2024-04-02 01:50:00,1,5,4,1,3,14
2024-04-02 02:00:00,3,6,5,4,6,24
2024-04-02 02:10:00,0,10,0,2,4,16
2024-04-02 02:20:00,0,8,0,5,7,20
2024-04-02 02:30:00,3,1,0,5,3,12
2024-04-02 02:40:00,0,10,0,2,8,20
2024-04-02 02:50:00,0,0,2,1,5,8
2024-04-02 03:00:00,0,6,0,1,2,9
2024-04-02 03:10:00,6,2,4,4,5,21
2024-04-02 03:20:00,1,6,3,4,7,21
2024-04-02 03:30:00,0,6,2,4,1,13
2024-04-02 03:40:00,1,1,3,6,1,12
2024-04-02 03:50:00,4,1,2,3,0,10
2024-04-02 04:00:00,3,4,0,2,7,16
2024-04-02 04:10:00,0,9,0,6,2,17
2024-04-02 04:20:00,15,3,6,3,4,31
2024-04-02 04:30:00,0,5,0,3,6,14
2024-04-02 04:40:00,7,7,0,7,9,30
2024-04-02 04:50:00,12,4,8,7,7,38
2024-04-02 05:00:00,15,17,4,2,11,49
2024-04-02 05:10:00,14,7,2,8,13,44
2024-04-02 05:20:00,20,13,9,19,8,69
2024-04-02 05:30:00,26,15,9,15,24,89
2024-04-02 05:40:00,24,24,10,15,17,90
2024-04-02 05:50:00,28,24,7,15,25,99
2024-04-02 06:00:00,33,19,8,11,15,86
2024-04-02 06:10:00,28,21,9,15,17,90
2024-04-02 06:20:00,25,23,7,14,17,86
2024-04-02 06:30:00,37,35,11,21,15,119
2024-04-02 06:40:00,25,30,19,21,39,134
2024-04-02 06:50:00,24,25,8,27,29,113
2024-04-02 07:00:00,22,20,9,24,22,97
2024-04-02 07:10:00,20,34,17,22,16,109
2024-04-02 07:20:00,16,29,11,23,18,97
2024-04-02 07:30:00,29,28,14,36,36,143
2024-04-02 07:40:00,17,37,17,21,29,121
2024-04-02 07:50:00,18,28,10,18,27,101
2024-04-02 08:00:00,18,24,14,27,26,109
2024-04-02 08:10:00,19,23,12,26,34,114
2024-04-02 08:20:00,17,29,7,23,22,98
2024-04-02 08:30:00,22,29,15,28,19,113
2024-04-02 08:40:00,22,28,17,28,28,123
2024-04-02 08:50:00,20,27,16,33,24,120
2024-04-02 09:00:00,27,26,21,24,21,119
2024-04-02 09:10:00,16,23,17,21,20,97
2024-04-02 09:20:00,19,27,15,23,21,105
2024-04-02 09:30:00,25,25,13,23,20,106
2024-04-02 09:40:00,23,36,17,26,18,120
2024-04-02 09:50:00,25,25,8,22,21,101
2024-04-02 10:00:00,15,28,15,22,18,98
2024-04-02 10:10:00,20,25,12,19,18,94
2024-04-02 10:20:00,25,27,8,26,17,103
2024-04-02 10:30:00,14,19,16,22,20,91
2024-04-02 10:40:00,23,26,11,26,21,107
2024-04-02 10:50:00,16,29,14,25,19,103
2024-04-02 11:00:00,19,30,9,32,23,113
2024-04-02 11:10:00,23,26,8,24,17,98
2024-04-02 11:20:00,13,21,15,21,23,93
2024-04-02 11:30:00,20,21,14,30,21,106
2024-04-02 11:40:00,13,17,18,28,20,96
2024-04-02 11:50:00,22,21,14,28,21,106
2024-04-02 12:00:00,30,20,12,28,26,116
2024-04-02 12:10:00,22,23,8,28,21,102
2024-04-02 12:20:00,23,27,12,27,22,111
2024-04-02 12:30:00,15,21,14,31,38,119
2024-04-02 12:40:00,17,31,10,30,24,112
2024-04-02 12:50:00,28,31,13,21,21,114
2024-04-02 13:00:00,25,34,16,26,26,127
2024-04-02 13:10:00,22,22,8,27,30,109
2024-04-02 13:20:00,17,26,17,29,21,110
2024-04-02 13:30:00,23,23,14,27,24,111
2024-04-02 13:40:00,25,24,18,23,24,114
2024-04-02 13:50:00,27,25,11,31,24,118
2024-04-02 14:00:00,18,21,17,27,24,107
2024-04-02 14:10:00,20,25,15,29,32,121
2024-04-02 14:20:00,21,32,15,36,30,134
2024-04-02 14:30:00,27,30,11,34,27,129
2024-04-02 14:40:00,14,36,15,29,22,116
2024-04-02 14:50:00,16,28,15,25,20,104
2024-04-02 15:00:00,17,34,21,30,31,133
2024-04-02 15:10:00,25,29,23,36,22,135
2024-04-02 15:20:00,22,34,16,33,24,129
2024-04-02 15:30:00,22,33,16,34,31,136
2024-04-02 15:40:00,26,28,17,24,26,121
2024-04-02 15:50:00,23,31,12,39,26,131
2024-04-02 16:00:00,23,38,19,36,25,141
2024-04-02 16:10:00,28,29,23,25,25,130
2024-04-02 16:20:00,26,39,26,42,32,165
2024-04-02 16:30:00,27,32,19,37,29,144
2024-04-02 16:40:00,29,33,22,24,25,133
2024-04-02 16:50:00,19,30,11,20,28,108
2024-04-02 17:00:00,25,37,21,31,29,143
2024-04-02 17:10:00,26,25,18,29,26,124
2024-04-02 17:20:00,29,30,15,21,23,118
2024-04-02 17:30:00,21,24,19,33,24,121
2024-04-02 17:40:00,15,26,13,27,27,108
2024-04-02 17:50:00,22,30,18,19,25,114
2024-04-02 18:00:00,21,19,12,33,28,113
2024-04-02 18:10:00,19,36,14,29,26,124
2024-04-02 18:20:00,18,57,16,22,24,137
2024-04-02 18:30:00,21,19,9,30,28,107
2024-04-02 18:40:00,23,25,11,31,33,123
2024-04-02 18:50:00,19,26,13,29,24,111
2024-04-02 19:00:00,18,18,13,27,24,100
2024-04-02 19:10:00,17,24,14,23,19,97
2024-04-02 19:20:00,17,20,15,28,18,98
2024-04-02 19:30:00,10,19,13,22,18,82
2024-04-02 19:40:00,11,18,13,21,19,82
2024-04-02 19:50:00,9,21,12,24,21,87
2024-04-02 20:00:00,11,12,4,24,18,69
2024-04-02 20:10:00,15,21,6,30,24,96
2024-04-02 20:20:00,9,20,7,21,18,75
2024-04-02 20:30:00,23,21,19,27,19,109
2024-04-02 20:40:00,24,15,16,28,34,117
2024-04-02 20:50:00,28,17,9,36,26,116
2024-04-02 21:00:00,12,27,29,19,18,105
2024-04-02 21:10:00,19,28,17,29,26,119
2024-04-02 21:20:00,24,33,6,19,25,107
2024-04-02 21:30:00,19,26,15,18,31,109
2024-04-02 21:40:00,9,15,12,19,18,73
2024-04-02 21:50:00,22,17,10,23,17,89
2024-04-02 22:00:00,7,16,14,24,24,85
2024-04-02 22:10:00,17,30,7,20,22,96
2024-04-02 22:20:00,7,19,8,25,26,85
2024-04-02 22:30:00,11,27,2,21,19,80
2024-04-02 22:40:00,13,26,13,21,19,92
2024-04-02 22:50:00,14,19,18,21,20,92
2024-04-02 23:00:00,6,15,7,19,22,69
2024-04-02 23:10:00,9,16,7,14,21,67
2024-04-02 23:20:00,5,18,2,22,18,65
2024-04-02 23:30:00,6,15,7,14,17,59
2024-04-02 23:40:00,14,9,0,8,15,46
2024-04-02 23:50:00,6,8,1,18,11,44
2024-04-03 00:00:00,3,10,4,17,11,45
2024-04-03 00:10:00,13,11,1,8,11,44
2024-04-03 00:20:00,6,7,3,4,8,28
2024-04-03 00:30:00,3,4,2,5,5,19
2024-04-03 00:40:00,4,6,4,4,9,27
2024-04-03 00:50:00,1,2,2,3,5,13
2024-04-03 01:00:00,2,5,0,7,8,22
2024-04-03 01:10:00,2,5,0,4,7,18
2024-04-03 01:20:00,2,9,1,4,6,22
2024-04-03 01:30:00,5,8,1,3,2,19
2024-04-03 01:40:00,0,6,1,3,3,13
2024-04-03 01:50:00,0,1,0,7,4,12
2024-04-03 02:00:00,4,6,0,8,3,21
2024-04-03 02:10:00,2,6,1,3,2,14
2024-04-03 02:20:00,0,3,2,5,3,13
2024-04-03 02:30:00,3,4,3,1,1,12
2024-04-03 02:40:00,4,6,3,0,0,13
2024-04-03 02:50:00,0,0,3,1,1,5
2024-04-03 03:00:00,0,0,0,4,2,6
2024-04-03 03:10:00,2,8,3,2,3,18
2024-04-03 03:20:00,1,5,1,1,2,10
2024-04-03 03:30:00,4,2,0,2,3,11
2024-04-03 03:40:00,1,2,0,3,3,9
2024-04-03 03:50:00,1,2,0,3,8,14
2024-04-03 04:00:00,1,3,0,8,6,18
2024-04-03 04:10:00,6,6,1,4,3,20
2024-04-03 04:20:00,3,3,3,3,4,16
2024-04-03 04:30:00,5,3,3,1,4,16
2024-04-03 04:40:00,4,1,2,6,6,19
2024-04-03 04:50:00,6,5,1,3,6,21
2024-04-03 05:00:00,17,5,4,4,9,39
2024-04-03 05:10:00,16,7,3,11,12,49
2024-04-03 05:20:00,14,10,6,9,14,53
2024-04-03 05:30:00,14,12,10,11,12,59
2024-04-03 05:40:00,20,18,9,14,10,71
2024-04-03 05:50:00,24,16,6,13,19,78
2024-04-03 06:00:00,19,20,6,10,13,68
2024-04-03 06:10:00,2,24,6,15,15,62
2024-04-03 06:20:00,22,26,6,14,15,83
2024-04-03 06:30:00,28,31,10,21,30,120
2024-04-03 06:40:00,26,23,15,16,29,109
2024-04-03 06:50:00,21,24,7,14,22,88
2024-04-03 07:00:00,17,26,13,21,18,95
2024-04-03 07:10:00,21,33,14,20,22,110
2024-04-03 07:20:00,18,26,13,26,19,102
2024-04-03 07:30:00,25,26,16,32,23,122
2024-04-03 07:40:00,20,27,22,22,26,117
2024-04-03 07:50:00,23,27,15,25,28,118
2024-04-03 08:00:00,25,20,13,24,22,104
2024-04-03 08:10:00,24,25,10,34,20,113
2024-04-03 08:20:00,18,26,16,24,26,110
2024-04-03 08:30:00,20,29,19,33,27,128
2024-04-03 08:40:00,24,27,16,30,31,128
2024-04-03 08:50:00,27,28,16,23,26,120
2024-04-03 09:00:00,21,30,12,23,23,109
2024-04-03 09:10:00,11,23,8,29,18,89
2024-04-03 09:20:00,19,26,14,24,22,105
2024-04-03 09:30:00,17,21,18,25,28,109
2024-04-03 09:40:00,13,24,20,23,20,100
2024-04-03 09:50:00,21,31,17,26,20,115
2024-04-03 10:00:00,15,17,16,28,24,100
2024-04-03 10:10:00,20,16,11,25,17,89
2024-04-03 10:20:00,22,25,12,26,16,101
2024-04-03 10:30:00,29,33,12,27,22,123
2024-04-03 10:40:00,25,26,13,33,29,126
2024-04-03 10:50:00,23,28,10,27,24,112
2024-04-03 11:00:00,19,24,12,31,22,108
2024-04-03 11:10:00,17,22,16,27,25,107
2024-04-03 11:20:00,16,21,9,31,21,98
2024-04-03 11:30:00,23,30,15,30,15,113
2024-04-03 11:40:00,21,32,27,34,17,131
2024-04-03 11:50:00,17,24,10,27,22,100
2024-04-03 12:00:00,40,25,10,24,22,121
2024-04-03 12:10:00,18,32,19,32,23,124
2024-04-03 12:20:00,28,25,13,30,21,117
2024-04-03 12:30:00,44,26,12,31,26,139
2024-04-03 12:40:00,16,22,14,29,22,103
2024-04-03 12:50:00,40,22,16,30,27,135
2024-04-03 13:00:00,20,22,11,35,25,113
2024-04-03 13:10:00,22,29,14,41,23,129
2024-04-03 13:20:00,24,21,13,37,23,118
2024-04-03 13:30:00,23,19,16,28,25,111
2024-04-03 13:40:00,22,24,11,29,21,107
2024-04-03 13:50:00,15,24,11,40,26,116
2024-04-03 14:00:00,23,32,16,38,31,140
2024-04-03 14:10:00,19,27,8,32,19,105
2024-04-03 14:20:00,26,28,14,33,23,124
2024-04-03 14:30:00,21,30,14,26,34,125
2024-04-03 14:40:00,20,33,12,23,24,112
2024-04-03 14:50:00,24,26,10,31,29,120
2024-04-03 15:00:00,21,27,11,31,29,119
2024-04-03 15:10:00,17,30,20,18,22,107
2024-04-03 15:20:00,22,27,19,33,23,124
2024-04-03 15:30:00,35,38,17,33,29,152
2024-04-03 15:40:00,18,31,16,34,28,127
2024-04-03 15:50:00,21,31,16,30,31,129
2024-04-03 16:00:00,24,34,24,30,36,148
2024-04-03 16:10:00,34,33,20,31,27,145
2024-04-03 16:20:00,21,34,24,33,34,146
2024-04-03 16:30:00,18,29,20,30,36,133
2024-04-03 16:40:00,30,31,18,33,26,138
2024-04-03 16:50:00,28,34,15,22,31,130
2024-04-03 17:00:00,25,34,17,28,37,141
2024-04-03 17:10:00,23,29,22,26,25,125
2024-04-03 17:20:00,28,33,22,27,29,139
2024-04-03 17:30:00,25,25,41,30,31,152
2024-04-03 17:40:00,20,34,17,33,27,131
2024-04-03 17:50:00,16,23,18,30,37,124
2024-04-03 18:00:00,18,30,15,32,24,119
2024-04-03 18:10:00,13,19,11,31,24,98
2024-04-03 18:20:00,23,26,15,23,27,114
2024-04-03 18:30:00,26,23,12,28,26,115
2024-04-03 18:40:00,26,24,9,28,27,114
2024-04-03 18:50:00,17,21,12,26,21,97
2024-04-03 19:00:00,16,24,29,25,21,115
2024-04-03 19:10:00,17,25,13,27,24,106
2024-04-03 19:20:00,18,25,9,22,18,92
2024-04-03 19:30:00,13,23,18,25,25,104
2024-04-03 19:40:00,11,22,9,24,23,89
2024-04-03 19:50:00,13,16,7,25,17,78
2024-04-03 20:00:00,15,13,10,23,16,77
2024-04-03 20:10:00,9,23,8,35,21,96
2024-04-03 20:20:00,19,16,17,29,24,105
2024-04-03 20:30:00,24,15,9,25,20,93
2024-04-03 20:40:00,18,16,7,25,27,93
2024-04-03 20:50:00,22,28,17,13,25,105
2024-04-03 21:00:00,20,30,10,18,18,96
2024-04-03 21:10:00,24,21,18,20,23,106
2024-04-03 21:20:00,24,42,22,31,32,151
2024-04-03 21:30:00,24,15,18,16,29,102
2024-04-03 21:40:00,11,20,16,19,24,90
2024-04-03 21:50:00,20,20,14,20,26,100
2024-04-03 22:00:00,9,16,4,19,16,64
2024-04-03 22:10:00,8,17,3,19,16,63
2024-04-03 22:20:00,8,15,7,15,15,60
2024-04-03 22:30:00,9,12,6,14,19,60
2024-04-03 22:40:00,6,15,7,21,25,74
2024-04-03 22:50:00,7,27,10,16,15,75
2024-04-03 23:00:00,4,12,1,21,18,56
2024-04-03 23:10:00,9,14,2,20,22,67
2024-04-03 23:20:00,7,11,2,11,12,43
2024-04-03 23:30:00,2,7,5,15,9,38
2024-04-03 23:40:00,4,7,2,7,10,30
2024-04-03 23:50:00,1,7,0,11,15,34
2024-04-04 00:00:00,6,7,3,10,6,32
2024-04-04 00:10:00,4,5,0,10,6,25
2024-04-04 00:20:00,3,6,1,5,4,19
2024-04-04 00:30:00,5,10,1,10,10,36
2024-04-04 00:40:00,5,5,0,5,13,28
2024-04-04 00:50:00,1,1,1,5,9,17
2024-04-04 01:00:00,1,3,0,12,5,21
2024-04-04 01:10:00,0,6,0,6,3,15
2024-04-04 01:20:00,2,5,2,6,7,22
2024-04-04 01:30:00,1,1,1,4,1,8
2024-04-04 01:40:00,3,4,1,4,5,17
2024-04-04 01:50:00,1,5,0,3,2,11
2024-04-04 02:00:00,0,5,0,12,3,20
2024-04-04 02:10:00,1,5,0,5,4,15
2024-04-04 02:20:00,2,7,2,3,1,15
2024-04-04 02:30:00,1,4,1,1,2,9
2024-04-04 02:40:00,1,4,3,2,4,14
2024-04-04 02:50:00,2,2,1,5,1,11
2024-04-04 03:00:00,0,5,2,4,0,11
2024-04-04 03:10:00,1,1,1,4,0,7
2024-04-04 03:20:00,1,3,0,2,1,7
2024-04-04 03:30:00,1,2,1,1,2,7
2024-04-04 03:40:00,0,2,3,5,4,14
2024-04-04 03:50:00,1,4,0,4,3,12
2024-04-04 04:00:00,0,4,0,3,4,11
2024-04-04 04:10:00,1,1,3,4,3,12
2024-04-04 04:20:00,1,4,0,7,3,15
2024-04-04 04:30:00,4,3,2,5,2,16
2024-04-04 04:40:00,3,7,1,7,5,23
2024-04-04 04:50:00,2,5,1,3,9,20
2024-04-04 05:00:00,8,4,1,4,11,28
2024-04-04 05:10:00,10,12,2,6,9,39
2024-04-04 05:20:00,10,6,4,9,9,38
2024-04-04 05:30:00,11,14,4,7,11,47
2024-04-04 05:40:00,15,16,8,11,14,64
2024-04-04 05:50:00,21,23,6,9,18,77
2024-04-04 06:00:00,19,19,9,15,9,71
2024-04-04 06:10:00,18,15,11,15,14,73
2024-04-04 06:20:00,26,16,6,20,15,83
2024-04-04 06:30:00,25,19,6,22,17,89
2024-04-04 06:40:00,27,24,16,16,24,107
2024-04-04 06:50:00,21,17,15,20,33,106
2024-04-04 07:00:00,28,16,10,16,17,87
2024-04-04 07:10:00,24,25,14,24,24,111
2024-04-04 07:20:00,17,23,17,21,25,103
2024-04-04 07:30:00,14,30,10,24,26,104
2024-04-04 07:40:00,29,25,15,26,22,117
2024-04-04 07:50:00,24,26,12,28,24,114
2024-04-04 08:00:00,21,29,16,24,23,113
2024-04-04 08:10:00,19,21,15,28,31,114
2024-04-04 08:20:00,16,25,15,31,30,117
2024-04-04 08:30:00,22,28,18,24,22,114
2024-04-04 08:40:00,20,30,21,32,22,125
2024-04-04 08:50:00,18,23,15,25,19,100
2024-04-04 09:00:00,24,25,13,24,20,106
2024-04-04 09:10:00,22,23,17,27,16,105
2024-04-04 09:20:00,17,24,14,24,20,99
2024-04-04 09:30:00,18,32,11,32,21,114
2024-04-04 09:40:00,21,27,16,25,24,113
2024-04-04 09:50:00,13,32,13,26,25,109
2024-04-04 10:00:00,18,27,14,25,19,103
2024-04-04 10:10:00,18,28,16,32,20,114
2024-04-04 10:20:00,20,28,11,27,21,107
2024-04-04 10:30:00,17,29,15,24,11,96
2024-04-04 10:40:00,16,23,15,28,22,104
2024-04-04 10:50:00,21,27,10,26,20,104
2024-04-04 11:00:00,19,24,14,25,16,98
2024-04-04 11:10:00,20,19,12,17,27,95
2024-04-04 11:20:00,15,33,22,29,28,127
2024-04-04 11:30:00,14,18,12,28,19,91
2024-04-04 11:40:00,19,18,22,34,20,113
2024-04-04 11:50:00,16,31,13,29,30,119
2024-04-04 12:00:00,24,24,19,32,19,118
2024-04-04 12:10:00,21,28,15,30,25,119
2024-04-04 12:20:00,25,18,15,39,16,113
2024-04-04 12:30:00,24,31,16,25,22,118
2024-04-04 12:40:00,20,21,13,31,24,109
2024-04-04 12:50:00,17,16,11,29,22,95
2024-04-04 13:00:00,24,28,13,28,24,117
2024-04-04 13:10:00,18,23,13,32,29,115
2024-04-04 13:20:00,19,25,21,32,24,121
2024-04-04 13:30:00,21,29,16,28,28,122
2024-04-04 13:40:00,18,25,17,26,17,103
2024-04-04 13:50:00,22,22,20,36,21,121
2024-04-04 14:00:00,25,22,12,30,26,115
2024-04-04 14:10:00,25,24,16,28,16,109
2024-04-04 14:20:00,15,25,17,27,26,110
2024-04-04 14:30:00,21,30,16,32,24,123
2024-04-04 14:40:00,20,23,16,33,23,115
2024-04-04 14:50:00,30,35,19,31,21,136
2024-04-04 15:00:00,22,25,13,31,27,118
2024-04-04 15:10:00,33,33,13,32,28,139
2024-04-04 15:20:00,22,33,21,31,25,132
2024-04-04 15:30:00,26,31,14,28,24,123
2024-04-04 15:40:00,28,33,19,33,30,143
2024-04-04 15:50:00,17,28,16,33,29,123
2024-04-04 16:00:00,13,27,22,28,23,113
2024-04-04 16:10:00,20,29,18,29,22,118
2024-04-04 16:20:00,23,34,22,32,36,147
2024-04-04 16:30:00,24,41,15,36,24,140
2024-04-04 16:40:00,16,30,12,27,29,114
2024-04-04 16:50:00,29,34,31,21,24,139
2024-04-04 17:00:00,19,30,18,29,33,129
2024-04-04 17:10:00,24,28,19,31,31,133
2024-04-04 17:20:00,22,31,14,28,29,124
2024-04-04 17:30:00,26,26,18,29,32,131
2024-04-04 17:40:00,24,24,20,23,20,111
2024-04-04 17:50:00,26,43,17,30,33,149
2024-04-04 18:00:00,15,21,12,28,24,100
2024-04-04 18:10:00,20,33,14,25,23,115
2024-04-04 18:20:00,32,23,15,24,22,116
2024-04-04 18:30:00,18,25,12,32,21,108
2024-04-04 18:40:00,20,25,13,36,32,126
2024-04-04 18:50:00,14,23,10,28,21,96
2024-04-04 19:00:00,14,23,14,29,25,105
2024-04-04 19:10:00,13,24,16,28,20,101
2024-04-04 19:20:00,14,21,10,27,26,98
2024-04-04 19:30:00,9,21,10,23,23,86
2024-04-04 19:40:00,18,18,9,26,19,90
2024-04-04 19:50:00,14,15,7,15,19,70
2024-04-04 20:00:00,15,22,9,24,22,92
2024-04-04 20:10:00,11,24,5,21,17,78
2024-04-04 20:20:00,6,24,4,14,17,65
2024-04-04 20:30:00,13,23,5,15,17,73
2024-04-04 20:40:00,15,15,4,17,20,71
2024-04-04 20:50:00,12,17,7,19,11,66
2024-04-04 21:00:00,14,14,5,19,18,70
2024-04-04 21:10:00,23,14,4,24,20,85
2024-04-04 21:20:00,20,20,10,18,27,95
2024-04-04 21:30:00,18,24,12,24,32,110
2024-04-04 21:40:00,13,23,7,22,21,86
2024-04-04 21:50:00,11,13,5,19,21,69
2024-04-04 22:00:00,9,15,8,18,15,65
2024-04-04 22:10:00,10,21,6,19,19,75
2024-04-04 22:20:00,7,20,6,16,13,62
2024-04-04 22:30:00,8,17,6,10,26,67
2024-04-04 22:40:00,6,21,11,16,22,76
2024-04-04 22:50:00,6,15,2,16,17,56
2024-04-04 23:00:00,7,8,5,16,9,45
2024-04-04 23:10:00,8,11,1,12,14,46
2024-04-04 23:20:00,3,9,1,13,18,44
2024-04-04 23:30:00,3,7,1,15,11,37
2024-04-04 23:40:00,3,12,2,12,6,35
2024-04-04 23:50:00,5,8,2,12,13,40
2024-04-05 00:00:00,4,5,1,16,15,41
2024-04-05 00:10:00,2,6,2,12,13,35
2024-04-05 00:20:00,3,6,2,10,11,32
2024-04-05 00:30:00,5,9,1,6,4,25
2024-04-05 00:40:00,6,9,2,5,8,30
2024-04-05 00:50:00,1,7,1,9,8,26
2024-04-05 01:00:00,1,1,1,6,9,18
2024-04-05 01:10:00,2,6,2,11,2,23
2024-04-05 01:20:00,1,4,0,8,4,17
2024-04-05 01:30:00,2,3,0,4,2,11
2024-04-05 01:40:00,2,1,0,3,7,13
2024-04-05 01:50:00,1,5,0,5,3,14
2024-04-05 02:00:00,0,0,0,2,0,2
