datetime,D21Z,D22Z,D31Z,D32Z,D33Z,D41Z,D42Z,Total
2024-03-01 01:00:00,0,0,1,0,0,3,4,8
2024-03-01 01:10:00,0,0,1,0,0,3,4,8
2024-03-01 01:20:00,0,0,0,0,0,1,4,5
2024-03-01 01:30:00,0,0,1,0,0,3,6,10
2024-03-01 01:40:00,0,0,0,0,0,3,6,9
2024-03-01 01:50:00,0,0,2,0,0,4,5,11
2024-03-01 02:00:00,0,0,0,0,0,2,1,3
2024-03-01 02:10:00,0,0,0,0,0,4,7,11
2024-03-01 02:20:00,0,0,0,0,0,1,3,4
2024-03-01 02:30:00,0,0,1,0,0,2,3,6
2024-03-01 02:40:00,0,0,0,0,0,1,1,2
2024-03-01 02:50:00,0,0,0,0,0,0,3,3
2024-03-01 03:00:00,0,0,1,0,0,2,4,7
2024-03-01 03:10:00,0,0,1,0,0,1,0,2
2024-03-01 03:20:00,0,0,1,0,0,1,0,2
2024-03-01 03:30:00,0,0,2,0,0,3,5,10
2024-03-01 03:40:00,0,0,1,0,0,1,2,4
2024-03-01 03:50:00,0,0,2,0,0,2,2,6
2024-03-01 04:00:00,0,0,0,0,0,4,6,10
2024-03-01 04:10:00,0,0,2,0,0,2,2,6
2024-03-01 04:20:00,0,0,0,0,0,3,4,7
2024-03-01 04:30:00,0,0,4,0,0,3,3,10
2024-03-01 04:40:00,0,0,2,0,0,7,7,16
2024-03-01 04:50:00,0,0,5,0,0,2,2,9
2024-03-01 05:00:00,0,0,1,0,0,8,7,16
2024-03-01 05:10:00,0,0,5,0,0,3,2,10
2024-03-01 05:20:00,0,0,8,0,0,11,8,27
2024-03-01 05:30:00,0,0,6,0,0,13,14,33
2024-03-01 05:40:00,0,0,5,0,0,20,16,41
2024-03-01 05:50:00,0,0,15,0,0,10,8,33
2024-03-01 06:00:00,0,0,14,0,0,22,14,50
2024-03-01 06:10:00,0,0,9,0,0,22,13,44
2024-03-01 06:20:00,0,0,12,0,0,27,19,58
2024-03-01 06:30:00,0,0,6,0,0,25,27,58
2024-03-01 06:40:00,0,0,8,0,0,34,16,58
2024-03-01 06:50:00,0,0,15,0,0,36,23,74
2024-03-01 07:00:00,0,0,17,0,0,43,33,93
2024-03-01 07:10:00,0,0,16,0,0,44,40,100
2024-03-01 07:20:00,0,0,14,0,0,42,49,105
2024-03-01 07:30:00,0,0,19,0,0,58,42,119
2024-03-01 07:40:00,0,0,18,0,0,58,61,137
2024-03-01 07:50:00,0,0,28,0,0,40,60,128
2024-03-01 08:00:00,0,0,15,0,0,54,50,119
2024-03-01 08:10:00,0,0,11,0,0,36,50,97
2024-03-01 08:20:00,0,0,14,0,0,52,54,120
2024-03-01 08:30:00,0,0,13,0,0,51,54,118
2024-03-01 08:40:00,0,0,17,0,0,65,54,136
2024-03-01 08:50:00,0,0,21,0,0,44,49,114
2024-03-01 09:00:00,0,0,11,0,0,45,44,100
2024-03-01 09:10:00,0,0,14,0,0,40,40,94
2024-03-01 09:20:00,0,0,12,0,0,52,42,106
2024-03-01 09:30:00,0,0,29,0,0,46,56,131
2024-03-01 09:40:00,0,0,22,0,0,41,46,109
2024-03-01 09:50:00,0,0,23,0,0,47,37,107
2024-03-01 10:00:00,0,0,16,0,0,47,44,107
2024-03-01 10:10:00,0,0,16,0,0,41,46,103
2024-03-01 10:20:00,0,0,31,0,0,39,42,112
2024-03-01 10:30:00,0,0,24,0,0,40,44,108
2024-03-01 10:40:00,0,0,26,0,0,52,60,138
2024-03-01 10:50:00,0,0,24,0,0,71,47,142
2024-03-01 11:00:00,0,0,18,0,0,41,58,117
2024-03-01 11:10:00,0,0,18,0,0,38,38,94
2024-03-01 11:20:00,0,0,26,0,0,42,43,111
2024-03-01 11:30:00,0,0,28,0,0,43,47,118
2024-03-01 11:40:00,0,0,23,0,0,41,52,116
2024-03-01 11:50:00,0,0,27,0,0,41,58,126
2024-03-01 12:00:00,0,0,17,0,0,49,36,102
2024-03-01 12:10:00,0,0,25,0,0,55,49,129
2024-03-01 12:20:00,0,0,29,0,0,47,57,133
2024-03-01 12:30:00,0,0,26,0,0,49,40,115
2024-03-01 12:40:00,0,0,33,0,0,55,64,152
2024-03-01 12:50:00,0,0,37,0,0,46,59,142
2024-03-01 13:00:00,0,0,24,0,0,49,62,135
2024-03-01 13:10:00,0,0,24,0,0,41,54,119
2024-03-01 13:20:00,0,0,29,0,0,51,54,134
2024-03-01 13:30:00,0,0,39,0,0,63,62,164
2024-03-01 13:40:00,0,0,29,0,0,46,51,126
2024-03-01 13:50:00,0,0,20,0,0,62,59,141
2024-03-01 14:00:00,0,0,30,0,0,39,54,123
2024-03-01 14:10:00,0,0,25,0,0,48,55,128
2024-03-01 14:20:00,0,0,25,0,0,48,60,133
2024-03-01 14:30:00,0,0,27,0,0,52,60,139
2024-03-01 14:40:00,0,0,13,0,0,54,72,139
2024-03-01 14:50:00,0,0,24,0,0,60,65,149
2024-03-01 15:00:00,0,0,17,0,0,41,58,116
2024-03-01 15:10:00,0,0,27,0,0,57,63,147
2024-03-01 15:20:00,0,0,29,0,0,60,65,154
2024-03-01 15:30:00,0,0,34,0,0,50,61,145
2024-03-01 15:40:00,0,0,23,0,0,59,56,138
2024-03-01 15:50:00,0,0,32,0,0,51,56,139
2024-03-01 16:00:00,0,0,24,0,0,55,64,143
2024-03-01 16:10:00,0,0,18,0,0,51,49,118
2024-03-01 16:20:00,0,0,23,0,0,67,66,156
2024-03-01 16:30:00,0,0,25,0,0,53,69,147
2024-03-01 16:40:00,0,0,21,0,0,59,52,132
2024-03-01 16:50:00,0,0,28,0,0,42,76,146
2024-03-01 17:00:00,0,0,22,0,0,47,65,134
2024-03-01 17:10:00,0,0,25,0,0,65,63,153
2024-03-01 17:20:00,0,0,12,0,0,59,64,135
2024-03-01 17:30:00,0,0,31,0,0,47,68,146
2024-03-01 17:40:00,0,0,12,0,0,55,50,117
2024-03-01 17:50:00,0,0,23,0,0,61,83,167
2024-03-01 18:00:00,0,0,16,0,0,39,45,100
2024-03-01 18:10:00,0,0,18,0,0,58,50,126
2024-03-01 18:20:00,0,0,20,0,0,55,72,147
2024-03-01 18:30:00,0,0,26,0,0,55,71,152
2024-03-01 18:40:00,0,0,14,0,0,63,61,138
2024-03-01 18:50:00,0,0,18,0,0,55,41,114
2024-03-01 19:00:00,0,0,15,0,0,51,62,128
2024-03-01 19:10:00,0,0,19,0,0,53,39,111
2024-03-01 19:20:00,0,0,13,0,0,42,60,115
2024-03-01 19:30:00,0,0,15,0,0,27,42,84
2024-03-01 19:40:00,0,0,10,0,0,48,54,112
2024-03-01 19:50:00,0,0,8,0,0,37,47,92
2024-03-01 20:00:00,0,0,6,0,0,40,46,92
2024-03-01 20:10:00,0,0,9,0,0,37,44,90
2024-03-01 20:20:00,0,0,12,0,0,37,54,103
2024-03-01 20:30:00,0,0,13,0,0,28,38,79
2024-03-01 20:40:00,0,0,8,0,0,21,34,63
2024-03-01 20:50:00,0,0,2,0,0,28,39,69
2024-03-01 21:00:00,0,0,3,0,0,22,27,52
2024-03-01 21:10:00,0,0,4,0,0,21,29,54
2024-03-01 21:20:00,0,0,8,0,0,14,23,45
2024-03-01 21:30:00,0,0,3,0,0,22,32,57
2024-03-01 21:40:00,0,0,12,0,0,22,16,50
2024-03-01 21:50:00,0,0,7,0,0,22,36,65
2024-03-01 22:00:00,0,0,10,0,0,20,23,53
2024-03-01 22:10:00,0,0,5,0,0,10,20,35
2024-03-01 22:20:00,0,0,5,0,0,20,21,46
2024-03-01 22:30:00,0,0,9,0,0,10,19,38
2024-03-01 22:40:00,0,0,4,0,0,14,18,36
2024-03-01 22:50:00,0,0,4,0,0,16,23,43
2024-03-01 23:00:00,0,0,6,0,0,23,21,50
2024-03-01 23:10:00,0,0,2,0,0,16,25,43
2024-03-01 23:20:00,0,0,3,0,0,8,20,31
2024-03-01 23:30:00,0,0,2,0,0,14,18,34
2024-03-01 23:40:00,0,0,5,0,0,6,10,21
2024-03-01 23:50:00,0,0,5,0,0,9,12,26
2024-03-02 00:00:00,0,0,6,0,0,9,14,29
2024-03-02 00:10:00,0,0,6,0,0,13,14,33
2024-03-02 00:20:00,0,0,2,0,0,11,14,27
2024-03-02 00:30:00,0,0,1,0,0,7,8,16
2024-03-02 00:40:00,0,0,1,0,0,5,7,13
2024-03-02 00:50:00,0,0,3,0,0,6,8,17
2024-03-02 01:00:00,0,0,0,0,0,5,7,12
2024-03-02 01:10:00,0,0,4,0,0,6,11,21
2024-03-02 01:20:00,0,0,0,0,0,7,3,10
2024-03-02 01:30:00,0,0,1,0,0,3,9,13
2024-03-02 01:40:00,0,0,3,0,0,8,4,15
2024-03-02 01:50:00,0,0,1,0,0,4,6,11
2024-03-02 02:00:00,0,0,0,0,0,8,12,20
2024-03-02 02:10:00,0,0,1,0,0,7,9,17
2024-03-02 02:20:00,0,0,2,0,0,7,9,18
2024-03-02 02:30:00,0,0,1,0,0,5,2,8
2024-03-02 02:40:00,0,0,0,0,0,4,3,7
2024-03-02 02:50:00,0,0,1,0,0,2,5,8
2024-03-02 03:00:00,0,0,1,0,0,0,6,7
2024-03-02 03:10:00,0,0,0,0,0,4,6,10
2024-03-02 03:20:00,0,0,3,0,0,4,2,9
2024-03-02 03:30:00,0,0,0,0,0,2,3,5
2024-03-02 03:40:00,0,0,0,0,0,1,10,11
2024-03-02 03:50:00,0,0,1,0,0,3,4,8
2024-03-02 04:00:00,0,0,7,0,0,2,5,14
2024-03-02 04:10:00,0,0,3,0,0,3,7,13
2024-03-02 04:20:00,0,0,0,0,0,4,1,5
2024-03-02 04:30:00,0,0,2,0,0,3,4,9
2024-03-02 04:40:00,0,0,3,0,0,4,3,10
2024-03-02 04:50:00,0,0,2,0,0,3,5,10
2024-03-02 05:00:00,0,0,0,0,0,4,5,9
2024-03-02 05:10:00,0,0,1,0,0,6,8,15
2024-03-02 05:20:00,0,0,2,0,0,6,6,14
2024-03-02 05:30:00,0,0,2,0,0,7,7,16
2024-03-02 05:40:00,0,0,6,0,0,17,11,34
2024-03-02 05:50:00,0,0,5,0,0,10,4,19
2024-03-02 06:00:00,0,0,3,0,0,4,2,9
2024-03-02 06:10:00,0,0,8,0,0,5,7,20
2024-03-02 06:20:00,0,0,4,0,0,11,7,22
2024-03-02 06:30:00,0,0,1,0,0,6,9,16
2024-03-02 06:40:00,0,0,3,0,0,13,7,23
2024-03-02 06:50:00,0,0,2,0,0,6,11,19
2024-03-02 07:00:00,0,0,5,0,0,5,11,21
2024-03-02 07:10:00,0,0,4,0,0,10,9,23
2024-03-02 07:20:00,0,0,5,0,0,5,9,19
2024-03-02 07:30:00,0,0,2,0,0,13,13,28
2024-03-02 07:40:00,0,0,7,0,0,16,12,35
2024-03-02 07:50:00,0,0,5,0,0,16,18,39
2024-03-02 08:00:00,0,0,9,0,0,12,15,36
2024-03-02 08:10:00,0,0,7,0,0,18,11,36
2024-03-02 08:20:00,0,0,6,0,0,18,15,39
2024-03-02 08:30:00,0,0,7,0,0,29,18,54
2024-03-02 08:40:00,0,0,9,0,0,15,22,46
2024-03-02 08:50:00,0,0,18,0,0,24,22,64
2024-03-02 09:00:00,0,0,16,0,0,28,29,73
2024-03-02 09:10:00,0,0,24,0,0,29,20,73
2024-03-02 09:20:00,0,0,18,0,0,33,33,84
2024-03-02 09:30:00,0,0,24,0,0,44,25,93
2024-03-02 09:40:00,0,0,17,0,0,37,29,83
2024-03-02 09:50:00,0,0,28,0,0,38,36,102
2024-03-02 10:00:00,0,0,33,0,0,36,17,86
2024-03-02 10:10:00,0,0,33,0,0,48,35,116
2024-03-02 10:20:00,0,0,30,0,0,43,34,107
2024-03-02 10:30:00,0,0,22,0,0,53,41,116
2024-03-02 10:40:00,0,0,21,0,0,50,45,116
2024-03-02 10:50:00,0,0,23,0,0,71,47,141
2024-03-02 11:00:00,0,0,25,0,0,62,63,150
2024-03-02 11:10:00,0,0,33,0,0,50,41,124
2024-03-02 11:20:00,0,0,30,0,0,55,56,141
2024-03-02 11:30:00,0,0,33,0,0,58,53,144
2024-03-02 11:40:00,0,0,29,0,0,60,59,148
2024-03-02 11:50:00,0,0,22,0,0,46,48,116
2024-03-02 12:00:00,0,0,33,0,0,54,46,133
2024-03-02 12:10:00,0,0,35,0,0,63,60,158
2024-03-02 12:20:00,0,0,26,0,0,56,49,131
2024-03-02 12:30:00,0,0,21,0,0,53,64,138
2024-03-02 12:40:00,0,0,19,0,0,60,59,138
2024-03-02 12:50:00,0,0,16,0,0,61,64,141
2024-03-02 13:00:00,0,0,25,0,0,60,45,130
2024-03-02 13:10:00,0,0,31,0,0,69,61,161
2024-03-02 13:20:00,0,0,24,0,0,64,61,149
2024-03-02 13:30:00,0,0,24,0,0,66,91,181
2024-03-02 13:40:00,0,0,18,0,0,79,71,168
2024-03-02 13:50:00,0,0,16,0,0,69,67,152
2024-03-02 14:00:00,0,0,25,0,0,71,76,172
2024-03-02 14:10:00,0,0,25,0,0,59,51,135
2024-03-02 14:20:00,0,0,17,0,0,73,81,171
2024-03-02 14:30:00,0,0,18,0,0,54,67,139
2024-03-02 14:40:00,0,0,25,0,0,53,72,150
2024-03-02 14:50:00,0,0,18,0,0,78,61,157
2024-03-02 15:00:00,0,0,24,0,0,63,49,136
2024-03-02 15:10:00,0,0,14,0,0,64,53,131
2024-03-02 15:20:00,0,0,25,0,0,66,64,155
2024-03-02 15:30:00,0,0,18,0,0,57,62,137
2024-03-02 15:40:00,0,0,19,0,0,68,74,161
2024-03-02 15:50:00,0,0,11,0,0,66,57,134
2024-03-02 16:00:00,0,0,15,0,0,64,55,134
2024-03-02 16:10:00,0,0,16,0,0,68,59,143
2024-03-02 16:20:00,0,0,12,0,0,53,67,132
2024-03-02 16:30:00,0,0,17,0,0,69,58,144
2024-03-02 16:40:00,0,0,15,0,0,55,38,108
2024-03-02 16:50:00,0,0,16,0,0,69,58,143
2024-03-02 17:00:00,0,0,22,0,0,51,46,119
2024-03-02 17:10:00,0,0,19,0,0,63,64,146
2024-03-02 17:20:00,0,0,23,0,0,55,55,133
2024-03-02 17:30:00,0,0,17,0,0,69,52,138
2024-03-02 17:40:00,0,0,17,0,0,62,56,135
2024-03-02 17:50:00,0,0,20,0,0,45,51,116
2024-03-02 18:00:00,0,0,15,0,0,54,64,133
2024-03-02 18:10:00,0,0,11,0,0,56,67,134
2024-03-02 18:20:00,0,0,29,0,0,56,53,138
2024-03-02 18:30:00,0,0,12,0,0,63,53,128
2024-03-02 18:40:00,0,0,15,0,0,59,50,124
2024-03-02 18:50:00,0,0,7,0,0,66,55,128
2024-03-02 19:00:00,0,0,13,0,0,60,50,123
2024-03-02 19:10:00,0,0,5,0,0,64,52,121
2024-03-02 19:20:00,0,0,14,0,0,44,48,106
2024-03-02 19:30:00,0,0,12,0,0,49,37,98
2024-03-02 19:40:00,0,0,25,0,0,37,46,108
2024-03-02 19:50:00,0,0,4,0,0,46,42,92
2024-03-02 20:00:00,0,0,11,0,0,42,43,96
2024-03-02 20:10:00,0,0,8,0,0,47,53,108
2024-03-02 20:20:00,0,0,9,0,0,22,48,79
2024-03-02 20:30:00,0,0,13,0,0,31,27,71
2024-03-02 20:40:00,0,0,8,0,0,25,27,60
2024-03-02 20:50:00,0,0,7,0,0,21,28,56
2024-03-02 21:00:00,0,0,4,0,0,19,24,47
2024-03-02 21:10:00,0,0,10,0,0,17,28,55
2024-03-02 21:20:00,0,0,4,0,0,20,27,51
2024-03-02 21:30:00,0,0,5,0,0,28,33,66
2024-03-02 21:40:00,0,0,6,0,0,21,23,50
2024-03-02 21:50:00,0,0,7,0,0,18,20,45
2024-03-02 22:00:00,0,0,4,0,0,16,23,43
2024-03-02 22:10:00,0,0,4,0,0,19,23,46
2024-03-02 22:20:00,0,0,4,0,0,26,28,58
2024-03-02 22:30:00,0,0,4,0,0,16,27,47
2024-03-02 22:40:00,0,0,4,0,0,17,22,43
2024-03-02 22:50:00,0,0,3,0,0,16,19,38
2024-03-02 23:00:00,0,0,4,0,0,17,23,44
2024-03-02 23:10:00,0,0,6,0,0,15,23,44
2024-03-02 23:20:00,0,0,6,0,0,13,11,30
2024-03-02 23:30:00,0,0,3,0,0,14,17,34
2024-03-02 23:40:00,0,0,4,0,0,11,21,36
2024-03-02 23:50:00,0,0,3,0,0,12,18,33
2024-03-03 00:00:00,0,0,3,0,0,14,15,32
2024-03-03 00:10:00,0,0,1,0,0,10,12,23
2024-03-03 00:20:00,0,0,3,0,0,7,11,21
2024-03-03 00:30:00,0,0,4,0,0,7,12,23
2024-03-03 00:40:00,0,0,1,0,0,15,15,31
2024-03-03 00:50:00,0,0,3,0,0,6,12,21
2024-03-03 01:00:00,0,0,3,0,0,5,15,23
2024-03-03 01:10:00,0,0,4,0,0,8,14,26
2024-03-03 01:20:00,0,0,1,0,0,7,9,17
2024-03-03 01:30:00,0,0,6,0,0,2,6,14
2024-03-03 01:40:00,0,0,3,0,0,7,10,20
2024-03-03 01:50:00,0,0,2,0,0,6,6,14
2024-03-03 02:00:00,0,0,4,0,0,8,8,20
2024-03-03 02:10:00,0,0,1,0,0,11,7,19
2024-03-03 02:20:00,0,0,0,0,0,7,11,18
2024-03-03 02:30:00,0,0,1,0,0,8,5,14
2024-03-03 02:40:00,0,0,2,0,0,3,6,11
2024-03-03 02:50:00,0,0,1,0,0,5,4,10
2024-03-03 03:00:00,0,0,1,0,0,0,6,7
2024-03-03 03:10:00,0,0,1,0,0,1,7,9
2024-03-03 03:20:00,0,0,1,0,0,3,4,8
2024-03-03 03:30:00,0,0,1,0,0,4,9,14
2024-03-03 03:40:00,0,0,1,0,0,4,5,10
2024-03-03 03:50:00,0,0,0,0,0,5,2,7
2024-03-03 04:00:00,0,0,1,0,0,2,6,9
2024-03-03 04:10:00,0,0,3,0,0,4,4,11
2024-03-03 04:20:00,0,0,1,0,0,3,3,7
2024-03-03 04:30:00,0,0,4,0,0,1,5,10
2024-03-03 04:40:00,0,0,0,0,0,2,9,11
2024-03-03 04:50:00,0,0,1,0,0,3,9,13
2024-03-03 05:00:00,0,0,1,0,0,3,4,8
2024-03-03 05:10:00,0,0,1,0,0,6,6,13
2024-03-03 05:20:00,0,0,1,0,0,7,5,13
2024-03-03 05:30:00,0,0,2,0,0,8,6,16
2024-03-03 05:40:00,0,0,1,0,0,10,8,19
2024-03-03 05:50:00,0,0,1,0,0,5,2,8
2024-03-03 06:00:00,0,0,1,0,0,3,1,5
2024-03-03 06:10:00,0,0,3,0,0,6,7,16
2024-03-03 06:20:00,0,0,5,0,0,4,4,13
2024-03-03 06:30:00,0,0,0,0,0,2,2,4
2024-03-03 06:40:00,0,0,2,0,0,0,2,4
2024-03-03 06:50:00,0,0,1,0,0,2,2,5
2024-03-03 07:00:00,0,0,2,0,0,2,4,8
2024-03-03 07:10:00,0,0,0,0,0,5,4,9
2024-03-03 07:20:00,0,0,2,0,0,3,2,7
2024-03-03 07:30:00,0,0,1,0,0,4,5,10
2024-03-03 07:40:00,0,0,0,0,0,6,7,13
2024-03-03 07:50:00,0,0,3,0,0,5,3,11
2024-03-03 08:00:00,0,0,4,0,0,5,4,13
2024-03-03 08:10:00,0,0,1,0,0,6,10,17
2024-03-03 08:20:00,0,0,4,0,0,7,10,21
2024-03-03 08:30:00,0,0,3,0,0,9,14,26
2024-03-03 08:40:00,0,0,5,0,0,10,6,21
2024-03-03 08:50:00,0,0,4,0,0,8,8,20
2024-03-03 09:00:00,0,0,2,0,0,10,15,27
2024-03-03 09:10:00,0,0,5,0,0,12,8,25
2024-03-03 09:20:00,0,0,8,0,0,15,23,46
2024-03-03 09:30:00,0,0,10,0,0,11,16,37
2024-03-03 09:40:00,0,0,5,0,0,21,13,39
2024-03-03 09:50:00,0,0,6,0,0,14,20,40
2024-03-03 10:00:00,0,0,6,0,0,18,22,46
2024-03-03 10:10:00,0,0,7,0,0,14,18,39
2024-03-03 10:20:00,0,0,9,0,0,23,17,49
2024-03-03 10:30:00,0,0,8,0,0,12,18,38
2024-03-03 10:40:00,0,0,7,0,0,25,31,63
2024-03-03 10:50:00,0,0,1,0,0,30,24,55
2024-03-03 11:00:00,0,0,7,0,0,16,28,51
2024-03-03 11:10:00,0,0,3,0,0,25,25,53
2024-03-03 11:20:00,0,0,9,0,0,15,19,43
2024-03-03 11:30:00,0,0,9,0,0,29,27,65
2024-03-03 11:40:00,0,0,15,0,0,18,36,69
2024-03-03 11:50:00,0,0,10,0,0,23,22,55
2024-03-03 12:00:00,0,0,8,0,0,29,39,76
2024-03-03 12:10:00,0,0,7,0,0,32,20,59
2024-03-03 12:20:00,0,0,12,0,0,34,37,83
2024-03-03 12:30:00,0,0,11,0,0,25,43,79
2024-03-03 12:40:00,0,0,12,0,0,31,36,79
2024-03-03 12:50:00,0,0,13,0,0,26,26,65
2024-03-03 13:00:00,0,0,8,0,0,26,34,68
2024-03-03 13:10:00,0,0,12,0,0,29,28,69
2024-03-03 13:20:00,0,0,8,0,0,31,29,68
2024-03-03 13:30:00,0,0,14,0,0,31,33,78
2024-03-03 13:40:00,0,0,11,0,0,25,29,65
2024-03-03 13:50:00,0,0,7,0,0,23,26,56
2024-03-03 14:00:00,0,0,8,0,0,35,22,65
2024-03-03 14:10:00,0,0,8,0,0,26,46,80
2024-03-03 14:20:00,0,0,12,0,0,37,48,97
2024-03-03 14:30:00,0,0,10,0,0,36,30,76
2024-03-03 14:40:00,0,0,13,0,0,28,40,81
2024-03-03 14:50:00,0,0,5,0,0,35,49,89
2024-03-03 15:00:00,0,0,9,0,0,36,40,85
2024-03-03 15:10:00,0,0,8,0,0,33,42,83
2024-03-03 15:20:00,0,0,11,0,0,20,35,66
2024-03-03 15:30:00,0,0,15,0,0,40,31,86
2024-03-03 15:40:00,0,0,10,0,0,25,39,74
2024-03-03 15:50:00,0,0,14,0,0,27,30,71
2024-03-03 16:00:00,0,0,8,0,0,31,32,71
2024-03-03 16:10:00,0,0,12,0,0,26,42,80
2024-03-03 16:20:00,0,0,16,0,0,24,51,91
2024-03-03 16:30:00,0,0,14,0,0,27,37,78
2024-03-03 16:40:00,0,0,8,0,0,28,27,63
2024-03-03 16:50:00,0,0,12,0,0,23,37,72
2024-03-03 17:00:00,0,0,9,0,0,29,38,76
2024-03-03 17:10:00,0,0,5,0,0,26,48,79
2024-03-03 17:20:00,0,0,10,0,0,28,31,69
2024-03-03 17:30:00,0,0,12,0,0,27,46,85
2024-03-03 17:40:00,0,0,10,0,0,36,30,76
2024-03-03 17:50:00,0,0,13,0,0,26,34,73
2024-03-03 18:00:00,0,0,14,0,0,28,37,79
2024-03-03 18:10:00,0,0,6,0,0,30,35,71
2024-03-03 18:20:00,0,0,10,0,0,31,32,73
2024-03-03 18:30:00,0,0,7,0,0,23,50,80
2024-03-03 18:40:00,0,0,5,0,0,28,39,72
2024-03-03 18:50:00,0,0,4,0,0,32,33,69
2024-03-03 19:00:00,0,0,8,0,0,20,25,53
2024-03-03 19:10:00,0,0,4,0,0,20,31,55
2024-03-03 19:20:00,0,0,7,0,0,16,28,51
2024-03-03 19:30:00,0,0,9,0,0,29,30,68
2024-03-03 19:40:00,0,0,5,0,0,17,31,53
2024-03-03 19:50:00,0,0,8,0,0,19,21,48
2024-03-03 20:00:00,0,0,6,0,0,17,25,48
2024-03-03 20:10:00,0,0,10,0,0,21,23,54
2024-03-03 20:20:00,0,0,5,0,0,12,22,39
2024-03-03 20:30:00,0,0,8,0,0,13,25,46
2024-03-03 20:40:00,0,0,10,0,0,17,19,46
2024-03-03 20:50:00,0,0,7,0,0,16,19,42
2024-03-03 21:00:00,0,0,6,0,0,18,22,46
2024-03-03 21:10:00,0,0,6,0,0,14,12,32
2024-03-03 21:20:00,0,0,4,0,0,15,18,37
2024-03-03 21:30:00,0,0,2,0,0,15,16,33
2024-03-03 21:40:00,0,0,2,0,0,11,15,28
2024-03-03 21:50:00,0,0,4,0,0,14,17,35
2024-03-03 22:00:00,0,0,3,0,0,9,10,22
2024-03-03 22:10:00,0,0,4,0,0,10,13,27
2024-03-03 22:20:00,0,0,6,0,0,16,17,39
2024-03-03 22:30:00,0,0,6,0,0,7,17,30
2024-03-03 22:40:00,0,0,4,0,0,9,3,16
2024-03-03 22:50:00,0,0,2,0,0,9,8,19
2024-03-03 23:00:00,0,0,1,0,0,8,11,20
2024-03-03 23:10:00,0,0,1,0,0,4,19,24
2024-03-03 23:20:00,0,0,5,0,0,7,10,22
2024-03-03 23:30:00,0,0,0,0,0,4,8,12
2024-03-03 23:40:00,0,0,4,0,0,4,6,14
2024-03-03 23:50:00,0,0,4,0,0,10,5,19
2024-03-04 00:00:00,0,0,4,0,0,5,5,14
2024-03-04 00:10:00,0,0,0,0,0,3,5,8
2024-03-04 00:20:00,0,0,2,0,0,5,4,11
2024-03-04 00:30:00,0,0,2,0,0,4,7,13
2024-03-04 00:40:00,0,0,0,0,0,3,1,4
2024-03-04 00:50:00,0,0,1,0,0,6,1,8
2024-03-04 01:00:00,0,0,2,0,0,2,7,11
2024-03-04 01:10:00,0,0,1,0,0,3,7,11
2024-03-04 01:20:00,0,0,1,0,0,1,0,2
2024-03-04 01:30:00,0,0,1,0,0,2,3,6
2024-03-04 01:40:00,0,0,0,0,0,2,1,3
2024-03-04 01:50:00,0,0,1,0,0,1,3,5
2024-03-04 02:00:00,0,0,1,0,0,2,5,8
2024-03-04 02:10:00,0,0,0,0,0,1,1,2
2024-03-04 02:20:00,0,0,0,0,0,4,2,6
2024-03-04 02:30:00,0,0,0,0,0,2,4,6
2024-03-04 02:40:00,0,0,0,0,0,2,0,2
2024-03-04 02:50:00,0,0,0,0,0,0,1,1
2024-03-04 03:00:00,0,0,0,0,0,3,1,4
2024-03-04 03:10:00,0,0,0,0,0,1,2,3
2024-03-04 03:20:00,0,0,1,0,0,5,2,8
2024-03-04 03:30:00,0,0,1,0,0,1,2,4
2024-03-04 03:40:00,0,0,0,0,0,1,3,4
2024-03-04 03:50:00,0,0,2,0,0,4,4,10
2024-03-04 04:00:00,0,0,1,0,0,4,4,9
2024-03-04 04:10:00,0,0,1,0,0,2,5,8
2024-03-04 04:20:00,0,0,0,0,0,4,8,12
2024-03-04 04:30:00,0,0,4,0,0,0,2,6
2024-03-04 04:40:00,0,0,1,0,0,4,3,8
2024-03-04 04:50:00,0,0,3,0,0,7,2,12
2024-03-04 05:00:00,0,0,3,0,0,5,2,10
2024-03-04 05:10:00,0,0,5,0,0,8,8,21
2024-03-04 05:20:00,0,0,7,0,0,5,9,21
2024-03-04 05:30:00,0,0,7,0,0,14,14,35
2024-03-04 05:40:00,0,0,8,0,0,24,11,43
2024-03-04 05:50:00,0,0,13,0,0,16,10,39
2024-03-04 06:00:00,0,0,10,0,0,18,12,40
2024-03-04 06:10:00,0,0,9,0,0,22,12,43
2024-03-04 06:20:00,0,0,11,0,0,27,16,54
2024-03-04 06:30:00,0,0,10,0,0,35,25,70
2024-03-04 06:40:00,0,0,12,0,0,34,33,79
2024-03-04 06:50:00,0,0,10,0,0,23,31,64
2024-03-04 07:00:00,0,0,12,0,0,44,40,96
2024-03-04 07:10:00,0,0,21,0,0,42,31,94
2024-03-04 07:20:00,0,0,7,0,0,62,62,131
2024-03-04 07:30:00,0,0,22,0,0,57,49,128
2024-03-04 07:40:00,0,0,9,0,0,67,64,140
2024-03-04 07:50:00,0,0,17,0,0,53,59,129
2024-03-04 08:00:00,0,0,21,0,0,58,66,145
2024-03-04 08:10:00,0,0,18,0,0,53,61,132
2024-03-04 08:20:00,0,0,17,0,0,45,56,118
2024-03-04 08:30:00,0,0,18,0,0,49,63,130
2024-03-04 08:40:00,0,0,13,0,0,49,60,122
2024-03-04 08:50:00,0,0,13,0,0,49,48,110
2024-03-04 09:00:00,0,0,16,0,0,48,30,94
2024-03-04 09:10:00,0,0,18,0,0,50,34,102
2024-03-04 09:20:00,0,0,19,0,0,44,47,110
2024-03-04 09:30:00,0,0,25,0,0,46,50,121
2024-03-04 09:40:00,0,0,19,0,0,53,47,119
2024-03-04 09:50:00,0,0,22,0,0,30,43,95
2024-03-04 10:00:00,0,0,19,0,0,40,48,107
2024-03-04 10:10:00,0,0,12,0,0,46,36,94
2024-03-04 10:20:00,0,0,15,0,0,46,41,102
2024-03-04 10:30:00,0,0,13,0,0,46,39,98
2024-03-04 10:40:00,0,0,16,0,0,49,40,105
2024-03-04 10:50:00,0,0,21,0,0,34,29,84
2024-03-04 11:00:00,0,0,22,0,0,38,40,100
2024-03-04 11:10:00,0,0,17,0,0,50,40,107
2024-03-04 11:20:00,0,0,21,0,0,38,38,97
2024-03-04 11:30:00,0,0,15,0,0,47,40,102
2024-03-04 11:40:00,0,0,22,0,0,46,36,104
2024-03-04 11:50:00,0,0,26,0,0,44,44,114
2024-03-04 12:00:00,0,0,30,0,0,51,50,131
2024-03-04 12:10:00,0,0,35,0,0,41,54,130
2024-03-04 12:20:00,0,0,15,0,0,60,50,125
2024-03-04 12:30:00,0,0,22,0,0,59,39,120
2024-03-04 12:40:00,0,0,23,0,0,48,30,101
2024-03-04 12:50:00,0,0,19,0,0,52,59,130
2024-03-04 13:00:00,0,0,26,0,0,37,38,101
2024-03-04 13:10:00,0,0,21,0,0,54,61,136
2024-03-04 13:20:00,0,0,21,0,0,35,39,95
2024-03-04 13:30:00,0,0,21,0,0,59,61,141
2024-03-04 13:40:00,0,0,16,0,0,58,60,134
2024-03-04 13:50:00,0,0,17,0,0,56,52,125
2024-03-04 14:00:00,0,0,19,0,0,36,49,104
2024-03-04 14:10:00,0,0,30,0,0,46,35,111
2024-03-04 14:20:00,0,0,28,0,0,59,58,145
2024-03-04 14:30:00,0,0,23,0,0,47,43,113
2024-03-04 14:40:00,0,0,24,0,0,52,52,128
2024-03-04 14:50:00,0,0,26,0,0,58,61,145
2024-03-04 15:00:00,0,0,28,0,0,46,75,149
2024-03-04 15:10:00,0,0,27,0,0,52,60,139
2024-03-04 15:20:00,0,0,27,0,0,46,71,144
2024-03-04 15:30:00,0,0,19,0,0,50,57,126
2024-03-04 15:40:00,0,0,30,0,0,42,78,150
2024-03-04 15:50:00,0,0,24,0,0,48,67,139
2024-03-04 16:00:00,0,0,25,0,0,54,51,130
2024-03-04 16:10:00,0,0,25,0,0,59,50,134
2024-03-04 16:20:00,0,0,26,0,0,60,77,163
2024-03-04 16:30:00,0,0,26,0,0,45,64,135
2024-03-04 16:40:00,0,0,19,0,0,61,79,159
2024-03-04 16:50:00,0,0,33,0,0,52,68,153
2024-03-04 17:00:00,0,0,23,0,0,54,62,139
2024-03-04 17:10:00,0,0,28,0,0,56,80,164
2024-03-04 17:20:00,0,0,27,0,0,69,74,170
2024-03-04 17:30:00,0,0,26,0,0,59,89,174
2024-03-04 17:40:00,0,0,24,0,0,68,77,169
2024-03-04 17:50:00,0,0,17,0,0,48,71,136
2024-03-04 18:00:00,0,0,20,0,0,39,62,121
2024-03-04 18:10:00,0,0,17,0,0,49,57,123
2024-03-04 18:20:00,0,0,23,0,0,47,56,126
2024-03-04 18:30:00,0,0,18,0,0,50,60,128
2024-03-04 18:40:00,0,0,13,0,0,41,53,107
2024-03-04 18:50:00,0,0,16,0,0,44,58,118
2024-03-04 19:00:00,0,0,16,0,0,38,34,88
2024-03-04 19:10:00,0,0,9,0,0,45,47,101
2024-03-04 19:20:00,0,0,10,0,0,40,39,89
2024-03-04 19:30:00,0,0,7,0,0,40,27,74
2024-03-04 19:40:00,0,0,7,0,0,29,23,59
2024-03-04 19:50:00,0,0,11,0,0,23,45,79
2024-03-04 20:00:00,0,0,10,0,0,21,33,64
2024-03-04 20:10:00,0,0,7,0,0,32,28,67
2024-03-04 20:20:00,0,0,3,0,0,28,30,61
2024-03-04 20:30:00,0,0,8,0,0,24,33,65
2024-03-04 20:40:00,0,0,11,0,0,20,20,51
2024-03-04 20:50:00,0,0,14,0,0,13,21,48
2024-03-04 21:00:00,0,0,2,0,0,9,25,36
2024-03-04 21:10:00,0,0,3,0,0,20,27,50
2024-03-04 21:20:00,0,0,3,0,0,12,16,31
2024-03-04 21:30:00,0,0,10,0,0,18,29,57
2024-03-04 21:40:00,0,0,7,0,0,19,13,39
2024-03-04 21:50:00,0,0,5,0,0,17,14,36
2024-03-04 22:00:00,0,0,6,0,0,12,15,33
2024-03-04 22:10:00,0,0,3,0,0,9,15,27
2024-03-04 22:20:00,0,0,9,0,0,12,17,38
2024-03-04 22:30:00,0,0,3,0,0,18,17,38
2024-03-04 22:40:00,0,0,5,0,0,8,8,21
2024-03-04 22:50:00,0,0,2,0,0,9,10,21
2024-03-04 23:00:00,0,0,2,0,0,8,11,21
2024-03-04 23:10:00,0,0,3,0,0,11,11,25
2024-03-04 23:20:00,0,0,4,0,0,6,8,18
2024-03-04 23:30:00,0,0,0,0,0,7,11,18
2024-03-04 23:40:00,0,0,2,0,0,3,11,16
2024-03-04 23:50:00,0,0,1,0,0,3,10,14
2024-03-05 00:00:00,0,0,3,0,0,11,9,23
2024-03-05 00:10:00,0,0,1,0,0,4,3,8
2024-03-05 00:20:00,0,0,0,0,0,1,4,5
2024-03-05 00:30:00,0,0,0,0,0,5,10,15
2024-03-05 00:40:00,0,0,0,0,0,3,3,6
2024-03-05 00:50:00,0,0,2,0,0,2,2,6
2024-03-05 01:00:00,0,0,3,0,0,2,1,6
2024-03-05 01:10:00,0,0,1,0,0,1,0,2
2024-03-05 01:20:00,0,0,0,0,0,3,3,6
2024-03-05 01:30:00,0,0,3,0,0,1,1,5
2024-03-05 01:40:00,0,0,1,0,0,2,1,4
2024-03-05 01:50:00,0,0,0,0,0,2,4,6
2024-03-05 02:00:00,0,0,2,0,0,2,1,5
2024-03-05 02:10:00,0,0,1,0,0,0,1,2
2024-03-05 02:20:00,0,0,0,0,0,3,1,4
2024-03-05 02:30:00,0,0,0,0,0,1,1,2
2024-03-05 02:40:00,0,0,1,0,0,1,2,4
2024-03-05 02:50:00,0,0,0,0,0,1,2,3
2024-03-05 03:00:00,0,0,0,0,0,2,0,2
2024-03-05 03:10:00,0,0,1,0,0,1,4,6
2024-03-05 03:20:00,0,0,1,0,0,1,1,3
2024-03-05 03:30:00,0,0,0,0,0,3,5,8
2024-03-05 03:40:00,0,0,0,0,0,1,1,2
2024-03-05 03:50:00,0,0,0,0,0,2,1,3
2024-03-05 04:00:00,0,0,1,0,0,5,6,12
2024-03-05 04:10:00,0,0,1,0,0,2,4,7
2024-03-05 04:20:00,0,0,0,0,0,5,7,12
2024-03-05 04:30:00,0,0,4,0,0,4,6,14
2024-03-05 04:40:00,0,0,3,0,0,2,4,9
2024-03-05 04:50:00,0,0,2,0,0,6,4,12
2024-03-05 05:00:00,0,0,2,0,0,6,4,12
2024-03-05 05:10:00,0,0,8,0,0,7,5,20
2024-03-05 05:20:00,0,0,7,0,0,16,7,30
2024-03-05 05:30:00,0,0,5,0,0,18,12,35
2024-03-05 05:40:00,0,0,7,0,0,12,8,27
2024-03-05 05:50:00,0,0,19,0,0,13,10,42
2024-03-05 06:00:00,0,0,14,0,0,19,12,45
2024-03-05 06:10:00,0,0,15,0,0,24,18,57
2024-03-05 06:20:00,0,0,9,0,0,28,24,61
2024-03-05 06:30:00,0,0,13,0,0,33,21,67
2024-03-05 06:40:00,0,0,10,0,0,32,22,64
2024-03-05 06:50:00,0,0,13,0,0,37,41,91
2024-03-05 07:00:00,0,0,10,0,0,42,41,93
2024-03-05 07:10:00,0,0,12,0,0,47,36,95
2024-03-05 07:20:00,0,0,13,0,0,50,50,113
2024-03-05 07:30:00,0,0,22,0,0,53,63,138
2024-03-05 07:40:00,0,0,15,0,0,60,74,149
2024-03-05 07:50:00,0,0,22,0,0,42,61,125
2024-03-05 08:00:00,0,0,21,0,0,66,67,154
2024-03-05 08:10:00,0,0,17,0,0,51,61,129
2024-03-05 08:20:00,0,0,11,0,0,52,47,110
2024-03-05 08:30:00,0,0,15,0,0,57,60,132
2024-03-05 08:40:00,0,0,22,0,0,49,64,135
2024-03-05 08:50:00,0,0,14,0,0,19,80,113
2024-03-05 09:00:00,0,0,16,0,0,56,49,121
2024-03-05 09:10:00,0,0,20,0,0,55,48,123
2024-03-05 09:20:00,0,0,21,0,0,44,56,121
2024-03-05 09:30:00,0,0,22,0,0,53,39,114
2024-03-05 09:40:00,0,0,16,0,0,41,47,104
2024-03-05 09:50:00,0,0,13,0,0,45,47,105
2024-03-05 10:00:00,0,0,27,0,0,33,42,102
2024-03-05 10:10:00,0,0,14,0,0,52,33,99
2024-03-05 10:20:00,0,0,22,0,0,47,46,115
2024-03-05 10:30:00,0,0,19,0,0,51,37,107
2024-03-05 10:40:00,0,0,23,0,0,48,50,121
2024-03-05 10:50:00,0,0,22,0,0,48,41,111
2024-03-05 11:00:00,0,0,27,0,0,40,39,106
2024-03-05 11:10:00,0,0,25,0,0,39,42,106
2024-03-05 11:20:00,0,0,14,0,0,50,39,103
2024-03-05 11:30:00,0,0,22,0,0,42,27,91
2024-03-05 11:40:00,0,0,17,0,0,34,47,98
2024-03-05 11:50:00,0,0,33,0,0,53,58,144
2024-03-05 12:00:00,0,0,24,0,0,42,41,107
2024-03-05 12:10:00,0,0,30,0,0,61,49,140
2024-03-05 12:20:00,0,0,23,0,0,48,59,130
2024-03-05 12:30:00,0,0,13,0,0,47,39,99
2024-03-05 12:40:00,0,0,26,0,0,53,38,117
2024-03-05 12:50:00,0,0,17,0,0,49,43,109
2024-03-05 13:00:00,0,0,21,0,0,57,47,125
2024-03-05 13:10:00,0,0,17,0,0,44,36,97
2024-03-05 13:20:00,0,0,26,0,0,45,41,112
2024-03-05 13:30:00,0,0,18,0,0,53,45,116
2024-03-05 13:40:00,0,0,19,0,0,47,51,117
2024-03-05 13:50:00,0,0,21,0,0,41,53,115
2024-03-05 14:00:00,0,0,22,0,0,54,48,124
2024-03-05 14:10:00,0,0,25,0,0,41,62,128
2024-03-05 14:20:00,0,0,12,0,0,56,51,119
2024-03-05 14:30:00,0,0,23,0,0,51,45,119
2024-03-05 14:40:00,0,0,17,0,0,61,59,137
2024-03-05 14:50:00,0,0,20,0,0,51,55,126
2024-03-05 15:00:00,0,0,24,0,0,55,50,129
2024-03-05 15:10:00,0,0,29,0,0,50,54,133
2024-03-05 15:20:00,0,0,34,0,0,44,63,141
2024-03-05 15:30:00,0,0,23,0,0,49,60,132
2024-03-05 15:40:00,0,0,29,0,0,68,69,166
2024-03-05 15:50:00,0,0,29,0,0,52,60,141
2024-03-05 16:00:00,0,0,26,0,0,49,54,129
2024-03-05 16:10:00,0,0,20,0,0,63,82,165
2024-03-05 16:20:00,0,0,26,0,0,60,66,152
2024-03-05 16:30:00,0,0,30,0,0,46,72,148
2024-03-05 16:40:00,0,0,25,0,0,65,69,159
2024-03-05 16:50:00,0,0,26,0,0,42,57,125
2024-03-05 17:00:00,0,0,27,0,0,55,64,146
2024-03-05 17:10:00,0,0,15,0,0,48,75,138
2024-03-05 17:20:00,0,0,22,0,0,74,80,176
2024-03-05 17:30:00,0,0,25,0,0,44,80,149
2024-03-05 17:40:00,0,0,23,0,0,43,79,145
2024-03-05 17:50:00,0,0,25,0,0,44,63,132
2024-03-05 18:00:00,0,0,30,0,0,56,76,162
2024-03-05 18:10:00,0,0,16,0,0,47,75,138
2024-03-05 18:20:00,0,0,23,0,0,50,78,151
2024-03-05 18:30:00,0,0,19,0,0,41,60,120
2024-03-05 18:40:00,0,0,17,0,0,46,58,121
2024-03-05 18:50:00,0,0,18,0,0,37,54,109
2024-03-05 19:00:00,0,0,18,0,0,42,55,115
2024-03-05 19:10:00,0,0,11,0,0,45,51,107
2024-03-05 19:20:00,0,0,13,0,0,38,38,89
2024-03-05 19:30:00,0,0,13,0,0,28,46,87
2024-03-05 19:40:00,0,0,11,0,0,33,42,86
2024-03-05 19:50:00,0,0,10,0,0,23,34,67
2024-03-05 20:00:00,0,0,14,0,0,27,37,78
2024-03-05 20:10:00,0,0,11,0,0,30,27,68
2024-03-05 20:20:00,0,0,12,0,0,20,28,60
2024-03-05 20:30:00,0,0,17,0,0,23,23,63
2024-03-05 20:40:00,0,0,7,0,0,23,24,54
2024-03-05 20:50:00,0,0,8,0,0,19,20,47
2024-03-05 21:00:00,0,0,7,0,0,17,24,48
2024-03-05 21:10:00,0,0,4,0,0,15,18,37
2024-03-05 21:20:00,0,0,6,0,0,12,28,46
2024-03-05 21:30:00,0,0,5,0,0,21,26,52
2024-03-05 21:40:00,0,0,3,0,0,15,21,39
2024-03-05 21:50:00,0,0,9,0,0,13,21,43
2024-03-05 22:00:00,0,0,8,0,0,11,17,36
2024-03-05 22:10:00,0,0,5,0,0,7,14,26
2024-03-05 22:20:00,0,0,7,0,0,8,17,32
2024-03-05 22:30:00,0,0,4,0,0,8,13,25
2024-03-05 22:40:00,0,0,4,0,0,9,21,34
2024-03-05 22:50:00,0,0,4,0,0,14,7,25
2024-03-05 23:00:00,0,0,3,0,0,7,18,28
2024-03-05 23:10:00,0,0,3,0,0,6,6,15
2024-03-05 23:20:00,0,0,4,0,0,6,9,19
2024-03-05 23:30:00,0,0,3,0,0,9,6,18
2024-03-05 23:40:00,0,0,1,0,0,6,3,10
2024-03-05 23:50:00,0,0,2,0,0,3,4,9
2024-03-06 00:00:00,0,0,0,0,0,8,7,15
2024-03-06 00:10:00,0,0,1,0,0,3,7,11
2024-03-06 00:20:00,0,0,0,0,0,3,7,10
2024-03-06 00:30:00,0,0,1,0,0,6,7,14
2024-03-06 00:40:00,0,0,2,0,0,4,4,10
2024-03-06 00:50:00,0,0,2,0,0,0,1,3
2024-03-06 01:00:00,0,0,1,0,0,6,6,13
2024-03-06 01:10:00,0,0,3,0,0,2,4,9
2024-03-06 01:20:00,0,0,0,0,0,1,2,3
2024-03-06 01:30:00,0,0,0,0,0,0,1,1
2024-03-06 01:40:00,0,0,0,0,0,2,4,6
2024-03-06 01:50:00,0,0,3,0,0,1,3,7
2024-03-06 02:00:00,0,0,1,0,0,4,8,13
2024-03-06 02:10:00,0,0,0,0,0,2,4,6
2024-03-06 02:20:00,0,0,1,0,0,4,4,9
2024-03-06 02:30:00,0,0,0,0,0,1,2,3
2024-03-06 02:40:00,0,0,0,0,0,1,3,4
2024-03-06 02:50:00,0,0,0,0,0,2,2,4
2024-03-06 03:00:00,0,0,0,0,0,4,2,6
2024-03-06 03:10:00,0,0,0,0,0,2,2,4
2024-03-06 03:20:00,0,0,1,0,0,0,3,4
2024-03-06 03:30:00,0,0,1,0,0,5,6,12
2024-03-06 03:40:00,0,0,0,0,0,2,2,4
2024-03-06 03:50:00,0,0,2,0,0,2,4,8
2024-03-06 04:00:00,0,0,2,0,0,0,2,4
2024-03-06 04:10:00,0,0,1,0,0,2,5,8
2024-03-06 04:20:00,0,0,0,0,0,1,4,5
2024-03-06 04:30:00,0,0,2,0,0,4,7,13
2024-03-06 04:40:00,0,0,3,0,0,5,3,11
2024-03-06 04:50:00,0,0,3,0,0,3,5,11
2024-03-06 05:00:00,0,0,4,0,0,7,2,13
2024-03-06 05:10:00,0,0,5,0,0,5,3,13
2024-03-06 05:20:00,0,0,6,0,0,8,8,22
2024-03-06 05:30:00,0,0,7,0,0,15,13,35
2024-03-06 05:40:00,0,0,5,0,0,11,11,27
2024-03-06 05:50:00,0,0,13,0,0,17,18,48
2024-03-06 06:00:00,0,0,11,0,0,22,13,46
2024-03-06 06:10:00,0,0,14,0,0,22,18,54
2024-03-06 06:20:00,0,0,19,0,0,25,19,63
2024-03-06 06:30:00,0,0,12,0,0,28,37,77
2024-03-06 06:40:00,0,0,12,0,0,36,29,77
2024-03-06 06:50:00,0,0,13,0,0,36,39,88
2024-03-06 07:00:00,0,0,15,0,0,53,39,107
2024-03-06 07:10:00,0,0,16,0,0,48,34,98
2024-03-06 07:20:00,0,0,13,0,0,57,51,121
2024-03-06 07:30:00,0,0,12,0,0,55,62,129
2024-03-06 07:40:00,0,0,25,0,0,60,64,149
2024-03-06 07:50:00,0,0,11,0,0,44,75,130
2024-03-06 08:00:00,0,0,22,0,0,52,68,142
2024-03-06 08:10:00,0,0,19,0,0,45,52,116
2024-03-06 08:20:00,0,0,14,0,0,61,67,142
2024-03-06 08:30:00,0,0,22,0,0,35,53,110
2024-03-06 08:40:00,0,0,20,0,0,55,52,127
2024-03-06 08:50:00,0,0,18,0,0,43,44,105
2024-03-06 09:00:00,0,0,10,0,0,43,69,122
2024-03-06 09:10:00,0,0,22,0,0,48,47,117
2024-03-06 09:20:00,0,0,14,0,0,54,58,126
2024-03-06 09:30:00,0,0,21,0,0,38,46,105
2024-03-06 09:40:00,0,0,16,0,0,56,41,113
2024-03-06 09:50:00,0,0,27,0,0,48,45,120
2024-03-06 10:00:00,0,0,18,0,0,46,34,98
2024-03-06 10:10:00,0,0,18,0,0,42,36,96
2024-03-06 10:20:00,0,0,24,0,0,43,32,99
2024-03-06 10:30:00,0,0,10,0,0,40,34,84
2024-03-06 10:40:00,0,0,23,0,0,51,45,119
2024-03-06 10:50:00,0,0,21,0,0,42,43,106
2024-03-06 11:00:00,0,0,20,0,0,40,33,93
2024-03-06 11:10:00,0,0,31,0,0,42,49,122
2024-03-06 11:20:00,0,0,12,0,0,66,50,128
2024-03-06 11:30:00,0,0,26,0,0,40,30,96
2024-03-06 11:40:00,0,0,18,0,0,50,45,113
2024-03-06 11:50:00,0,0,26,0,0,52,46,124
2024-03-06 12:00:00,0,0,20,0,0,48,56,124
2024-03-06 12:10:00,0,0,31,0,0,46,60,137
2024-03-06 12:20:00,0,0,28,0,0,48,39,115
2024-03-06 12:30:00,0,0,20,0,0,39,44,103
2024-03-06 12:40:00,0,0,28,0,0,48,43,119
2024-03-06 12:50:00,0,0,23,0,0,45,53,121
2024-03-06 13:00:00,0,0,23,0,0,34,42,99
2024-03-06 13:10:00,0,0,24,0,0,43,38,105
2024-03-06 13:20:00,0,0,26,0,0,44,60,130
2024-03-06 13:30:00,0,0,19,0,0,48,41,108
2024-03-06 13:40:00,0,0,22,0,0,42,47,111
2024-03-06 13:50:00,0,0,24,0,0,32,64,120
2024-03-06 14:00:00,0,0,24,0,0,42,51,117
2024-03-06 14:10:00,0,0,22,0,0,55,45,122
2024-03-06 14:20:00,0,0,13,0,0,54,45,112
2024-03-06 14:30:00,0,0,30,0,0,48,55,133
2024-03-06 14:40:00,0,0,26,0,0,64,57,147
2024-03-06 14:50:00,0,0,31,0,0,44,48,123
2024-03-06 15:00:00,0,0,24,0,0,40,70,134
2024-03-06 15:10:00,0,0,21,0,0,62,44,127
2024-03-06 15:20:00,0,0,24,0,0,49,60,133
2024-03-06 15:30:00,0,0,27,0,0,48,50,125
2024-03-06 15:40:00,0,0,28,0,0,46,65,139
2024-03-06 15:50:00,0,0,27,0,0,59,59,145
2024-03-06 16:00:00,0,0,33,0,0,52,79,164
2024-03-06 16:10:00,0,0,20,0,0,47,68,135
2024-03-06 16:20:00,0,0,23,0,0,55,66,144
2024-03-06 16:30:00,0,0,26,0,0,61,65,152
2024-03-06 16:40:00,0,0,35,0,0,84,76,195
2024-03-06 16:50:00,0,0,18,0,0,57,57,132
2024-03-06 17:00:00,0,0,20,0,0,53,79,152
2024-03-06 17:10:00,0,0,19,0,0,55,69,143
2024-03-06 17:20:00,0,0,14,0,0,55,65,134
2024-03-06 17:30:00,0,0,20,0,0,61,72,153
2024-03-06 17:40:00,0,0,24,0,0,49,60,133
2024-03-06 17:50:00,0,0,24,0,0,49,87,160
2024-03-06 18:00:00,0,0,16,0,0,53,72,141
2024-03-06 18:10:00,0,0,14,0,0,44,57,115
2024-03-06 18:20:00,0,0,18,0,0,43,81,142
2024-03-06 18:30:00,0,0,17,0,0,56,66,139
2024-03-06 18:40:00,0,0,14,0,0,46,69,129
2024-03-06 18:50:00,0,0,16,0,0,57,48,121
2024-03-06 19:00:00,0,0,13,0,0,38,59,110
2024-03-06 19:10:00,0,0,13,0,0,40,55,108
2024-03-06 19:20:00,0,0,15,0,0,42,51,108
2024-03-06 19:30:00,0,0,15,0,0,27,44,86
2024-03-06 19:40:00,0,0,13,0,0,18,29,60
2024-03-06 19:50:00,0,0,6,0,0,42,39,87
2024-03-06 20:00:00,0,0,8,0,0,31,26,65
2024-03-06 20:10:00,0,0,9,0,0,24,21,54
2024-03-06 20:20:00,0,0,7,0,0,22,32,61
2024-03-06 20:30:00,0,0,12,0,0,19,26,57
2024-03-06 20:40:00,0,0,6,0,0,12,26,44
2024-03-06 20:50:00,0,0,11,0,0,13,23,47
2024-03-06 21:00:00,0,0,10,0,0,22,17,49
2024-03-06 21:10:00,0,0,8,0,0,24,15,47
2024-03-06 21:20:00,0,0,7,0,0,14,25,46
2024-03-06 21:30:00,0,0,8,0,0,19,17,44
2024-03-06 21:40:00,0,0,3,0,0,11,21,35
2024-03-06 21:50:00,0,0,7,0,0,12,18,37
2024-03-06 22:00:00,0,0,11,0,0,9,13,33
2024-03-06 22:10:00,0,0,4,0,0,16,12,32
2024-03-06 22:20:00,0,0,3,0,0,18,16,37
2024-03-06 22:30:00,0,0,1,0,0,11,11,23
2024-03-06 22:40:00,0,0,2,0,0,8,9,19
2024-03-06 22:50:00,0,0,3,0,0,7,14,24
2024-03-06 23:00:00,0,0,2,0,0,10,10,22
2024-03-06 23:10:00,0,0,8,0,0,7,14,29
2024-03-06 23:20:00,0,0,0,0,0,8,6,14
2024-03-06 23:30:00,0,0,4,0,0,6,15,25
2024-03-06 23:40:00,0,0,1,0,0,3,17,21
2024-03-06 23:50:00,0,0,2,0,0,4,5,11
2024-03-07 00:00:00,0,0,4,0,0,4,3,11
2024-03-07 00:10:00,0,0,1,0,0,8,9,18
2024-03-07 00:20:00,0,0,1,0,0,2,4,7
2024-03-07 00:30:00,0,0,1,0,0,4,5,10
2024-03-07 00:40:00,0,0,2,0,0,5,9,16
2024-03-07 00:50:00,0,0,2,0,0,2,1,5
2024-03-07 01:00:00,0,0,3,0,0,5,3,11
2024-03-07 01:10:00,0,0,0,0,0,3,6,9
2024-03-07 01:20:00,0,0,1,0,0,2,3,6
2024-03-07 01:30:00,0,0,0,0,0,1,4,5
2024-03-07 01:40:00,0,0,0,0,0,3,4,7
2024-03-07 01:50:00,0,0,1,0,0,0,3,4
2024-03-07 02:00:00,0,0,0,0,0,2,2,4
2024-03-07 02:10:00,0,0,2,0,0,2,3,7
2024-03-07 02:20:00,0,0,1,0,0,2,5,8
2024-03-07 02:30:00,0,0,1,0,0,1,0,2
2024-03-07 02:40:00,0,0,1,0,0,1,3,5
2024-03-07 02:50:00,0,0,2,0,0,1,0,3
2024-03-07 03:00:00,0,0,1,0,0,1,3,5
2024-03-07 03:10:00,0,0,2,0,0,3,5,10
2024-03-07 03:20:00,0,0,1,0,0,2,0,3
2024-03-07 03:30:00,0,0,1,0,0,3,3,7
2024-03-07 03:40:00,0,0,0,0,0,1,0,1
2024-03-07 03:50:00,0,0,1,0,0,0,0,1
2024-03-07 04:00:00,0,0,0,0,0,1,3,4
2024-03-07 04:10:00,0,0,0,0,0,2,3,5
2024-03-07 04:20:00,0,0,0,0,0,6,11,17
2024-03-07 04:30:00,0,0,3,0,0,2,4,9
2024-03-07 04:40:00,0,0,4,0,0,5,9,18
2024-03-07 04:50:00,0,0,2,0,0,5,3,10
2024-03-07 05:00:00,0,0,5,0,0,7,8,20
2024-03-07 05:10:00,0,0,1,0,0,5,7,13
2024-03-07 05:20:00,0,0,8,0,0,8,6,22
2024-03-07 05:30:00,0,0,4,0,0,18,11,33
2024-03-07 05:40:00,0,0,9,0,0,5,10,24
2024-03-07 05:50:00,0,0,11,0,0,18,13,42
2024-03-07 06:00:00,0,0,12,0,0,25,17,54
2024-03-07 06:10:00,0,0,18,0,0,28,24,70
2024-03-07 06:20:00,0,0,13,0,0,37,19,69
2024-03-07 06:30:00,0,0,9,0,0,27,28,64
2024-03-07 06:40:00,0,0,11,0,0,33,37,81
2024-03-07 06:50:00,0,0,12,0,0,30,33,75
2024-03-07 07:00:00,0,0,13,0,0,55,34,102
2024-03-07 07:10:00,0,0,12,0,0,34,50,96
2024-03-07 07:20:00,0,0,10,0,0,71,60,141
2024-03-07 07:30:00,0,0,17,0,0,66,61,144
2024-03-07 07:40:00,0,0,16,0,0,58,56,130
2024-03-07 07:50:00,0,0,22,0,0,60,72,154
2024-03-07 08:00:00,0,0,21,0,0,63,65,149
2024-03-07 08:10:00,0,0,13,0,0,48,60,121
2024-03-07 08:20:00,0,0,12,0,0,50,69,131
2024-03-07 08:30:00,0,0,15,0,0,59,70,144
2024-03-07 08:40:00,0,0,20,0,0,41,42,103
2024-03-07 08:50:00,0,0,11,0,0,53,47,111
2024-03-07 09:00:00,0,0,15,0,0,45,51,111
2024-03-07 09:10:00,0,0,17,0,0,35,38,90
2024-03-07 09:20:00,0,0,22,0,0,47,46,115
2024-03-07 09:30:00,0,0,20,0,0,60,48,128
2024-03-07 09:40:00,0,0,16,0,0,43,33,92
2024-03-07 09:50:00,0,0,21,0,0,38,33,92
2024-03-07 10:00:00,0,0,11,0,0,51,51,113
2024-03-07 10:10:00,0,0,24,0,0,39,32,95
2024-03-07 10:20:00,0,0,13,0,0,60,60,133
2024-03-07 10:30:00,0,0,13,0,0,43,33,89
2024-03-07 10:40:00,0,0,24,0,0,41,41,106
2024-03-07 10:50:00,0,0,14,0,0,44,46,104
2024-03-07 11:00:00,0,0,13,0,0,48,39,100
2024-03-07 11:10:00,0,0,12,0,0,39,47,98
2024-03-07 11:20:00,0,0,17,0,0,49,59,125
2024-03-07 11:30:00,0,0,28,0,0,42,49,119
2024-03-07 11:40:00,0,0,26,0,0,49,50,125
2024-03-07 11:50:00,0,0,24,0,0,41,52,117
2024-03-07 12:00:00,0,0,24,0,0,52,60,136
2024-03-07 12:10:00,0,0,32,0,0,52,56,140
2024-03-07 12:20:00,0,0,29,0,0,55,50,134
2024-03-07 12:30:00,0,0,15,0,0,47,50,112
2024-03-07 12:40:00,0,0,26,0,0,50,60,136
2024-03-07 12:50:00,0,0,23,0,0,50,43,116
2024-03-07 13:00:00,0,0,22,0,0,46,46,114
2024-03-07 13:10:00,0,0,24,0,0,41,51,116
2024-03-07 13:20:00,0,0,32,0,0,46,37,115
2024-03-07 13:30:00,0,0,14,0,0,51,53,118
2024-03-07 13:40:00,0,0,14,0,0,55,56,125
2024-03-07 13:50:00,0,0,26,0,0,56,59,141
2024-03-07 14:00:00,0,0,21,0,0,49,61,131
2024-03-07 14:10:00,0,0,23,0,0,41,41,105
2024-03-07 14:20:00,0,0,18,0,0,50,73,141
2024-03-07 14:30:00,0,0,23,0,0,54,55,132
2024-03-07 14:40:00,0,0,17,0,0,40,58,115
2024-03-07 14:50:00,0,0,26,0,0,53,56,135
2024-03-07 15:00:00,0,0,28,0,0,49,55,132
2024-03-07 15:10:00,0,0,30,0,0,51,62,143
2024-03-07 15:20:00,0,0,26,0,0,56,58,140
2024-03-07 15:30:00,0,0,32,0,0,46,56,134
2024-03-07 15:40:00,0,0,16,0,0,48,67,131
2024-03-07 15:50:00,0,0,30,0,0,55,67,152
2024-03-07 16:00:00,0,0,25,0,0,55,69,149
2024-03-07 16:10:00,0,0,28,0,0,70,77,175
2024-03-07 16:20:00,0,0,31,0,0,62,47,140
2024-03-07 16:30:00,0,0,31,0,0,55,59,145
2024-03-07 16:40:00,0,0,26,0,0,70,71,167
2024-03-07 16:50:00,0,0,19,0,0,69,83,171
2024-03-07 17:00:00,0,0,27,0,0,49,80,156
2024-03-07 17:10:00,0,0,30,0,0,54,73,157
2024-03-07 17:20:00,0,0,21,0,0,58,65,144
2024-03-07 17:30:00,0,0,29,0,0,53,84,166
2024-03-07 17:40:00,0,0,27,0,0,55,62,144
2024-03-07 17:50:00,0,0,33,0,0,49,55,137
2024-03-07 18:00:00,0,0,21,0,0,59,78,158
2024-03-07 18:10:00,0,0,33,0,0,50,86,169
2024-03-07 18:20:00,0,0,23,0,0,52,87,162
2024-03-07 18:30:00,0,0,15,0,0,45,50,110
2024-03-07 18:40:00,0,0,20,0,0,56,54,130
2024-03-07 18:50:00,0,0,13,0,0,55,55,123
2024-03-07 19:00:00,0,0,14,0,0,49,54,117
2024-03-07 19:10:00,0,0,14,0,0,34,51,99
2024-03-07 19:20:00,0,0,15,0,0,46,54,115
2024-03-07 19:30:00,0,0,16,0,0,28,39,83
2024-03-07 19:40:00,0,0,11,0,0,38,46,95
2024-03-07 19:50:00,0,0,21,0,0,22,26,69
2024-03-07 20:00:00,0,0,12,0,0,36,39,87
2024-03-07 20:10:00,0,0,6,0,0,26,35,67
2024-03-07 20:20:00,0,0,5,0,0,35,41,81
2024-03-07 20:30:00,0,0,10,0,0,26,24,60
2024-03-07 20:40:00,0,0,8,0,0,24,32,64
2024-03-07 20:50:00,0,0,4,0,0,19,20,43
2024-03-07 21:00:00,0,0,5,0,0,23,22,50
2024-03-07 21:10:00,0,0,9,0,0,19,22,50
2024-03-07 21:20:00,0,0,15,0,0,17,24,56
2024-03-07 21:30:00,0,0,6,0,0,13,20,39
2024-03-07 21:40:00,0,0,8,0,0,20,20,48
2024-03-07 21:50:00,0,0,7,0,0,18,17,42
2024-03-07 22:00:00,0,0,12,0,0,19,21,52
2024-03-07 22:10:00,0,0,5,0,0,15,23,43
2024-03-07 22:20:00,0,0,7,0,0,10,21,38
2024-03-07 22:30:00,0,0,4,0,0,10,24,38
2024-03-07 22:40:00,0,0,2,0,0,13,19,34
2024-03-07 22:50:00,0,0,1,0,0,12,22,35
2024-03-07 23:00:00,0,0,5,0,0,13,13,31
2024-03-07 23:10:00,0,0,5,0,0,9,14,28
2024-03-07 23:20:00,0,0,4,0,0,7,9,20
2024-03-07 23:30:00,0,0,2,0,0,10,15,27
2024-03-07 23:40:00,0,0,0,0,0,4,9,13
2024-03-07 23:50:00,0,0,3,0,0,5,9,17
2024-03-08 00:00:00,0,0,3,0,0,3,11,17
2024-03-08 00:10:00,0,0,1,0,0,8,6,15
2024-03-08 00:20:00,0,0,0,0,0,2,2,4
2024-03-08 00:30:00,0,0,1,0,0,8,8,17
2024-03-08 00:40:00,0,0,0,0,0,4,7,11
2024-03-08 00:50:00,0,0,1,0,0,4,4,9
2024-03-08 01:00:00,0,0,3,0,0,5,3,11
2024-03-08 01:10:00,0,0,0,0,0,2,3,5
2024-03-08 01:20:00,0,0,0,0,0,3,5,8
2024-03-08 01:30:00,0,0,3,0,0,4,4,11
2024-03-08 01:40:00,0,0,0,0,0,2,0,2
2024-03-08 01:50:00,0,0,0,0,0,2,6,8
2024-03-08 02:00:00,0,0,0,0,0,1,2,3
2024-03-08 02:10:00,0,0,2,0,0,1,3,6
2024-03-08 02:20:00,0,0,0,0,0,3,1,4
2024-03-08 02:30:00,0,0,0,0,0,1,1,2
2024-03-08 02:40:00,0,0,0,0,0,1,1,2
2024-03-08 02:50:00,0,0,0,0,0,2,2,4
2024-03-08 03:00:00,0,0,0,0,0,2,3,5
2024-03-08 03:10:00,0,0,0,0,0,1,1,2
2024-03-08 03:20:00,0,0,1,0,0,1,1,3
2024-03-08 03:30:00,0,0,2,0,0,2,3,7
2024-03-08 03:40:00,0,0,1,0,0,1,5,7
2024-03-08 03:50:00,0,0,1,0,0,2,2,5
2024-03-08 04:00:00,0,0,1,0,0,3,3,7
2024-03-08 04:10:00,0,0,0,0,0,3,1,4
2024-03-08 04:20:00,0,0,1,0,0,5,4,10
2024-03-08 04:30:00,0,0,3,0,0,2,4,9
2024-03-08 04:40:00,0,0,4,0,0,3,6,13
2024-03-08 04:50:00,0,0,3,0,0,5,6,14
2024-03-08 05:00:00,0,0,4,0,0,4,4,12
2024-03-08 05:10:00,0,0,8,0,0,8,5,21
2024-03-08 05:20:00,0,0,5,0,0,11,8,24
2024-03-08 05:30:00,0,0,5,0,0,14,14,33
2024-03-08 05:40:00,0,0,5,0,0,13,8,26
2024-03-08 05:50:00,0,0,12,0,0,23,16,51
2024-03-08 06:00:00,0,0,10,0,0,20,18,48
2024-03-08 06:10:00,0,0,11,0,0,22,13,46
2024-03-08 06:20:00,0,0,14,0,0,28,21,63
2024-03-08 06:30:00,0,0,12,0,0,31,36,79
2024-03-08 06:40:00,0,0,11,0,0,22,26,59
2024-03-08 06:50:00,0,0,15,0,0,36,33,84
2024-03-08 07:00:00,0,0,11,0,0,50,44,105
2024-03-08 07:10:00,0,0,8,0,0,34,33,75
2024-03-08 07:20:00,0,0,19,0,0,58,49,126
2024-03-08 07:30:00,0,0,15,0,0,65,60,140
2024-03-08 07:40:00,0,0,20,0,0,73,57,150
2024-03-08 07:50:00,0,0,16,0,0,35,57,108
2024-03-08 08:00:00,0,0,21,0,0,40,47,108
2024-03-08 08:10:00,0,0,14,0,0,55,38,107
2024-03-08 08:20:00,0,0,18,0,0,41,51,110
2024-03-08 08:30:00,0,0,18,0,0,59,44,121
2024-03-08 08:40:00,0,0,15,0,0,51,42,108
2024-03-08 08:50:00,0,0,17,0,0,47,39,103
2024-03-08 09:00:00,0,0,16,0,0,49,40,105
2024-03-08 09:10:00,0,0,13,0,0,36,42,91
2024-03-08 09:20:00,0,0,20,0,0,41,44,105
2024-03-08 09:30:00,0,0,12,0,0,59,44,115
2024-03-08 09:40:00,0,0,23,0,0,57,45,125
2024-03-08 09:50:00,0,0,20,0,0,42,43,105
2024-03-08 10:00:00,0,0,21,0,0,46,40,107
2024-03-08 10:10:00,0,0,25,0,0,40,49,114
2024-03-08 10:20:00,0,0,17,0,0,54,51,122
2024-03-08 10:30:00,0,0,17,0,0,42,40,99
2024-03-08 10:40:00,0,0,18,0,0,51,55,124
2024-03-08 10:50:00,0,0,24,0,0,47,35,106
2024-03-08 11:00:00,0,0,19,0,0,48,53,120
2024-03-08 11:10:00,0,0,22,0,0,50,47,119
2024-03-08 11:20:00,0,0,26,0,0,45,51,122
2024-03-08 11:30:00,0,0,20,0,0,44,58,122
2024-03-08 11:40:00,0,0,17,0,0,61,56,134
2024-03-08 11:50:00,0,0,25,0,0,57,57,139
2024-03-08 12:00:00,0,0,28,0,0,42,67,137
2024-03-08 12:10:00,0,0,21,0,0,62,55,138
2024-03-08 12:20:00,0,0,34,0,0,41,61,136
2024-03-08 12:30:00,0,0,24,0,0,61,59,144
2024-03-08 12:40:00,0,0,16,0,0,46,53,115
2024-03-08 12:50:00,0,0,34,0,0,55,69,158
2024-03-08 13:00:00,0,0,36,0,0,66,64,166
2024-03-08 13:10:00,0,0,27,0,0,49,61,137
2024-03-08 13:20:00,0,0,23,0,0,58,49,130
2024-03-08 13:30:00,0,0,36,0,0,62,56,154
2024-03-08 13:40:00,0,0,31,0,0,58,58,147
2024-03-08 13:50:00,0,0,19,0,0,70,73,162
2024-03-08 14:00:00,0,0,29,0,0,55,79,163
2024-03-08 14:10:00,0,0,21,0,0,55,62,138
2024-03-08 14:20:00,0,0,23,0,0,59,50,132
2024-03-08 14:30:00,0,0,20,0,0,55,59,134
2024-03-08 14:40:00,0,0,14,0,0,58,53,125
2024-03-08 14:50:00,0,0,29,0,0,61,77,167
2024-03-08 15:00:00,0,0,31,0,0,60,65,156
2024-03-08 15:10:00,0,0,21,0,0,66,76,163
2024-03-08 15:20:00,0,0,29,0,0,45,63,137
2024-03-08 15:30:00,0,0,28,0,0,45,64,137
2024-03-08 15:40:00,0,0,23,0,0,62,69,154
2024-03-08 15:50:00,0,0,31,0,0,48,69,148
2024-03-08 16:00:00,0,0,26,0,0,50,66,142
2024-03-08 16:10:00,0,0,27,0,0,58,68,153
2024-03-08 16:20:00,0,0,21,0,0,68,71,160
2024-03-08 16:30:00,0,0,21,0,0,47,86,154
2024-03-08 16:40:00,0,0,16,0,0,60,75,151
2024-03-08 16:50:00,0,0,18,0,0,70,80,168
2024-03-08 17:00:00,0,0,22,0,0,62,70,154
2024-03-08 17:10:00,0,0,17,0,0,49,82,148
2024-03-08 17:20:00,0,0,22,0,0,71,88,181
2024-03-08 17:30:00,0,0,22,0,0,72,58,152
2024-03-08 17:40:00,0,0,19,0,0,69,89,177
2024-03-08 17:50:00,0,0,33,0,0,58,73,164
2024-03-08 18:00:00,0,0,13,0,0,58,80,151
2024-03-08 18:10:00,0,0,21,0,0,63,66,150
2024-03-08 18:20:00,0,0,26,0,0,59,88,173
2024-03-08 18:30:00,0,0,16,0,0,59,72,147
2024-03-08 18:40:00,0,0,12,0,0,50,75,137
2024-03-08 18:50:00,0,0,18,0,0,59,57,134
2024-03-08 19:00:00,0,0,16,0,0,56,42,114
2024-03-08 19:10:00,0,0,15,0,0,60,53,128
2024-03-08 19:20:00,0,0,11,0,0,46,57,114
2024-03-08 19:30:00,0,0,20,0,0,41,45,106
2024-03-08 19:40:00,0,0,15,0,0,39,55,109
2024-03-08 19:50:00,0,0,9,0,0,43,52,104
2024-03-08 20:00:00,0,0,6,0,0,46,42,94
2024-03-08 20:10:00,0,0,2,0,0,31,40,73
2024-03-08 20:20:00,0,0,9,0,0,31,39,79
2024-03-08 20:30:00,0,0,11,0,0,24,25,60
2024-03-08 20:40:00,0,0,12,0,0,38,26,76
2024-03-08 20:50:00,0,0,9,0,0,17,24,50
2024-03-08 21:00:00,0,0,3,0,0,32,32,67
2024-03-08 21:10:00,0,0,9,0,0,24,24,57
2024-03-08 21:20:00,0,0,12,0,0,16,26,54
2024-03-08 21:30:00,0,0,6,0,0,19,24,49
2024-03-08 21:40:00,0,0,8,0,0,15,22,45
2024-03-08 21:50:00,0,0,8,0,0,23,26,57
2024-03-08 22:00:00,0,0,15,0,0,22,25,62
2024-03-08 22:10:00,0,0,3,0,0,15,19,37
2024-03-08 22:20:00,0,0,6,0,0,19,22,47
2024-03-08 22:30:00,0,0,6,0,0,17,23,46
2024-03-08 22:40:00,0,0,2,0,0,16,21,39
2024-03-08 22:50:00,0,0,5,0,0,20,25,50
2024-03-08 23:00:00,0,0,4,0,0,26,21,51
2024-03-08 23:10:00,0,0,7,0,0,12,27,46
2024-03-08 23:20:00,0,0,2,0,0,16,19,37
2024-03-08 23:30:00,0,0,4,0,0,14,21,39
2024-03-08 23:40:00,0,0,3,0,0,7,17,27
2024-03-08 23:50:00,0,0,2,0,0,9,18,29
2024-03-09 00:00:00,0,0,1,0,0,11,11,23
2024-03-09 00:10:00,0,0,2,0,0,6,15,23
2024-03-09 00:20:00,0,0,3,0,0,6,11,20
2024-03-09 00:30:00,0,0,1,0,0,5,10,16
2024-03-09 00:40:00,0,0,4,0,0,5,5,14
2024-03-09 00:50:00,0,0,1,0,0,5,7,13
2024-03-09 01:00:00,0,0,2,0,0,6,5,13
2024-03-09 01:10:00,0,0,1,0,0,4,4,9
2024-03-09 01:20:00,0,0,3,0,0,6,5,14
2024-03-09 01:30:00,0,0,2,0,0,5,9,16
2024-03-09 01:40:00,0,0,1,0,0,4,4,9
2024-03-09 01:50:00,0,0,2,0,0,4,3,9
2024-03-09 02:00:00,0,0,0,0,0,5,14,19
2024-03-09 02:10:00,0,0,2,0,0,3,9,14
2024-03-09 02:20:00,0,0,1,0,0,4,5,10
2024-03-09 02:30:00,0,0,1,0,0,3,5,9
2024-03-09 02:40:00,0,0,2,0,0,5,6,13
2024-03-09 02:50:00,0,0,2,0,0,1,1,4
2024-03-09 03:00:00,0,0,2,0,0,2,6,10
2024-03-09 03:10:00,0,0,1,0,0,0,2,3
2024-03-09 03:20:00,0,0,0,0,0,3,7,10
2024-03-09 03:30:00,0,0,0,0,0,3,7,10
2024-03-09 03:40:00,0,0,1,0,0,1,7,9
2024-03-09 03:50:00,0,0,1,0,0,4,5,10
2024-03-09 04:00:00,0,0,2,0,0,5,13,20
2024-03-09 04:10:00,0,0,2,0,0,5,4,11
2024-03-09 04:20:00,0,0,1,0,0,0,1,2
2024-03-09 04:30:00,0,0,4,0,0,4,1,9
2024-03-09 04:40:00,0,0,0,0,0,3,2,5
2024-03-09 04:50:00,0,0,2,0,0,4,6,12
2024-03-09 05:00:00,0,0,1,0,0,2,3,6
2024-03-09 05:10:00,0,0,4,0,0,5,8,17
2024-03-09 05:20:00,0,0,1,0,0,4,5,10
2024-03-09 05:30:00,0,0,4,0,0,13,7,24
2024-03-09 05:40:00,0,0,4,0,0,6,9,19
2024-03-09 05:50:00,0,0,4,0,0,3,3,10
2024-03-09 06:00:00,0,0,2,0,0,6,5,13
2024-03-09 06:10:00,0,0,4,0,0,4,11,19
2024-03-09 06:20:00,0,0,7,0,0,14,6,27
2024-03-09 06:30:00,0,0,3,0,0,7,15,25
2024-03-09 06:40:00,0,0,10,0,0,3,6,19
2024-03-09 06:50:00,0,0,6,0,0,9,7,22
2024-03-09 07:00:00,0,0,7,0,0,11,11,29
2024-03-09 07:10:00,0,0,6,0,0,9,13,28
2024-03-09 07:20:00,0,0,8,0,0,8,7,23
2024-03-09 07:30:00,0,0,5,0,0,13,15,33
2024-03-09 07:40:00,0,0,9,0,0,20,20,49
2024-03-09 07:50:00,0,0,7,0,0,13,17,37
2024-03-09 08:00:00,0,0,8,0,0,18,22,48
2024-03-09 08:10:00,0,0,8,0,0,16,15,39
2024-03-09 08:20:00,0,0,11,0,0,20,14,45
2024-03-09 08:30:00,0,0,15,0,0,21,19,55
2024-03-09 08:40:00,0,0,10,0,0,14,28,52
2024-03-09 08:50:00,0,0,13,0,0,22,24,59
2024-03-09 09:00:00,0,0,18,0,0,24,27,69
2024-03-09 09:10:00,0,0,17,0,0,27,23,67
2024-03-09 09:20:00,0,0,30,0,0,38,30,98
2024-03-09 09:30:00,0,0,25,0,0,35,44,104
2024-03-09 09:40:00,0,0,25,0,0,46,37,108
2024-03-09 09:50:00,0,0,23,0,0,59,37,119
2024-03-09 10:00:00,0,0,27,0,0,46,48,121
2024-03-09 10:10:00,0,0,27,0,0,38,42,107
2024-03-09 10:20:00,0,0,32,0,0,47,36,115
2024-03-09 10:30:00,0,0,19,0,0,50,58,127
2024-03-09 10:40:00,0,0,22,0,0,52,44,118
2024-03-09 10:50:00,0,0,28,0,0,63,50,141
2024-03-09 11:00:00,0,0,30,0,0,52,47,129
2024-03-09 11:10:00,0,0,33,0,0,53,46,132
2024-03-09 11:20:00,0,0,29,0,0,65,46,140
2024-03-09 11:30:00,0,0,27,0,0,65,59,151
2024-03-09 11:40:00,0,0,33,0,0,53,61,147
2024-03-09 11:50:00,0,0,27,0,0,64,62,153
2024-03-09 12:00:00,0,0,21,0,0,59,58,138
2024-03-09 12:10:00,0,0,32,0,0,57,52,141
2024-03-09 12:20:00,0,0,33,0,0,62,51,146
2024-03-09 12:30:00,0,0,23,0,0,81,78,182
2024-03-09 12:40:00,0,0,27,0,0,63,69,159
2024-03-09 12:50:00,0,0,32,0,0,61,54,147
2024-03-09 13:00:00,0,0,20,0,0,68,58,146
2024-03-09 13:10:00,0,0,27,0,0,60,56,143
2024-03-09 13:20:00,0,0,21,0,0,73,72,166
2024-03-09 13:30:00,0,0,23,0,0,76,57,156
2024-03-09 13:40:00,0,0,25,0,0,70,56,151
2024-03-09 13:50:00,0,0,32,0,0,76,68,176
2024-03-09 14:00:00,0,0,19,0,0,58,52,129
2024-03-09 14:10:00,0,0,19,0,0,60,62,141
2024-03-09 14:20:00,0,0,26,0,0,66,77,169
2024-03-09 14:30:00,0,0,18,0,0,58,75,151
2024-03-09 14:40:00,0,0,27,0,0,60,61,148
2024-03-09 14:50:00,0,0,18,0,0,61,57,136
2024-03-09 15:00:00,0,0,20,0,0,69,51,140
2024-03-09 15:10:00,0,0,13,0,0,49,52,114
2024-03-09 15:20:00,0,0,16,0,0,67,76,159
2024-03-09 15:30:00,0,0,17,0,0,59,62,138
2024-03-09 15:40:00,0,0,20,0,0,69,47,136
2024-03-09 15:50:00,0,0,24,0,0,51,48,123
2024-03-09 16:00:00,0,0,15,0,0,57,55,127
2024-03-09 16:10:00,0,0,14,0,0,49,44,107
2024-03-09 16:20:00,0,0,19,0,0,55,52,126
2024-03-09 16:30:00,0,0,21,0,0,62,49,132
2024-03-09 16:40:00,0,0,13,0,0,59,49,121
2024-03-09 16:50:00,0,0,18,0,0,71,49,138
2024-03-09 17:00:00,0,0,15,0,0,63,55,133
2024-03-09 17:10:00,0,0,18,0,0,60,49,127
2024-03-09 17:20:00,0,0,18,0,0,59,56,133
2024-03-09 17:30:00,0,0,14,0,0,54,53,121
2024-03-09 17:40:00,0,0,19,0,0,68,64,151
2024-03-09 17:50:00,0,0,22,0,0,69,54,145
2024-03-09 18:00:00,0,0,20,0,0,51,50,121
2024-03-09 18:10:00,0,0,21,0,0,69,56,146
2024-03-09 18:20:00,0,0,10,0,0,64,52,126
2024-03-09 18:30:00,0,0,15,0,0,53,50,118
2024-03-09 18:40:00,0,0,11,0,0,69,56,136
2024-03-09 18:50:00,0,0,17,0,0,49,60,126
2024-03-09 19:00:00,0,0,25,0,0,64,48,137
2024-03-09 19:10:00,0,0,17,0,0,53,32,102
2024-03-09 19:20:00,0,0,13,0,0,49,33,95
2024-03-09 19:30:00,0,0,17,0,0,42,40,99
2024-03-09 19:40:00,0,0,15,0,0,44,46,105
2024-03-09 19:50:00,0,0,11,0,0,32,32,75
2024-03-09 20:00:00,0,0,11,0,0,43,52,106
2024-03-09 20:10:00,0,0,7,0,0,35,36,78
2024-03-09 20:20:00,0,0,3,0,0,22,30,55
2024-03-09 20:30:00,0,0,12,0,0,28,41,81
2024-03-09 20:40:00,0,0,11,0,0,22,23,56
2024-03-09 20:50:00,0,0,6,0,0,18,31,55
2024-03-09 21:00:00,0,0,10,0,0,16,21,47
2024-03-09 21:10:00,0,0,8,0,0,24,28,60
2024-03-09 21:20:00,0,0,8,0,0,28,21,57
2024-03-09 21:30:00,0,0,4,0,0,24,36,64
2024-03-09 21:40:00,0,0,8,0,0,14,24,46
2024-03-09 21:50:00,0,0,5,0,0,16,22,43
2024-03-09 22:00:00,0,0,9,0,0,17,20,46
2024-03-09 22:10:00,0,0,14,0,0,16,30,60
2024-03-09 22:20:00,0,0,4,0,0,19,14,37
2024-03-09 22:30:00,0,0,8,0,0,23,22,53
2024-03-09 22:40:00,0,0,6,0,0,18,17,41
2024-03-09 22:50:00,0,0,5,0,0,11,20,36
2024-03-09 23:00:00,0,0,5,0,0,17,22,44
2024-03-09 23:10:00,0,0,3,0,0,16,16,35
2024-03-09 23:20:00,0,0,7,0,0,15,14,36
2024-03-09 23:30:00,0,0,7,0,0,15,11,33
2024-03-09 23:40:00,0,0,6,0,0,16,17,39
2024-03-09 23:50:00,0,0,2,0,0,7,14,23
2024-03-10 00:00:00,0,0,3,0,0,15,16,34
2024-03-10 00:10:00,0,0,4,0,0,5,9,18
2024-03-10 00:20:00,0,0,3,0,0,11,11,25
2024-03-10 00:30:00,0,0,2,0,0,6,12,20
2024-03-10 00:40:00,0,0,4,0,0,11,14,29
2024-03-10 00:50:00,0,0,5,0,0,8,15,28
2024-03-10 01:00:00,0,0,4,0,0,4,7,15
2024-03-10 01:10:00,0,0,0,0,0,3,9,12
2024-03-10 01:20:00,0,0,1,0,0,8,12,21
2024-03-10 01:30:00,0,0,2,0,0,4,7,13
2024-03-10 01:40:00,0,0,1,0,0,4,4,9
2024-03-10 01:50:00,0,0,2,0,0,7,4,13
2024-03-10 02:00:00,0,0,1,0,0,3,7,11
2024-03-10 02:10:00,0,0,0,0,0,7,12,19
2024-03-10 02:20:00,0,0,1,0,0,5,6,12
2024-03-10 02:30:00,0,0,2,0,0,6,9,17
2024-03-10 02:40:00,0,0,0,0,0,6,7,13
2024-03-10 02:50:00,0,0,2,0,0,0,5,7
2024-03-10 03:00:00,0,0,0,0,0,5,3,8
2024-03-10 03:10:00,0,0,0,0,0,7,9,16
2024-03-10 03:20:00,0,0,2,0,0,5,7,14
2024-03-10 03:30:00,0,0,1,0,0,4,6,11
2024-03-10 03:40:00,0,0,2,0,0,5,7,14
2024-03-10 03:50:00,0,0,2,0,0,1,5,8
2024-03-10 04:00:00,0,0,2,0,0,3,4,9
2024-03-10 04:10:00,0,0,1,0,0,7,6,14
2024-03-10 04:20:00,0,0,1,0,0,9,4,14
2024-03-10 04:30:00,0,0,2,0,0,5,5,12
2024-03-10 04:40:00,0,0,2,0,0,2,6,10
2024-03-10 04:50:00,0,0,2,0,0,3,2,7
2024-03-10 05:00:00,0,0,2,0,0,2,3,7
2024-03-10 05:10:00,0,0,3,0,0,3,2,8
2024-03-10 05:20:00,0,0,3,0,0,5,6,14
2024-03-10 05:30:00,0,0,5,0,0,8,10,23
2024-03-10 05:40:00,0,0,1,0,0,12,6,19
2024-03-10 05:50:00,0,0,1,0,0,1,5,7
2024-03-10 06:00:00,0,0,4,0,0,2,0,6
2024-03-10 06:10:00,0,0,1,0,0,6,5,12
2024-03-10 06:20:00,0,0,2,0,0,3,4,9
2024-03-10 06:30:00,0,0,3,0,0,2,4,9
2024-03-10 06:40:00,0,0,1,0,0,5,6,12
2024-03-10 06:50:00,0,0,2,0,0,4,4,10
2024-03-10 07:00:00,0,0,1,0,0,4,3,8
2024-03-10 07:10:00,0,0,2,0,0,5,3,10
2024-03-10 07:20:00,0,0,1,0,0,2,2,5
2024-03-10 07:30:00,0,0,1,0,0,4,5,10
2024-03-10 07:40:00,0,0,1,0,0,4,8,13
2024-03-10 07:50:00,0,0,1,0,0,1,4,6
2024-03-10 08:00:00,0,0,4,0,0,3,6,13
2024-03-10 08:10:00,0,0,5,0,0,3,2,10
2024-03-10 08:20:00,0,0,1,0,0,3,6,10
2024-03-10 08:30:00,0,0,1,0,0,7,10,18
2024-03-10 08:40:00,0,0,4,0,0,9,8,21
2024-03-10 08:50:00,0,0,3,0,0,15,8,26
2024-03-10 09:00:00,0,0,6,0,0,9,15,30
2024-03-10 09:10:00,0,0,5,0,0,10,12,27
2024-03-10 09:20:00,0,0,4,0,0,10,9,23
2024-03-10 09:30:00,0,0,4,0,0,14,16,34
2024-03-10 09:40:00,0,0,8,0,0,23,10,41
2024-03-10 09:50:00,0,0,9,0,0,13,11,33
2024-03-10 10:00:00,0,0,6,0,0,13,20,39
2024-03-10 10:10:00,0,0,7,0,0,20,17,44
2024-03-10 10:20:00,0,0,10,0,0,16,21,47
2024-03-10 10:30:00,0,0,4,0,0,16,19,39
2024-03-10 10:40:00,0,0,5,0,0,14,23,42
2024-03-10 10:50:00,0,0,3,0,0,16,21,40
2024-03-10 11:00:00,0,0,7,0,0,20,30,57
2024-03-10 11:10:00,0,0,3,0,0,23,26,52
2024-03-10 11:20:00,0,0,7,0,0,23,27,57
2024-03-10 11:30:00,0,0,5,0,0,19,29,53
2024-03-10 11:40:00,0,0,9,0,0,19,21,49
2024-03-10 11:50:00,0,0,9,0,0,29,23,61
2024-03-10 12:00:00,0,0,13,0,0,26,22,61
2024-03-10 12:10:00,0,0,5,0,0,20,32,57
2024-03-10 12:20:00,0,0,9,0,0,34,38,81
2024-03-10 12:30:00,0,0,5,0,0,29,27,61
2024-03-10 12:40:00,0,0,9,0,0,16,30,55
2024-03-10 12:50:00,0,0,10,0,0,32,50,92
2024-03-10 13:00:00,0,0,10,0,0,25,33,68
2024-03-10 13:10:00,0,0,13,0,0,23,23,59
2024-03-10 13:20:00,0,0,5,0,0,22,25,52
2024-03-10 13:30:00,0,0,7,0,0,22,24,53
2024-03-10 13:40:00,0,0,8,0,0,14,24,46
2024-03-10 13:50:00,0,0,12,0,0,37,28,77
2024-03-10 14:00:00,0,0,9,0,0,37,30,76
2024-03-10 14:10:00,0,0,7,0,0,32,30,69
2024-03-10 14:20:00,0,0,5,0,0,20,33,58
2024-03-10 14:30:00,0,0,9,0,0,29,35,73
2024-03-10 14:40:00,0,0,6,0,0,29,29,64
2024-03-10 14:50:00,0,0,9,0,0,30,25,64
2024-03-10 15:00:00,0,0,8,0,0,28,44,80
2024-03-10 15:10:00,0,0,8,0,0,31,38,77
2024-03-10 15:20:00,0,0,9,0,0,22,42,73
2024-03-10 15:30:00,0,0,7,0,0,25,41,73
2024-03-10 15:40:00,0,0,9,0,0,33,34,76
2024-03-10 15:50:00,0,0,10,0,0,32,30,72
2024-03-10 16:00:00,0,0,11,0,0,22,33,66
2024-03-10 16:10:00,0,0,6,0,0,28,27,61
2024-03-10 16:20:00,0,0,9,0,0,21,30,60
2024-03-10 16:30:00,0,0,11,0,0,37,46,94
2024-03-10 16:40:00,0,0,7,0,0,24,39,70
2024-03-10 16:50:00,0,0,13,0,0,24,31,68
2024-03-10 17:00:00,0,0,14,0,0,27,31,72
2024-03-10 17:10:00,0,0,10,0,0,31,37,78
2024-03-10 17:20:00,0,0,16,0,0,34,33,83
2024-03-10 17:30:00,0,0,13,0,0,29,41,83
2024-03-10 17:40:00,0,0,9,0,0,28,45,82
2024-03-10 17:50:00,0,0,10,0,0,20,36,66
2024-03-10 18:00:00,0,0,9,0,0,26,39,74
2024-03-10 18:10:00,0,0,8,0,0,29,48,85
2024-03-10 18:20:00,0,0,5,0,0,28,33,66
2024-03-10 18:30:00,0,0,6,0,0,26,40,72
2024-03-10 18:40:00,0,0,12,0,0,26,24,62
2024-03-10 18:50:00,0,0,8,0,0,28,40,76
2024-03-10 19:00:00,0,0,5,0,0,30,28,63
2024-03-10 19:10:00,0,0,11,0,0,24,18,53
2024-03-10 19:20:00,0,0,7,0,0,22,31,60
2024-03-10 19:30:00,0,0,13,0,0,22,38,73
2024-03-10 19:40:00,0,0,6,0,0,23,38,67
2024-03-10 19:50:00,0,0,17,0,0,25,28,70
2024-03-10 20:00:00,0,0,11,0,0,22,26,59
2024-03-10 20:10:00,0,0,8,0,0,26,21,55
2024-03-10 20:20:00,0,0,12,0,0,18,21,51
2024-03-10 20:30:00,0,0,2,0,0,14,20,36
2024-03-10 20:40:00,0,0,14,0,0,18,28,60
2024-03-10 20:50:00,0,0,4,0,0,14,21,39
2024-03-10 21:00:00,0,0,7,0,0,19,26,52
2024-03-10 21:10:00,0,0,5,0,0,19,20,44
2024-03-10 21:20:00,0,0,5,0,0,11,23,39
2024-03-10 21:30:00,0,0,6,0,0,18,28,52
2024-03-10 21:40:00,0,0,7,0,0,14,26,47
2024-03-10 21:50:00,0,0,2,0,0,9,11,22
2024-03-10 22:00:00,0,0,5,0,0,12,11,28
2024-03-10 22:10:00,0,0,5,0,0,8,14,27
2024-03-10 22:20:00,0,0,3,0,0,6,10,19
2024-03-10 22:30:00,0,0,7,0,0,15,23,45
2024-03-10 22:40:00,0,0,5,0,0,5,7,17
2024-03-10 22:50:00,0,0,3,0,0,11,11,25
2024-03-10 23:00:00,0,0,3,0,0,4,6,13
2024-03-10 23:10:00,0,0,0,0,0,13,10,23
2024-03-10 23:20:00,0,0,0,0,0,3,8,11
2024-03-10 23:30:00,0,0,3,0,0,6,13,22
2024-03-10 23:40:00,0,0,2,0,0,4,6,12
2024-03-10 23:50:00,0,0,1,0,0,3,3,7
2024-03-11 00:00:00,0,0,0,0,0,5,7,12
2024-03-11 00:10:00,0,0,3,0,0,7,6,16
2024-03-11 00:20:00,0,0,2,0,0,2,5,9
2024-03-11 00:30:00,0,0,1,0,0,4,5,10
2024-03-11 00:40:00,0,0,0,0,0,1,4,5
2024-03-11 00:50:00,0,0,2,0,0,4,3,9
2024-03-11 01:00:00,0,0,0,0,0,3,7,10
2024-03-11 01:10:00,0,0,1,0,0,0,0,1
2024-03-11 01:20:00,0,0,1,0,0,1,3,5
2024-03-11 01:30:00,0,0,1,0,0,2,2,5
2024-03-11 01:40:00,0,0,0,0,0,3,4,7
2024-03-11 01:50:00,0,0,1,0,0,0,0,1
2024-03-11 02:00:00,0,0,1,0,0,1,2,4
2024-03-11 02:10:00,0,0,1,0,0,1,0,2
2024-03-11 02:20:00,0,0,1,0,0,2,1,4
2024-03-11 02:30:00,0,0,0,0,0,0,2,2
2024-03-11 02:40:00,0,0,0,0,0,1,1,2
2024-03-11 02:50:00,0,0,0,0,0,0,2,2
2024-03-11 03:00:00,0,0,1,0,0,1,4,6
2024-03-11 03:10:00,0,0,0,0,0,2,0,2
2024-03-11 03:20:00,0,0,2,0,0,2,1,5
2024-03-11 03:30:00,0,0,0,0,0,1,3,4
2024-03-11 03:40:00,0,0,1,0,0,0,2,3
2024-03-11 03:50:00,0,0,0,0,0,1,2,3
2024-03-11 04:00:00,0,0,3,0,0,2,2,7
2024-03-11 04:10:00,0,0,1,0,0,4,1,6
2024-03-11 04:20:00,0,0,1,0,0,4,5,10
2024-03-11 04:30:00,0,0,3,0,0,1,2,6
2024-03-11 04:40:00,0,0,4,0,0,2,4,10
2024-03-11 04:50:00,0,0,4,0,0,3,5,12
2024-03-11 05:00:00,0,0,3,0,0,2,4,9
2024-03-11 05:10:00,0,0,7,0,0,7,7,21
2024-03-11 05:20:00,0,0,7,0,0,13,12,32
2024-03-11 05:30:00,0,0,10,0,0,17,13,40
2024-03-11 05:40:00,0,0,6,0,0,12,14,32
2024-03-11 05:50:00,0,0,17,0,0,14,8,39
2024-03-11 06:00:00,0,0,11,0,0,19,13,43
2024-03-11 06:10:00,0,0,11,0,0,24,15,50
2024-03-11 06:20:00,0,0,12,0,0,26,18,56
2024-03-11 06:30:00,0,0,11,0,0,27,24,62
2024-03-11 06:40:00,0,0,13,0,0,42,44,99
2024-03-11 06:50:00,0,0,14,0,0,43,43,100
2024-03-11 07:00:00,0,0,17,0,0,49,40,106
2024-03-11 07:10:00,0,0,16,0,0,54,42,112
2024-03-11 07:20:00,0,0,13,0,0,55,55,123
2024-03-11 07:30:00,0,0,22,0,0,60,65,147
2024-03-11 07:40:00,0,0,21,0,0,60,69,150
2024-03-11 07:50:00,0,0,14,0,0,40,69,123
2024-03-11 08:00:00,0,0,14,0,0,51,67,132
2024-03-11 08:10:00,0,0,28,0,0,62,59,149
2024-03-11 08:20:00,0,0,28,0,0,65,55,148
2024-03-11 08:30:00,0,0,13,0,0,56,60,129
2024-03-11 08:40:00,0,0,15,0,0,66,51,132
2024-03-11 08:50:00,0,0,19,0,0,52,63,134
2024-03-11 09:00:00,0,0,23,0,0,48,42,113
2024-03-11 09:10:00,0,0,13,0,0,54,45,112
2024-03-11 09:20:00,0,0,11,0,0,68,44,123
2024-03-11 09:30:00,0,0,16,0,0,61,47,124
2024-03-11 09:40:00,0,0,21,0,0,46,41,108
2024-03-11 09:50:00,0,0,18,0,0,47,39,104
2024-03-11 10:00:00,0,0,15,0,0,45,48,108
2024-03-11 10:10:00,0,0,22,0,0,47,36,105
2024-03-11 10:20:00,0,0,21,0,0,51,49,121
2024-03-11 10:30:00,0,0,20,0,0,42,51,113
2024-03-11 10:40:00,0,0,21,0,0,49,59,129
2024-03-11 10:50:00,0,0,9,0,0,38,34,81
2024-03-11 11:00:00,0,0,23,0,0,44,54,121
2024-03-11 11:10:00,0,0,19,0,0,42,47,108
2024-03-11 11:20:00,0,0,13,0,0,44,45,102
2024-03-11 11:30:00,0,0,22,0,0,40,40,102
2024-03-11 11:40:00,0,0,30,0,0,46,49,125
2024-03-11 11:50:00,0,0,27,0,0,50,57,134
2024-03-11 12:00:00,0,0,26,0,0,50,44,120
2024-03-11 12:10:00,0,0,14,0,0,44,48,106
2024-03-11 12:20:00,0,0,25,0,0,43,46,114
2024-03-11 12:30:00,0,0,23,0,0,42,38,103
2024-03-11 12:40:00,0,0,19,0,0,40,55,114
2024-03-11 12:50:00,0,0,27,0,0,56,41,124
2024-03-11 13:00:00,0,0,29,0,0,40,46,115
2024-03-11 13:10:00,0,0,19,0,0,57,44,120
2024-03-11 13:20:00,0,0,16,0,0,55,45,116
2024-03-11 13:30:00,0,0,22,0,0,44,45,111
2024-03-11 13:40:00,0,0,23,0,0,48,58,129
2024-03-11 13:50:00,0,0,27,0,0,40,49,116
2024-03-11 14:00:00,0,0,17,0,0,54,50,121
2024-03-11 14:10:00,0,0,27,0,0,54,50,131
2024-03-11 14:20:00,0,0,20,0,0,51,58,129
2024-03-11 14:30:00,0,0,26,0,0,56,47,129
2024-03-11 14:40:00,0,0,27,0,0,60,45,132
2024-03-11 14:50:00,0,0,34,0,0,52,47,133
2024-03-11 15:00:00,0,0,35,0,0,49,72,156
2024-03-11 15:10:00,0,0,24,0,0,43,50,117
2024-03-11 15:20:00,0,0,23,0,0,58,80,161
2024-03-11 15:30:00,0,0,24,0,0,55,55,134
2024-03-11 15:40:00,0,0,26,0,0,54,56,136
2024-03-11 15:50:00,0,0,24,0,0,52,58,134
2024-03-11 16:00:00,0,0,28,0,0,57,65,150
2024-03-11 16:10:00,0,0,29,0,0,59,83,171
2024-03-11 16:20:00,0,0,29,0,0,56,56,141
2024-03-11 16:30:00,0,0,30,0,0,60,60,150
2024-03-11 16:40:00,0,0,38,0,0,70,69,177
2024-03-11 16:50:00,0,0,31,0,0,61,72,164
2024-03-11 17:00:00,0,0,28,0,0,61,59,148
2024-03-11 17:10:00,0,0,29,0,0,52,68,149
2024-03-11 17:20:00,0,0,33,0,0,55,72,160
2024-03-11 17:30:00,0,0,20,0,0,60,69,149
2024-03-11 17:40:00,0,0,20,0,0,63,47,130
2024-03-11 17:50:00,0,0,28,0,0,61,69,158
2024-03-11 18:00:00,0,0,21,0,0,46,57,124
2024-03-11 18:10:00,0,0,19,0,0,56,55,130
2024-03-11 18:20:00,0,0,13,0,0,39,54,106
2024-03-11 18:30:00,0,0,26,0,0,46,57,129
2024-03-11 18:40:00,0,0,13,0,0,35,48,96
2024-03-11 18:50:00,0,0,14,0,0,36,44,94
2024-03-11 19:00:00,0,0,16,0,0,29,51,96
2024-03-11 19:10:00,0,0,8,0,0,45,34,87
2024-03-11 19:20:00,0,0,15,0,0,39,49,103
2024-03-11 19:30:00,0,0,17,0,0,30,38,85
2024-03-11 19:40:00,0,0,13,0,0,34,47,94
2024-03-11 19:50:00,0,0,17,0,0,34,38,89
2024-03-11 20:00:00,0,0,15,0,0,26,29,70
2024-03-11 20:10:00,0,0,13,0,0,27,25,65
2024-03-11 20:20:00,0,0,9,0,0,25,29,63
2024-03-11 20:30:00,0,0,13,0,0,15,23,51
2024-03-11 20:40:00,0,0,7,0,0,18,22,47
2024-03-11 20:50:00,0,0,10,0,0,16,19,45
2024-03-11 21:00:00,0,0,8,0,0,20,33,61
2024-03-11 21:10:00,0,0,4,0,0,20,23,47
2024-03-11 21:20:00,0,0,6,0,0,21,19,46
2024-03-11 21:30:00,0,0,10,0,0,12,24,46
2024-03-11 21:40:00,0,0,8,0,0,12,19,39
2024-03-11 21:50:00,0,0,6,0,0,16,19,41
2024-03-11 22:00:00,0,0,6,0,0,8,11,25
2024-03-11 22:10:00,0,0,6,0,0,11,19,36
2024-03-11 22:20:00,0,0,3,0,0,15,16,34
2024-03-11 22:30:00,0,0,4,0,0,14,8,26
2024-03-11 22:40:00,0,0,2,0,0,8,15,25
2024-03-11 22:50:00,0,0,3,0,0,8,6,17
2024-03-11 23:00:00,0,0,2,0,0,15,9,26
2024-03-11 23:10:00,0,0,4,0,0,8,10,22
2024-03-11 23:20:00,0,0,1,0,0,10,16,27
2024-03-11 23:30:00,0,0,0,0,0,9,10,19
2024-03-11 23:40:00,0,0,3,0,0,1,6,10
2024-03-11 23:50:00,0,0,1,0,0,3,10,14
2024-03-12 00:00:00,0,0,2,0,0,4,9,15
2024-03-12 00:10:00,0,0,1,0,0,3,5,9
2024-03-12 00:20:00,0,0,0,0,0,2,1,3
2024-03-12 00:30:00,0,0,1,0,0,5,3,9
2024-03-12 00:40:00,0,0,0,0,0,4,5,9
2024-03-12 00:50:00,0,0,1,0,0,3,5,9
2024-03-12 01:00:00,0,0,2,0,0,2,2,6
2024-03-12 01:10:00,0,0,1,0,0,3,5,9
2024-03-12 01:20:00,0,0,1,0,0,0,1,2
2024-03-12 01:30:00,0,0,0,0,0,1,3,4
2024-03-12 01:40:00,0,0,0,0,0,1,1,2
2024-03-12 01:50:00,0,0,0,0,0,1,2,3
2024-03-12 02:00:00,0,0,0,0,0,2,4,6
2024-03-12 02:10:00,0,0,0,0,0,1,0,1
2024-03-12 02:20:00,0,0,0,0,0,1,1,2
2024-03-12 02:30:00,0,0,1,0,0,3,3,7
2024-03-12 02:40:00,0,0,0,0,0,1,3,4
2024-03-12 02:50:00,0,0,0,0,0,1,2,3
2024-03-12 03:00:00,0,0,0,0,0,3,1,4
2024-03-12 03:10:00,0,0,0,0,0,3,2,5
2024-03-12 03:20:00,0,0,1,0,0,1,3,5
2024-03-12 03:30:00,0,0,1,0,0,3,7,11
2024-03-12 03:40:00,0,0,0,0,0,2,2,4
2024-03-12 03:50:00,0,0,1,0,0,2,5,8
2024-03-12 04:00:00,0,0,0,0,0,1,2,3
2024-03-12 04:10:00,0,0,0,0,0,3,1,4
2024-03-12 04:20:00,0,0,0,0,0,1,3,4
2024-03-12 04:30:00,0,0,3,0,0,2,4,9
2024-03-12 04:40:00,0,0,4,0,0,1,2,7
2024-03-12 04:50:00,0,0,4,0,0,5,2,11
2024-03-12 05:00:00,0,0,4,0,0,4,6,14
2024-03-12 05:10:00,0,0,6,0,0,10,9,25
2024-03-12 05:20:00,0,0,5,0,0,10,11,26
2024-03-12 05:30:00,0,0,4,0,0,16,10,30
2024-03-12 05:40:00,0,0,12,0,0,18,14,44
2024-03-12 05:50:00,0,0,10,0,0,19,14,43
2024-03-12 06:00:00,0,0,7,0,0,17,21,45
2024-03-12 06:10:00,0,0,14,0,0,23,17,54
2024-03-12 06:20:00,0,0,9,0,0,23,26,58
2024-03-12 06:30:00,0,0,11,0,0,38,30,79
2024-03-12 06:40:00,0,0,18,0,0,31,27,76
2024-03-12 06:50:00,0,0,13,0,0,46,34,93
2024-03-12 07:00:00,0,0,9,0,0,58,50,117
2024-03-12 07:10:00,0,0,19,0,0,47,42,108
2024-03-12 07:20:00,0,0,21,0,0,73,58,152
2024-03-12 07:30:00,0,0,19,0,0,63,71,153
2024-03-12 07:40:00,0,0,18,0,0,58,67,143
2024-03-12 07:50:00,0,0,19,0,0,55,73,147
2024-03-12 08:00:00,0,0,20,0,0,62,67,149
2024-03-12 08:10:00,0,0,30,0,0,47,56,133
2024-03-12 08:20:00,0,0,16,0,0,59,69,144
2024-03-12 08:30:00,0,0,17,0,0,50,72,139
2024-03-12 08:40:00,0,0,21,0,0,52,64,137
2024-03-12 08:50:00,0,0,18,0,0,60,49,127
2024-03-12 09:00:00,0,0,17,0,0,48,45,110
2024-03-12 09:10:00,0,0,19,0,0,50,43,112
2024-03-12 09:20:00,0,0,17,0,0,50,55,122
2024-03-12 09:30:00,0,0,14,0,0,53,54,121
2024-03-12 09:40:00,0,0,18,0,0,43,60,121
2024-03-12 09:50:00,0,0,22,0,0,55,57,134
2024-03-12 10:00:00,0,0,13,0,0,32,41,86
2024-03-12 10:10:00,0,0,20,0,0,56,30,106
2024-03-12 10:20:00,0,0,12,0,0,45,42,99
2024-03-12 10:30:00,0,0,14,0,0,46,52,112
2024-03-12 10:40:00,0,0,27,0,0,40,45,112
2024-03-12 10:50:00,0,0,20,0,0,50,41,111
2024-03-12 11:00:00,0,0,22,0,0,33,47,102
2024-03-12 11:10:00,0,0,18,0,0,41,35,94
2024-03-12 11:20:00,0,0,22,0,0,49,32,103
2024-03-12 11:30:00,0,0,15,0,0,51,46,112
2024-03-12 11:40:00,0,0,22,0,0,43,43,108
2024-03-12 11:50:00,0,0,28,0,0,44,42,114
2024-03-12 12:00:00,0,0,17,0,0,40,42,99
2024-03-12 12:10:00,0,0,29,0,0,48,50,127
2024-03-12 12:20:00,0,0,13,0,0,62,56,131
2024-03-12 12:30:00,0,0,26,0,0,57,48,131
2024-03-12 12:40:00,0,0,27,0,0,39,50,116
2024-03-12 12:50:00,0,0,30,0,0,37,37,104
2024-03-12 13:00:00,0,0,23,0,0,46,44,113
2024-03-12 13:10:00,0,0,30,0,0,44,42,116
2024-03-12 13:20:00,0,0,21,0,0,38,42,101
2024-03-12 13:30:00,0,0,22,0,0,50,41,113
2024-03-12 13:40:00,0,0,16,0,0,50,50,116
2024-03-12 13:50:00,0,0,27,0,0,44,58,129
2024-03-12 14:00:00,0,0,29,0,0,44,46,119
2024-03-12 14:10:00,0,0,31,0,0,37,55,123
2024-03-12 14:20:00,0,0,23,0,0,59,60,142
2024-03-12 14:30:00,0,0,27,0,0,48,55,130
2024-03-12 14:40:00,0,0,28,0,0,51,55,134
2024-03-12 14:50:00,0,0,26,0,0,55,44,125
2024-03-12 15:00:00,0,0,28,0,0,31,65,124
2024-03-12 15:10:00,0,0,36,0,0,41,48,125
2024-03-12 15:20:00,0,0,37,0,0,55,54,146
2024-03-12 15:30:00,0,0,32,0,0,61,64,157
2024-03-12 15:40:00,0,0,24,0,0,61,64,149
2024-03-12 15:50:00,0,0,31,0,0,65,63,159
2024-03-12 16:00:00,0,0,26,0,0,41,69,136
2024-03-12 16:10:00,0,0,17,0,0,54,62,133
2024-03-12 16:20:00,0,0,24,0,0,53,61,138
2024-03-12 16:30:00,0,0,31,0,0,85,70,186
2024-03-12 16:40:00,0,0,21,0,0,51,57,129
2024-03-12 16:50:00,0,0,29,0,0,62,75,166
2024-03-12 17:00:00,0,0,17,0,0,64,70,151
2024-03-12 17:10:00,0,0,29,0,0,56,70,155
2024-03-12 17:20:00,0,0,31,0,0,69,82,182
2024-03-12 17:30:00,0,0,27,0,0,62,84,173
2024-03-12 17:40:00,0,0,23,0,0,56,77,156
2024-03-12 17:50:00,0,0,16,0,0,66,76,158
2024-03-12 18:00:00,0,0,27,0,0,53,69,149
2024-03-12 18:10:00,0,0,20,0,0,51,56,127
2024-03-12 18:20:00,0,0,20,0,0,57,67,144
2024-03-12 18:30:00,0,0,22,0,0,45,52,119
2024-03-12 18:40:00,0,0,18,0,0,35,33,86
2024-03-12 18:50:00,0,0,26,0,0,33,48,107
2024-03-12 19:00:00,0,0,12,0,0,37,51,100
2024-03-12 19:10:00,0,0,12,0,0,39,45,96
2024-03-12 19:20:00,0,0,17,0,0,32,45,94
2024-03-12 19:30:00,0,0,14,0,0,38,46,98
2024-03-12 19:40:00,0,0,17,0,0,32,52,101
2024-03-12 19:50:00,0,0,27,0,0,39,39,105
2024-03-12 20:00:00,0,0,12,0,0,20,24,56
2024-03-12 20:10:00,0,0,12,0,0,23,29,64
2024-03-12 20:20:00,0,0,10,0,0,35,16,61
2024-03-12 20:30:00,0,0,7,0,0,16,26,49
2024-03-12 20:40:00,0,0,10,0,0,19,29,58
2024-03-12 20:50:00,0,0,4,0,0,11,25,40
2024-03-12 21:00:00,0,0,7,0,0,18,16,41
2024-03-12 21:10:00,0,0,5,0,0,19,33,57
2024-03-12 21:20:00,0,0,6,0,0,20,35,61
2024-03-12 21:30:00,0,0,4,0,0,9,17,30
2024-03-12 21:40:00,0,0,8,0,0,10,16,34
2024-03-12 21:50:00,0,0,10,0,0,18,12,40
2024-03-12 22:00:00,0,0,3,0,0,17,11,31
2024-03-12 22:10:00,0,0,6,0,0,10,11,27
2024-03-12 22:20:00,0,0,9,0,0,15,16,40
2024-03-12 22:30:00,0,0,2,0,0,9,6,17
2024-03-12 22:40:00,0,0,7,0,0,20,13,40
2024-03-12 22:50:00,0,0,4,0,0,12,14,30
2024-03-12 23:00:00,0,0,6,0,0,11,6,23
2024-03-12 23:10:00,0,0,3,0,0,6,8,17
2024-03-12 23:20:00,0,0,4,0,0,6,7,17
2024-03-12 23:30:00,0,0,1,0,0,9,8,18
2024-03-12 23:40:00,0,0,1,0,0,3,7,11
2024-03-12 23:50:00,0,0,3,0,0,2,3,8
2024-03-13 00:00:00,0,0,2,0,0,6,6,14
2024-03-13 00:10:00,0,0,0,0,0,6,4,10
2024-03-13 00:20:00,0,0,0,0,0,1,6,7
2024-03-13 00:30:00,0,0,1,0,0,4,4,9
2024-03-13 00:40:00,0,0,1,0,0,1,4,6
2024-03-13 00:50:00,0,0,1,0,0,3,3,7
2024-03-13 01:00:00,0,0,1,0,0,5,2,8
2024-03-13 01:10:00,0,0,1,0,0,9,6,16
2024-03-13 01:20:00,0,0,1,0,0,0,3,4
2024-03-13 01:30:00,0,0,0,0,0,0,5,5
2024-03-13 01:40:00,0,0,0,0,0,2,2,4
2024-03-13 01:50:00,0,0,0,0,0,1,1,2
2024-03-13 02:00:00,0,0,1,0,0,2,4,7
2024-03-13 02:10:00,0,0,2,0,0,1,1,4
2024-03-13 02:20:00,0,0,0,0,0,1,0,1
2024-03-13 02:30:00,0,0,0,0,0,1,1,2
2024-03-13 02:40:00,0,0,1,0,0,1,1,3
2024-03-13 02:50:00,0,0,0,0,0,3,2,5
2024-03-13 03:00:00,0,0,0,0,0,3,1,4
2024-03-13 03:10:00,0,0,0,0,0,1,1,2
2024-03-13 03:20:00,0,0,1,0,0,3,5,9
2024-03-13 03:30:00,0,0,2,0,0,2,3,7
2024-03-13 03:40:00,0,0,0,0,0,1,2,3
2024-03-13 03:50:00,0,0,1,0,0,3,5,9
2024-03-13 04:00:00,0,0,1,0,0,1,0,2
2024-03-13 04:10:00,0,0,2,0,0,3,2,7
2024-03-13 04:20:00,0,0,1,0,0,5,4,10
2024-03-13 04:30:00,0,0,3,0,0,3,7,13
2024-03-13 04:40:00,0,0,5,0,0,2,2,9
2024-03-13 04:50:00,0,0,4,0,0,4,2,10
2024-03-13 05:00:00,0,0,0,0,0,6,8,14
2024-03-13 05:10:00,0,0,7,0,0,15,6,28
2024-03-13 05:20:00,0,0,10,0,0,6,8,24
2024-03-13 05:30:00,0,0,2,0,0,10,9,21
2024-03-13 05:40:00,0,0,9,0,0,11,11,31
2024-03-13 05:50:00,0,0,12,0,0,19,14,45
2024-03-13 06:00:00,0,0,7,0,0,24,14,45
2024-03-13 06:10:00,0,0,14,0,0,26,17,57
2024-03-13 06:20:00,0,0,10,0,0,25,21,56
2024-03-13 06:30:00,0,0,12,0,0,30,29,71
2024-03-13 06:40:00,0,0,7,0,0,32,36,75
2024-03-13 06:50:00,0,0,17,0,0,41,46,104
2024-03-13 07:00:00,0,0,11,0,0,50,43,104
2024-03-13 07:10:00,0,0,13,0,0,48,39,100
2024-03-13 07:20:00,0,0,15,0,0,58,52,125
2024-03-13 07:30:00,0,0,19,0,0,54,70,143
2024-03-13 07:40:00,0,0,19,0,0,55,69,143
2024-03-13 07:50:00,0,0,13,0,0,53,58,124
2024-03-13 08:00:00,0,0,26,0,0,61,57,144
2024-03-13 08:10:00,0,0,19,0,0,63,56,138
2024-03-13 08:20:00,0,0,17,0,0,62,52,131
2024-03-13 08:30:00,0,0,17,0,0,54,69,140
2024-03-13 08:40:00,0,0,18,0,0,55,61,134
2024-03-13 08:50:00,0,0,16,0,0,61,57,134
2024-03-13 09:00:00,0,0,18,0,0,50,52,120
2024-03-13 09:10:00,0,0,15,0,0,54,43,112
2024-03-13 09:20:00,0,0,10,0,0,53,58,121
2024-03-13 09:30:00,0,0,10,0,0,62,50,122
2024-03-13 09:40:00,0,0,16,0,0,40,39,95
2024-03-13 09:50:00,0,0,12,0,0,47,38,97
2024-03-13 10:00:00,0,0,20,0,0,14,74,108
2024-03-13 10:10:00,0,0,18,0,0,36,36,90
2024-03-13 10:20:00,0,0,15,0,0,46,33,94
2024-03-13 10:30:00,0,0,16,0,0,43,44,103
2024-03-13 10:40:00,0,0,20,0,0,51,35,106
2024-03-13 10:50:00,0,0,13,0,0,42,46,101
2024-03-13 11:00:00,0,0,13,0,0,44,37,94
2024-03-13 11:10:00,0,0,22,0,0,33,24,79
2024-03-13 11:20:00,0,0,21,0,0,62,47,130
2024-03-13 11:30:00,0,0,23,0,0,51,36,110
2024-03-13 11:40:00,0,0,19,0,0,39,45,103
2024-03-13 11:50:00,0,0,24,0,0,50,44,118
2024-03-13 12:00:00,0,0,27,0,0,52,59,138
2024-03-13 12:10:00,0,0,19,0,0,40,45,104
2024-03-13 12:20:00,0,0,21,0,0,37,35,93
2024-03-13 12:30:00,0,0,22,0,0,41,44,107
2024-03-13 12:40:00,0,0,21,0,0,52,46,119
2024-03-13 12:50:00,0,0,25,0,0,51,43,119
2024-03-13 13:00:00,0,0,17,0,0,41,39,97
2024-03-13 13:10:00,0,0,23,0,0,48,35,106
2024-03-13 13:20:00,0,0,25,0,0,43,48,116
2024-03-13 13:30:00,0,0,25,0,0,42,27,94
2024-03-13 13:40:00,0,0,20,0,0,42,36,98
2024-03-13 13:50:00,0,0,31,0,0,35,50,116
2024-03-13 14:00:00,0,0,23,0,0,50,50,123
2024-03-13 14:10:00,0,0,27,0,0,45,41,113
2024-03-13 14:20:00,0,0,23,0,0,52,56,131
2024-03-13 14:30:00,0,0,26,0,0,49,64,139
2024-03-13 14:40:00,0,0,28,0,0,53,60,141
2024-03-13 14:50:00,0,0,33,0,0,56,51,140
2024-03-13 15:00:00,0,0,27,0,0,52,51,130
2024-03-13 15:10:00,0,0,30,0,0,55,58,143
2024-03-13 15:20:00,0,0,27,0,0,44,59,130
2024-03-13 15:30:00,0,0,32,0,0,59,55,146
2024-03-13 15:40:00,0,0,21,0,0,47,63,131
2024-03-13 15:50:00,0,0,34,0,0,56,69,159
2024-03-13 16:00:00,0,0,22,0,0,51,45,118
2024-03-13 16:10:00,0,0,28,0,0,69,80,177
2024-03-13 16:20:00,0,0,29,0,0,73,64,166
2024-03-13 16:30:00,0,0,25,0,0,50,67,142
2024-03-13 16:40:00,0,0,23,0,0,60,85,168
2024-03-13 16:50:00,0,0,30,0,0,67,72,169
2024-03-13 17:00:00,0,0,31,0,0,66,63,160
2024-03-13 17:10:00,0,0,22,0,0,60,69,151
2024-03-13 17:20:00,0,0,36,0,0,54,83,173
2024-03-13 17:30:00,0,0,28,0,0,49,54,131
2024-03-13 17:40:00,0,0,26,0,0,59,69,154
2024-03-13 17:50:00,0,0,18,0,0,49,68,135
2024-03-13 18:00:00,0,0,21,0,0,57,80,158
2024-03-13 18:10:00,0,0,11,0,0,46,59,116
2024-03-13 18:20:00,0,0,11,0,0,42,80,133
2024-03-13 18:30:00,0,0,14,0,0,53,65,132
2024-03-13 18:40:00,0,0,12,0,0,40,69,121
2024-03-13 18:50:00,0,0,18,0,0,32,52,102
2024-03-13 19:00:00,0,0,15,0,0,32,45,92
2024-03-13 19:10:00,0,0,10,0,0,43,47,100
2024-03-13 19:20:00,0,0,15,0,0,37,48,100
2024-03-13 19:30:00,0,0,19,0,0,37,45,101
2024-03-13 19:40:00,0,0,13,0,0,22,54,89
2024-03-13 19:50:00,0,0,23,0,0,37,50,110
2024-03-13 20:00:00,0,0,17,0,0,26,33,76
2024-03-13 20:10:00,0,0,9,0,0,26,30,65
2024-03-13 20:20:00,0,0,14,0,0,26,27,67
2024-03-13 20:30:00,0,0,9,0,0,25,41,75
2024-03-13 20:40:00,0,0,13,0,0,21,22,56
2024-03-13 20:50:00,0,0,9,0,0,17,21,47
2024-03-13 21:00:00,0,0,11,0,0,27,25,63
2024-03-13 21:10:00,0,0,6,0,0,19,21,46
2024-03-13 21:20:00,0,0,8,0,0,12,21,41
2024-03-13 21:30:00,0,0,8,0,0,17,17,42
2024-03-13 21:40:00,0,0,10,0,0,16,17,43
2024-03-13 21:50:00,0,0,7,0,0,8,15,30
2024-03-13 22:00:00,0,0,2,0,0,11,16,29
2024-03-13 22:10:00,0,0,5,0,0,11,12,28
2024-03-13 22:20:00,0,0,5,0,0,11,15,31
2024-03-13 22:30:00,0,0,4,0,0,14,19,37
2024-03-13 22:40:00,0,0,5,0,0,23,24,52
2024-03-13 22:50:00,0,0,3,0,0,10,6,19
2024-03-13 23:00:00,0,0,6,0,0,12,19,37
2024-03-13 23:10:00,0,0,1,0,0,10,14,25
2024-03-13 23:20:00,0,0,1,0,0,11,11,23
2024-03-13 23:30:00,0,0,5,0,0,8,12,25
2024-03-13 23:40:00,0,0,6,0,0,4,7,17
2024-03-13 23:50:00,0,0,1,0,0,3,5,9
2024-03-14 00:00:00,0,0,1,0,0,8,6,15
2024-03-14 00:10:00,0,0,2,0,0,7,8,17
2024-03-14 00:20:00,0,0,1,0,0,5,6,12
2024-03-14 00:30:00,0,0,2,0,0,2,3,7
2024-03-14 00:40:00,0,0,0,0,0,2,7,9
2024-03-14 00:50:00,0,0,0,0,0,2,3,5
2024-03-14 01:00:00,0,0,2,0,0,2,1,5
2024-03-14 01:10:00,0,0,1,0,0,3,6,10
2024-03-14 01:20:00,0,0,2,0,0,3,3,8
2024-03-14 01:30:00,0,0,4,0,0,2,6,12
2024-03-14 01:40:00,0,0,0,0,0,1,2,3
2024-03-14 01:50:00,0,0,0,0,0,0,1,1
2024-03-14 02:00:00,0,0,0,0,0,0,3,3
2024-03-14 02:10:00,0,0,0,0,0,1,0,1
2024-03-14 02:20:00,0,0,0,0,0,1,1,2
2024-03-14 02:30:00,0,0,0,0,0,4,7,11
2024-03-14 02:40:00,0,0,0,0,0,1,2,3
2024-03-14 02:50:00,0,0,1,0,0,2,3,6
2024-03-14 03:00:00,0,0,0,0,0,3,1,4
2024-03-14 03:10:00,0,0,0,0,0,2,3,5
2024-03-14 03:20:00,0,0,3,0,0,1,6,10
2024-03-14 03:30:00,0,0,1,0,0,2,2,5
2024-03-14 03:40:00,0,0,0,0,0,1,3,4
2024-03-14 03:50:00,0,0,1,0,0,2,1,4
2024-03-14 04:00:00,0,0,0,0,0,2,3,5
2024-03-14 04:10:00,0,0,0,0,0,4,6,10
2024-03-14 04:20:00,0,0,0,0,0,2,3,5
2024-03-14 04:30:00,0,0,6,0,0,1,3,10
2024-03-14 04:40:00,0,0,1,0,0,4,5,10
2024-03-14 04:50:00,0,0,4,0,0,4,5,13
2024-03-14 05:00:00,0,0,5,0,0,5,4,14
2024-03-14 05:10:00,0,0,6,0,0,5,9,20
2024-03-14 05:20:00,0,0,8,0,0,13,7,28
2024-03-14 05:30:00,0,0,3,0,0,17,10,30
2024-03-14 05:40:00,0,0,8,0,0,12,10,30
2024-03-14 05:50:00,0,0,13,0,0,19,11,43
2024-03-14 06:00:00,0,0,12,0,0,20,13,45
2024-03-14 06:10:00,0,0,21,0,0,24,16,61
2024-03-14 06:20:00,0,0,11,0,0,26,20,57
2024-03-14 06:30:00,0,0,8,0,0,23,25,56
2024-03-14 06:40:00,0,0,13,0,0,31,28,72
2024-03-14 06:50:00,0,0,14,0,0,33,31,78
2024-03-14 07:00:00,0,0,12,0,0,49,54,115
2024-03-14 07:10:00,0,0,13,0,0,48,37,98
2024-03-14 07:20:00,0,0,18,0,0,68,57,143
2024-03-14 07:30:00,0,0,11,0,0,63,63,137
2024-03-14 07:40:00,0,0,16,0,0,49,62,127
2024-03-14 07:50:00,0,0,23,0,0,62,83,168
2024-03-14 08:00:00,0,0,12,0,0,50,70,132
2024-03-14 08:10:00,0,0,17,0,0,49,62,128
2024-03-14 08:20:00,0,0,15,0,0,50,56,121
2024-03-14 08:30:00,0,0,17,0,0,50,47,114
2024-03-14 08:40:00,0,0,18,0,0,43,67,128
2024-03-14 08:50:00,0,0,21,0,0,60,67,148
2024-03-14 09:00:00,0,0,11,0,0,60,55,126
2024-03-14 09:10:00,0,0,26,0,0,35,36,97
2024-03-14 09:20:00,0,0,18,0,0,42,45,105
2024-03-14 09:30:00,0,0,21,0,0,54,51,126
2024-03-14 09:40:00,0,0,16,0,0,53,53,122
2024-03-14 09:50:00,0,0,19,0,0,47,41,107
2024-03-14 10:00:00,0,0,15,0,0,43,35,93
2024-03-14 10:10:00,0,0,21,0,0,28,39,88
2024-03-14 10:20:00,0,0,24,0,0,33,44,101
2024-03-14 10:30:00,0,0,18,0,0,45,46,109
2024-03-14 10:40:00,0,0,20,0,0,56,54,130
2024-03-14 10:50:00,0,0,23,0,0,50,45,118
2024-03-14 11:00:00,0,0,21,0,0,38,41,100
2024-03-14 11:10:00,0,0,27,0,0,42,49,118
2024-03-14 11:20:00,0,0,25,0,0,37,34,96
2024-03-14 11:30:00,0,0,33,0,0,55,47,135
2024-03-14 11:40:00,0,0,22,0,0,46,49,117
2024-03-14 11:50:00,0,0,25,0,0,49,48,122
2024-03-14 12:00:00,0,0,30,0,0,44,56,130
2024-03-14 12:10:00,0,0,23,0,0,53,50,126
2024-03-14 12:20:00,0,0,30,0,0,49,47,126
2024-03-14 12:30:00,0,0,22,0,0,37,40,99
2024-03-14 12:40:00,0,0,22,0,0,45,53,120
2024-03-14 12:50:00,0,0,20,0,0,48,44,112
2024-03-14 13:00:00,0,0,19,0,0,44,49,112
2024-03-14 13:10:00,0,0,28,0,0,46,31,105
2024-03-14 13:20:00,0,0,25,0,0,44,57,126
2024-03-14 13:30:00,0,0,26,0,0,48,41,115
2024-03-14 13:40:00,0,0,18,0,0,63,56,137
2024-03-14 13:50:00,0,0,26,0,0,45,49,120
2024-03-14 14:00:00,0,0,24,0,0,46,63,133
2024-03-14 14:10:00,0,0,24,0,0,40,49,113
2024-03-14 14:20:00,0,0,17,0,0,36,65,118
2024-03-14 14:30:00,0,0,29,0,0,40,59,128
2024-03-14 14:40:00,0,0,19,0,0,58,58,135
2024-03-14 14:50:00,0,0,27,0,0,50,54,131
2024-03-14 15:00:00,0,0,23,0,0,53,53,129
2024-03-14 15:10:00,0,0,20,0,0,53,57,130
2024-03-14 15:20:00,0,0,25,0,0,51,76,152
2024-03-14 15:30:00,0,0,22,0,0,62,41,125
2024-03-14 15:40:00,0,0,30,0,0,63,63,156
2024-03-14 15:50:00,0,0,27,0,0,47,65,139
2024-03-14 16:00:00,0,0,34,0,0,37,70,141
2024-03-14 16:10:00,0,0,21,0,0,60,76,157
2024-03-14 16:20:00,0,0,25,0,0,48,60,133
2024-03-14 16:30:00,0,0,39,0,0,66,81,186
2024-03-14 16:40:00,0,0,17,0,0,41,50,108
2024-03-14 16:50:00,0,0,32,0,0,62,61,155
2024-03-14 17:00:00,0,0,27,0,0,48,73,148
2024-03-14 17:10:00,0,0,22,0,0,58,70,150
2024-03-14 17:20:00,0,0,32,0,0,71,77,180
2024-03-14 17:30:00,0,0,26,0,0,56,63,145
2024-03-14 17:40:00,0,0,24,0,0,50,71,145
2024-03-14 17:50:00,0,0,19,0,0,64,66,149
2024-03-14 18:00:00,0,0,21,0,0,66,73,160
2024-03-14 18:10:00,0,0,15,0,0,48,69,132
2024-03-14 18:20:00,0,0,22,0,0,55,78,155
2024-03-14 18:30:00,0,0,13,0,0,45,55,113
2024-03-14 18:40:00,0,0,11,0,0,33,54,98
2024-03-14 18:50:00,0,0,9,0,0,30,38,77
2024-03-14 19:00:00,0,0,19,0,0,50,32,101
2024-03-14 19:10:00,0,0,15,0,0,29,42,86
2024-03-14 19:20:00,0,0,10,0,0,33,54,97
2024-03-14 19:30:00,0,0,27,0,0,31,51,109
2024-03-14 19:40:00,0,0,17,0,0,31,43,91
2024-03-14 19:50:00,0,0,18,0,0,29,42,89
2024-03-14 20:00:00,0,0,21,0,0,26,28,75
2024-03-14 20:10:00,0,0,12,0,0,36,33,81
2024-03-14 20:20:00,0,0,11,0,0,24,26,61
2024-03-14 20:30:00,0,0,11,0,0,31,25,67
2024-03-14 20:40:00,0,0,13,0,0,21,24,58
2024-03-14 20:50:00,0,0,9,0,0,19,30,58
2024-03-14 21:00:00,0,0,9,0,0,19,17,45
2024-03-14 21:10:00,0,0,7,0,0,22,21,50
2024-03-14 21:20:00,0,0,10,0,0,16,19,45
2024-03-14 21:30:00,0,0,7,0,0,21,30,58
2024-03-14 21:40:00,0,0,9,0,0,11,21,41
2024-03-14 21:50:00,0,0,4,0,0,11,15,30
2024-03-14 22:00:00,0,0,3,0,0,16,12,31
2024-03-14 22:10:00,0,0,10,0,0,17,14,41
2024-03-14 22:20:00,0,0,3,0,0,15,24,42
2024-03-14 22:30:00,0,0,8,0,0,17,24,49
2024-03-14 22:40:00,0,0,4,0,0,14,13,31
2024-03-14 22:50:00,0,0,2,0,0,14,15,31
2024-03-14 23:00:00,0,0,2,0,0,10,19,31
2024-03-14 23:10:00,0,0,3,0,0,7,14,24
2024-03-14 23:20:00,0,0,1,0,0,9,11,21
2024-03-14 23:30:00,0,0,5,0,0,11,10,26
2024-03-14 23:40:00,0,0,2,0,0,6,10,18
2024-03-14 23:50:00,0,0,2,0,0,8,14,24
2024-03-15 00:00:00,0,0,2,0,0,9,7,18
2024-03-15 00:10:00,0,0,2,0,0,6,10,18
2024-03-15 00:20:00,0,0,0,0,0,3,3,6
2024-03-15 00:30:00,0,0,3,0,0,4,8,15
2024-03-15 00:40:00,0,0,0,0,0,0,0,0
2024-03-15 00:50:00,0,0,0,0,0,4,5,9
2024-03-15 01:00:00,0,0,3,0,0,2,4,9
2024-03-15 01:10:00,0,0,2,0,0,6,7,15
2024-03-15 01:20:00,0,0,2,0,0,5,4,11
2024-03-15 01:30:00,0,0,0,0,0,0,2,2
2024-03-15 01:40:00,0,0,1,0,0,3,3,7
2024-03-15 01:50:00,0,0,0,0,0,2,2,4
2024-03-15 02:00:00,0,0,1,0,0,4,2,7
2024-03-15 02:10:00,0,0,3,0,0,1,3,7
2024-03-15 02:20:00,0,0,0,0,0,1,0,1
2024-03-15 02:30:00,0,0,0,0,0,2,3,5
2024-03-15 02:40:00,0,0,0,0,0,2,2,4
2024-03-15 02:50:00,0,0,0,0,0,0,3,3
2024-03-15 03:00:00,0,0,0,0,0,7,2,9
2024-03-15 03:10:00,0,0,0,0,0,2,1,3
2024-03-15 03:20:00,0,0,1,0,0,2,2,5
2024-03-15 03:30:00,0,0,2,0,0,4,5,11
2024-03-15 03:40:00,0,0,1,0,0,0,0,1
2024-03-15 03:50:00,0,0,3,0,0,1,2,6
2024-03-15 04:00:00,0,0,0,0,0,1,1,2
2024-03-15 04:10:00,0,0,0,0,0,3,4,7
2024-03-15 04:20:00,0,0,0,0,0,3,4,7
2024-03-15 04:30:00,0,0,3,0,0,2,6,11
2024-03-15 04:40:00,0,0,2,0,0,4,4,10
2024-03-15 04:50:00,0,0,6,0,0,4,5,15
2024-03-15 05:00:00,0,0,2,0,0,4,1,7
2024-03-15 05:10:00,0,0,5,0,0,5,6,16
2024-03-15 05:20:00,0,0,9,0,0,10,12,31
2024-03-15 05:30:00,0,0,3,0,0,17,13,33
2024-03-15 05:40:00,0,0,4,0,0,8,8,20
2024-03-15 05:50:00,0,0,10,0,0,17,8,35
2024-03-15 06:00:00,0,0,11,0,0,22,18,51
2024-03-15 06:10:00,0,0,16,0,0,20,11,47
2024-03-15 06:20:00,0,0,13,0,0,21,20,54
2024-03-15 06:30:00,0,0,7,0,0,24,24,55
2024-03-15 06:40:00,0,0,10,0,0,27,28,65
2024-03-15 06:50:00,0,0,9,0,0,41,29,79
2024-03-15 07:00:00,0,0,8,0,0,41,41,90
2024-03-15 07:10:00,0,0,15,0,0,52,39,106
2024-03-15 07:20:00,0,0,11,0,0,60,51,122
2024-03-15 07:30:00,0,0,14,0,0,45,60,119
2024-03-15 07:40:00,0,0,13,0,0,49,63,125
2024-03-15 07:50:00,0,0,17,0,0,48,52,117
2024-03-15 08:00:00,0,0,21,0,0,54,60,135
2024-03-15 08:10:00,0,0,15,0,0,52,40,107
2024-03-15 08:20:00,0,0,10,0,0,52,53,115
2024-03-15 08:30:00,0,0,16,0,0,46,57,119
2024-03-15 08:40:00,0,0,15,0,0,50,51,116
2024-03-15 08:50:00,0,0,9,0,0,58,63,130
2024-03-15 09:00:00,0,0,22,0,0,52,36,110
2024-03-15 09:10:00,0,0,13,0,0,50,37,100
2024-03-15 09:20:00,0,0,18,0,0,40,53,111
2024-03-15 09:30:00,0,0,24,0,0,39,50,113
2024-03-15 09:40:00,0,0,16,0,0,48,55,119
2024-03-15 09:50:00,0,0,14,0,0,54,38,106
2024-03-15 10:00:00,0,0,15,0,0,41,42,98
2024-03-15 10:10:00,0,0,17,0,0,47,34,98
2024-03-15 10:20:00,0,0,11,0,0,44,45,100
2024-03-15 10:30:00,0,0,23,0,0,43,37,103
2024-03-15 10:40:00,0,0,18,0,0,47,45,110
2024-03-15 10:50:00,0,0,17,0,0,55,50,122
2024-03-15 11:00:00,0,0,16,0,0,45,35,96
2024-03-15 11:10:00,0,0,25,0,0,42,50,117
2024-03-15 11:20:00,0,0,17,0,0,51,34,102
2024-03-15 11:30:00,0,0,13,0,0,59,38,110
2024-03-15 11:40:00,0,0,14,0,0,53,56,123
2024-03-15 11:50:00,0,0,25,0,0,53,46,124
2024-03-15 12:00:00,0,0,23,0,0,46,34,103
2024-03-15 12:10:00,0,0,29,0,0,41,43,113
2024-03-15 12:20:00,0,0,33,0,0,52,70,155
2024-03-15 12:30:00,0,0,28,0,0,55,63,146
2024-03-15 12:40:00,0,0,20,0,0,38,52,110
2024-03-15 12:50:00,0,0,34,0,0,63,50,147
2024-03-15 13:00:00,0,0,37,0,0,50,56,143
2024-03-15 13:10:00,0,0,33,0,0,52,49,134
2024-03-15 13:20:00,0,0,31,0,0,47,43,121
2024-03-15 13:30:00,0,0,36,0,0,57,72,165
2024-03-15 13:40:00,0,0,25,0,0,52,70,147
2024-03-15 13:50:00,0,0,30,0,0,46,69,145
2024-03-15 14:00:00,0,0,21,0,0,48,59,128
2024-03-15 14:10:00,0,0,21,0,0,50,67,138
2024-03-15 14:20:00,0,0,19,0,0,61,57,137
2024-03-15 14:30:00,0,0,30,0,0,47,60,137
2024-03-15 14:40:00,0,0,30,0,0,52,58,140
2024-03-15 14:50:00,0,0,26,0,0,61,65,152
2024-03-15 15:00:00,0,0,29,0,0,47,77,153
2024-03-15 15:10:00,0,0,23,0,0,51,58,132
2024-03-15 15:20:00,0,0,26,0,0,61,53,140
2024-03-15 15:30:00,0,0,30,0,0,53,79,162
2024-03-15 15:40:00,0,0,19,0,0,60,64,143
2024-03-15 15:50:00,0,0,26,0,0,72,52,150
2024-03-15 16:00:00,0,0,11,0,0,43,63,117
2024-03-15 16:10:00,0,0,20,0,0,61,56,137
2024-03-15 16:20:00,0,0,24,0,0,62,71,157
2024-03-15 16:30:00,0,0,23,0,0,48,56,127
2024-03-15 16:40:00,0,0,28,0,0,74,78,180
2024-03-15 16:50:00,0,0,27,0,0,59,61,147
2024-03-15 17:00:00,0,0,23,0,0,48,56,127
2024-03-15 17:10:00,0,0,19,0,0,43,60,122
2024-03-15 17:20:00,0,0,16,0,0,55,71,142
2024-03-15 17:30:00,0,0,19,0,0,54,60,133
2024-03-15 17:40:00,0,0,22,0,0,58,66,146
2024-03-15 17:50:00,0,0,35,0,0,52,72,159
2024-03-15 18:00:00,0,0,18,0,0,55,66,139
2024-03-15 18:10:00,0,0,21,0,0,50,64,135
2024-03-15 18:20:00,0,0,18,0,0,64,74,156
2024-03-15 18:30:00,0,0,19,0,0,51,53,123
2024-03-15 18:40:00,0,0,14,0,0,48,61,123
2024-03-15 18:50:00,0,0,8,0,0,45,48,101
2024-03-15 19:00:00,0,0,10,0,0,52,54,116
2024-03-15 19:10:00,0,0,10,0,0,33,44,87
2024-03-15 19:20:00,0,0,6,0,0,43,32,81
2024-03-15 19:30:00,0,0,13,0,0,51,42,106
2024-03-15 19:40:00,0,0,15,0,0,35,54,104
2024-03-15 19:50:00,0,0,21,0,0,37,47,105
2024-03-15 20:00:00,0,0,11,0,0,43,45,99
2024-03-15 20:10:00,0,0,17,0,0,18,35,70
2024-03-15 20:20:00,0,0,10,0,0,32,35,77
2024-03-15 20:30:00,0,0,11,0,0,37,28,76
2024-03-15 20:40:00,0,0,8,0,0,35,33,76
2024-03-15 20:50:00,0,0,6,0,0,19,33,58
2024-03-15 21:00:00,0,0,7,0,0,27,32,66
2024-03-15 21:10:00,0,0,2,0,0,24,33,59
2024-03-15 21:20:00,0,0,8,0,0,22,21,51
2024-03-15 21:30:00,0,0,8,0,0,25,30,63
2024-03-15 21:40:00,0,0,10,0,0,24,29,63
2024-03-15 21:50:00,0,0,8,0,0,22,16,46
2024-03-15 22:00:00,0,0,6,0,0,21,17,44
2024-03-15 22:10:00,0,0,4,0,0,20,22,46
2024-03-15 22:20:00,0,0,5,0,0,18,21,44
2024-03-15 22:30:00,0,0,8,0,0,18,20,46
2024-03-15 22:40:00,0,0,3,0,0,22,21,46
2024-03-15 22:50:00,0,0,4,0,0,10,20,34
2024-03-15 23:00:00,0,0,9,0,0,15,15,39
2024-03-15 23:10:00,0,0,2,0,0,9,11,22
2024-03-15 23:20:00,0,0,2,0,0,10,24,36
2024-03-15 23:30:00,0,0,1,0,0,10,20,31
2024-03-15 23:40:00,0,0,1,0,0,4,13,18
2024-03-15 23:50:00,0,0,4,0,0,8,17,29
2024-03-16 00:00:00,0,0,3,0,0,9,15,27
2024-03-16 00:10:00,0,0,4,0,0,10,18,32
2024-03-16 00:20:00,0,0,0,0,0,6,10,16
2024-03-16 00:30:00,0,0,4,0,0,5,7,16
2024-03-16 00:40:00,0,0,4,0,0,3,8,15
2024-03-16 00:50:00,0,0,3,0,0,5,9,17
2024-03-16 01:00:00,0,0,2,0,0,8,9,19
2024-03-16 01:10:00,0,0,2,0,0,5,10,17
2024-03-16 01:20:00,0,0,2,0,0,5,9,16
2024-03-16 01:30:00,0,0,2,0,0,3,9,14
2024-03-16 01:40:00,0,0,7,0,0,6,5,18
2024-03-16 01:50:00,0,0,2,0,0,5,9,16
2024-03-16 02:00:00,0,0,4,0,0,6,10,20
2024-03-16 02:10:00,0,0,0,0,0,4,4,8
2024-03-16 02:20:00,0,0,1,0,0,5,5,11
2024-03-16 02:30:00,0,0,2,0,0,2,7,11
2024-03-16 02:40:00,0,0,0,0,0,1,3,4
2024-03-16 02:50:00,0,0,0,0,0,1,4,5
2024-03-16 03:00:00,0,0,0,0,0,5,2,7
2024-03-16 03:10:00,0,0,2,0,0,6,8,16
2024-03-16 03:20:00,0,0,0,0,0,2,4,6
2024-03-16 03:30:00,0,0,2,0,0,5,5,12
2024-03-16 03:40:00,0,0,0,0,0,1,4,5
2024-03-16 03:50:00,0,0,0,0,0,4,4,8
2024-03-16 04:00:00,0,0,1,0,0,1,1,3
2024-03-16 04:10:00,0,0,1,0,0,3,4,8
2024-03-16 04:20:00,0,0,1,0,0,5,5,11
2024-03-16 04:30:00,0,0,1,0,0,2,1,4
2024-03-16 04:40:00,0,0,6,0,0,1,2,9
2024-03-16 04:50:00,0,0,2,0,0,2,4,8
2024-03-16 05:00:00,0,0,1,0,0,3,8,12
2024-03-16 05:10:00,0,0,3,0,0,4,5,12
2024-03-16 05:20:00,0,0,0,0,0,6,6,12
2024-03-16 05:30:00,0,0,1,0,0,7,8,16
2024-03-16 05:40:00,0,0,1,0,0,13,6,20
2024-03-16 05:50:00,0,0,3,0,0,3,2,8
2024-03-16 06:00:00,0,0,4,0,0,3,7,14
2024-03-16 06:10:00,0,0,6,0,0,5,6,17
2024-03-16 06:20:00,0,0,2,0,0,6,10,18
2024-03-16 06:30:00,0,0,5,0,0,4,5,14
2024-03-16 06:40:00,0,0,4,0,0,5,8,17
2024-03-16 06:50:00,0,0,6,0,0,11,5,22
2024-03-16 07:00:00,0,0,7,0,0,2,10,19
2024-03-16 07:10:00,0,0,6,0,0,5,13,24
2024-03-16 07:20:00,0,0,6,0,0,7,11,24
2024-03-16 07:30:00,0,0,4,0,0,13,18,35
2024-03-16 07:40:00,0,0,3,0,0,23,20,46
2024-03-16 07:50:00,0,0,13,0,0,15,20,48
2024-03-16 08:00:00,0,0,6,0,0,17,24,47
2024-03-16 08:10:00,0,0,9,0,0,15,19,43
2024-03-16 08:20:00,0,0,5,0,0,29,12,46
2024-03-16 08:30:00,0,0,6,0,0,27,25,58
2024-03-16 08:40:00,0,0,14,0,0,28,21,63
2024-03-16 08:50:00,0,0,21,0,0,33,38,92
2024-03-16 09:00:00,0,0,12,0,0,27,30,69
2024-03-16 09:10:00,0,0,16,0,0,25,21,62
2024-03-16 09:20:00,0,0,14,0,0,40,31,85
2024-03-16 09:30:00,0,0,21,0,0,37,27,85
2024-03-16 09:40:00,0,0,20,0,0,37,36,93
2024-03-16 09:50:00,0,0,16,0,0,43,36,95
2024-03-16 10:00:00,0,0,20,0,0,53,37,110
2024-03-16 10:10:00,0,0,16,0,0,40,35,91
2024-03-16 10:20:00,0,0,26,0,0,60,50,136
2024-03-16 10:30:00,0,0,18,0,0,56,42,116
2024-03-16 10:40:00,0,0,22,0,0,50,39,111
2024-03-16 10:50:00,0,0,22,0,0,63,33,118
2024-03-16 11:00:00,0,0,27,0,0,49,41,117
2024-03-16 11:10:00,0,0,38,0,0,53,50,141
2024-03-16 11:20:00,0,0,28,0,0,56,61,145
2024-03-16 11:30:00,0,0,39,0,0,53,51,143
2024-03-16 11:40:00,0,0,22,0,0,69,56,147
2024-03-16 11:50:00,0,0,30,0,0,81,54,165
2024-03-16 12:00:00,0,0,25,0,0,60,52,137
2024-03-16 12:10:00,0,0,17,0,0,58,57,132
2024-03-16 12:20:00,0,0,31,0,0,61,66,158
2024-03-16 12:30:00,0,0,24,0,0,57,58,139
2024-03-16 12:40:00,0,0,27,0,0,82,62,171
2024-03-16 12:50:00,0,0,26,0,0,68,65,159
2024-03-16 13:00:00,0,0,18,0,0,65,44,127
2024-03-16 13:10:00,0,0,18,0,0,53,65,136
2024-03-16 13:20:00,0,0,21,0,0,67,56,144
2024-03-16 13:30:00,0,0,24,0,0,61,69,154
2024-03-16 13:40:00,0,0,22,0,0,50,52,124
2024-03-16 13:50:00,0,0,28,0,0,73,46,147
2024-03-16 14:00:00,0,0,27,0,0,71,79,177
2024-03-16 14:10:00,0,0,18,0,0,64,56,138
2024-03-16 14:20:00,0,0,27,0,0,73,52,152
2024-03-16 14:30:00,0,0,28,0,0,59,55,142
2024-03-16 14:40:00,0,0,28,0,0,57,58,143
2024-03-16 14:50:00,0,0,22,0,0,66,58,146
2024-03-16 15:00:00,0,0,23,0,0,64,57,144
2024-03-16 15:10:00,0,0,17,0,0,49,46,112
2024-03-16 15:20:00,0,0,14,0,0,63,54,131
2024-03-16 15:30:00,0,0,18,0,0,59,57,134
2024-03-16 15:40:00,0,0,26,0,0,63,47,136
2024-03-16 15:50:00,0,0,15,0,0,73,66,154
2024-03-16 16:00:00,0,0,20,0,0,70,44,134
2024-03-16 16:10:00,0,0,21,0,0,51,49,121
2024-03-16 16:20:00,0,0,15,0,0,57,52,124
2024-03-16 16:30:00,0,0,19,0,0,55,59,133
2024-03-16 16:40:00,0,0,20,0,0,41,54,115
2024-03-16 16:50:00,0,0,13,0,0,62,49,124
2024-03-16 17:00:00,0,0,15,0,0,59,60,134
2024-03-16 17:10:00,0,0,9,0,0,53,48,110
2024-03-16 17:20:00,0,0,15,0,0,60,54,129
2024-03-16 17:30:00,0,0,19,0,0,62,53,134
2024-03-16 17:40:00,0,0,19,0,0,44,54,117
2024-03-16 17:50:00,0,0,14,0,0,49,40,103
2024-03-16 18:00:00,0,0,19,0,0,54,67,140
2024-03-16 18:10:00,0,0,17,0,0,52,59,128
2024-03-16 18:20:00,0,0,13,0,0,58,57,128
2024-03-16 18:30:00,0,0,11,0,0,64,42,117
2024-03-16 18:40:00,0,0,10,0,0,60,54,124
2024-03-16 18:50:00,0,0,8,0,0,45,39,92
2024-03-16 19:00:00,0,0,11,0,0,37,41,89
2024-03-16 19:10:00,0,0,17,0,0,56,46,119
2024-03-16 19:20:00,0,0,10,0,0,36,45,91
2024-03-16 19:30:00,0,0,16,0,0,26,48,90
2024-03-16 19:40:00,0,0,20,0,0,37,55,112
2024-03-16 19:50:00,0,0,17,0,0,36,43,96
2024-03-16 20:00:00,0,0,16,0,0,42,51,109
2024-03-16 20:10:00,0,0,8,0,0,31,45,84
2024-03-16 20:20:00,0,0,12,0,0,29,38,79
2024-03-16 20:30:00,0,0,8,0,0,18,47,73
2024-03-16 20:40:00,0,0,13,0,0,18,23,54
2024-03-16 20:50:00,0,0,11,0,0,23,34,68
2024-03-16 21:00:00,0,0,7,0,0,18,23,48
2024-03-16 21:10:00,0,0,9,0,0,28,34,71
2024-03-16 21:20:00,0,0,13,0,0,14,17,44
2024-03-16 21:30:00,0,0,4,0,0,30,32,66
2024-03-16 21:40:00,0,0,9,0,0,30,28,67
2024-03-16 21:50:00,0,0,12,0,0,18,30,60
2024-03-16 22:00:00,0,0,2,0,0,24,24,50
2024-03-16 22:10:00,0,0,6,0,0,19,20,45
2024-03-16 22:20:00,0,0,4,0,0,14,18,36
2024-03-16 22:30:00,0,0,4,0,0,16,17,37
2024-03-16 22:40:00,0,0,5,0,0,17,14,36
2024-03-16 22:50:00,0,0,4,0,0,18,26,48
2024-03-16 23:00:00,0,0,5,0,0,12,27,44
2024-03-16 23:10:00,0,0,6,0,0,16,16,38
2024-03-16 23:20:00,0,0,5,0,0,9,22,36
2024-03-16 23:30:00,0,0,5,0,0,16,16,37
2024-03-16 23:40:00,0,0,2,0,0,16,16,34
2024-03-16 23:50:00,0,0,5,0,0,10,20,35
2024-03-17 00:00:00,0,0,3,0,0,9,10,22
2024-03-17 00:10:00,0,0,2,0,0,13,19,34
2024-03-17 00:20:00,0,0,6,0,0,8,19,33
2024-03-17 00:30:00,0,0,4,0,0,7,17,28
2024-03-17 00:40:00,0,0,2,0,0,3,10,15
2024-03-17 00:50:00,0,0,2,0,0,10,10,22
2024-03-17 01:00:00,0,0,1,0,0,8,16,25
2024-03-17 01:10:00,0,0,2,0,0,4,9,15
2024-03-17 01:20:00,0,0,1,0,0,6,7,14
2024-03-17 01:30:00,0,0,2,0,0,8,10,20
2024-03-17 01:40:00,0,0,2,0,0,5,9,16
2024-03-17 01:50:00,0,0,2,0,0,5,7,14
2024-03-17 02:00:00,0,0,2,0,0,3,10,15
2024-03-17 02:10:00,0,0,1,0,0,7,8,16
2024-03-17 02:20:00,0,0,1,0,0,7,4,12
2024-03-17 02:30:00,0,0,1,0,0,7,7,15
2024-03-17 02:40:00,0,0,4,0,0,2,2,8
2024-03-17 02:50:00,0,0,1,0,0,5,9,15
2024-03-17 03:00:00,0,0,1,0,0,4,9,14
2024-03-17 03:10:00,0,0,0,0,0,7,8,15
2024-03-17 03:20:00,0,0,0,0,0,3,4,7
2024-03-17 03:30:00,0,0,6,0,0,4,8,18
2024-03-17 03:40:00,0,0,2,0,0,1,6,9
2024-03-17 03:50:00,0,0,1,0,0,2,5,8
2024-03-17 04:00:00,0,0,0,0,0,2,1,3
2024-03-17 04:10:00,0,0,1,0,0,2,3,6
2024-03-17 04:20:00,0,0,0,0,0,2,3,5
2024-03-17 04:30:00,0,0,0,0,0,1,1,2
2024-03-17 04:40:00,0,0,5,0,0,2,4,11
2024-03-17 04:50:00,0,0,1,0,0,1,5,7
2024-03-17 05:00:00,0,0,2,0,0,2,7,11
2024-03-17 05:10:00,0,0,1,0,0,1,4,6
2024-03-17 05:20:00,0,0,1,0,0,4,7,12
2024-03-17 05:30:00,0,0,1,0,0,7,6,14
2024-03-17 05:40:00,0,0,1,0,0,5,3,9
2024-03-17 05:50:00,0,0,0,0,0,1,1,2
2024-03-17 06:00:00,0,0,4,0,0,4,2,10
2024-03-17 06:10:00,0,0,3,0,0,6,4,13
2024-03-17 06:20:00,0,0,0,0,0,3,1,4
2024-03-17 06:30:00,0,0,4,0,0,3,1,8
2024-03-17 06:40:00,0,0,0,0,0,3,3,6
2024-03-17 06:50:00,0,0,2,0,0,5,3,10
2024-03-17 07:00:00,0,0,1,0,0,5,6,12
2024-03-17 07:10:00,0,0,2,0,0,2,3,7
2024-03-17 07:20:00,0,0,1,0,0,5,9,15
2024-03-17 07:30:00,0,0,3,0,0,2,6,11
2024-03-17 07:40:00,0,0,2,0,0,5,13,20
2024-03-17 07:50:00,0,0,0,0,0,7,11,18
2024-03-17 08:00:00,0,0,2,0,0,7,11,20
2024-03-17 08:10:00,0,0,2,0,0,7,9,18
2024-03-17 08:20:00,0,0,5,0,0,5,10,20
2024-03-17 08:30:00,0,0,1,0,0,5,9,15
2024-03-17 08:40:00,0,0,6,0,0,9,7,22
2024-03-17 08:50:00,0,0,3,0,0,12,16,31
2024-03-17 09:00:00,0,0,1,0,0,9,12,22
2024-03-17 09:10:00,0,0,5,0,0,13,8,26
2024-03-17 09:20:00,0,0,8,0,0,11,16,35
2024-03-17 09:30:00,0,0,4,0,0,12,12,28
2024-03-17 09:40:00,0,0,13,0,0,14,17,44
2024-03-17 09:50:00,0,0,9,0,0,19,15,43
2024-03-17 10:00:00,0,0,11,0,0,13,21,45
2024-03-17 10:10:00,0,0,10,0,0,12,20,42
2024-03-17 10:20:00,0,0,8,0,0,20,16,44
2024-03-17 10:30:00,0,0,13,0,0,17,21,51
2024-03-17 10:40:00,0,0,3,0,0,23,25,51
2024-03-17 10:50:00,0,0,9,0,0,18,15,42
2024-03-17 11:00:00,0,0,9,0,0,17,27,53
2024-03-17 11:10:00,0,0,11,0,0,16,28,55
2024-03-17 11:20:00,0,0,12,0,0,14,21,47
2024-03-17 11:30:00,0,0,7,0,0,21,32,60
2024-03-17 11:40:00,0,0,12,0,0,21,27,60
2024-03-17 11:50:00,0,0,4,0,0,25,19,48
2024-03-17 12:00:00,0,0,13,0,0,24,27,64
2024-03-17 12:10:00,0,0,8,0,0,31,35,74
2024-03-17 12:20:00,0,0,15,0,0,21,28,64
2024-03-17 12:30:00,0,0,12,0,0,28,33,73
2024-03-17 12:40:00,0,0,15,0,0,20,28,63
2024-03-17 12:50:00,0,0,15,0,0,27,28,70
2024-03-17 13:00:00,0,0,4,0,0,28,33,65
2024-03-17 13:10:00,0,0,11,0,0,26,31,68
2024-03-17 13:20:00,0,0,15,0,0,20,18,53
2024-03-17 13:30:00,0,0,12,0,0,21,36,69
2024-03-17 13:40:00,0,0,9,0,0,20,26,55
2024-03-17 13:50:00,0,0,12,0,0,16,43,71
2024-03-17 14:00:00,0,0,9,0,0,34,37,80
2024-03-17 14:10:00,0,0,11,0,0,29,32,72
2024-03-17 14:20:00,0,0,9,0,0,19,25,53
2024-03-17 14:30:00,0,0,9,0,0,30,39,78
2024-03-17 14:40:00,0,0,11,0,0,40,41,92
2024-03-17 14:50:00,0,0,6,0,0,20,37,63
2024-03-17 15:00:00,0,0,10,0,0,29,37,76
2024-03-17 15:10:00,0,0,18,0,0,29,34,81
2024-03-17 15:20:00,0,0,12,0,0,21,48,81
2024-03-17 15:30:00,0,0,11,0,0,33,35,79
2024-03-17 15:40:00,0,0,10,0,0,25,25,60
2024-03-17 15:50:00,0,0,11,0,0,23,32,66
2024-03-17 16:00:00,0,0,14,0,0,16,16,46
2024-03-17 16:10:00,0,0,8,0,0,27,36,71
2024-03-17 16:20:00,0,0,10,0,0,28,21,59
2024-03-17 16:30:00,0,0,9,0,0,21,34,64
2024-03-17 16:40:00,0,0,4,0,0,20,34,58
2024-03-17 16:50:00,0,0,11,0,0,26,26,63
2024-03-17 17:00:00,0,0,5,0,0,27,37,69
2024-03-17 17:10:00,0,0,7,0,0,28,27,62
2024-03-17 17:20:00,0,0,12,0,0,32,39,83
2024-03-17 17:30:00,0,0,6,0,0,31,38,75
2024-03-17 17:40:00,0,0,12,0,0,28,34,74
2024-03-17 17:50:00,0,0,10,0,0,28,38,76
2024-03-17 18:00:00,0,0,10,0,0,28,38,76
2024-03-17 18:10:00,0,0,11,0,0,27,32,70
2024-03-17 18:20:00,0,0,10,0,0,25,42,77
2024-03-17 18:30:00,0,0,10,0,0,20,24,54
2024-03-17 18:40:00,0,0,5,0,0,26,25,56
2024-03-17 18:50:00,0,0,6,0,0,23,39,68
2024-03-17 19:00:00,0,0,11,0,0,18,21,50
2024-03-17 19:10:00,0,0,6,0,0,15,25,46
2024-03-17 19:20:00,0,0,6,0,0,23,30,59
2024-03-17 19:30:00,0,0,11,0,0,19,30,60
2024-03-17 19:40:00,0,0,15,0,0,20,29,64
2024-03-17 19:50:00,0,0,18,0,0,25,30,73
2024-03-17 20:00:00,0,0,15,0,0,23,25,63
2024-03-17 20:10:00,0,0,10,0,0,20,22,52
2024-03-17 20:20:00,0,0,9,0,0,15,17,41
2024-03-17 20:30:00,0,0,9,0,0,30,24,63
2024-03-17 20:40:00,0,0,8,0,0,11,6,25
2024-03-17 20:50:00,0,0,6,0,0,21,29,56
2024-03-17 21:00:00,0,0,3,0,0,20,18,41
2024-03-17 21:10:00,0,0,3,0,0,14,20,37
2024-03-17 21:20:00,0,0,2,0,0,10,14,26
2024-03-17 21:30:00,0,0,3,0,0,10,10,23
2024-03-17 21:40:00,0,0,4,0,0,13,13,30
2024-03-17 21:50:00,0,0,4,0,0,8,10,22
2024-03-17 22:00:00,0,0,4,0,0,10,10,24
2024-03-17 22:10:00,0,0,8,0,0,6,19,33
2024-03-17 22:20:00,0,0,2,0,0,10,16,28
2024-03-17 22:30:00,0,0,5,0,0,8,14,27
2024-03-17 22:40:00,0,0,5,0,0,6,14,25
2024-03-17 22:50:00,0,0,4,0,0,10,7,21
2024-03-17 23:00:00,0,0,2,0,0,4,12,18
2024-03-17 23:10:00,0,0,3,0,0,5,5,13
2024-03-17 23:20:00,0,0,2,0,0,8,10,20
2024-03-17 23:30:00,0,0,4,0,0,5,7,16
2024-03-17 23:40:00,0,0,1,0,0,3,6,10
2024-03-17 23:50:00,0,0,3,0,0,4,4,11
2024-03-18 00:00:00,0,0,1,0,0,9,4,14
2024-03-18 00:10:00,0,0,0,0,0,4,4,8
2024-03-18 00:20:00,0,0,1,0,0,3,6,10
2024-03-18 00:30:00,0,0,2,0,0,7,6,15
2024-03-18 00:40:00,0,0,2,0,0,3,3,8
2024-03-18 00:50:00,0,0,2,0,0,2,2,6
2024-03-18 01:00:00,0,0,3,0,0,5,5,13
2024-03-18 01:10:00,0,0,1,0,0,1,2,4
2024-03-18 01:20:00,0,0,1,0,0,3,6,10
2024-03-18 01:30:00,0,0,2,0,0,0,3,5
2024-03-18 01:40:00,0,0,0,0,0,3,2,5
2024-03-18 01:50:00,0,0,1,0,0,1,2,4
2024-03-18 02:00:00,0,0,0,0,0,2,1,3
2024-03-18 02:10:00,0,0,0,0,0,1,1,2
2024-03-18 02:20:00,0,0,0,0,0,0,1,1
2024-03-18 02:30:00,0,0,1,0,0,2,1,4
2024-03-18 02:40:00,0,0,1,0,0,4,3,8
2024-03-18 02:50:00,0,0,0,0,0,1,0,1
2024-03-18 03:00:00,0,0,1,0,0,4,3,8
2024-03-18 03:10:00,0,0,0,0,0,1,0,1
2024-03-18 03:20:00,0,0,1,0,0,1,2,4
2024-03-18 03:30:00,0,0,2,0,0,4,1,7
2024-03-18 03:40:00,0,0,2,0,0,3,1,6
2024-03-18 03:50:00,0,0,3,0,0,0,3,6
2024-03-18 04:00:00,0,0,0,0,0,1,3,4
2024-03-18 04:10:00,0,0,3,0,0,1,1,5
2024-03-18 04:20:00,0,0,0,0,0,2,4,6
2024-03-18 04:30:00,0,0,5,0,0,2,5,12
2024-03-18 04:40:00,0,0,3,0,0,4,6,13
2024-03-18 04:50:00,0,0,3,0,0,2,5,10
2024-03-18 05:00:00,0,0,4,0,0,6,9,19
2024-03-18 05:10:00,0,0,5,0,0,9,9,23
2024-03-18 05:20:00,0,0,12,0,0,7,5,24
2024-03-18 05:30:00,0,0,5,0,0,12,12,29
2024-03-18 05:40:00,0,0,2,0,0,17,13,32
2024-03-18 05:50:00,0,0,16,0,0,15,15,46
2024-03-18 06:00:00,0,0,11,0,0,18,13,42
2024-03-18 06:10:00,0,0,13,0,0,19,20,52
2024-03-18 06:20:00,0,0,16,0,0,24,21,61
2024-03-18 06:30:00,0,0,11,0,0,38,22,71
2024-03-18 06:40:00,0,0,10,0,0,25,23,58
2024-03-18 06:50:00,0,0,9,0,0,56,47,112
2024-03-18 07:00:00,0,0,13,0,0,45,44,102
2024-03-18 07:10:00,0,0,15,0,0,56,40,111
2024-03-18 07:20:00,0,0,10,0,0,50,50,110
2024-03-18 07:30:00,0,0,19,0,0,57,57,133
2024-03-18 07:40:00,0,0,12,0,0,47,76,135
2024-03-18 07:50:00,0,0,19,0,0,57,59,135
2024-03-18 08:00:00,0,0,17,0,0,72,68,157
2024-03-18 08:10:00,0,0,20,0,0,44,60,124
2024-03-18 08:20:00,0,0,10,0,0,55,57,122
2024-03-18 08:30:00,0,0,16,0,0,49,51,116
2024-03-18 08:40:00,0,0,24,0,0,37,59,120
2024-03-18 08:50:00,0,0,15,0,0,62,57,134
2024-03-18 09:00:00,0,0,21,0,0,35,45,101
2024-03-18 09:10:00,0,0,18,0,0,40,39,97
2024-03-18 09:20:00,0,0,19,0,0,43,58,120
2024-03-18 09:30:00,0,0,21,0,0,47,45,113
2024-03-18 09:40:00,0,0,18,0,0,33,40,91
2024-03-18 09:50:00,0,0,24,0,0,44,45,113
2024-03-18 10:00:00,0,0,17,0,0,44,39,100
2024-03-18 10:10:00,0,0,16,0,0,41,31,88
2024-03-18 10:20:00,0,0,20,0,0,37,41,98
2024-03-18 10:30:00,0,0,23,0,0,49,41,113
2024-03-18 10:40:00,0,0,23,0,0,42,35,100
2024-03-18 10:50:00,0,0,17,0,0,47,45,109
2024-03-18 11:00:00,0,0,13,0,0,50,31,94
2024-03-18 11:10:00,0,0,22,0,0,38,35,95
2024-03-18 11:20:00,0,0,18,0,0,51,53,122
2024-03-18 11:30:00,0,0,18,0,0,57,44,119
2024-03-18 11:40:00,0,0,30,0,0,51,38,119
2024-03-18 11:50:00,0,0,22,0,0,39,41,102
2024-03-18 12:00:00,0,0,25,0,0,53,49,127
2024-03-18 12:10:00,0,0,28,0,0,33,56,117
2024-03-18 12:20:00,0,0,18,0,0,45,52,115
2024-03-18 12:30:00,0,0,23,0,0,35,47,105
2024-03-18 12:40:00,0,0,26,0,0,58,57,141
2024-03-18 12:50:00,0,0,19,0,0,47,66,132
2024-03-18 13:00:00,0,0,21,0,0,54,55,130
2024-03-18 13:10:00,0,0,27,0,0,39,34,100
2024-03-18 13:20:00,0,0,21,0,0,36,45,102
2024-03-18 13:30:00,0,0,25,0,0,55,36,116
2024-03-18 13:40:00,0,0,19,0,0,54,47,120
2024-03-18 13:50:00,0,0,17,0,0,42,43,102
2024-03-18 14:00:00,0,0,14,0,0,46,45,105
2024-03-18 14:10:00,0,0,26,0,0,40,55,121
2024-03-18 14:20:00,0,0,19,0,0,58,54,131
2024-03-18 14:30:00,0,0,22,0,0,55,39,116
2024-03-18 14:40:00,0,0,23,0,0,54,59,136
2024-03-18 14:50:00,0,0,26,0,0,45,73,144
2024-03-18 15:00:00,0,0,18,0,0,51,57,126
2024-03-18 15:10:00,0,0,25,0,0,56,67,148
2024-03-18 15:20:00,0,0,24,0,0,52,68,144
2024-03-18 15:30:00,0,0,24,0,0,44,57,125
2024-03-18 15:40:00,0,0,27,0,0,51,64,142
2024-03-18 15:50:00,0,0,32,0,0,62,59,153
2024-03-18 16:00:00,0,0,29,0,0,61,79,169
2024-03-18 16:10:00,0,0,28,0,0,45,65,138
2024-03-18 16:20:00,0,0,27,0,0,57,73,157
2024-03-18 16:30:00,0,0,26,0,0,65,55,146
2024-03-18 16:40:00,0,0,25,0,0,54,63,142
2024-03-18 16:50:00,0,0,17,0,0,53,71,141
2024-03-18 17:00:00,0,0,20,0,0,56,64,140
2024-03-18 17:10:00,0,0,23,0,0,75,74,172
2024-03-18 17:20:00,0,0,17,0,0,59,68,144
2024-03-18 17:30:00,0,0,28,0,0,53,84,165
2024-03-18 17:40:00,0,0,21,0,0,49,54,124
2024-03-18 17:50:00,0,0,23,0,0,65,65,153
2024-03-18 18:00:00,0,0,28,0,0,59,68,155
2024-03-18 18:10:00,0,0,12,0,0,55,66,133
2024-03-18 18:20:00,0,0,28,0,0,53,55,136
2024-03-18 18:30:00,0,0,19,0,0,38,51,108
2024-03-18 18:40:00,0,0,14,0,0,52,49,115
2024-03-18 18:50:00,0,0,15,0,0,33,27,75
2024-03-18 19:00:00,0,0,14,0,0,27,42,83
2024-03-18 19:10:00,0,0,22,0,0,36,49,107
2024-03-18 19:20:00,0,0,12,0,0,27,45,84
2024-03-18 19:30:00,0,0,17,0,0,28,38,83
2024-03-18 19:40:00,0,0,15,0,0,17,46,78
2024-03-18 19:50:00,0,0,16,0,0,30,43,89
2024-03-18 20:00:00,0,0,12,0,0,24,41,77
2024-03-18 20:10:00,0,0,11,0,0,20,39,70
2024-03-18 20:20:00,0,0,7,0,0,40,40,87
2024-03-18 20:30:00,0,0,7,0,0,26,23,56
2024-03-18 20:40:00,0,0,7,0,0,24,20,51
2024-03-18 20:50:00,0,0,4,0,0,14,23,41
2024-03-18 21:00:00,0,0,5,0,0,17,15,37
2024-03-18 21:10:00,0,0,6,0,0,13,25,44
2024-03-18 21:20:00,0,0,4,0,0,22,23,49
2024-03-18 21:30:00,0,0,11,0,0,16,19,46
2024-03-18 21:40:00,0,0,5,0,0,19,25,49
2024-03-18 21:50:00,0,0,4,0,0,9,16,29
2024-03-18 22:00:00,0,0,6,0,0,10,15,31
2024-03-18 22:10:00,0,0,6,0,0,9,11,26
2024-03-18 22:20:00,0,0,7,0,0,14,16,37
2024-03-18 22:30:00,0,0,5,0,0,11,13,29
2024-03-18 22:40:00,0,0,5,0,0,11,9,25
2024-03-18 22:50:00,0,0,4,0,0,11,8,23
2024-03-18 23:00:00,0,0,5,0,0,12,11,28
2024-03-18 23:10:00,0,0,4,0,0,12,8,24
2024-03-18 23:20:00,0,0,2,0,0,3,5,10
2024-03-18 23:30:00,0,0,4,0,0,7,4,15
2024-03-18 23:40:00,0,0,4,0,0,2,13,19
2024-03-18 23:50:00,0,0,4,0,0,1,2,7
2024-03-19 00:00:00,0,0,2,0,0,5,6,13
2024-03-19 00:10:00,0,0,3,0,0,5,6,14
2024-03-19 00:20:00,0,0,1,0,0,5,3,9
2024-03-19 00:30:00,0,0,1,0,0,4,7,12
2024-03-19 00:40:00,0,0,2,0,0,6,4,12
2024-03-19 00:50:00,0,0,2,0,0,2,2,6
2024-03-19 01:00:00,0,0,0,0,0,3,2,5
2024-03-19 01:10:00,0,0,1,0,0,2,5,8
2024-03-19 01:20:00,0,0,1,0,0,3,0,4
2024-03-19 01:30:00,0,0,0,0,0,1,1,2
2024-03-19 01:40:00,0,0,0,0,0,3,3,6
2024-03-19 01:50:00,0,0,0,0,0,3,4,7
2024-03-19 02:00:00,0,0,1,0,0,1,2,4
2024-03-19 02:10:00,0,0,0,0,0,1,1,2
2024-03-19 02:20:00,0,0,4,0,0,2,4,10
2024-03-19 02:30:00,0,0,1,0,0,1,3,5
2024-03-19 02:40:00,0,0,0,0,0,2,2,4
2024-03-19 02:50:00,0,0,1,0,0,1,2,4
2024-03-19 03:00:00,0,0,0,0,0,4,2,6
2024-03-19 03:10:00,0,0,0,0,0,3,3,6
2024-03-19 03:20:00,0,0,2,0,0,2,3,7
2024-03-19 03:30:00,0,0,1,0,0,2,2,5
2024-03-19 03:40:00,0,0,1,0,0,0,5,6
2024-03-19 03:50:00,0,0,0,0,0,3,4,7
2024-03-19 04:00:00,0,0,2,0,0,5,2,9
2024-03-19 04:10:00,0,0,1,0,0,1,3,5
2024-03-19 04:20:00,0,0,1,0,0,3,5,9
2024-03-19 04:30:00,0,0,5,0,0,3,4,12
2024-03-19 04:40:00,0,0,3,0,0,4,4,11
2024-03-19 04:50:00,0,0,2,0,0,6,6,14
2024-03-19 05:00:00,0,0,5,0,0,9,5,19
2024-03-19 05:10:00,0,0,4,0,0,5,4,13
2024-03-19 05:20:00,0,0,6,0,0,9,7,22
2024-03-19 05:30:00,0,0,6,0,0,11,10,27
2024-03-19 05:40:00,0,0,2,0,0,22,11,35
2024-03-19 05:50:00,0,0,13,0,0,21,15,49
2024-03-19 06:00:00,0,0,12,0,0,23,18,53
2024-03-19 06:10:00,0,0,14,0,0,23,26,63
2024-03-19 06:20:00,0,0,12,0,0,24,27,63
2024-03-19 06:30:00,0,0,10,0,0,26,28,64
2024-03-19 06:40:00,0,0,13,0,0,34,32,79
2024-03-19 06:50:00,0,0,11,0,0,46,32,89
2024-03-19 07:00:00,0,0,9,0,0,59,50,118
2024-03-19 07:10:00,0,0,11,0,0,45,41,97
2024-03-19 07:20:00,0,0,14,0,0,61,53,128
2024-03-19 07:30:00,0,0,13,0,0,60,65,138
2024-03-19 07:40:00,0,0,20,0,0,51,67,138
2024-03-19 07:50:00,0,0,17,0,0,54,63,134
2024-03-19 08:00:00,0,0,15,0,0,48,66,129
2024-03-19 08:10:00,0,0,21,0,0,54,63,138
2024-03-19 08:20:00,0,0,19,0,0,46,60,125
2024-03-19 08:30:00,0,0,14,0,0,52,60,126
2024-03-19 08:40:00,0,0,16,0,0,57,47,120
2024-03-19 08:50:00,0,0,13,0,0,46,65,124
2024-03-19 09:00:00,0,0,21,0,0,36,48,105
2024-03-19 09:10:00,0,0,25,0,0,36,44,105
2024-03-19 09:20:00,0,0,17,0,0,43,46,106
2024-03-19 09:30:00,0,0,21,0,0,51,32,104
2024-03-19 09:40:00,0,0,15,0,0,55,54,124
2024-03-19 09:50:00,0,0,13,0,0,47,41,101
2024-03-19 10:00:00,0,0,18,0,0,55,51,124
2024-03-19 10:10:00,0,0,21,0,0,59,43,123
2024-03-19 10:20:00,0,0,21,0,0,42,47,110
2024-03-19 10:30:00,0,0,21,0,0,49,44,114
2024-03-19 10:40:00,0,0,17,0,0,56,51,124
2024-03-19 10:50:00,0,0,18,0,0,42,39,99
2024-03-19 11:00:00,0,0,19,0,0,45,39,103
2024-03-19 11:10:00,0,0,18,0,0,51,35,104
2024-03-19 11:20:00,0,0,19,0,0,49,38,106
2024-03-19 11:30:00,0,0,27,0,0,59,44,130
2024-03-19 11:40:00,0,0,20,0,0,50,39,109
2024-03-19 11:50:00,0,0,31,0,0,51,49,131
2024-03-19 12:00:00,0,0,18,0,0,43,37,98
2024-03-19 12:10:00,0,0,32,0,0,54,60,146
2024-03-19 12:20:00,0,0,23,0,0,44,45,112
2024-03-19 12:30:00,0,0,20,0,0,46,47,113
2024-03-19 12:40:00,0,0,24,0,0,58,58,140
2024-03-19 12:50:00,0,0,18,0,0,47,43,108
2024-03-19 13:00:00,0,0,17,0,0,61,53,131
2024-03-19 13:10:00,0,0,30,0,0,47,38,115
2024-03-19 13:20:00,0,0,18,0,0,55,56,129
2024-03-19 13:30:00,0,0,21,0,0,29,40,90
2024-03-19 13:40:00,0,0,26,0,0,61,44,131
2024-03-19 13:50:00,0,0,25,0,0,42,62,129
2024-03-19 14:00:00,0,0,25,0,0,42,61,128
2024-03-19 14:10:00,0,0,23,0,0,51,55,129
2024-03-19 14:20:00,0,0,23,0,0,53,58,134
2024-03-19 14:30:00,0,0,28,0,0,54,54,136
2024-03-19 14:40:00,0,0,25,0,0,43,61,129
2024-03-19 14:50:00,0,0,23,0,0,59,55,137
2024-03-19 15:00:00,0,0,26,0,0,50,55,131
2024-03-19 15:10:00,0,0,30,0,0,78,72,180
2024-03-19 15:20:00,0,0,31,0,0,58,76,165
2024-03-19 15:30:00,0,0,26,0,0,48,52,126
2024-03-19 15:40:00,0,0,27,0,0,74,75,176
2024-03-19 15:50:00,0,0,24,0,0,56,70,150
2024-03-19 16:00:00,0,0,26,0,0,57,70,153
2024-03-19 16:10:00,0,0,24,0,0,51,74,149
2024-03-19 16:20:00,0,0,31,0,0,66,94,191
2024-03-19 16:30:00,0,0,28,0,0,49,61,138
2024-03-19 16:40:00,0,0,30,0,0,55,73,158
2024-03-19 16:50:00,0,0,29,0,0,48,67,144
2024-03-19 17:00:00,0,0,24,0,0,53,72,149
2024-03-19 17:10:00,0,0,20,0,0,58,76,154
2024-03-19 17:20:00,0,0,40,0,0,61,79,180
2024-03-19 17:30:00,0,0,26,0,0,57,72,155
2024-03-19 17:40:00,0,0,13,0,0,60,59,132
2024-03-19 17:50:00,0,0,26,0,0,68,78,172
2024-03-19 18:00:00,0,0,20,0,0,44,64,128
2024-03-19 18:10:00,0,0,20,0,0,57,58,135
2024-03-19 18:20:00,0,0,17,0,0,54,76,147
2024-03-19 18:30:00,0,0,21,0,0,63,62,146
2024-03-19 18:40:00,0,0,20,0,0,46,50,116
2024-03-19 18:50:00,0,0,14,0,0,49,54,117
2024-03-19 19:00:00,0,0,14,0,0,34,28,76
2024-03-19 19:10:00,0,0,13,0,0,37,51,101
2024-03-19 19:20:00,0,0,16,0,0,52,45,113
2024-03-19 19:30:00,0,0,17,0,0,26,36,79
2024-03-19 19:40:00,0,0,15,0,0,36,42,93
2024-03-19 19:50:00,0,0,15,0,0,24,54,93
2024-03-19 20:00:00,0,0,19,0,0,32,42,93
2024-03-19 20:10:00,0,0,12,0,0,31,31,74
2024-03-19 20:20:00,0,0,14,0,0,29,26,69
2024-03-19 20:30:00,0,0,12,0,0,24,28,64
2024-03-19 20:40:00,0,0,7,0,0,23,24,54
2024-03-19 20:50:00,0,0,10,0,0,19,16,45
2024-03-19 21:00:00,0,0,6,0,0,16,12,34
2024-03-19 21:10:00,0,0,3,0,0,29,28,60
2024-03-19 21:20:00,0,0,6,0,0,16,25,47
2024-03-19 21:30:00,0,0,7,0,0,19,28,54
2024-03-19 21:40:00,0,0,7,0,0,20,27,54
2024-03-19 21:50:00,0,0,5,0,0,10,13,28
2024-03-19 22:00:00,0,0,8,0,0,15,14,37
2024-03-19 22:10:00,0,0,14,0,0,19,25,58
2024-03-19 22:20:00,0,0,6,0,0,8,12,26
2024-03-19 22:30:00,0,0,5,0,0,16,22,43
2024-03-19 22:40:00,0,0,5,0,0,14,17,36
2024-03-19 22:50:00,0,0,6,0,0,10,8,24
2024-03-19 23:00:00,0,0,5,0,0,7,9,21
2024-03-19 23:10:00,0,0,3,0,0,10,15,28
2024-03-19 23:20:00,0,0,1,0,0,5,7,13
2024-03-19 23:30:00,0,0,1,0,0,8,15,24
2024-03-19 23:40:00,0,0,3,0,0,8,5,16
2024-03-19 23:50:00,0,0,3,0,0,10,3,16
2024-03-20 00:00:00,0,0,1,0,0,3,6,10
2024-03-20 00:10:00,0,0,2,0,0,5,7,14
2024-03-20 00:20:00,0,0,0,0,0,1,4,5
2024-03-20 00:30:00,0,0,1,0,0,4,6,11
2024-03-20 00:40:00,0,0,4,0,0,2,2,8
2024-03-20 00:50:00,0,0,2,0,0,4,6,12
2024-03-20 01:00:00,0,0,2,0,0,3,3,8
2024-03-20 01:10:00,0,0,2,0,0,4,2,8
2024-03-20 01:20:00,0,0,0,0,0,2,5,7
2024-03-20 01:30:00,0,0,1,0,0,0,4,5
2024-03-20 01:40:00,0,0,1,0,0,2,1,4
2024-03-20 01:50:00,0,0,1,0,0,2,1,4
2024-03-20 02:00:00,0,0,0,0,0,1,2,3
2024-03-20 02:10:00,0,0,2,0,0,3,2,7
2024-03-20 02:20:00,0,0,1,0,0,3,5,9
2024-03-20 02:30:00,0,0,0,0,0,1,3,4
2024-03-20 02:40:00,0,0,0,0,0,0,0,0
2024-03-20 02:50:00,0,0,0,0,0,1,1,2
2024-03-20 03:00:00,0,0,0,0,0,3,1,4
2024-03-20 03:10:00,0,0,0,0,0,2,3,5
2024-03-20 03:20:00,0,0,2,0,0,1,4,7
2024-03-20 03:30:00,0,0,1,0,0,4,3,8
2024-03-20 03:40:00,0,0,1,0,0,2,3,6
2024-03-20 03:50:00,0,0,0,0,0,2,4,6
2024-03-20 04:00:00,0,0,0,0,0,0,2,2
2024-03-20 04:10:00,0,0,1,0,0,2,1,4
2024-03-20 04:20:00,0,0,0,0,0,2,4,6
2024-03-20 04:30:00,0,0,3,0,0,5,6,14
2024-03-20 04:40:00,0,0,3,0,0,4,4,11
2024-03-20 04:50:00,0,0,3,0,0,5,6,14
2024-03-20 05:00:00,0,0,6,0,0,5,4,15
2024-03-20 05:10:00,0,0,7,0,0,2,4,13
2024-03-20 05:20:00,0,0,8,0,0,9,8,25
2024-03-20 05:30:00,0,0,3,0,0,15,11,29
2024-03-20 05:40:00,0,0,8,0,0,8,10,26
2024-03-20 05:50:00,0,0,10,0,0,17,16,43
2024-03-20 06:00:00,0,0,9,0,0,18,8,35
2024-03-20 06:10:00,0,0,11,0,0,17,21,49
2024-03-20 06:20:00,0,0,14,0,0,30,25,69
2024-03-20 06:30:00,0,0,12,0,0,22,29,63
2024-03-20 06:40:00,0,0,8,0,0,22,36,66
2024-03-20 06:50:00,0,0,12,0,0,50,44,106
2024-03-20 07:00:00,0,0,14,0,0,55,47,116
2024-03-20 07:10:00,0,0,17,0,0,40,47,104
2024-03-20 07:20:00,0,0,15,0,0,66,60,141
2024-03-20 07:30:00,0,0,13,0,0,57,55,125
2024-03-20 07:40:00,0,0,19,0,0,60,56,135
2024-03-20 07:50:00,0,0,23,0,0,63,68,154
2024-03-20 08:00:00,0,0,18,0,0,58,70,146
2024-03-20 08:10:00,0,0,24,0,0,50,62,136
2024-03-20 08:20:00,0,0,18,0,0,50,63,131
2024-03-20 08:30:00,0,0,19,0,0,50,55,124
2024-03-20 08:40:00,0,0,28,0,0,50,57,135
2024-03-20 08:50:00,0,0,10,0,0,57,66,133
2024-03-20 09:00:00,0,0,14,0,0,53,58,125
2024-03-20 09:10:00,0,0,17,0,0,52,48,117
2024-03-20 09:20:00,0,0,17,0,0,55,53,125
2024-03-20 09:30:00,0,0,16,0,0,51,50,117
2024-03-20 09:40:00,0,0,13,0,0,42,51,106
2024-03-20 09:50:00,0,0,14,0,0,66,43,123
2024-03-20 10:00:00,0,0,14,0,0,44,53,111
2024-03-20 10:10:00,0,0,14,0,0,41,42,97
2024-03-20 10:20:00,0,0,17,0,0,33,44,94
2024-03-20 10:30:00,0,0,16,0,0,46,44,106
2024-03-20 10:40:00,0,0,13,0,0,45,32,90
2024-03-20 10:50:00,0,0,14,0,0,49,32,95
2024-03-20 11:00:00,0,0,22,0,0,38,37,97
2024-03-20 11:10:00,0,0,14,0,0,44,57,115
2024-03-20 11:20:00,0,0,13,0,0,42,44,99
2024-03-20 11:30:00,0,0,23,0,0,35,41,99
2024-03-20 11:40:00,0,0,24,0,0,35,43,102
2024-03-20 11:50:00,0,0,30,0,0,62,45,137
2024-03-20 12:00:00,0,0,22,0,0,51,66,139
2024-03-20 12:10:00,0,0,22,0,0,55,64,141
2024-03-20 12:20:00,0,0,20,0,0,46,54,120
2024-03-20 12:30:00,0,0,17,0,0,54,49,120
2024-03-20 12:40:00,0,0,24,0,0,44,50,118
2024-03-20 12:50:00,0,0,19,0,0,51,49,119
2024-03-20 13:00:00,0,0,27,0,0,52,54,133
2024-03-20 13:10:00,0,0,23,0,0,62,45,130
2024-03-20 13:20:00,0,0,32,0,0,54,61,147
2024-03-20 13:30:00,0,0,28,0,0,47,43,118
2024-03-20 13:40:00,0,0,27,0,0,44,60,131
2024-03-20 13:50:00,0,0,26,0,0,40,54,120
2024-03-20 14:00:00,0,0,19,0,0,48,49,116
2024-03-20 14:10:00,0,0,20,0,0,54,49,123
2024-03-20 14:20:00,0,0,27,0,0,46,67,140
2024-03-20 14:30:00,0,0,29,0,0,56,49,134
2024-03-20 14:40:00,0,0,21,0,0,52,62,135
2024-03-20 14:50:00,0,0,29,0,0,51,52,132
2024-03-20 15:00:00,0,0,28,0,0,46,48,122
2024-03-20 15:10:00,0,0,26,0,0,58,70,154
2024-03-20 15:20:00,0,0,26,0,0,61,69,156
2024-03-20 15:30:00,0,0,23,0,0,54,50,127
2024-03-20 15:40:00,0,0,17,0,0,49,76,142
2024-03-20 15:50:00,0,0,41,0,0,51,59,151
2024-03-20 16:00:00,0,0,30,0,0,46,76,152
2024-03-20 16:10:00,0,0,24,0,0,49,68,141
2024-03-20 16:20:00,0,0,31,0,0,54,76,161
2024-03-20 16:30:00,0,0,23,0,0,49,77,149
2024-03-20 16:40:00,0,0,26,0,0,52,69,147
2024-03-20 16:50:00,0,0,27,0,0,69,86,182
2024-03-20 17:00:00,0,0,24,0,0,53,75,152
2024-03-20 17:10:00,0,0,23,0,0,58,63,144
2024-03-20 17:20:00,0,0,24,0,0,51,66,141
2024-03-20 17:30:00,0,0,23,0,0,60,78,161
2024-03-20 17:40:00,0,0,25,0,0,48,72,145
2024-03-20 17:50:00,0,0,23,0,0,49,77,149
2024-03-20 18:00:00,0,0,18,0,0,57,84,159
2024-03-20 18:10:00,0,0,24,0,0,60,76,160
2024-03-20 18:20:00,0,0,18,0,0,38,66,122
2024-03-20 18:30:00,0,0,22,0,0,50,80,152
2024-03-20 18:40:00,0,0,13,0,0,42,62,117
2024-03-20 18:50:00,0,0,15,0,0,50,52,117
2024-03-20 19:00:00,0,0,13,0,0,34,38,85
2024-03-20 19:10:00,0,0,14,0,0,45,39,98
2024-03-20 19:20:00,0,0,13,0,0,31,36,80
2024-03-20 19:30:00,0,0,17,0,0,41,50,108
2024-03-20 19:40:00,0,0,16,0,0,22,44,82
2024-03-20 19:50:00,0,0,22,0,0,25,47,94
2024-03-20 20:00:00,0,0,15,0,0,21,39,75
2024-03-20 20:10:00,0,0,14,0,0,30,18,62
2024-03-20 20:20:00,0,0,10,0,0,21,29,60
2024-03-20 20:30:00,0,0,12,0,0,18,22,52
2024-03-20 20:40:00,0,0,10,0,0,19,24,53
2024-03-20 20:50:00,0,0,8,0,0,20,23,51
2024-03-20 21:00:00,0,0,4,0,0,19,25,48
2024-03-20 21:10:00,0,0,5,0,0,22,21,48
2024-03-20 21:20:00,0,0,7,0,0,13,21,41
2024-03-20 21:30:00,0,0,10,0,0,24,19,53
2024-03-20 21:40:00,0,0,5,0,0,14,19,38
2024-03-20 21:50:00,0,0,4,0,0,11,22,37
2024-03-20 22:00:00,0,0,7,0,0,13,15,35
2024-03-20 22:10:00,0,0,7,0,0,11,17,35
2024-03-20 22:20:00,0,0,6,0,0,24,19,49
2024-03-20 22:30:00,0,0,5,0,0,13,16,34
2024-03-20 22:40:00,0,0,4,0,0,9,16,29
2024-03-20 22:50:00,0,0,5,0,0,10,9,24
2024-03-20 23:00:00,0,0,1,0,0,7,16,24
2024-03-20 23:10:00,0,0,3,0,0,7,13,23
2024-03-20 23:20:00,0,0,1,0,0,3,14,18
2024-03-20 23:30:00,0,0,2,0,0,8,7,17
2024-03-20 23:40:00,0,0,5,0,0,9,10,24
2024-03-20 23:50:00,0,0,1,0,0,6,9,16
2024-03-21 00:00:00,0,0,0,0,0,8,7,15
2024-03-21 00:10:00,0,0,3,0,0,4,5,12
2024-03-21 00:20:00,0,0,0,0,0,5,8,13
2024-03-21 00:30:00,0,0,0,0,0,2,3,5
2024-03-21 00:40:00,0,0,2,0,0,1,3,6
2024-03-21 00:50:00,0,0,3,0,0,2,4,9
2024-03-21 01:00:00,0,0,0,0,0,2,8,10
2024-03-21 01:10:00,0,0,2,0,0,5,7,14
2024-03-21 01:20:00,0,0,0,0,0,1,5,6
2024-03-21 01:30:00,0,0,0,0,0,2,5,7
2024-03-21 01:40:00,0,0,0,0,0,3,3,6
2024-03-21 01:50:00,0,0,2,0,0,4,3,9
2024-03-21 02:00:00,0,0,3,0,0,2,2,7
2024-03-21 02:10:00,0,0,0,0,0,0,0,0
2024-03-21 02:20:00,0,0,2,0,0,4,6,12
2024-03-21 02:30:00,0,0,0,0,0,1,2,3
2024-03-21 02:40:00,0,0,0,0,0,0,2,2
2024-03-21 02:50:00,0,0,0,0,0,0,0,0
2024-03-21 03:00:00,0,0,2,0,0,4,1,7
2024-03-21 03:10:00,0,0,0,0,0,1,4,5
2024-03-21 03:20:00,0,0,1,0,0,2,2,5
2024-03-21 03:30:00,0,0,1,0,0,4,5,10
2024-03-21 03:40:00,0,0,2,0,0,2,2,6
2024-03-21 03:50:00,0,0,2,0,0,2,2,6
2024-03-21 04:00:00,0,0,0,0,0,0,0,0
2024-03-21 04:10:00,0,0,0,0,0,2,3,5
2024-03-21 04:20:00,0,0,1,0,0,3,6,10
2024-03-21 04:30:00,0,0,3,0,0,3,7,13
2024-03-21 04:40:00,0,0,2,0,0,4,4,10
2024-03-21 04:50:00,0,0,4,0,0,4,5,13
2024-03-21 05:00:00,0,0,8,0,0,8,8,24
2024-03-21 05:10:00,0,0,7,0,0,5,3,15
2024-03-21 05:20:00,0,0,5,0,0,9,5,19
2024-03-21 05:30:00,0,0,9,0,0,13,10,32
2024-03-21 05:40:00,0,0,3,0,0,9,13,25
2024-03-21 05:50:00,0,0,11,0,0,21,12,44
2024-03-21 06:00:00,0,0,12,0,0,12,8,32
2024-03-21 06:10:00,0,0,12,0,0,21,27,60
2024-03-21 06:20:00,0,0,11,0,0,35,20,66
2024-03-21 06:30:00,0,0,7,0,0,26,40,73
2024-03-21 06:40:00,0,0,11,0,0,28,33,72
2024-03-21 06:50:00,0,0,13,0,0,42,32,87
2024-03-21 07:00:00,0,0,13,0,0,59,52,124
2024-03-21 07:10:00,0,0,22,0,0,46,39,107
2024-03-21 07:20:00,0,0,16,0,0,52,51,119
2024-03-21 07:30:00,0,0,18,0,0,52,66,136
2024-03-21 07:40:00,0,0,16,0,0,51,68,135
2024-03-21 07:50:00,0,0,20,0,0,55,73,148
2024-03-21 08:00:00,0,0,13,0,0,67,61,141
2024-03-21 08:10:00,0,0,15,0,0,56,51,122
2024-03-21 08:20:00,0,0,13,0,0,47,53,113
2024-03-21 08:30:00,0,0,16,0,0,40,65,121
2024-03-21 08:40:00,0,0,18,0,0,56,62,136
2024-03-21 08:50:00,0,0,20,0,0,32,50,102
2024-03-21 09:00:00,0,0,13,0,0,52,63,128
2024-03-21 09:10:00,0,0,24,0,0,41,42,107
2024-03-21 09:20:00,0,0,18,0,0,50,49,117
2024-03-21 09:30:00,0,0,18,0,0,42,40,100
2024-03-21 09:40:00,0,0,14,0,0,51,52,117
2024-03-21 09:50:00,0,0,27,0,0,38,49,114
2024-03-21 10:00:00,0,0,20,0,0,37,50,107
2024-03-21 10:10:00,0,0,16,0,0,47,35,98
2024-03-21 10:20:00,0,0,9,0,0,27,37,73
2024-03-21 10:30:00,0,0,0,0,0,0,0,0
2024-03-21 10:40:00,0,0,0,0,0,0,0,0
2024-03-21 10:50:00,0,0,0,0,0,0,0,0
2024-03-21 11:00:00,0,0,0,0,0,0,0,0
2024-03-21 11:10:00,0,0,0,0,0,0,0,0
2024-03-21 11:20:00,0,0,0,0,0,0,0,0
2024-03-21 11:30:00,0,0,0,0,0,0,0,0
2024-03-21 11:40:00,0,0,0,0,0,0,0,0
2024-03-21 11:50:00,0,0,0,0,0,0,0,0
2024-03-21 12:00:00,0,0,0,0,0,0,0,0
2024-03-21 12:10:00,0,0,0,0,0,0,0,0
2024-03-21 12:20:00,0,0,0,0,0,0,0,0
2024-03-21 12:30:00,0,0,0,0,0,0,0,0
2024-03-21 12:40:00,0,0,0,0,0,0,0,0
2024-03-21 12:50:00,0,0,0,0,0,0,0,0
2024-03-21 13:00:00,0,0,0,0,0,0,0,0
2024-03-21 13:10:00,0,0,0,0,0,0,0,0
2024-03-21 13:20:00,0,0,0,0,0,0,0,0
2024-03-21 13:30:00,0,0,0,0,0,0,0,0
2024-03-21 13:40:00,0,0,0,0,0,0,0,0
2024-03-21 13:50:00,0,0,0,0,0,0,0,0
2024-03-21 14:00:00,0,0,0,0,0,0,0,0
2024-03-21 14:10:00,0,0,0,0,0,0,0,0
2024-03-21 14:20:00,0,0,0,0,0,0,0,0
2024-03-21 14:30:00,0,0,0,0,0,0,0,0
2024-03-21 14:40:00,0,0,0,0,0,0,0,0
2024-03-21 14:50:00,0,0,0,0,0,0,0,0
2024-03-21 15:00:00,0,0,0,0,0,0,0,0
2024-03-21 15:10:00,0,0,0,0,0,0,0,0
2024-03-21 15:20:00,0,0,0,0,0,0,0,0
2024-03-21 15:30:00,0,0,0,0,0,0,0,0
2024-03-21 15:40:00,0,0,0,0,0,0,0,0
2024-03-21 15:50:00,0,0,0,0,0,0,0,0
2024-03-21 16:00:00,0,0,0,0,0,0,0,0
2024-03-21 16:10:00,0,0,0,0,0,0,0,0
2024-03-21 16:20:00,0,0,0,0,0,0,0,0
2024-03-21 16:30:00,0,0,0,0,0,0,0,0
2024-03-21 16:40:00,0,0,0,0,0,0,0,0
2024-03-21 16:50:00,0,0,0,0,0,0,0,0
2024-03-21 17:00:00,0,0,0,0,0,0,0,0
2024-03-21 17:10:00,0,0,0,0,0,0,0,0
2024-03-21 17:20:00,0,0,0,0,0,0,0,0
2024-03-21 17:30:00,0,0,0,0,0,0,0,0
2024-03-21 17:40:00,0,0,0,0,0,0,0,0
2024-03-21 17:50:00,0,0,0,0,0,0,0,0
2024-03-21 18:00:00,0,0,0,0,0,0,0,0
2024-03-21 18:10:00,0,0,0,0,0,0,0,0
2024-03-21 18:20:00,0,0,0,0,0,0,0,0
2024-03-21 18:30:00,0,0,0,0,0,0,0,0
2024-03-21 18:40:00,0,0,0,0,0,0,0,0
2024-03-21 18:50:00,0,0,0,0,0,0,0,0
2024-03-21 19:00:00,0,0,0,0,0,0,0,0
2024-03-21 19:10:00,0,0,0,0,0,0,0,0
2024-03-21 19:20:00,0,0,0,0,0,0,0,0
2024-03-21 19:30:00,0,0,0,0,0,0,0,0
2024-03-21 19:40:00,0,0,0,0,0,0,0,0
2024-03-21 19:50:00,0,0,0,0,0,0,0,0
2024-03-21 20:00:00,0,0,0,0,0,0,0,0
2024-03-21 20:10:00,0,0,0,0,0,0,0,0
2024-03-21 20:20:00,0,0,0,0,0,0,0,0
2024-03-21 20:30:00,0,0,0,0,0,0,0,0
2024-03-21 20:40:00,0,0,0,0,0,0,0,0
2024-03-21 20:50:00,0,0,0,0,0,0,0,0
2024-03-21 21:00:00,0,0,0,0,0,0,0,0
2024-03-21 21:10:00,0,0,0,0,0,0,0,0
2024-03-21 21:20:00,0,0,0,0,0,0,0,0
2024-03-21 21:30:00,0,0,0,0,0,0,0,0
2024-03-21 21:40:00,0,0,0,0,0,0,0,0
2024-03-21 21:50:00,0,0,0,0,0,0,0,0
2024-03-21 22:00:00,0,0,0,0,0,0,0,0
2024-03-21 22:10:00,0,0,0,0,0,0,0,0
2024-03-21 22:20:00,0,0,0,0,0,0,0,0
2024-03-21 22:30:00,0,0,0,0,0,0,0,0
2024-03-21 22:40:00,0,0,0,0,0,0,0,0
2024-03-21 22:50:00,0,0,0,0,0,0,0,0
2024-03-21 23:00:00,0,0,0,0,0,0,0,0
2024-03-21 23:10:00,0,0,0,0,0,0,0,0
2024-03-21 23:20:00,0,0,0,0,0,0,0,0
2024-03-21 23:30:00,0,0,0,0,0,0,0,0
2024-03-21 23:40:00,0,0,0,0,0,0,0,0
2024-03-21 23:50:00,0,0,0,0,0,0,0,0
2024-03-22 00:00:00,0,0,0,0,0,0,0,0
2024-03-22 00:10:00,0,0,0,0,0,0,0,0
2024-03-22 00:20:00,0,0,0,0,0,0,0,0
2024-03-22 00:30:00,0,0,0,0,0,0,0,0
2024-03-22 00:40:00,0,0,0,0,0,0,0,0
2024-03-22 00:50:00,0,0,0,0,0,0,0,0
2024-03-22 01:00:00,0,0,0,0,0,0,0,0
2024-03-22 01:10:00,0,0,0,0,0,0,0,0
2024-03-22 01:20:00,0,0,0,0,0,0,0,0
2024-03-22 01:30:00,0,0,0,0,0,0,0,0
2024-03-22 01:40:00,0,0,0,0,0,0,0,0
2024-03-22 01:50:00,0,0,0,0,0,0,0,0
2024-03-22 02:00:00,0,0,0,0,0,0,0,0
2024-03-22 02:10:00,0,0,0,0,0,0,0,0
2024-03-22 02:20:00,0,0,0,0,0,0,0,0
2024-03-22 02:30:00,0,0,0,0,0,0,0,0
2024-03-22 02:40:00,0,0,0,0,0,0,0,0
2024-03-22 02:50:00,0,0,0,0,0,0,0,0
2024-03-22 03:00:00,0,0,0,0,0,0,0,0
2024-03-22 03:10:00,0,0,0,0,0,0,0,0
2024-03-22 03:20:00,0,0,0,0,0,0,0,0
2024-03-22 03:30:00,0,0,0,0,0,0,0,0
2024-03-22 03:40:00,0,0,0,0,0,0,0,0
2024-03-22 03:50:00,0,0,0,0,0,0,0,0
2024-03-22 04:00:00,0,0,0,0,0,0,0,0
2024-03-22 04:10:00,0,0,0,0,0,0,0,0
2024-03-22 04:20:00,0,0,0,0,0,0,0,0
2024-03-22 04:30:00,0,0,0,0,0,0,0,0
2024-03-22 04:40:00,0,0,0,0,0,0,0,0
2024-03-22 04:50:00,0,0,0,0,0,0,0,0
2024-03-22 05:00:00,0,0,0,0,0,0,0,0
2024-03-22 05:10:00,0,0,0,0,0,0,0,0
2024-03-22 05:20:00,0,0,0,0,0,0,0,0
2024-03-22 05:30:00,0,0,0,0,0,0,0,0
2024-03-22 05:40:00,0,0,0,0,0,0,0,0
2024-03-22 05:50:00,0,0,0,0,0,0,0,0
2024-03-22 06:00:00,0,0,0,0,0,0,0,0
2024-03-22 06:10:00,0,0,0,0,0,0,0,0
2024-03-22 06:20:00,0,0,0,0,0,0,0,0
2024-03-22 06:30:00,0,0,0,0,0,0,0,0
2024-03-22 06:40:00,0,0,0,0,0,0,0,0
2024-03-22 06:50:00,0,0,0,0,0,0,0,0
2024-03-22 07:00:00,0,0,0,0,0,0,0,0
2024-03-22 07:10:00,0,0,0,0,0,0,0,0
2024-03-22 07:20:00,0,0,0,0,0,0,0,0
2024-03-22 07:30:00,0,0,0,0,0,0,0,0
2024-03-22 07:40:00,0,0,0,0,0,0,0,0
2024-03-22 07:50:00,0,0,0,0,0,0,0,0
2024-03-22 08:00:00,0,0,0,0,0,0,0,0
2024-03-22 08:10:00,0,0,0,0,0,0,0,0
2024-03-22 08:20:00,0,0,0,0,0,0,0,0
2024-03-22 08:30:00,0,0,0,0,0,0,0,0
2024-03-22 08:40:00,0,0,0,0,0,0,0,0
2024-03-22 08:50:00,0,0,0,0,0,0,0,0
2024-03-22 09:00:00,0,0,0,0,0,0,0,0
2024-03-22 09:10:00,0,0,0,0,0,0,0,0
2024-03-22 09:20:00,0,0,0,0,0,0,0,0
2024-03-22 09:30:00,0,0,0,0,0,0,0,0
2024-03-22 09:40:00,0,0,0,0,0,0,0,0
2024-03-22 09:50:00,0,0,0,0,0,0,0,0
2024-03-22 10:00:00,0,0,0,0,0,0,0,0
2024-03-22 10:10:00,0,0,0,0,0,0,0,0
2024-03-22 10:20:00,0,0,0,0,0,0,0,0
2024-03-22 10:30:00,0,0,0,0,0,0,0,0
2024-03-22 10:40:00,0,0,0,0,0,0,0,0
2024-03-22 10:50:00,0,0,0,0,0,0,0,0
2024-03-22 11:00:00,0,0,0,0,0,0,0,0
2024-03-22 11:10:00,0,0,0,0,0,0,0,0
2024-03-22 11:20:00,0,0,0,0,0,0,0,0
2024-03-22 11:30:00,0,0,0,0,0,0,0,0
2024-03-22 11:40:00,0,0,0,0,0,0,0,0
2024-03-22 11:50:00,0,0,0,0,0,0,0,0
2024-03-22 12:00:00,0,0,0,0,0,0,0,0
2024-03-22 12:10:00,0,0,0,0,0,0,0,0
2024-03-22 12:20:00,0,0,0,0,0,0,0,0
2024-03-22 12:30:00,0,0,0,0,0,0,0,0
2024-03-22 12:40:00,0,0,0,0,0,0,0,0
2024-03-22 12:50:00,0,0,0,0,0,0,0,0
2024-03-22 13:00:00,0,0,0,0,0,0,0,0
2024-03-22 13:10:00,0,0,0,0,0,0,0,0
2024-03-22 13:20:00,0,0,0,0,0,0,0,0
2024-03-22 13:30:00,0,0,0,0,0,0,0,0
2024-03-22 13:40:00,0,0,0,0,0,0,0,0
2024-03-22 13:50:00,0,0,0,0,0,0,0,0
2024-03-22 14:00:00,0,0,0,0,0,0,0,0
2024-03-22 14:10:00,0,0,0,0,0,0,0,0
2024-03-22 14:20:00,0,0,0,0,0,0,0,0
2024-03-22 14:30:00,0,0,0,0,0,0,0,0
2024-03-22 14:40:00,0,0,0,0,0,0,0,0
2024-03-22 14:50:00,0,0,0,0,0,0,0,0
2024-03-22 15:00:00,0,0,0,0,0,0,0,0
2024-03-22 15:10:00,0,0,0,0,0,0,0,0
2024-03-22 15:20:00,0,0,0,0,0,0,0,0
2024-03-22 15:30:00,0,0,0,0,0,0,0,0
2024-03-22 15:40:00,0,0,0,0,0,0,0,0
2024-03-22 15:50:00,0,0,0,0,0,0,0,0
2024-03-22 16:00:00,0,0,0,0,0,0,0,0
2024-03-22 16:10:00,0,0,0,0,0,0,0,0
2024-03-22 16:20:00,0,0,0,0,0,0,0,0
2024-03-22 16:30:00,0,0,0,0,0,0,0,0
2024-03-22 16:40:00,0,0,0,0,0,0,0,0
2024-03-22 16:50:00,0,0,0,0,0,0,0,0
2024-03-22 17:00:00,0,0,0,0,0,0,0,0
2024-03-22 17:10:00,0,0,0,0,0,0,0,0
2024-03-22 17:20:00,0,0,0,0,0,0,0,0
2024-03-22 17:30:00,0,0,0,0,0,0,0,0
2024-03-22 17:40:00,0,0,0,0,0,0,0,0
2024-03-22 17:50:00,0,0,0,0,0,0,0,0
2024-03-22 18:00:00,0,0,0,0,0,0,0,0
2024-03-22 18:10:00,0,0,0,0,0,0,0,0
2024-03-22 18:20:00,0,0,0,0,0,0,0,0
2024-03-22 18:30:00,0,0,0,0,0,0,0,0
2024-03-22 18:40:00,0,0,0,0,0,0,0,0
2024-03-22 18:50:00,0,0,0,0,0,0,0,0
2024-03-22 19:00:00,0,0,0,0,0,0,0,0
2024-03-22 19:10:00,0,0,0,0,0,0,0,0
2024-03-22 19:20:00,0,0,0,0,0,0,0,0
2024-03-22 19:30:00,0,0,0,0,0,0,0,0
2024-03-22 19:40:00,0,0,0,0,0,0,0,0
2024-03-22 19:50:00,0,0,0,0,0,0,0,0
2024-03-22 20:00:00,0,0,0,0,0,0,0,0
2024-03-22 20:10:00,0,0,0,0,0,0,0,0
2024-03-22 20:20:00,0,0,0,0,0,0,0,0
2024-03-22 20:30:00,0,0,0,0,0,0,0,0
2024-03-22 20:40:00,0,0,0,0,0,0,0,0
2024-03-22 20:50:00,0,0,0,0,0,0,0,0
2024-03-22 21:00:00,0,0,0,0,0,0,0,0
2024-03-22 21:10:00,0,0,0,0,0,0,0,0
2024-03-22 21:20:00,0,0,0,0,0,0,0,0
2024-03-22 21:30:00,0,0,0,0,0,0,0,0
2024-03-22 21:40:00,0,0,0,0,0,0,0,0
2024-03-22 21:50:00,0,0,0,0,0,0,0,0
2024-03-22 22:00:00,0,0,0,0,0,0,0,0
2024-03-22 22:10:00,0,0,0,0,0,0,0,0
2024-03-22 22:20:00,0,0,0,0,0,0,0,0
2024-03-22 22:30:00,0,0,0,0,0,0,0,0
2024-03-22 22:40:00,0,0,0,0,0,0,0,0
2024-03-22 22:50:00,0,0,0,0,0,0,0,0
2024-03-22 23:00:00,0,0,0,0,0,0,0,0
2024-03-22 23:10:00,0,0,0,0,0,0,0,0
2024-03-22 23:20:00,0,0,0,0,0,0,0,0
2024-03-22 23:30:00,0,0,0,0,0,0,0,0
2024-03-22 23:40:00,0,0,0,0,0,0,0,0
2024-03-22 23:50:00,0,0,0,0,0,0,0,0
2024-03-23 00:00:00,0,0,0,0,0,0,0,0
2024-03-23 00:10:00,0,0,0,0,0,0,0,0
2024-03-23 00:20:00,0,0,0,0,0,0,0,0
2024-03-23 00:30:00,0,0,0,0,0,0,0,0
2024-03-23 00:40:00,0,0,0,0,0,0,0,0
2024-03-23 00:50:00,0,0,0,0,0,0,0,0
2024-03-23 01:00:00,0,0,0,0,0,0,0,0
2024-03-23 01:10:00,0,0,0,0,0,0,0,0
2024-03-23 01:20:00,0,0,0,0,0,0,0,0
2024-03-23 01:30:00,0,0,0,0,0,0,0,0
2024-03-23 01:40:00,0,0,0,0,0,0,0,0
2024-03-23 01:50:00,0,0,0,0,0,0,0,0
2024-03-23 02:00:00,0,0,0,0,0,0,0,0
2024-03-23 02:10:00,0,0,0,0,0,0,0,0
2024-03-23 02:20:00,0,0,0,0,0,0,0,0
2024-03-23 02:30:00,0,0,0,0,0,0,0,0
2024-03-23 02:40:00,0,0,0,0,0,0,0,0
2024-03-23 02:50:00,0,0,0,0,0,0,0,0
2024-03-23 03:00:00,0,0,0,0,0,0,0,0
2024-03-23 03:10:00,0,0,0,0,0,0,0,0
2024-03-23 03:20:00,0,0,0,0,0,0,0,0
2024-03-23 03:30:00,0,0,0,0,0,0,0,0
2024-03-23 03:40:00,0,0,0,0,0,0,0,0
2024-03-23 03:50:00,0,0,0,0,0,0,0,0
2024-03-23 04:00:00,0,0,0,0,0,0,0,0
2024-03-23 04:10:00,0,0,0,0,0,0,0,0
2024-03-23 04:20:00,0,0,0,0,0,0,0,0
2024-03-23 04:30:00,0,0,0,0,0,0,0,0
2024-03-23 04:40:00,0,0,0,0,0,0,0,0
2024-03-23 04:50:00,0,0,0,0,0,0,0,0
2024-03-23 05:00:00,0,0,0,0,0,0,0,0
2024-03-23 05:10:00,0,0,0,0,0,0,0,0
2024-03-23 05:20:00,0,0,0,0,0,0,0,0
2024-03-23 05:30:00,0,0,0,0,0,0,0,0
2024-03-23 05:40:00,0,0,0,0,0,0,0,0
2024-03-23 05:50:00,0,0,0,0,0,0,0,0
2024-03-23 06:00:00,0,0,0,0,0,0,0,0
2024-03-23 06:10:00,0,0,0,0,0,0,0,0
2024-03-23 06:20:00,0,0,0,0,0,0,0,0
2024-03-23 06:30:00,0,0,0,0,0,0,0,0
2024-03-23 06:40:00,0,0,0,0,0,0,0,0
2024-03-23 06:50:00,0,0,0,0,0,0,0,0
2024-03-23 07:00:00,0,0,0,0,0,0,0,0
2024-03-23 07:10:00,0,0,0,0,0,0,0,0
2024-03-23 07:20:00,0,0,0,0,0,0,0,0
2024-03-23 07:30:00,0,0,0,0,0,0,0,0
2024-03-23 07:40:00,0,0,0,0,0,0,0,0
2024-03-23 07:50:00,0,0,0,0,0,0,0,0
2024-03-23 08:00:00,0,0,0,0,0,0,0,0
2024-03-23 08:10:00,0,0,0,0,0,0,0,0
2024-03-23 08:20:00,0,0,0,0,0,0,0,0
2024-03-23 08:30:00,0,0,0,0,0,0,0,0
2024-03-23 08:40:00,0,0,0,0,0,0,0,0
2024-03-23 08:50:00,0,0,0,0,0,0,0,0
2024-03-23 09:00:00,0,0,0,0,0,0,0,0
2024-03-23 09:10:00,0,0,0,0,0,0,0,0
2024-03-23 09:20:00,0,0,0,0,0,0,0,0
2024-03-23 09:30:00,0,0,0,0,0,0,0,0
2024-03-23 09:40:00,0,0,0,0,0,0,0,0
2024-03-23 09:50:00,0,0,0,0,0,0,0,0
2024-03-23 10:00:00,0,0,0,0,0,0,0,0
2024-03-23 10:10:00,0,0,0,0,0,0,0,0
2024-03-23 10:20:00,0,0,0,0,0,0,0,0
2024-03-23 10:30:00,0,0,0,0,0,0,0,0
2024-03-23 10:40:00,0,0,0,0,0,0,0,0
2024-03-23 10:50:00,0,0,0,0,0,0,0,0
2024-03-23 11:00:00,0,0,0,0,0,0,0,0
2024-03-23 11:10:00,0,0,0,0,0,0,0,0
2024-03-23 11:20:00,0,0,0,0,0,0,0,0
2024-03-23 11:30:00,0,0,0,0,0,0,0,0
2024-03-23 11:40:00,0,0,0,0,0,0,0,0
2024-03-23 11:50:00,0,0,0,0,0,0,0,0
2024-03-23 12:00:00,0,0,0,0,0,0,0,0
2024-03-23 12:10:00,0,0,0,0,0,0,0,0
2024-03-23 12:20:00,0,0,0,0,0,0,0,0
2024-03-23 12:30:00,0,0,0,0,0,0,0,0
2024-03-23 12:40:00,0,0,0,0,0,0,0,0
2024-03-23 12:50:00,0,0,0,0,0,0,0,0
2024-03-23 13:00:00,0,0,0,0,0,0,0,0
2024-03-23 13:10:00,0,0,0,0,0,0,0,0
2024-03-23 13:20:00,0,0,0,0,0,0,0,0
2024-03-23 13:30:00,0,0,0,0,0,0,0,0
2024-03-23 13:40:00,0,0,0,0,0,0,0,0
2024-03-23 13:50:00,0,0,0,0,0,0,0,0
2024-03-23 14:00:00,0,0,0,0,0,0,0,0
2024-03-23 14:10:00,0,0,0,0,0,0,0,0
2024-03-23 14:20:00,0,0,0,0,0,0,0,0
2024-03-23 14:30:00,0,0,0,0,0,0,0,0
2024-03-23 14:40:00,0,0,0,0,0,0,0,0
2024-03-23 14:50:00,0,0,0,0,0,0,0,0
2024-03-23 15:00:00,0,0,0,0,0,0,0,0
2024-03-23 15:10:00,0,0,0,0,0,0,0,0
2024-03-23 15:20:00,0,0,0,0,0,0,0,0
2024-03-23 15:30:00,0,0,0,0,0,0,0,0
2024-03-23 15:40:00,0,0,0,0,0,0,0,0
2024-03-23 15:50:00,0,0,0,0,0,0,0,0
2024-03-23 16:00:00,0,0,0,0,0,0,0,0
2024-03-23 16:10:00,0,0,0,0,0,0,0,0
2024-03-23 16:20:00,0,0,0,0,0,0,0,0
2024-03-23 16:30:00,0,0,0,0,0,0,0,0
2024-03-23 16:40:00,0,0,0,0,0,0,0,0
2024-03-23 16:50:00,0,0,0,0,0,0,0,0
2024-03-23 17:00:00,0,0,0,0,0,0,0,0
2024-03-23 17:10:00,0,0,0,0,0,0,0,0
2024-03-23 17:20:00,0,0,0,0,0,0,0,0
2024-03-23 17:30:00,0,0,0,0,0,0,0,0
2024-03-23 17:40:00,0,0,0,0,0,0,0,0
2024-03-23 17:50:00,0,0,0,0,0,0,0,0
2024-03-23 18:00:00,0,0,0,0,0,0,0,0
2024-03-23 18:10:00,0,0,0,0,0,0,0,0
2024-03-23 18:20:00,0,0,0,0,0,0,0,0
2024-03-23 18:30:00,0,0,0,0,0,0,0,0
2024-03-23 18:40:00,0,0,0,0,0,0,0,0
2024-03-23 18:50:00,0,0,0,0,0,0,0,0
2024-03-23 19:00:00,0,0,0,0,0,0,0,0
2024-03-23 19:10:00,0,0,0,0,0,0,0,0
2024-03-23 19:20:00,0,0,0,0,0,0,0,0
2024-03-23 19:30:00,0,0,0,0,0,0,0,0
2024-03-23 19:40:00,0,0,0,0,0,0,0,0
2024-03-23 19:50:00,0,0,0,0,0,0,0,0
2024-03-23 20:00:00,0,0,0,0,0,0,0,0
2024-03-23 20:10:00,0,0,0,0,0,0,0,0
2024-03-23 20:20:00,0,0,0,0,0,0,0,0
2024-03-23 20:30:00,0,0,0,0,0,0,0,0
2024-03-23 20:40:00,0,0,0,0,0,0,0,0
2024-03-23 20:50:00,0,0,0,0,0,0,0,0
2024-03-23 21:00:00,0,0,0,0,0,0,0,0
2024-03-23 21:10:00,0,0,0,0,0,0,0,0
2024-03-23 21:20:00,0,0,0,0,0,0,0,0
2024-03-23 21:30:00,0,0,0,0,0,0,0,0
2024-03-23 21:40:00,0,0,0,0,0,0,0,0
2024-03-23 21:50:00,0,0,0,0,0,0,0,0
2024-03-23 22:00:00,0,0,0,0,0,0,0,0
2024-03-23 22:10:00,0,0,0,0,0,0,0,0
2024-03-23 22:20:00,0,0,0,0,0,0,0,0
2024-03-23 22:30:00,0,0,0,0,0,0,0,0
2024-03-23 22:40:00,0,0,0,0,0,0,0,0
2024-03-23 22:50:00,0,0,0,0,0,0,0,0
2024-03-23 23:00:00,0,0,0,0,0,0,0,0
2024-03-23 23:10:00,0,0,0,0,0,0,0,0
2024-03-23 23:20:00,0,0,0,0,0,0,0,0
2024-03-23 23:30:00,0,0,0,0,0,0,0,0
2024-03-23 23:40:00,0,0,0,0,0,0,0,0
2024-03-23 23:50:00,0,0,0,0,0,0,0,0
2024-03-24 00:00:00,0,0,0,0,0,0,0,0
2024-03-24 00:10:00,0,0,0,0,0,0,0,0
2024-03-24 00:20:00,0,0,0,0,0,0,0,0
2024-03-24 00:30:00,0,0,0,0,0,0,0,0
2024-03-24 00:40:00,0,0,0,0,0,0,0,0
2024-03-24 00:50:00,0,0,0,0,0,0,0,0
2024-03-24 01:00:00,0,0,0,0,0,0,0,0
2024-03-24 01:10:00,0,0,0,0,0,0,0,0
2024-03-24 01:20:00,0,0,0,0,0,0,0,0
2024-03-24 01:30:00,0,0,0,0,0,0,0,0
2024-03-24 01:40:00,0,0,0,0,0,0,0,0
2024-03-24 01:50:00,0,0,0,0,0,0,0,0
2024-03-24 02:00:00,0,0,0,0,0,0,0,0
2024-03-24 02:10:00,0,0,0,0,0,0,0,0
2024-03-24 02:20:00,0,0,0,0,0,0,0,0
2024-03-24 02:30:00,0,0,0,0,0,0,0,0
2024-03-24 02:40:00,0,0,0,0,0,0,0,0
2024-03-24 02:50:00,0,0,0,0,0,0,0,0
2024-03-24 03:00:00,0,0,0,0,0,0,0,0
2024-03-24 03:10:00,0,0,0,0,0,0,0,0
2024-03-24 03:20:00,0,0,0,0,0,0,0,0
2024-03-24 03:30:00,0,0,0,0,0,0,0,0
2024-03-24 03:40:00,0,0,0,0,0,0,0,0
2024-03-24 03:50:00,0,0,0,0,0,0,0,0
2024-03-24 04:00:00,0,0,0,0,0,0,0,0
2024-03-24 04:10:00,0,0,0,0,0,0,0,0
2024-03-24 04:20:00,0,0,0,0,0,0,0,0
2024-03-24 04:30:00,0,0,0,0,0,0,0,0
2024-03-24 04:40:00,0,0,0,0,0,0,0,0
2024-03-24 04:50:00,0,0,0,0,0,0,0,0
2024-03-24 05:00:00,0,0,0,0,0,0,0,0
2024-03-24 05:10:00,0,0,0,0,0,0,0,0
2024-03-24 05:20:00,0,0,0,0,0,0,0,0
2024-03-24 05:30:00,0,0,0,0,0,0,0,0
2024-03-24 05:40:00,0,0,0,0,0,0,0,0
2024-03-24 05:50:00,0,0,0,0,0,0,0,0
2024-03-24 06:00:00,0,0,0,0,0,0,0,0
2024-03-24 06:10:00,0,0,0,0,0,0,0,0
2024-03-24 06:20:00,0,0,0,0,0,0,0,0
2024-03-24 06:30:00,0,0,0,0,0,0,0,0
2024-03-24 06:40:00,0,0,0,0,0,0,0,0
2024-03-24 06:50:00,0,0,0,0,0,0,0,0
2024-03-24 07:00:00,0,0,0,0,0,0,0,0
2024-03-24 07:10:00,0,0,0,0,0,0,0,0
2024-03-24 07:20:00,0,0,0,0,0,0,0,0
2024-03-24 07:30:00,0,0,0,0,0,0,0,0
2024-03-24 07:40:00,0,0,0,0,0,0,0,0
2024-03-24 07:50:00,0,0,0,0,0,0,0,0
2024-03-24 08:00:00,0,0,0,0,0,0,0,0
2024-03-24 08:10:00,0,0,0,0,0,0,0,0
2024-03-24 08:20:00,0,0,0,0,0,0,0,0
2024-03-24 08:30:00,0,0,0,0,0,0,0,0
2024-03-24 08:40:00,0,0,0,0,0,0,0,0
2024-03-24 08:50:00,0,0,0,0,0,0,0,0
2024-03-24 09:00:00,0,0,0,0,0,0,0,0
2024-03-24 09:10:00,0,0,0,0,0,0,0,0
2024-03-24 09:20:00,0,0,0,0,0,0,0,0
2024-03-24 09:30:00,0,0,0,0,0,0,0,0
2024-03-24 09:40:00,0,0,0,0,0,0,0,0
2024-03-24 09:50:00,0,0,0,0,0,0,0,0
2024-03-24 10:00:00,0,0,0,0,0,0,0,0
2024-03-24 10:10:00,0,0,0,0,0,0,0,0
2024-03-24 10:20:00,0,0,0,0,0,0,0,0
2024-03-24 10:30:00,0,0,0,0,0,0,0,0
2024-03-24 10:40:00,0,0,0,0,0,0,0,0
2024-03-24 10:50:00,0,0,0,0,0,0,0,0
2024-03-24 11:00:00,0,0,0,0,0,0,0,0
2024-03-24 11:10:00,0,0,0,0,0,0,0,0
2024-03-24 11:20:00,0,0,0,0,0,0,0,0
2024-03-24 11:30:00,0,0,0,0,0,0,0,0
2024-03-24 11:40:00,0,0,0,0,0,0,0,0
2024-03-24 11:50:00,0,0,0,0,0,0,0,0
2024-03-24 12:00:00,0,0,0,0,0,0,0,0
2024-03-24 12:10:00,0,0,0,0,0,0,0,0
2024-03-24 12:20:00,0,0,0,0,0,0,0,0
2024-03-24 12:30:00,0,0,0,0,0,0,0,0
2024-03-24 12:40:00,0,0,0,0,0,0,0,0
2024-03-24 12:50:00,0,0,0,0,0,0,0,0
2024-03-24 13:00:00,0,0,0,0,0,0,0,0
2024-03-24 13:10:00,0,0,0,0,0,0,0,0
2024-03-24 13:20:00,0,0,0,0,0,0,0,0
2024-03-24 13:30:00,0,0,0,0,0,0,0,0
2024-03-24 13:40:00,0,0,0,0,0,0,0,0
2024-03-24 13:50:00,0,0,0,0,0,0,0,0
2024-03-24 14:00:00,0,0,0,0,0,0,0,0
2024-03-24 14:10:00,0,0,0,0,0,0,0,0
2024-03-24 14:20:00,0,0,0,0,0,0,0,0
2024-03-24 14:30:00,0,0,0,0,0,0,0,0
2024-03-24 14:40:00,0,0,0,0,0,0,0,0
2024-03-24 14:50:00,0,0,0,0,0,0,0,0
2024-03-24 15:00:00,0,0,0,0,0,0,0,0
2024-03-24 15:10:00,0,0,0,0,0,0,0,0
2024-03-24 15:20:00,0,0,0,0,0,0,0,0
2024-03-24 15:30:00,0,0,0,0,0,0,0,0
2024-03-24 15:40:00,0,0,0,0,0,0,0,0
2024-03-24 15:50:00,0,0,0,0,0,0,0,0
2024-03-24 16:00:00,0,0,0,0,0,0,0,0
2024-03-24 16:10:00,0,0,0,0,0,0,0,0
2024-03-24 16:20:00,0,0,0,0,0,0,0,0
2024-03-24 16:30:00,0,0,0,0,0,0,0,0
2024-03-24 16:40:00,0,0,0,0,0,0,0,0
2024-03-24 16:50:00,0,0,0,0,0,0,0,0
2024-03-24 17:00:00,0,0,0,0,0,0,0,0
2024-03-24 17:10:00,0,0,0,0,0,0,0,0
2024-03-24 17:20:00,0,0,0,0,0,0,0,0
2024-03-24 17:30:00,0,0,0,0,0,0,0,0
2024-03-24 17:40:00,0,0,0,0,0,0,0,0
2024-03-24 17:50:00,0,0,0,0,0,0,0,0
2024-03-24 18:00:00,0,0,0,0,0,0,0,0
2024-03-24 18:10:00,0,0,0,0,0,0,0,0
2024-03-24 18:20:00,0,0,0,0,0,0,0,0
2024-03-24 18:30:00,0,0,0,0,0,0,0,0
2024-03-24 18:40:00,0,0,0,0,0,0,0,0
2024-03-24 18:50:00,0,0,0,0,0,0,0,0
2024-03-24 19:00:00,0,0,0,0,0,0,0,0
2024-03-24 19:10:00,0,0,0,0,0,0,0,0
2024-03-24 19:20:00,0,0,0,0,0,0,0,0
2024-03-24 19:30:00,0,0,0,0,0,0,0,0
2024-03-24 19:40:00,0,0,0,0,0,0,0,0
2024-03-24 19:50:00,0,0,0,0,0,0,0,0
2024-03-24 20:00:00,0,0,0,0,0,0,0,0
2024-03-24 20:10:00,0,0,0,0,0,0,0,0
2024-03-24 20:20:00,0,0,0,0,0,0,0,0
2024-03-24 20:30:00,0,0,0,0,0,0,0,0
2024-03-24 20:40:00,0,0,0,0,0,0,0,0
2024-03-24 20:50:00,0,0,0,0,0,0,0,0
2024-03-24 21:00:00,0,0,0,0,0,0,0,0
2024-03-24 21:10:00,0,0,0,0,0,0,0,0
2024-03-24 21:20:00,0,0,0,0,0,0,0,0
2024-03-24 21:30:00,0,0,0,0,0,0,0,0
2024-03-24 21:40:00,0,0,0,0,0,0,0,0
2024-03-24 21:50:00,0,0,0,0,0,0,0,0
2024-03-24 22:00:00,0,0,0,0,0,0,0,0
2024-03-24 22:10:00,0,0,0,0,0,0,0,0
2024-03-24 22:20:00,0,0,0,0,0,0,0,0
2024-03-24 22:30:00,0,0,0,0,0,0,0,0
2024-03-24 22:40:00,0,0,0,0,0,0,0,0
2024-03-24 22:50:00,0,0,0,0,0,0,0,0
2024-03-24 23:00:00,0,0,0,0,0,0,0,0
2024-03-24 23:10:00,0,0,0,0,0,0,0,0
2024-03-24 23:20:00,0,0,0,0,0,0,0,0
2024-03-24 23:30:00,0,0,0,0,0,0,0,0
2024-03-24 23:40:00,0,0,0,0,0,0,0,0
2024-03-24 23:50:00,0,0,0,0,0,0,0,0
2024-03-25 00:00:00,0,0,0,0,0,0,0,0
2024-03-25 00:10:00,0,0,0,0,0,0,0,0
2024-03-25 00:20:00,0,0,0,0,0,0,0,0
2024-03-25 00:30:00,0,0,0,0,0,0,0,0
2024-03-25 00:40:00,0,0,0,0,0,0,0,0
2024-03-25 00:50:00,0,0,0,0,0,0,0,0
2024-03-25 01:00:00,0,0,0,0,0,0,0,0
2024-03-25 01:10:00,0,0,0,0,0,0,0,0
2024-03-25 01:20:00,0,0,0,0,0,0,0,0
2024-03-25 01:30:00,0,0,0,0,0,0,0,0
2024-03-25 01:40:00,0,0,0,0,0,0,0,0
2024-03-25 01:50:00,0,0,0,0,0,0,0,0
2024-03-25 02:00:00,0,0,0,0,0,0,0,0
2024-03-25 02:10:00,0,0,0,0,0,0,0,0
2024-03-25 02:20:00,0,0,0,0,0,0,0,0
2024-03-25 02:30:00,0,0,0,0,0,0,0,0
2024-03-25 02:40:00,0,0,0,0,0,0,0,0
2024-03-25 02:50:00,0,0,0,0,0,0,0,0
2024-03-25 03:00:00,0,0,0,0,0,0,0,0
2024-03-25 03:10:00,0,0,0,0,0,0,0,0
2024-03-25 03:20:00,0,0,0,0,0,0,0,0
2024-03-25 03:30:00,0,0,0,0,0,0,0,0
2024-03-25 03:40:00,0,0,0,0,0,0,0,0
2024-03-25 03:50:00,0,0,0,0,0,0,0,0
2024-03-25 04:00:00,0,0,0,0,0,0,0,0
2024-03-25 04:10:00,0,0,0,0,0,0,0,0
2024-03-25 04:20:00,0,0,0,0,0,0,0,0
2024-03-25 04:30:00,0,0,0,0,0,0,0,0
2024-03-25 04:40:00,0,0,0,0,0,0,0,0
2024-03-25 04:50:00,0,0,0,0,0,0,0,0
2024-03-25 05:00:00,0,0,0,0,0,0,0,0
2024-03-25 05:10:00,0,0,0,0,0,0,0,0
2024-03-25 05:20:00,0,0,0,0,0,0,0,0
2024-03-25 05:30:00,0,0,0,0,0,0,0,0
2024-03-25 05:40:00,0,0,0,0,0,0,0,0
2024-03-25 05:50:00,0,0,0,0,0,0,0,0
2024-03-25 06:00:00,0,0,0,0,0,0,0,0
2024-03-25 06:10:00,0,0,0,0,0,0,0,0
2024-03-25 06:20:00,0,0,0,0,0,0,0,0
2024-03-25 06:30:00,0,0,0,0,0,0,0,0
2024-03-25 06:40:00,0,0,0,0,0,0,0,0
2024-03-25 06:50:00,0,0,0,0,0,0,0,0
2024-03-25 07:00:00,0,0,0,0,0,0,0,0
2024-03-25 07:10:00,0,0,0,0,0,0,0,0
2024-03-25 07:20:00,0,0,0,0,0,0,0,0
2024-03-25 07:30:00,0,0,0,0,0,0,0,0
2024-03-25 07:40:00,0,0,0,0,0,0,0,0
2024-03-25 07:50:00,0,0,0,0,0,0,0,0
2024-03-25 08:00:00,0,0,0,0,0,0,0,0
2024-03-25 08:10:00,0,0,0,0,0,0,0,0
2024-03-25 08:20:00,0,0,0,0,0,0,0,0
2024-03-25 08:30:00,0,0,0,0,0,0,0,0
2024-03-25 08:40:00,0,0,0,0,0,0,0,0
2024-03-25 08:50:00,0,0,0,0,0,0,0,0
2024-03-25 09:00:00,0,0,0,0,0,0,0,0
2024-03-25 09:10:00,0,0,0,0,0,0,0,0
2024-03-25 09:20:00,0,0,0,0,0,0,0,0
2024-03-25 09:30:00,0,0,0,0,0,0,0,0
2024-03-25 09:40:00,0,0,0,0,0,0,0,0
2024-03-25 09:50:00,0,0,0,0,0,0,0,0
2024-03-25 10:00:00,0,0,0,0,0,0,0,0
2024-03-25 10:10:00,0,0,0,0,0,0,0,0
2024-03-25 10:20:00,0,0,0,0,0,0,0,0
2024-03-25 10:30:00,0,0,0,0,0,0,0,0
2024-03-25 10:40:00,0,0,0,0,0,0,0,0
2024-03-25 10:50:00,0,0,0,0,0,0,0,0
2024-03-25 11:00:00,0,0,0,0,0,0,0,0
2024-03-25 11:10:00,0,0,0,0,0,0,0,0
2024-03-25 11:20:00,0,0,0,0,0,0,0,0
2024-03-25 11:30:00,0,0,0,0,0,0,0,0
2024-03-25 11:40:00,0,0,0,0,0,0,0,0
2024-03-25 11:50:00,0,0,0,0,0,0,0,0
2024-03-25 12:00:00,0,0,0,0,0,0,0,0
2024-03-25 12:10:00,0,0,0,0,0,0,0,0
2024-03-25 12:20:00,0,0,0,0,0,0,0,0
2024-03-25 12:30:00,0,0,0,0,0,0,0,0
2024-03-25 12:40:00,0,0,0,0,0,0,0,0
2024-03-25 12:50:00,0,0,0,0,0,0,0,0
2024-03-25 13:00:00,0,0,0,0,0,0,0,0
2024-03-25 13:10:00,0,0,0,0,0,0,0,0
2024-03-25 13:20:00,0,0,0,0,0,0,0,0
2024-03-25 13:30:00,0,0,0,0,0,0,0,0
2024-03-25 13:40:00,0,0,0,0,0,0,0,0
2024-03-25 13:50:00,0,0,0,0,0,0,0,0
2024-03-25 14:00:00,0,0,0,0,0,0,0,0
2024-03-25 14:10:00,0,0,0,0,0,0,0,0
2024-03-25 14:20:00,0,0,0,0,0,0,0,0
2024-03-25 14:30:00,0,0,0,0,0,0,0,0
2024-03-25 14:40:00,0,0,0,0,0,0,0,0
2024-03-25 14:50:00,0,0,0,0,0,0,0,0
2024-03-25 15:00:00,0,0,0,0,0,0,0,0
2024-03-25 15:10:00,0,0,0,0,0,0,0,0
2024-03-25 15:20:00,0,0,0,0,0,0,0,0
2024-03-25 15:30:00,0,0,0,0,0,0,0,0
2024-03-25 15:40:00,0,0,0,0,0,0,0,0
2024-03-25 15:50:00,0,0,0,0,0,0,0,0
2024-03-25 16:00:00,0,0,0,0,0,0,0,0
2024-03-25 16:10:00,0,0,0,0,0,0,0,0
2024-03-25 16:20:00,0,0,0,0,0,0,0,0
2024-03-25 16:30:00,0,0,0,0,0,0,0,0
2024-03-25 16:40:00,0,0,0,0,0,0,0,0
2024-03-25 16:50:00,0,0,0,0,0,0,0,0
2024-03-25 17:00:00,0,0,0,0,0,0,0,0
2024-03-25 17:10:00,0,0,0,0,0,0,0,0
2024-03-25 17:20:00,0,0,0,0,0,0,0,0
2024-03-25 17:30:00,0,0,0,0,0,0,0,0
2024-03-25 17:40:00,0,0,0,0,0,0,0,0
2024-03-25 17:50:00,0,0,0,0,0,0,0,0
2024-03-25 18:00:00,0,0,0,0,0,0,0,0
2024-03-25 18:10:00,0,0,0,0,0,0,0,0
2024-03-25 18:20:00,0,0,0,0,0,0,0,0
2024-03-25 18:30:00,0,0,0,0,0,0,0,0
2024-03-25 18:40:00,0,0,0,0,0,0,0,0
2024-03-25 18:50:00,0,0,0,0,0,0,0,0
2024-03-25 19:00:00,0,0,0,0,0,0,0,0
2024-03-25 19:10:00,0,0,0,0,0,0,0,0
2024-03-25 19:20:00,0,0,0,0,0,0,0,0
2024-03-25 19:30:00,0,0,0,0,0,0,0,0
2024-03-25 19:40:00,0,0,0,0,0,0,0,0
2024-03-25 19:50:00,0,0,0,0,0,0,0,0
2024-03-25 20:00:00,0,0,0,0,0,0,0,0
2024-03-25 20:10:00,0,0,0,0,0,0,0,0
2024-03-25 20:20:00,0,0,0,0,0,0,0,0
2024-03-25 20:30:00,0,0,0,0,0,0,0,0
2024-03-25 20:40:00,0,0,0,0,0,0,0,0
2024-03-25 20:50:00,0,0,0,0,0,0,0,0
2024-03-25 21:00:00,0,0,0,0,0,0,0,0
2024-03-25 21:10:00,0,0,0,0,0,0,0,0
2024-03-25 21:20:00,0,0,0,0,0,0,0,0
2024-03-25 21:30:00,0,0,0,0,0,0,0,0
2024-03-25 21:40:00,0,0,0,0,0,0,0,0
2024-03-25 21:50:00,0,0,0,0,0,0,0,0
2024-03-25 22:00:00,0,0,0,0,0,0,0,0
2024-03-25 22:10:00,0,0,0,0,0,0,0,0
2024-03-25 22:20:00,0,0,0,0,0,0,0,0
2024-03-25 22:30:00,0,0,0,0,0,0,0,0
2024-03-25 22:40:00,0,0,0,0,0,0,0,0
2024-03-25 22:50:00,0,0,0,0,0,0,0,0
2024-03-25 23:00:00,0,0,0,0,0,0,0,0
2024-03-25 23:10:00,0,0,0,0,0,0,0,0
2024-03-25 23:20:00,0,0,0,0,0,0,0,0
2024-03-25 23:30:00,0,0,0,0,0,0,0,0
2024-03-25 23:40:00,0,0,0,0,0,0,0,0
2024-03-25 23:50:00,0,0,0,0,0,0,0,0
2024-03-26 00:00:00,0,0,0,0,0,0,0,0
2024-03-26 00:10:00,0,0,0,0,0,0,0,0
2024-03-26 00:20:00,0,0,0,0,0,0,0,0
2024-03-26 00:30:00,0,0,0,0,0,0,0,0
2024-03-26 00:40:00,0,0,0,0,0,0,0,0
2024-03-26 00:50:00,0,0,0,0,0,0,0,0
2024-03-26 01:00:00,0,0,0,0,0,0,0,0
2024-03-26 01:10:00,0,0,0,0,0,0,0,0
2024-03-26 01:20:00,0,0,0,0,0,0,0,0
2024-03-26 01:30:00,0,0,0,0,0,0,0,0
2024-03-26 01:40:00,0,0,0,0,0,0,0,0
2024-03-26 01:50:00,0,0,0,0,0,0,0,0
2024-03-26 02:00:00,0,0,0,0,0,0,0,0
2024-03-26 02:10:00,0,0,0,0,0,0,0,0
2024-03-26 02:20:00,0,0,0,0,0,0,0,0
2024-03-26 02:30:00,0,0,0,0,0,0,0,0
2024-03-26 02:40:00,0,0,0,0,0,0,0,0
2024-03-26 02:50:00,0,0,0,0,0,0,0,0
2024-03-26 03:00:00,0,0,0,0,0,0,0,0
2024-03-26 03:10:00,0,0,0,0,0,0,0,0
2024-03-26 03:20:00,0,0,0,0,0,0,0,0
2024-03-26 03:30:00,0,0,0,0,0,0,0,0
2024-03-26 03:40:00,0,0,0,0,0,0,0,0
2024-03-26 03:50:00,0,0,0,0,0,0,0,0
2024-03-26 04:00:00,0,0,0,0,0,0,0,0
2024-03-26 04:10:00,0,0,0,0,0,0,0,0
2024-03-26 04:20:00,0,0,0,0,0,0,0,0
2024-03-26 04:30:00,0,0,0,0,0,0,0,0
2024-03-26 04:40:00,0,0,0,0,0,0,0,0
2024-03-26 04:50:00,0,0,0,0,0,0,0,0
2024-03-26 05:00:00,0,0,0,0,0,0,0,0
2024-03-26 05:10:00,0,0,0,0,0,0,0,0
2024-03-26 05:20:00,0,0,0,0,0,0,0,0
2024-03-26 05:30:00,0,0,0,0,0,0,0,0
2024-03-26 05:40:00,0,0,0,0,0,0,0,0
2024-03-26 05:50:00,0,0,0,0,0,0,0,0
2024-03-26 06:00:00,0,0,0,0,0,0,0,0
2024-03-26 06:10:00,0,0,0,0,0,0,0,0
2024-03-26 06:20:00,0,0,0,0,0,0,0,0
2024-03-26 06:30:00,0,0,0,0,0,0,0,0
2024-03-26 06:40:00,0,0,0,0,0,0,0,0
2024-03-26 06:50:00,0,0,0,0,0,0,0,0
2024-03-26 07:00:00,0,0,0,0,0,0,0,0
2024-03-26 07:10:00,0,0,0,0,0,0,0,0
2024-03-26 07:20:00,0,0,0,0,0,0,0,0
2024-03-26 07:30:00,0,0,0,0,0,0,0,0
2024-03-26 07:40:00,0,0,0,0,0,0,0,0
2024-03-26 07:50:00,0,0,0,0,0,0,0,0
2024-03-26 08:00:00,0,0,0,0,0,0,0,0
2024-03-26 08:10:00,0,0,0,0,0,0,0,0
2024-03-26 08:20:00,0,0,0,0,0,0,0,0
2024-03-26 08:30:00,0,0,0,0,0,0,0,0
2024-03-26 08:40:00,0,0,0,0,0,0,0,0
2024-03-26 08:50:00,0,0,0,0,0,0,0,0
2024-03-26 09:00:00,0,0,0,0,0,0,0,0
2024-03-26 09:10:00,0,0,0,0,0,0,0,0
2024-03-26 09:20:00,0,0,0,0,0,0,0,0
2024-03-26 09:30:00,0,0,0,0,0,0,0,0
2024-03-26 09:40:00,0,0,0,0,0,0,0,0
2024-03-26 09:50:00,0,0,0,0,0,0,0,0
2024-03-26 10:00:00,0,0,0,0,0,0,0,0
2024-03-26 10:10:00,0,0,0,0,0,0,0,0
2024-03-26 10:20:00,0,0,0,0,0,0,0,0
2024-03-26 10:30:00,0,0,0,0,0,0,0,0
2024-03-26 10:40:00,0,0,0,0,0,0,0,0
2024-03-26 10:50:00,0,0,0,0,0,0,0,0
2024-03-26 11:00:00,0,0,0,0,0,0,0,0
2024-03-26 11:10:00,0,0,0,0,0,0,0,0
2024-03-26 11:20:00,0,0,0,0,0,0,0,0
2024-03-26 11:30:00,0,0,0,0,0,0,0,0
2024-03-26 11:40:00,0,0,0,0,0,0,0,0
2024-03-26 11:50:00,0,0,0,0,0,0,0,0
2024-03-26 12:00:00,0,0,0,0,0,0,0,0
2024-03-26 12:10:00,0,0,0,0,0,0,0,0
2024-03-26 12:20:00,0,0,0,0,0,0,0,0
2024-03-26 12:30:00,0,0,0,0,0,0,0,0
2024-03-26 12:40:00,0,0,0,0,0,0,0,0
2024-03-26 12:50:00,0,0,0,0,0,0,0,0
2024-03-26 13:00:00,0,0,0,0,0,0,0,0
2024-03-26 13:10:00,0,0,0,0,0,0,0,0
2024-03-26 13:20:00,0,0,0,0,0,0,0,0
2024-03-26 13:30:00,0,0,0,0,0,0,0,0
2024-03-26 13:40:00,0,0,0,0,0,0,0,0
2024-03-26 13:50:00,0,0,0,0,0,0,0,0
2024-03-26 14:00:00,0,0,0,0,0,0,0,0
2024-03-26 14:10:00,0,0,0,0,0,0,0,0
2024-03-26 14:20:00,0,0,0,0,0,0,0,0
2024-03-26 14:30:00,0,0,0,0,0,0,0,0
2024-03-26 14:40:00,0,0,0,0,0,0,0,0
2024-03-26 14:50:00,0,0,0,0,0,0,0,0
2024-03-26 15:00:00,0,0,0,0,0,0,0,0
2024-03-26 15:10:00,0,0,0,0,0,0,0,0
2024-03-26 15:20:00,0,0,0,0,0,0,0,0
2024-03-26 15:30:00,0,0,0,0,0,0,0,0
2024-03-26 15:40:00,0,0,0,0,0,0,0,0
2024-03-26 15:50:00,0,0,0,0,0,0,0,0
2024-03-26 16:00:00,0,0,0,0,0,0,0,0
2024-03-26 16:10:00,0,0,0,0,0,0,0,0
2024-03-26 16:20:00,0,0,0,0,0,0,0,0
2024-03-26 16:30:00,0,0,0,0,0,0,0,0
2024-03-26 16:40:00,0,0,0,0,0,0,0,0
2024-03-26 16:50:00,0,0,0,0,0,0,0,0
2024-03-26 17:00:00,0,0,0,0,0,0,0,0
2024-03-26 17:10:00,0,0,0,0,0,0,0,0
2024-03-26 17:20:00,0,0,0,0,0,0,0,0
2024-03-26 17:30:00,0,0,0,0,0,0,0,0
2024-03-26 17:40:00,0,0,0,0,0,0,0,0
2024-03-26 17:50:00,0,0,0,0,0,0,0,0
2024-03-26 18:00:00,0,0,0,0,0,0,0,0
2024-03-26 18:10:00,0,0,0,0,0,0,0,0
2024-03-26 18:20:00,0,0,0,0,0,0,0,0
2024-03-26 18:30:00,0,0,0,0,0,0,0,0
2024-03-26 18:40:00,0,0,0,0,0,0,0,0
2024-03-26 18:50:00,0,0,0,0,0,0,0,0
2024-03-26 19:00:00,0,0,0,0,0,0,0,0
2024-03-26 19:10:00,0,0,0,0,0,0,0,0
2024-03-26 19:20:00,0,0,0,0,0,0,0,0
2024-03-26 19:30:00,0,0,0,0,0,0,0,0
2024-03-26 19:40:00,0,0,0,0,0,0,0,0
2024-03-26 19:50:00,0,0,0,0,0,0,0,0
2024-03-26 20:00:00,0,0,0,0,0,0,0,0
2024-03-26 20:10:00,0,0,0,0,0,0,0,0
2024-03-26 20:20:00,0,0,0,0,0,0,0,0
2024-03-26 20:30:00,0,0,0,0,0,0,0,0
2024-03-26 20:40:00,0,0,0,0,0,0,0,0
2024-03-26 20:50:00,0,0,0,0,0,0,0,0
2024-03-26 21:00:00,0,0,0,0,0,0,0,0
2024-03-26 21:10:00,0,0,0,0,0,0,0,0
2024-03-26 21:20:00,0,0,0,0,0,0,0,0
2024-03-26 21:30:00,0,0,0,0,0,0,0,0
2024-03-26 21:40:00,0,0,0,0,0,0,0,0
2024-03-26 21:50:00,0,0,0,0,0,0,0,0
2024-03-26 22:00:00,0,0,0,0,0,0,0,0
2024-03-26 22:10:00,0,0,0,0,0,0,0,0
2024-03-26 22:20:00,0,0,0,0,0,0,0,0
2024-03-26 22:30:00,0,0,0,0,0,0,0,0
2024-03-26 22:40:00,0,0,0,0,0,0,0,0
2024-03-26 22:50:00,0,0,0,0,0,0,0,0
2024-03-26 23:00:00,0,0,0,0,0,0,0,0
2024-03-26 23:10:00,0,0,0,0,0,0,0,0
2024-03-26 23:20:00,0,0,0,0,0,0,0,0
2024-03-26 23:30:00,0,0,0,0,0,0,0,0
2024-03-26 23:40:00,0,0,0,0,0,0,0,0
2024-03-26 23:50:00,0,0,0,0,0,0,0,0
2024-03-27 00:00:00,0,0,0,0,0,0,0,0
2024-03-27 00:10:00,0,0,0,0,0,0,0,0
2024-03-27 00:20:00,0,0,0,0,0,0,0,0
2024-03-27 00:30:00,0,0,0,0,0,0,0,0
2024-03-27 00:40:00,0,0,0,0,0,0,0,0
2024-03-27 00:50:00,0,0,0,0,0,0,0,0
2024-03-27 01:00:00,0,0,0,0,0,0,0,0
2024-03-27 01:10:00,0,0,0,0,0,0,0,0
2024-03-27 01:20:00,0,0,0,0,0,0,0,0
2024-03-27 01:30:00,0,0,0,0,0,0,0,0
2024-03-27 01:40:00,0,0,0,0,0,0,0,0
2024-03-27 01:50:00,0,0,0,0,0,0,0,0
2024-03-27 02:00:00,0,0,0,0,0,0,0,0
2024-03-27 02:10:00,0,0,0,0,0,0,0,0
2024-03-27 02:20:00,0,0,0,0,0,0,0,0
2024-03-27 02:30:00,0,0,0,0,0,0,0,0
2024-03-27 02:40:00,0,0,0,0,0,0,0,0
2024-03-27 02:50:00,0,0,0,0,0,0,0,0
2024-03-27 03:00:00,0,0,0,0,0,0,0,0
2024-03-27 03:10:00,0,0,0,0,0,0,0,0
2024-03-27 03:20:00,0,0,0,0,0,0,0,0
2024-03-27 03:30:00,0,0,0,0,0,0,0,0
2024-03-27 03:40:00,0,0,0,0,0,0,0,0
2024-03-27 03:50:00,0,0,0,0,0,0,0,0
2024-03-27 04:00:00,0,0,0,0,0,0,0,0
2024-03-27 04:10:00,0,0,0,0,0,0,0,0
2024-03-27 04:20:00,0,0,0,0,0,0,0,0
2024-03-27 04:30:00,0,0,0,0,0,0,0,0
2024-03-27 04:40:00,0,0,0,0,0,0,0,0
2024-03-27 04:50:00,0,0,0,0,0,0,0,0
2024-03-27 05:00:00,0,0,0,0,0,0,0,0
2024-03-27 05:10:00,0,0,0,0,0,0,0,0
2024-03-27 05:20:00,0,0,0,0,0,0,0,0
2024-03-27 05:30:00,0,0,0,0,0,0,0,0
2024-03-27 05:40:00,0,0,0,0,0,0,0,0
2024-03-27 05:50:00,0,0,0,0,0,0,0,0
2024-03-27 06:00:00,0,0,0,0,0,0,0,0
2024-03-27 06:10:00,0,0,0,0,0,0,0,0
2024-03-27 06:20:00,0,0,0,0,0,0,0,0
2024-03-27 06:30:00,0,0,0,0,0,0,0,0
2024-03-27 06:40:00,0,0,0,0,0,0,0,0
2024-03-27 06:50:00,0,0,0,0,0,0,0,0
2024-03-27 07:00:00,0,0,0,0,0,0,0,0
2024-03-27 07:10:00,0,0,0,0,0,0,0,0
2024-03-27 07:20:00,0,0,0,0,0,0,0,0
2024-03-27 07:30:00,0,0,0,0,0,0,0,0
2024-03-27 07:40:00,0,0,0,0,0,0,0,0
2024-03-27 07:50:00,0,0,0,0,0,0,0,0
2024-03-27 08:00:00,0,0,0,0,0,0,0,0
2024-03-27 08:10:00,0,0,0,0,0,0,0,0
2024-03-27 08:20:00,0,0,0,0,0,0,0,0
2024-03-27 08:30:00,0,0,0,0,0,0,0,0
2024-03-27 08:40:00,0,0,0,0,0,0,0,0
2024-03-27 08:50:00,0,0,0,0,0,0,0,0
2024-03-27 09:00:00,0,0,0,0,0,0,0,0
2024-03-27 09:10:00,0,0,0,0,0,0,0,0
2024-03-27 09:20:00,0,0,0,0,0,0,0,0
2024-03-27 09:30:00,0,0,0,0,0,0,0,0
2024-03-27 09:40:00,0,0,0,0,0,0,0,0
2024-03-27 09:50:00,0,0,0,0,0,0,0,0
2024-03-27 10:00:00,0,0,0,0,0,0,0,0
2024-03-27 10:10:00,0,0,0,0,0,0,0,0
2024-03-27 10:20:00,0,0,0,0,0,0,0,0
2024-03-27 10:30:00,0,0,0,0,0,0,0,0
2024-03-27 10:40:00,0,0,0,0,0,0,0,0
2024-03-27 10:50:00,0,0,0,0,0,0,0,0
2024-03-27 11:00:00,0,0,0,0,0,0,0,0
2024-03-27 11:10:00,0,0,0,0,0,0,0,0
2024-03-27 11:20:00,0,0,0,0,0,0,0,0
2024-03-27 11:30:00,0,0,0,0,0,0,0,0
2024-03-27 11:40:00,0,0,0,0,0,0,0,0
2024-03-27 11:50:00,0,0,0,0,0,0,0,0
2024-03-27 12:00:00,0,0,0,0,0,0,0,0
2024-03-27 12:10:00,0,0,0,0,0,0,0,0
2024-03-27 12:20:00,0,0,0,0,0,0,0,0
2024-03-27 12:30:00,0,0,0,0,0,0,0,0
2024-03-27 12:40:00,0,0,0,0,0,0,0,0
2024-03-27 12:50:00,0,0,0,0,0,0,0,0
2024-03-27 13:00:00,0,0,0,0,0,0,0,0
2024-03-27 13:10:00,0,0,0,0,0,0,0,0
2024-03-27 13:20:00,0,0,0,0,0,0,0,0
2024-03-27 13:30:00,0,0,0,0,0,0,0,0
2024-03-27 13:40:00,0,0,0,0,0,0,0,0
2024-03-27 13:50:00,0,0,0,0,0,0,0,0
2024-03-27 14:00:00,0,0,0,0,0,0,0,0
2024-03-27 14:10:00,0,0,0,0,0,0,0,0
2024-03-27 14:20:00,0,0,0,0,0,0,0,0
2024-03-27 14:30:00,0,0,0,0,0,0,0,0
2024-03-27 14:40:00,0,0,0,0,0,0,0,0
2024-03-27 14:50:00,0,0,0,0,0,0,0,0
2024-03-27 15:00:00,0,0,0,0,0,0,0,0
2024-03-27 15:10:00,0,0,0,0,0,0,0,0
2024-03-27 15:20:00,0,0,0,0,0,0,0,0
2024-03-27 15:30:00,0,0,0,0,0,0,0,0
2024-03-27 15:40:00,0,0,0,0,0,0,0,0
2024-03-27 15:50:00,0,0,0,0,0,0,0,0
2024-03-27 16:00:00,0,0,0,0,0,0,0,0
2024-03-27 16:10:00,0,0,0,0,0,0,0,0
2024-03-27 16:20:00,0,0,0,0,0,0,0,0
2024-03-27 16:30:00,0,0,0,0,0,0,0,0
2024-03-27 16:40:00,0,0,0,0,0,0,0,0
2024-03-27 16:50:00,0,0,0,0,0,0,0,0
2024-03-27 17:00:00,0,0,0,0,0,0,0,0
2024-03-27 17:10:00,0,0,0,0,0,0,0,0
2024-03-27 17:20:00,0,0,0,0,0,0,0,0
2024-03-27 17:30:00,0,0,0,0,0,0,0,0
2024-03-27 17:40:00,0,0,0,0,0,0,0,0
2024-03-27 17:50:00,0,0,0,0,0,0,0,0
2024-03-27 18:00:00,0,0,0,0,0,0,0,0
2024-03-27 18:10:00,0,0,0,0,0,0,0,0
2024-03-27 18:20:00,0,0,0,0,0,0,0,0
2024-03-27 18:30:00,0,0,0,0,0,0,0,0
2024-03-27 18:40:00,0,0,0,0,0,0,0,0
2024-03-27 18:50:00,0,0,0,0,0,0,0,0
2024-03-27 19:00:00,0,0,0,0,0,0,0,0
2024-03-27 19:10:00,0,0,0,0,0,0,0,0
2024-03-27 19:20:00,0,0,0,0,0,0,0,0
2024-03-27 19:30:00,0,0,0,0,0,0,0,0
2024-03-27 19:40:00,0,0,0,0,0,0,0,0
2024-03-27 19:50:00,0,0,0,0,0,0,0,0
2024-03-27 20:00:00,0,0,0,0,0,0,0,0
2024-03-27 20:10:00,0,0,0,0,0,0,0,0
2024-03-27 20:20:00,0,0,0,0,0,0,0,0
2024-03-27 20:30:00,0,0,0,0,0,0,0,0
2024-03-27 20:40:00,0,0,0,0,0,0,0,0
2024-03-27 20:50:00,0,0,0,0,0,0,0,0
2024-03-27 21:00:00,0,0,0,0,0,0,0,0
2024-03-27 21:10:00,0,0,0,0,0,0,0,0
2024-03-27 21:20:00,0,0,0,0,0,0,0,0
2024-03-27 21:30:00,0,0,0,0,0,0,0,0
2024-03-27 21:40:00,0,0,0,0,0,0,0,0
2024-03-27 21:50:00,0,0,0,0,0,0,0,0
2024-03-27 22:00:00,0,0,0,0,0,0,0,0
2024-03-27 22:10:00,0,0,0,0,0,0,0,0
2024-03-27 22:20:00,0,0,0,0,0,0,0,0
2024-03-27 22:30:00,0,0,0,0,0,0,0,0
2024-03-27 22:40:00,0,0,0,0,0,0,0,0
2024-03-27 22:50:00,0,0,0,0,0,0,0,0
2024-03-27 23:00:00,0,0,0,0,0,0,0,0
2024-03-27 23:10:00,0,0,0,0,0,0,0,0
2024-03-27 23:20:00,0,0,0,0,0,0,0,0
2024-03-27 23:30:00,0,0,0,0,0,0,0,0
2024-03-27 23:40:00,0,0,0,0,0,0,0,0
2024-03-27 23:50:00,0,0,0,0,0,0,0,0
2024-03-28 00:00:00,0,0,0,0,0,0,0,0
2024-03-28 00:10:00,0,0,0,0,0,0,0,0
2024-03-28 00:20:00,0,0,0,0,0,0,0,0
2024-03-28 00:30:00,0,0,0,0,0,0,0,0
2024-03-28 00:40:00,0,0,0,0,0,0,0,0
2024-03-28 00:50:00,0,0,0,0,0,0,0,0
2024-03-28 01:00:00,0,0,0,0,0,0,0,0
2024-03-28 01:10:00,0,0,0,0,0,0,0,0
2024-03-28 01:20:00,0,0,0,0,0,0,0,0
2024-03-28 01:30:00,0,0,0,0,0,0,0,0
2024-03-28 01:40:00,0,0,0,0,0,0,0,0
2024-03-28 01:50:00,0,0,0,0,0,0,0,0
2024-03-28 02:00:00,0,0,0,0,0,0,0,0
2024-03-28 02:10:00,0,0,0,0,0,0,0,0
2024-03-28 02:20:00,0,0,0,0,0,0,0,0
2024-03-28 02:30:00,0,0,0,0,0,0,0,0
2024-03-28 02:40:00,0,0,0,0,0,0,0,0
2024-03-28 02:50:00,0,0,0,0,0,0,0,0
2024-03-28 03:00:00,0,0,0,0,0,0,0,0
2024-03-28 03:10:00,0,0,0,0,0,0,0,0
2024-03-28 03:20:00,0,0,0,0,0,0,0,0
2024-03-28 03:30:00,0,0,0,0,0,0,0,0
2024-03-28 03:40:00,0,0,0,0,0,0,0,0
2024-03-28 03:50:00,0,0,0,0,0,0,0,0
2024-03-28 04:00:00,0,0,0,0,0,0,0,0
2024-03-28 04:10:00,0,0,0,0,0,0,0,0
2024-03-28 04:20:00,0,0,0,0,0,0,0,0
2024-03-28 04:30:00,0,0,0,0,0,0,0,0
2024-03-28 04:40:00,0,0,0,0,0,0,0,0
2024-03-28 04:50:00,0,0,0,0,0,0,0,0
2024-03-28 05:00:00,0,0,0,0,0,0,0,0
2024-03-28 05:10:00,0,0,0,0,0,0,0,0
2024-03-28 05:20:00,0,0,0,0,0,0,0,0
2024-03-28 05:30:00,0,0,0,0,0,0,0,0
2024-03-28 05:40:00,0,0,0,0,0,0,0,0
2024-03-28 05:50:00,0,0,0,0,0,0,0,0
2024-03-28 06:00:00,0,0,0,0,0,0,0,0
2024-03-28 06:10:00,0,0,0,0,0,0,0,0
2024-03-28 06:20:00,0,0,0,0,0,0,0,0
2024-03-28 06:30:00,0,0,0,0,0,0,0,0
2024-03-28 06:40:00,0,0,0,0,0,0,0,0
2024-03-28 06:50:00,0,0,0,0,0,0,0,0
2024-03-28 07:00:00,0,0,0,0,0,0,0,0
2024-03-28 07:10:00,0,0,0,0,0,0,0,0
2024-03-28 07:20:00,0,0,0,0,0,0,0,0
2024-03-28 07:30:00,0,0,0,0,0,0,0,0
2024-03-28 07:40:00,0,0,0,0,0,0,0,0
2024-03-28 07:50:00,0,0,0,0,0,0,0,0
2024-03-28 08:00:00,0,0,0,0,0,0,0,0
2024-03-28 08:10:00,0,0,0,0,0,0,0,0
2024-03-28 08:20:00,0,0,0,0,0,0,0,0
2024-03-28 08:30:00,0,0,0,0,0,0,0,0
2024-03-28 08:40:00,0,0,0,0,0,0,0,0
2024-03-28 08:50:00,0,0,0,0,0,0,0,0
2024-03-28 09:00:00,0,0,0,0,0,0,0,0
2024-03-28 09:10:00,0,0,0,0,0,0,0,0
2024-03-28 09:20:00,0,0,0,0,0,0,0,0
2024-03-28 09:30:00,0,0,0,0,0,0,0,0
2024-03-28 09:40:00,0,0,0,0,0,0,0,0
2024-03-28 09:50:00,0,0,0,0,0,0,0,0
2024-03-28 10:00:00,0,0,0,0,0,0,0,0
2024-03-28 10:10:00,0,0,0,0,0,0,0,0
2024-03-28 10:20:00,0,0,0,0,0,0,0,0
2024-03-28 10:30:00,0,0,0,0,0,0,0,0
2024-03-28 10:40:00,0,0,0,0,0,0,0,0
2024-03-28 10:50:00,0,0,0,0,0,0,0,0
2024-03-28 11:00:00,0,0,0,0,0,0,0,0
2024-03-28 11:10:00,0,0,0,0,0,0,0,0
2024-03-28 11:20:00,0,0,0,0,0,0,0,0
2024-03-28 11:30:00,0,0,0,0,0,0,0,0
2024-03-28 11:40:00,0,0,0,0,0,0,0,0
2024-03-28 11:50:00,0,0,0,0,0,0,0,0
2024-03-28 12:00:00,0,0,0,0,0,0,0,0
2024-03-28 12:10:00,0,0,0,0,0,0,0,0
2024-03-28 12:20:00,0,0,0,0,0,0,0,0
2024-03-28 12:30:00,0,0,0,0,0,0,0,0
2024-03-28 12:40:00,0,0,0,0,0,0,0,0
2024-03-28 12:50:00,0,0,0,0,0,0,0,0
2024-03-28 13:00:00,0,0,0,0,0,0,0,0
2024-03-28 13:10:00,0,0,0,0,0,0,0,0
2024-03-28 13:20:00,0,0,0,0,0,0,0,0
2024-03-28 13:30:00,0,0,0,0,0,0,0,0
2024-03-28 13:40:00,0,0,0,0,0,0,0,0
2024-03-28 13:50:00,0,0,0,0,0,0,0,0
2024-03-28 14:00:00,0,0,0,0,0,0,0,0
2024-03-28 14:10:00,0,0,0,0,0,0,0,0
2024-03-28 14:20:00,0,0,0,0,0,0,0,0
2024-03-28 14:30:00,0,0,0,0,0,0,0,0
2024-03-28 14:40:00,0,0,0,0,0,0,0,0
2024-03-28 14:50:00,0,0,0,0,0,0,0,0
2024-03-28 15:00:00,0,0,0,0,0,0,0,0
2024-03-28 15:10:00,0,0,0,0,0,0,0,0
2024-03-28 15:20:00,0,0,0,0,0,0,0,0
2024-03-28 15:30:00,0,0,0,0,0,0,0,0
2024-03-28 15:40:00,0,0,0,0,0,0,0,0
2024-03-28 15:50:00,0,0,0,0,0,0,0,0
2024-03-28 16:00:00,0,0,0,0,0,0,0,0
2024-03-28 16:10:00,0,0,0,0,0,0,0,0
2024-03-28 16:20:00,0,0,0,0,0,0,0,0
2024-03-28 16:30:00,0,0,0,0,0,0,0,0
2024-03-28 16:40:00,0,0,0,0,0,0,0,0
2024-03-28 16:50:00,0,0,0,0,0,0,0,0
2024-03-28 17:00:00,0,0,0,0,0,0,0,0
2024-03-28 17:10:00,0,0,0,0,0,0,0,0
2024-03-28 17:20:00,0,0,0,0,0,0,0,0
2024-03-28 17:30:00,0,0,0,0,0,0,0,0
2024-03-28 17:40:00,0,0,0,0,0,0,0,0
2024-03-28 17:50:00,0,0,0,0,0,0,0,0
2024-03-28 18:00:00,0,0,0,0,0,0,0,0
2024-03-28 18:10:00,0,0,0,0,0,0,0,0
2024-03-28 18:20:00,0,0,0,0,0,0,0,0
2024-03-28 18:30:00,0,0,0,0,0,0,0,0
2024-03-28 18:40:00,0,0,0,0,0,0,0,0
2024-03-28 18:50:00,0,0,0,0,0,0,0,0
2024-03-28 19:00:00,0,0,0,0,0,0,0,0
2024-03-28 19:10:00,0,0,0,0,0,0,0,0
2024-03-28 19:20:00,0,0,0,0,0,0,0,0
2024-03-28 19:30:00,0,0,0,0,0,0,0,0
2024-03-28 19:40:00,0,0,0,0,0,0,0,0
2024-03-28 19:50:00,0,0,0,0,0,0,0,0
2024-03-28 20:00:00,0,0,0,0,0,0,0,0
2024-03-28 20:10:00,0,0,0,0,0,0,0,0
2024-03-28 20:20:00,0,0,0,0,0,0,0,0
2024-03-28 20:30:00,0,0,0,0,0,0,0,0
2024-03-28 20:40:00,0,0,0,0,0,0,0,0
2024-03-28 20:50:00,0,0,0,0,0,0,0,0
2024-03-28 21:00:00,0,0,0,0,0,0,0,0
2024-03-28 21:10:00,0,0,0,0,0,0,0,0
2024-03-28 21:20:00,0,0,0,0,0,0,0,0
2024-03-28 21:30:00,0,0,0,0,0,0,0,0
2024-03-28 21:40:00,0,0,0,0,0,0,0,0
2024-03-28 21:50:00,0,0,0,0,0,0,0,0
2024-03-28 22:00:00,0,0,0,0,0,0,0,0
2024-03-28 22:10:00,0,0,0,0,0,0,0,0
2024-03-28 22:20:00,0,0,0,0,0,0,0,0
2024-03-28 22:30:00,0,0,0,0,0,0,0,0
2024-03-28 22:40:00,0,0,0,0,0,0,0,0
2024-03-28 22:50:00,0,0,0,0,0,0,0,0
2024-03-28 23:00:00,0,0,0,0,0,0,0,0
2024-03-28 23:10:00,0,0,0,0,0,0,0,0
2024-03-28 23:20:00,0,0,0,0,0,0,0,0
2024-03-28 23:30:00,0,0,0,0,0,0,0,0
2024-03-28 23:40:00,0,0,0,0,0,0,0,0
2024-03-28 23:50:00,0,0,0,0,0,0,0,0
2024-03-29 00:00:00,0,0,0,0,0,0,0,0
2024-03-29 00:10:00,0,0,0,0,0,0,0,0
2024-03-29 00:20:00,0,0,0,0,0,0,0,0
2024-03-29 00:30:00,0,0,0,0,0,0,0,0
2024-03-29 00:40:00,0,0,0,0,0,0,0,0
2024-03-29 00:50:00,0,0,0,0,0,0,0,0
2024-03-29 01:00:00,0,0,0,0,0,0,0,0
2024-03-29 01:10:00,0,0,0,0,0,0,0,0
2024-03-29 01:20:00,0,0,0,0,0,0,0,0
2024-03-29 01:30:00,0,0,0,0,0,0,0,0
2024-03-29 01:40:00,0,0,0,0,0,0,0,0
2024-03-29 01:50:00,0,0,0,0,0,0,0,0
2024-03-29 02:00:00,0,0,0,0,0,0,0,0
2024-03-29 02:10:00,0,0,0,0,0,0,0,0
2024-03-29 02:20:00,0,0,0,0,0,0,0,0
2024-03-29 02:30:00,0,0,0,0,0,0,0,0
2024-03-29 02:40:00,0,0,0,0,0,0,0,0
2024-03-29 02:50:00,0,0,0,0,0,0,0,0
2024-03-29 03:00:00,0,0,0,0,0,0,0,0
2024-03-29 03:10:00,0,0,0,0,0,0,0,0
2024-03-29 03:20:00,0,0,0,0,0,0,0,0
2024-03-29 03:30:00,0,0,0,0,0,0,0,0
2024-03-29 03:40:00,0,0,0,0,0,0,0,0
2024-03-29 03:50:00,0,0,0,0,0,0,0,0
2024-03-29 04:00:00,0,0,0,0,0,0,0,0
2024-03-29 04:10:00,0,0,0,0,0,0,0,0
2024-03-29 04:20:00,0,0,0,0,0,0,0,0
2024-03-29 04:30:00,0,0,0,0,0,0,0,0
2024-03-29 04:40:00,0,0,0,0,0,0,0,0
2024-03-29 04:50:00,0,0,0,0,0,0,0,0
2024-03-29 05:00:00,0,0,0,0,0,0,0,0
2024-03-29 05:10:00,0,0,0,0,0,0,0,0
2024-03-29 05:20:00,0,0,0,0,0,0,0,0
2024-03-29 05:30:00,0,0,0,0,0,0,0,0
2024-03-29 05:40:00,0,0,0,0,0,0,0,0
2024-03-29 05:50:00,0,0,0,0,0,0,0,0
2024-03-29 06:00:00,0,0,0,0,0,0,0,0
2024-03-29 06:10:00,0,0,0,0,0,0,0,0
2024-03-29 06:20:00,0,0,0,0,0,0,0,0
2024-03-29 06:30:00,0,0,0,0,0,0,0,0
2024-03-29 06:40:00,0,0,0,0,0,0,0,0
2024-03-29 06:50:00,0,0,0,0,0,0,0,0
2024-03-29 07:00:00,0,0,0,0,0,0,0,0
2024-03-29 07:10:00,0,0,0,0,0,0,0,0
2024-03-29 07:20:00,0,0,0,0,0,0,0,0
2024-03-29 07:30:00,0,0,0,0,0,0,0,0
2024-03-29 07:40:00,0,0,0,0,0,0,0,0
2024-03-29 07:50:00,0,0,0,0,0,0,0,0
2024-03-29 08:00:00,0,0,0,0,0,0,0,0
2024-03-29 08:10:00,0,0,0,0,0,0,0,0
2024-03-29 08:20:00,0,0,0,0,0,0,0,0
2024-03-29 08:30:00,0,0,0,0,0,0,0,0
2024-03-29 08:40:00,0,0,0,0,0,0,0,0
2024-03-29 08:50:00,0,0,0,0,0,0,0,0
2024-03-29 09:00:00,0,0,0,0,0,0,0,0
2024-03-29 09:10:00,0,0,0,0,0,0,0,0
2024-03-29 09:20:00,0,0,0,0,0,0,0,0
2024-03-29 09:30:00,0,0,0,0,0,0,0,0
2024-03-29 09:40:00,0,0,0,0,0,0,0,0
2024-03-29 09:50:00,0,0,0,0,0,0,0,0
2024-03-29 10:00:00,0,0,0,0,0,0,0,0
2024-03-29 10:10:00,0,0,0,0,0,0,0,0
2024-03-29 10:20:00,0,0,0,0,0,0,0,0
2024-03-29 10:30:00,0,0,0,0,0,0,0,0
2024-03-29 10:40:00,0,0,0,0,0,0,0,0
2024-03-29 10:50:00,0,0,0,0,0,0,0,0
2024-03-29 11:00:00,0,0,0,0,0,0,0,0
2024-03-29 11:10:00,0,0,0,0,0,0,0,0
2024-03-29 11:20:00,0,0,0,0,0,0,0,0
2024-03-29 11:30:00,0,0,0,0,0,0,0,0
2024-03-29 11:40:00,0,0,0,0,0,0,0,0
2024-03-29 11:50:00,0,0,0,0,0,0,0,0
2024-03-29 12:00:00,0,0,0,0,0,0,0,0
2024-03-29 12:10:00,0,0,0,0,0,0,0,0
2024-03-29 12:20:00,0,0,0,0,0,0,0,0
2024-03-29 12:30:00,0,0,0,0,0,0,0,0
2024-03-29 12:40:00,0,0,0,0,0,0,0,0
2024-03-29 12:50:00,0,0,0,0,0,0,0,0
2024-03-29 13:00:00,0,0,0,0,0,0,0,0
2024-03-29 13:10:00,0,0,0,0,0,0,0,0
2024-03-29 13:20:00,0,0,0,0,0,0,0,0
2024-03-29 13:30:00,0,0,0,0,0,0,0,0
2024-03-29 13:40:00,0,0,0,0,0,0,0,0
2024-03-29 13:50:00,0,0,0,0,0,0,0,0
2024-03-29 14:00:00,0,0,0,0,0,0,0,0
2024-03-29 14:10:00,0,0,0,0,0,0,0,0
2024-03-29 14:20:00,0,0,0,0,0,0,0,0
2024-03-29 14:30:00,0,0,0,0,0,0,0,0
2024-03-29 14:40:00,0,0,0,0,0,0,0,0
2024-03-29 14:50:00,0,0,0,0,0,0,0,0
2024-03-29 15:00:00,0,0,0,0,0,0,0,0
2024-03-29 15:10:00,0,0,0,0,0,0,0,0
2024-03-29 15:20:00,0,0,0,0,0,0,0,0
2024-03-29 15:30:00,0,0,0,0,0,0,0,0
2024-03-29 15:40:00,0,0,0,0,0,0,0,0
2024-03-29 15:50:00,0,0,0,0,0,0,0,0
2024-03-29 16:00:00,0,0,0,0,0,0,0,0
2024-03-29 16:10:00,0,0,0,0,0,0,0,0
2024-03-29 16:20:00,0,0,0,0,0,0,0,0
2024-03-29 16:30:00,0,0,0,0,0,0,0,0
2024-03-29 16:40:00,0,0,0,0,0,0,0,0
2024-03-29 16:50:00,0,0,0,0,0,0,0,0
2024-03-29 17:00:00,0,0,0,0,0,0,0,0
2024-03-29 17:10:00,0,0,0,0,0,0,0,0
2024-03-29 17:20:00,0,0,0,0,0,0,0,0
2024-03-29 17:30:00,0,0,0,0,0,0,0,0
2024-03-29 17:40:00,0,0,0,0,0,0,0,0
2024-03-29 17:50:00,0,0,0,0,0,0,0,0
2024-03-29 18:00:00,0,0,0,0,0,0,0,0
2024-03-29 18:10:00,0,0,0,0,0,0,0,0
2024-03-29 18:20:00,0,0,0,0,0,0,0,0
2024-03-29 18:30:00,0,0,0,0,0,0,0,0
2024-03-29 18:40:00,0,0,0,0,0,0,0,0
2024-03-29 18:50:00,0,0,0,0,0,0,0,0
2024-03-29 19:00:00,0,0,0,0,0,0,0,0
2024-03-29 19:10:00,0,0,0,0,0,0,0,0
2024-03-29 19:20:00,0,0,0,0,0,0,0,0
2024-03-29 19:30:00,0,0,0,0,0,0,0,0
2024-03-29 19:40:00,0,0,0,0,0,0,0,0
2024-03-29 19:50:00,0,0,0,0,0,0,0,0
2024-03-29 20:00:00,0,0,0,0,0,0,0,0
2024-03-29 20:10:00,0,0,0,0,0,0,0,0
2024-03-29 20:20:00,0,0,0,0,0,0,0,0
2024-03-29 20:30:00,0,0,0,0,0,0,0,0
2024-03-29 20:40:00,0,0,0,0,0,0,0,0
2024-03-29 20:50:00,0,0,0,0,0,0,0,0
2024-03-29 21:00:00,0,0,0,0,0,0,0,0
2024-03-29 21:10:00,0,0,0,0,0,0,0,0
2024-03-29 21:20:00,0,0,0,0,0,0,0,0
2024-03-29 21:30:00,0,0,0,0,0,0,0,0
2024-03-29 21:40:00,0,0,0,0,0,0,0,0
2024-03-29 21:50:00,0,0,0,0,0,0,0,0
2024-03-29 22:00:00,0,0,0,0,0,0,0,0
2024-03-29 22:10:00,0,0,0,0,0,0,0,0
2024-03-29 22:20:00,0,0,0,0,0,0,0,0
2024-03-29 22:30:00,0,0,0,0,0,0,0,0
2024-03-29 22:40:00,0,0,0,0,0,0,0,0
2024-03-29 22:50:00,0,0,0,0,0,0,0,0
2024-03-29 23:00:00,0,0,0,0,0,0,0,0
2024-03-29 23:10:00,0,0,0,0,0,0,0,0
2024-03-29 23:20:00,0,0,0,0,0,0,0,0
2024-03-29 23:30:00,0,0,0,0,0,0,0,0
2024-03-29 23:40:00,0,0,0,0,0,0,0,0
2024-03-29 23:50:00,0,0,0,0,0,0,0,0
2024-03-30 00:00:00,0,0,0,0,0,0,0,0
2024-03-30 00:10:00,0,0,0,0,0,0,0,0
2024-03-30 00:20:00,0,0,0,0,0,0,0,0
2024-03-30 00:30:00,0,0,0,0,0,0,0,0
2024-03-30 00:40:00,0,0,0,0,0,0,0,0
2024-03-30 00:50:00,0,0,0,0,0,0,0,0
2024-03-30 01:00:00,0,0,0,0,0,0,0,0
2024-03-30 01:10:00,0,0,0,0,0,0,0,0
2024-03-30 01:20:00,0,0,0,0,0,0,0,0
2024-03-30 01:30:00,0,0,0,0,0,0,0,0
2024-03-30 01:40:00,0,0,0,0,0,0,0,0
2024-03-30 01:50:00,0,0,0,0,0,0,0,0
2024-03-30 02:00:00,0,0,0,0,0,0,0,0
2024-03-30 02:10:00,0,0,0,0,0,0,0,0
2024-03-30 02:20:00,0,0,0,0,0,0,0,0
2024-03-30 02:30:00,0,0,0,0,0,0,0,0
2024-03-30 02:40:00,0,0,0,0,0,0,0,0
2024-03-30 02:50:00,0,0,0,0,0,0,0,0
2024-03-30 03:00:00,0,0,0,0,0,0,0,0
2024-03-30 03:10:00,0,0,0,0,0,0,0,0
2024-03-30 03:20:00,0,0,0,0,0,0,0,0
2024-03-30 03:30:00,0,0,0,0,0,0,0,0
2024-03-30 03:40:00,0,0,0,0,0,0,0,0
2024-03-30 03:50:00,0,0,0,0,0,0,0,0
2024-03-30 04:00:00,0,0,0,0,0,0,0,0
2024-03-30 04:10:00,0,0,0,0,0,0,0,0
2024-03-30 04:20:00,0,0,0,0,0,0,0,0
2024-03-30 04:30:00,0,0,0,0,0,0,0,0
2024-03-30 04:40:00,0,0,0,0,0,0,0,0
2024-03-30 04:50:00,0,0,0,0,0,0,0,0
2024-03-30 05:00:00,0,0,0,0,0,0,0,0
2024-03-30 05:10:00,0,0,0,0,0,0,0,0
2024-03-30 05:20:00,0,0,0,0,0,0,0,0
2024-03-30 05:30:00,0,0,0,0,0,0,0,0
2024-03-30 05:40:00,0,0,0,0,0,0,0,0
2024-03-30 05:50:00,0,0,0,0,0,0,0,0
2024-03-30 06:00:00,0,0,0,0,0,0,0,0
2024-03-30 06:10:00,0,0,0,0,0,0,0,0
2024-03-30 06:20:00,0,0,0,0,0,0,0,0
2024-03-30 06:30:00,0,0,0,0,0,0,0,0
2024-03-30 06:40:00,0,0,0,0,0,0,0,0
2024-03-30 06:50:00,0,0,0,0,0,0,0,0
2024-03-30 07:00:00,0,0,0,0,0,0,0,0
2024-03-30 07:10:00,0,0,0,0,0,0,0,0
2024-03-30 07:20:00,0,0,0,0,0,0,0,0
2024-03-30 07:30:00,0,0,0,0,0,0,0,0
2024-03-30 07:40:00,0,0,0,0,0,0,0,0
2024-03-30 07:50:00,0,0,0,0,0,0,0,0
2024-03-30 08:00:00,0,0,0,0,0,0,0,0
2024-03-30 08:10:00,0,0,0,0,0,0,0,0
2024-03-30 08:20:00,0,0,0,0,0,0,0,0
2024-03-30 08:30:00,0,0,0,0,0,0,0,0
2024-03-30 08:40:00,0,0,0,0,0,0,0,0
2024-03-30 08:50:00,0,0,0,0,0,0,0,0
2024-03-30 09:00:00,0,0,0,0,0,0,0,0
2024-03-30 09:10:00,0,0,0,0,0,0,0,0
2024-03-30 09:20:00,0,0,0,0,0,0,0,0
2024-03-30 09:30:00,0,0,0,0,0,0,0,0
2024-03-30 09:40:00,0,0,0,0,0,0,0,0
2024-03-30 09:50:00,0,0,0,0,0,0,0,0
2024-03-30 10:00:00,0,0,0,0,0,0,0,0
2024-03-30 10:10:00,0,0,0,0,0,0,0,0
2024-03-30 10:20:00,0,0,0,0,0,0,0,0
2024-03-30 10:30:00,0,0,0,0,0,0,0,0
2024-03-30 10:40:00,0,0,0,0,0,0,0,0
2024-03-30 10:50:00,0,0,0,0,0,0,0,0
2024-03-30 11:00:00,0,0,0,0,0,0,0,0
2024-03-30 11:10:00,0,0,0,0,0,0,0,0
2024-03-30 11:20:00,0,0,0,0,0,0,0,0
2024-03-30 11:30:00,0,0,0,0,0,0,0,0
2024-03-30 11:40:00,0,0,0,0,0,0,0,0
2024-03-30 11:50:00,0,0,0,0,0,0,0,0
2024-03-30 12:00:00,0,0,0,0,0,0,0,0
2024-03-30 12:10:00,0,0,0,0,0,0,0,0
2024-03-30 12:20:00,0,0,0,0,0,0,0,0
2024-03-30 12:30:00,0,0,0,0,0,0,0,0
2024-03-30 12:40:00,0,0,0,0,0,0,0,0
2024-03-30 12:50:00,0,0,0,0,0,0,0,0
2024-03-30 13:00:00,0,0,0,0,0,0,0,0
2024-03-30 13:10:00,0,0,0,0,0,0,0,0
2024-03-30 13:20:00,0,0,0,0,0,0,0,0
2024-03-30 13:30:00,0,0,0,0,0,0,0,0
2024-03-30 13:40:00,0,0,0,0,0,0,0,0
2024-03-30 13:50:00,0,0,0,0,0,0,0,0
2024-03-30 14:00:00,0,0,0,0,0,0,0,0
2024-03-30 14:10:00,0,0,0,0,0,0,0,0
2024-03-30 14:20:00,0,0,0,0,0,0,0,0
2024-03-30 14:30:00,0,0,0,0,0,0,0,0
2024-03-30 14:40:00,0,0,0,0,0,0,0,0
2024-03-30 14:50:00,0,0,0,0,0,0,0,0
2024-03-30 15:00:00,0,0,0,0,0,0,0,0
2024-03-30 15:10:00,0,0,0,0,0,0,0,0
2024-03-30 15:20:00,0,0,0,0,0,0,0,0
2024-03-30 15:30:00,0,0,0,0,0,0,0,0
2024-03-30 15:40:00,0,0,0,0,0,0,0,0
2024-03-30 15:50:00,0,0,0,0,0,0,0,0
2024-03-30 16:00:00,0,0,0,0,0,0,0,0
2024-03-30 16:10:00,0,0,0,0,0,0,0,0
2024-03-30 16:20:00,0,0,0,0,0,0,0,0
2024-03-30 16:30:00,0,0,0,0,0,0,0,0
2024-03-30 16:40:00,0,0,0,0,0,0,0,0
2024-03-30 16:50:00,0,0,0,0,0,0,0,0
2024-03-30 17:00:00,0,0,0,0,0,0,0,0
2024-03-30 17:10:00,0,0,0,0,0,0,0,0
2024-03-30 17:20:00,0,0,0,0,0,0,0,0
2024-03-30 17:30:00,0,0,0,0,0,0,0,0
2024-03-30 17:40:00,0,0,0,0,0,0,0,0
2024-03-30 17:50:00,0,0,0,0,0,0,0,0
2024-03-30 18:00:00,0,0,0,0,0,0,0,0
2024-03-30 18:10:00,0,0,0,0,0,0,0,0
2024-03-30 18:20:00,0,0,0,0,0,0,0,0
2024-03-30 18:30:00,0,0,0,0,0,0,0,0
2024-03-30 18:40:00,0,0,0,0,0,0,0,0
2024-03-30 18:50:00,0,0,0,0,0,0,0,0
2024-03-30 19:00:00,0,0,0,0,0,0,0,0
2024-03-30 19:10:00,0,0,0,0,0,0,0,0
2024-03-30 19:20:00,0,0,0,0,0,0,0,0
2024-03-30 19:30:00,0,0,0,0,0,0,0,0
2024-03-30 19:40:00,0,0,0,0,0,0,0,0
2024-03-30 19:50:00,0,0,0,0,0,0,0,0
2024-03-30 20:00:00,0,0,0,0,0,0,0,0
2024-03-30 20:10:00,0,0,0,0,0,0,0,0
2024-03-30 20:20:00,0,0,0,0,0,0,0,0
2024-03-30 20:30:00,0,0,0,0,0,0,0,0
2024-03-30 20:40:00,0,0,0,0,0,0,0,0
2024-03-30 20:50:00,0,0,0,0,0,0,0,0
2024-03-30 21:00:00,0,0,0,0,0,0,0,0
2024-03-30 21:10:00,0,0,0,0,0,0,0,0
2024-03-30 21:20:00,0,0,0,0,0,0,0,0
2024-03-30 21:30:00,0,0,0,0,0,0,0,0
2024-03-30 21:40:00,0,0,0,0,0,0,0,0
2024-03-30 21:50:00,0,0,0,0,0,0,0,0
2024-03-30 22:00:00,0,0,0,0,0,0,0,0
2024-03-30 22:10:00,0,0,0,0,0,0,0,0
2024-03-30 22:20:00,0,0,0,0,0,0,0,0
2024-03-30 22:30:00,0,0,0,0,0,0,0,0
2024-03-30 22:40:00,0,0,0,0,0,0,0,0
2024-03-30 22:50:00,0,0,0,0,0,0,0,0
2024-03-30 23:00:00,0,0,0,0,0,0,0,0
2024-03-30 23:10:00,0,0,0,0,0,0,0,0
2024-03-30 23:20:00,0,0,0,0,0,0,0,0
2024-03-30 23:30:00,0,0,0,0,0,0,0,0
2024-03-30 23:40:00,0,0,0,0,0,0,0,0
2024-03-30 23:50:00,0,0,0,0,0,0,0,0
2024-03-31 00:00:00,0,0,0,0,0,0,0,0
2024-03-31 00:10:00,0,0,0,0,0,0,0,0
2024-03-31 00:20:00,0,0,0,0,0,0,0,0
2024-03-31 00:30:00,0,0,0,0,0,0,0,0
2024-03-31 00:40:00,0,0,0,0,0,0,0,0
2024-03-31 00:50:00,0,0,0,0,0,0,0,0
2024-03-31 01:00:00,0,0,0,0,0,0,0,0
2024-03-31 01:10:00,0,0,0,0,0,0,0,0
2024-03-31 01:20:00,0,0,0,0,0,0,0,0
2024-03-31 01:30:00,0,0,0,0,0,0,0,0
2024-03-31 01:40:00,0,0,0,0,0,0,0,0
2024-03-31 01:50:00,0,0,0,0,0,0,0,0
2024-03-31 02:00:00,0,0,0,0,0,0,0,0
2024-03-31 02:10:00,0,0,0,0,0,0,0,0
2024-03-31 02:20:00,0,0,0,0,0,0,0,0
2024-03-31 02:30:00,0,0,0,0,0,0,0,0
2024-03-31 02:40:00,0,0,0,0,0,0,0,0
2024-03-31 02:50:00,0,0,0,0,0,0,0,0
2024-03-31 03:00:00,0,0,0,0,0,0,0,0
2024-03-31 03:10:00,0,0,0,0,0,0,0,0
2024-03-31 03:20:00,0,0,0,0,0,0,0,0
2024-03-31 03:30:00,0,0,0,0,0,0,0,0
2024-03-31 03:40:00,0,0,0,0,0,0,0,0
2024-03-31 03:50:00,0,0,0,0,0,0,0,0
2024-03-31 04:00:00,0,0,0,0,0,0,0,0
2024-03-31 04:10:00,0,0,0,0,0,0,0,0
2024-03-31 04:20:00,0,0,0,0,0,0,0,0
2024-03-31 04:30:00,0,0,0,0,0,0,0,0
2024-03-31 04:40:00,0,0,0,0,0,0,0,0
2024-03-31 04:50:00,0,0,0,0,0,0,0,0
2024-03-31 05:00:00,0,0,0,0,0,0,0,0
2024-03-31 05:10:00,0,0,0,0,0,0,0,0
2024-03-31 05:20:00,0,0,0,0,0,0,0,0
2024-03-31 05:30:00,0,0,0,0,0,0,0,0
2024-03-31 05:40:00,0,0,0,0,0,0,0,0
2024-03-31 05:50:00,0,0,0,0,0,0,0,0
2024-03-31 06:00:00,0,0,0,0,0,0,0,0
2024-03-31 06:10:00,0,0,0,0,0,0,0,0
2024-03-31 06:20:00,0,0,0,0,0,0,0,0
2024-03-31 06:30:00,0,0,0,0,0,0,0,0
2024-03-31 06:40:00,0,0,0,0,0,0,0,0
2024-03-31 06:50:00,0,0,0,0,0,0,0,0
2024-03-31 07:00:00,0,0,0,0,0,0,0,0
2024-03-31 07:10:00,0,0,0,0,0,0,0,0
2024-03-31 07:20:00,0,0,0,0,0,0,0,0
2024-03-31 07:30:00,0,0,0,0,0,0,0,0
2024-03-31 07:40:00,0,0,0,0,0,0,0,0
2024-03-31 07:50:00,0,0,0,0,0,0,0,0
2024-03-31 08:00:00,0,0,0,0,0,0,0,0
2024-03-31 08:10:00,0,0,0,0,0,0,0,0
2024-03-31 08:20:00,0,0,0,0,0,0,0,0
2024-03-31 08:30:00,0,0,0,0,0,0,0,0
2024-03-31 08:40:00,0,0,0,0,0,0,0,0
2024-03-31 08:50:00,0,0,0,0,0,0,0,0
2024-03-31 09:00:00,0,0,0,0,0,0,0,0
2024-03-31 09:10:00,0,0,0,0,0,0,0,0
2024-03-31 09:20:00,0,0,0,0,0,0,0,0
2024-03-31 09:30:00,0,0,0,0,0,0,0,0
2024-03-31 09:40:00,0,0,0,0,0,0,0,0
2024-03-31 09:50:00,0,0,0,0,0,0,0,0
2024-03-31 10:00:00,0,0,0,0,0,0,0,0
2024-03-31 10:10:00,0,0,0,0,0,0,0,0
2024-03-31 10:20:00,0,0,0,0,0,0,0,0
2024-03-31 10:30:00,0,0,0,0,0,0,0,0
2024-03-31 10:40:00,0,0,0,0,0,0,0,0
2024-03-31 10:50:00,0,0,0,0,0,0,0,0
2024-03-31 11:00:00,0,0,0,0,0,0,0,0
2024-03-31 11:10:00,0,0,0,0,0,0,0,0
2024-03-31 11:20:00,0,0,0,0,0,0,0,0
2024-03-31 11:30:00,0,0,0,0,0,0,0,0
2024-03-31 11:40:00,0,0,0,0,0,0,0,0
2024-03-31 11:50:00,0,0,0,0,0,0,0,0
2024-03-31 12:00:00,0,0,0,0,0,0,0,0
2024-03-31 12:10:00,0,0,0,0,0,0,0,0
2024-03-31 12:20:00,0,0,0,0,0,0,0,0
2024-03-31 12:30:00,0,0,0,0,0,0,0,0
2024-03-31 12:40:00,0,0,0,0,0,0,0,0
2024-03-31 12:50:00,0,0,0,0,0,0,0,0
2024-03-31 13:00:00,0,0,0,0,0,0,0,0
2024-03-31 13:10:00,0,0,0,0,0,0,0,0
2024-03-31 13:20:00,0,0,0,0,0,0,0,0
2024-03-31 13:30:00,0,0,0,0,0,0,0,0
2024-03-31 13:40:00,0,0,0,0,0,0,0,0
2024-03-31 13:50:00,0,0,0,0,0,0,0,0
2024-03-31 14:00:00,0,0,0,0,0,0,0,0
2024-03-31 14:10:00,0,0,0,0,0,0,0,0
2024-03-31 14:20:00,0,0,0,0,0,0,0,0
2024-03-31 14:30:00,0,0,0,0,0,0,0,0
2024-03-31 14:40:00,0,0,0,0,0,0,0,0
2024-03-31 14:50:00,0,0,0,0,0,0,0,0
2024-03-31 15:00:00,0,0,0,0,0,0,0,0
2024-03-31 15:10:00,0,0,0,0,0,0,0,0
2024-03-31 15:20:00,0,0,0,0,0,0,0,0
2024-03-31 15:30:00,0,0,0,0,0,0,0,0
2024-03-31 15:40:00,0,0,0,0,0,0,0,0
2024-03-31 15:50:00,0,0,0,0,0,0,0,0
2024-03-31 16:00:00,0,0,0,0,0,0,0,0
2024-03-31 16:10:00,0,0,0,0,0,0,0,0
2024-03-31 16:20:00,0,0,0,0,0,0,0,0
2024-03-31 16:30:00,0,0,0,0,0,0,0,0
2024-03-31 16:40:00,0,0,0,0,0,0,0,0
2024-03-31 16:50:00,0,0,0,0,0,0,0,0
2024-03-31 17:00:00,0,0,0,0,0,0,0,0
2024-03-31 17:10:00,0,0,0,0,0,0,0,0
2024-03-31 17:20:00,0,0,0,0,0,0,0,0
2024-03-31 17:30:00,0,0,0,0,0,0,0,0
2024-03-31 17:40:00,0,0,0,0,0,0,0,0
2024-03-31 17:50:00,0,0,0,0,0,0,0,0
2024-03-31 18:00:00,0,0,0,0,0,0,0,0
2024-03-31 18:10:00,0,0,0,0,0,0,0,0
2024-03-31 18:20:00,0,0,0,0,0,0,0,0
2024-03-31 18:30:00,0,0,0,0,0,0,0,0
2024-03-31 18:40:00,0,0,0,0,0,0,0,0
2024-03-31 18:50:00,0,0,0,0,0,0,0,0
2024-03-31 19:00:00,0,0,0,0,0,0,0,0
2024-03-31 19:10:00,0,0,0,0,0,0,0,0
2024-03-31 19:20:00,0,0,0,0,0,0,0,0
2024-03-31 19:30:00,0,0,0,0,0,0,0,0
2024-03-31 19:40:00,0,0,0,0,0,0,0,0
2024-03-31 19:50:00,0,0,0,0,0,0,0,0
2024-03-31 20:00:00,0,0,0,0,0,0,0,0
2024-03-31 20:10:00,0,0,0,0,0,0,0,0
2024-03-31 20:20:00,0,0,0,0,0,0,0,0
2024-03-31 20:30:00,0,0,0,0,0,0,0,0
2024-03-31 20:40:00,0,0,0,0,0,0,0,0
2024-03-31 20:50:00,0,0,0,0,0,0,0,0
2024-03-31 21:00:00,0,0,0,0,0,0,0,0
2024-03-31 21:10:00,0,0,0,0,0,0,0,0
2024-03-31 21:20:00,0,0,0,0,0,0,0,0
2024-03-31 21:30:00,0,0,0,0,0,0,0,0
2024-03-31 21:40:00,0,0,0,0,0,0,0,0
2024-03-31 21:50:00,0,0,0,0,0,0,0,0
2024-03-31 22:00:00,0,0,0,0,0,0,0,0
2024-03-31 22:10:00,0,0,0,0,0,0,0,0
2024-03-31 22:20:00,0,0,0,0,0,0,0,0
2024-03-31 22:30:00,0,0,0,0,0,0,0,0
2024-03-31 22:40:00,0,0,0,0,0,0,0,0
2024-03-31 22:50:00,0,0,0,0,0,0,0,0
2024-03-31 23:00:00,0,0,0,0,0,0,0,0
2024-03-31 23:10:00,0,0,0,0,0,0,0,0
2024-03-31 23:20:00,0,0,0,0,0,0,0,0
2024-03-31 23:30:00,0,0,0,0,0,0,0,0
2024-03-31 23:40:00,0,0,0,0,0,0,0,0
2024-03-31 23:50:00,0,0,0,0,0,0,0,0
2024-04-01 00:00:00,0,0,0,0,0,0,0,0
2024-04-01 00:10:00,0,0,0,0,0,0,0,0
2024-04-01 00:20:00,0,0,0,0,0,0,0,0
2024-04-01 00:30:00,0,0,0,0,0,0,0,0
2024-04-01 00:40:00,0,0,0,0,0,0,0,0
2024-04-01 00:50:00,0,0,0,0,0,0,0,0
2024-04-01 01:00:00,0,0,0,0,0,0,0,0
2024-04-01 01:10:00,0,0,0,0,0,0,0,0
2024-04-01 01:20:00,0,0,0,0,0,0,0,0
2024-04-01 01:30:00,0,0,0,0,0,0,0,0
2024-04-01 01:40:00,0,0,0,0,0,0,0,0
2024-04-01 01:50:00,0,0,0,0,0,0,0,0
2024-04-01 02:00:00,0,0,0,0,0,0,0,0
2024-04-01 02:10:00,0,0,0,0,0,0,0,0
2024-04-01 02:20:00,0,0,0,0,0,0,0,0
2024-04-01 02:30:00,0,0,0,0,0,0,0,0
2024-04-01 02:40:00,0,0,0,0,0,0,0,0
2024-04-01 02:50:00,0,0,0,0,0,0,0,0
2024-04-01 03:00:00,0,0,0,0,0,0,0,0
2024-04-01 03:10:00,0,0,0,0,0,0,0,0
2024-04-01 03:20:00,0,0,0,0,0,0,0,0
2024-04-01 03:30:00,0,0,0,0,0,0,0,0
2024-04-01 03:40:00,0,0,0,0,0,0,0,0
2024-04-01 03:50:00,0,0,0,0,0,0,0,0
2024-04-01 04:00:00,0,0,0,0,0,0,0,0
2024-04-01 04:10:00,0,0,0,0,0,0,0,0
2024-04-01 04:20:00,0,0,0,0,0,0,0,0
2024-04-01 04:30:00,0,0,0,0,0,0,0,0
2024-04-01 04:40:00,0,0,0,0,0,0,0,0
2024-04-01 04:50:00,0,0,0,0,0,0,0,0
2024-04-01 05:00:00,0,0,0,0,0,0,0,0
2024-04-01 05:10:00,0,0,0,0,0,0,0,0
2024-04-01 05:20:00,0,0,0,0,0,0,0,0
2024-04-01 05:30:00,0,0,0,0,0,0,0,0
2024-04-01 05:40:00,0,0,0,0,0,0,0,0
2024-04-01 05:50:00,0,0,0,0,0,0,0,0
2024-04-01 06:00:00,0,0,0,0,0,0,0,0
2024-04-01 06:10:00,0,0,0,0,0,0,0,0
2024-04-01 06:20:00,0,0,0,0,0,0,0,0
2024-04-01 06:30:00,0,0,0,0,0,0,0,0
2024-04-01 06:40:00,0,0,0,0,0,0,0,0
2024-04-01 06:50:00,0,0,0,0,0,0,0,0
2024-04-01 07:00:00,0,0,0,0,0,0,0,0
2024-04-01 07:10:00,0,0,0,0,0,0,0,0
2024-04-01 07:20:00,0,0,0,0,0,0,0,0
2024-04-01 07:30:00,0,0,0,0,0,0,0,0
2024-04-01 07:40:00,0,0,0,0,0,0,0,0
2024-04-01 07:50:00,0,0,0,0,0,0,0,0
2024-04-01 08:00:00,0,0,0,0,0,0,0,0
2024-04-01 08:10:00,0,0,0,0,0,0,0,0
2024-04-01 08:20:00,0,0,0,0,0,0,0,0
2024-04-01 08:30:00,0,0,0,0,0,0,0,0
2024-04-01 08:40:00,0,0,0,0,0,0,0,0
2024-04-01 08:50:00,0,0,0,0,0,0,0,0
2024-04-01 09:00:00,0,0,0,0,0,0,0,0
2024-04-01 09:10:00,0,0,0,0,0,0,0,0
2024-04-01 09:20:00,0,0,0,0,0,0,0,0
2024-04-01 09:30:00,0,0,0,0,0,0,0,0
2024-04-01 09:40:00,0,0,0,0,0,0,0,0
2024-04-01 09:50:00,0,0,0,0,0,0,0,0
2024-04-01 10:00:00,0,0,0,0,0,0,0,0
2024-04-01 10:10:00,0,0,0,0,0,0,0,0
2024-04-01 10:20:00,0,0,0,0,0,0,0,0
2024-04-01 10:30:00,0,0,0,0,0,0,0,0
2024-04-01 10:40:00,0,0,0,0,0,0,0,0
2024-04-01 10:50:00,0,0,0,0,0,0,0,0
2024-04-01 11:00:00,0,0,0,0,0,0,0,0
2024-04-01 11:10:00,0,0,0,0,0,0,0,0
2024-04-01 11:20:00,0,0,0,0,0,0,0,0
2024-04-01 11:30:00,0,0,0,0,0,0,0,0
2024-04-01 11:40:00,0,0,0,0,0,0,0,0
2024-04-01 11:50:00,0,0,0,0,0,0,0,0
2024-04-01 12:00:00,0,0,0,0,0,0,0,0
2024-04-01 12:10:00,0,0,0,0,0,0,0,0
2024-04-01 12:20:00,0,0,0,0,0,0,0,0
2024-04-01 12:30:00,0,0,0,0,0,0,0,0
2024-04-01 12:40:00,0,0,0,0,0,0,0,0
2024-04-01 12:50:00,0,0,0,0,0,0,0,0
2024-04-01 13:00:00,0,0,0,0,0,0,0,0
2024-04-01 13:10:00,0,0,0,0,0,0,0,0
2024-04-01 13:20:00,0,0,0,0,0,0,0,0
2024-04-01 13:30:00,0,0,0,0,0,0,0,0
2024-04-01 13:40:00,0,0,0,0,0,0,0,0
2024-04-01 13:50:00,0,0,0,0,0,0,0,0
2024-04-01 14:00:00,0,0,0,0,0,0,0,0
2024-04-01 14:10:00,0,0,0,0,0,0,0,0
2024-04-01 14:20:00,0,0,0,0,0,0,0,0
2024-04-01 14:30:00,0,0,0,0,0,0,0,0
2024-04-01 14:40:00,0,0,0,0,0,0,0,0
2024-04-01 14:50:00,0,0,0,0,0,0,0,0
2024-04-01 15:00:00,0,0,0,0,0,0,0,0
2024-04-01 15:10:00,0,0,0,0,0,0,0,0
2024-04-01 15:20:00,0,0,0,0,0,0,0,0
2024-04-01 15:30:00,0,0,0,0,0,0,0,0
2024-04-01 15:40:00,0,0,0,0,0,0,0,0
2024-04-01 15:50:00,0,0,0,0,0,0,0,0
2024-04-01 16:00:00,0,0,0,0,0,0,0,0
2024-04-01 16:10:00,0,0,0,0,0,0,0,0
2024-04-01 16:20:00,0,0,0,0,0,0,0,0
2024-04-01 16:30:00,0,0,0,0,0,0,0,0
2024-04-01 16:40:00,0,0,0,0,0,0,0,0
2024-04-01 16:50:00,0,0,0,0,0,0,0,0
2024-04-01 17:00:00,0,0,0,0,0,0,0,0
2024-04-01 17:10:00,0,0,0,0,0,0,0,0
2024-04-01 17:20:00,0,0,0,0,0,0,0,0
2024-04-01 17:30:00,0,0,0,0,0,0,0,0
2024-04-01 17:40:00,0,0,0,0,0,0,0,0
2024-04-01 17:50:00,0,0,0,0,0,0,0,0
2024-04-01 18:00:00,0,0,0,0,0,0,0,0
2024-04-01 18:10:00,0,0,0,0,0,0,0,0
2024-04-01 18:20:00,0,0,0,0,0,0,0,0
2024-04-01 18:30:00,0,0,0,0,0,0,0,0
2024-04-01 18:40:00,0,0,0,0,0,0,0,0
2024-04-01 18:50:00,0,0,0,0,0,0,0,0
2024-04-01 19:00:00,0,0,0,0,0,0,0,0
2024-04-01 19:10:00,0,0,0,0,0,0,0,0
2024-04-01 19:20:00,0,0,0,0,0,0,0,0
2024-04-01 19:30:00,0,0,0,0,0,0,0,0
2024-04-01 19:40:00,0,0,0,0,0,0,0,0
2024-04-01 19:50:00,0,0,0,0,0,0,0,0
2024-04-01 20:00:00,0,0,0,0,0,0,0,0
2024-04-01 20:10:00,0,0,0,0,0,0,0,0
2024-04-01 20:20:00,0,0,0,0,0,0,0,0
2024-04-01 20:30:00,0,0,0,0,0,0,0,0
2024-04-01 20:40:00,0,0,0,0,0,0,0,0
2024-04-01 20:50:00,0,0,0,0,0,0,0,0
2024-04-01 21:00:00,0,0,0,0,0,0,0,0
2024-04-01 21:10:00,0,0,0,0,0,0,0,0
2024-04-01 21:20:00,0,0,0,0,0,0,0,0
2024-04-01 21:30:00,0,0,0,0,0,0,0,0
2024-04-01 21:40:00,0,0,0,0,0,0,0,0
2024-04-01 21:50:00,0,0,0,0,0,0,0,0
2024-04-01 22:00:00,0,0,0,0,0,0,0,0
2024-04-01 22:10:00,0,0,0,0,0,0,0,0
2024-04-01 22:20:00,0,0,0,0,0,0,0,0
2024-04-01 22:30:00,0,0,0,0,0,0,0,0
2024-04-01 22:40:00,0,0,0,0,0,0,0,0
2024-04-01 22:50:00,0,0,0,0,0,0,0,0
2024-04-01 23:00:00,0,0,0,0,0,0,0,0
2024-04-01 23:10:00,0,0,0,0,0,0,0,0
2024-04-01 23:20:00,0,0,0,0,0,0,0,0
2024-04-01 23:30:00,0,0,0,0,0,0,0,0
2024-04-01 23:40:00,0,0,0,0,0,0,0,0
2024-04-01 23:50:00,0,0,0,0,0,0,0,0
2024-04-02 00:00:00,0,0,0,0,0,0,0,0
2024-04-02 00:10:00,0,0,0,0,0,0,0,0
2024-04-02 00:20:00,0,0,0,0,0,0,0,0
2024-04-02 00:30:00,0,0,0,0,0,0,0,0
2024-04-02 00:40:00,0,0,0,0,0,0,0,0
2024-04-02 00:50:00,0,0,0,0,0,0,0,0
2024-04-02 01:00:00,0,0,0,0,0,0,0,0
2024-04-02 01:10:00,0,0,0,0,0,0,0,0
2024-04-02 01:20:00,0,0,0,0,0,0,0,0
2024-04-02 01:30:00,0,0,0,0,0,0,0,0
2024-04-02 01:40:00,0,0,0,0,0,0,0,0
2024-04-02 01:50:00,0,0,0,0,0,0,0,0
2024-04-02 02:00:00,0,0,0,0,0,0,0,0
2024-04-02 02:10:00,0,0,0,0,0,0,0,0
2024-04-02 02:20:00,0,0,0,0,0,0,0,0
2024-04-02 02:30:00,0,0,0,0,0,0,0,0
2024-04-02 02:40:00,0,0,0,0,0,0,0,0
2024-04-02 02:50:00,0,0,0,0,0,0,0,0
2024-04-02 03:00:00,0,0,0,0,0,0,0,0
2024-04-02 03:10:00,0,0,0,0,0,0,0,0
2024-04-02 03:20:00,0,0,0,0,0,0,0,0
2024-04-02 03:30:00,0,0,0,0,0,0,0,0
2024-04-02 03:40:00,0,0,0,0,0,0,0,0
2024-04-02 03:50:00,0,0,0,0,0,0,0,0
2024-04-02 04:00:00,0,0,0,0,0,0,0,0
2024-04-02 04:10:00,0,0,0,0,0,0,0,0
2024-04-02 04:20:00,0,0,0,0,0,0,0,0
2024-04-02 04:30:00,0,0,0,0,0,0,0,0
2024-04-02 04:40:00,0,0,0,0,0,0,0,0
2024-04-02 04:50:00,0,0,0,0,0,0,0,0
2024-04-02 05:00:00,0,0,0,0,0,0,0,0
2024-04-02 05:10:00,0,0,0,0,0,0,0,0
2024-04-02 05:20:00,0,0,0,0,0,0,0,0
2024-04-02 05:30:00,0,0,0,0,0,0,0,0
2024-04-02 05:40:00,0,0,0,0,0,0,0,0
2024-04-02 05:50:00,0,0,0,0,0,0,0,0
2024-04-02 06:00:00,0,0,0,0,0,0,0,0
2024-04-02 06:10:00,0,0,0,0,0,0,0,0
2024-04-02 06:20:00,0,0,0,0,0,0,0,0
2024-04-02 06:30:00,0,0,0,0,0,0,0,0
2024-04-02 06:40:00,0,0,0,0,0,0,0,0
2024-04-02 06:50:00,0,0,0,0,0,0,0,0
2024-04-02 07:00:00,0,0,0,0,0,0,0,0
2024-04-02 07:10:00,0,0,0,0,0,0,0,0
2024-04-02 07:20:00,0,0,0,0,0,0,0,0
2024-04-02 07:30:00,0,0,0,0,0,0,0,0
2024-04-02 07:40:00,0,0,0,0,0,0,0,0
2024-04-02 07:50:00,0,0,0,0,0,0,0,0
2024-04-02 08:00:00,0,0,0,0,0,0,0,0
2024-04-02 08:10:00,0,0,0,0,0,0,0,0
2024-04-02 08:20:00,0,0,0,0,0,0,0,0
2024-04-02 08:30:00,0,0,0,0,0,0,0,0
2024-04-02 08:40:00,0,0,0,0,0,0,0,0
2024-04-02 08:50:00,0,0,0,0,0,0,0,0
2024-04-02 09:00:00,0,0,0,0,0,0,0,0
2024-04-02 09:10:00,0,0,0,0,0,0,0,0
2024-04-02 09:20:00,0,0,0,0,0,0,0,0
2024-04-02 09:30:00,0,0,0,0,0,0,0,0
2024-04-02 09:40:00,0,0,0,0,0,0,0,0
2024-04-02 09:50:00,0,0,0,0,0,0,0,0
2024-04-02 10:00:00,0,0,0,0,0,0,0,0
2024-04-02 10:10:00,0,0,0,0,0,0,0,0
2024-04-02 10:20:00,0,0,0,0,0,0,0,0
2024-04-02 10:30:00,0,0,0,0,0,0,0,0
2024-04-02 10:40:00,0,0,0,0,0,0,0,0
2024-04-02 10:50:00,0,0,0,0,0,0,0,0
2024-04-02 11:00:00,0,0,0,0,0,0,0,0
2024-04-02 11:10:00,0,0,0,0,0,0,0,0
2024-04-02 11:20:00,0,0,0,0,0,0,0,0
2024-04-02 11:30:00,0,0,0,0,0,0,0,0
2024-04-02 11:40:00,0,0,0,0,0,0,0,0
2024-04-02 11:50:00,0,0,0,0,0,0,0,0
2024-04-02 12:00:00,0,0,0,0,0,0,0,0
2024-04-02 12:10:00,0,0,0,0,0,0,0,0
2024-04-02 12:20:00,0,0,0,0,0,0,0,0
2024-04-02 12:30:00,0,0,0,0,0,0,0,0
2024-04-02 12:40:00,0,0,0,0,0,0,0,0
2024-04-02 12:50:00,0,0,0,0,0,0,0,0
2024-04-02 13:00:00,0,0,0,0,0,0,0,0
2024-04-02 13:10:00,0,0,0,0,0,0,0,0
2024-04-02 13:20:00,0,0,0,0,0,0,0,0
2024-04-02 13:30:00,0,0,0,0,0,0,0,0
2024-04-02 13:40:00,0,0,0,0,0,0,0,0
2024-04-02 13:50:00,0,0,0,0,0,0,0,0
2024-04-02 14:00:00,0,0,0,0,0,0,0,0
2024-04-02 14:10:00,0,0,0,0,0,0,0,0
2024-04-02 14:20:00,0,0,0,0,0,0,0,0
2024-04-02 14:30:00,0,0,0,0,0,0,0,0
2024-04-02 14:40:00,0,0,0,0,0,0,0,0
2024-04-02 14:50:00,0,0,0,0,0,0,0,0
2024-04-02 15:00:00,0,0,0,0,0,0,0,0
2024-04-02 15:10:00,0,0,0,0,0,0,0,0
2024-04-02 15:20:00,0,0,0,0,0,0,0,0
2024-04-02 15:30:00,0,0,0,0,0,0,0,0
2024-04-02 15:40:00,0,0,0,0,0,0,0,0
2024-04-02 15:50:00,0,0,0,0,0,0,0,0
2024-04-02 16:00:00,0,0,0,0,0,0,0,0
2024-04-02 16:10:00,0,0,0,0,0,0,0,0
2024-04-02 16:20:00,0,0,0,0,0,0,0,0
2024-04-02 16:30:00,0,0,0,0,0,0,0,0
2024-04-02 16:40:00,0,0,0,0,0,0,0,0
2024-04-02 16:50:00,0,0,0,0,0,0,0,0
2024-04-02 17:00:00,0,0,0,0,0,0,0,0
2024-04-02 17:10:00,0,0,0,0,0,0,0,0
2024-04-02 17:20:00,0,0,0,0,0,0,0,0
2024-04-02 17:30:00,0,0,0,0,0,0,0,0
2024-04-02 17:40:00,0,0,0,0,0,0,0,0
2024-04-02 17:50:00,0,0,0,0,0,0,0,0
2024-04-02 18:00:00,0,0,0,0,0,0,0,0
2024-04-02 18:10:00,0,0,0,0,0,0,0,0
2024-04-02 18:20:00,0,0,0,0,0,0,0,0
2024-04-02 18:30:00,0,0,0,0,0,0,0,0
2024-04-02 18:40:00,0,0,0,0,0,0,0,0
2024-04-02 18:50:00,0,0,0,0,0,0,0,0
2024-04-02 19:00:00,0,0,0,0,0,0,0,0
2024-04-02 19:10:00,0,0,0,0,0,0,0,0
2024-04-02 19:20:00,0,0,0,0,0,0,0,0
2024-04-02 19:30:00,0,0,0,0,0,0,0,0
2024-04-02 19:40:00,0,0,0,0,0,0,0,0
2024-04-02 19:50:00,0,0,0,0,0,0,0,0
2024-04-02 20:00:00,0,0,0,0,0,0,0,0
2024-04-02 20:10:00,0,0,0,0,0,0,0,0
2024-04-02 20:20:00,0,0,0,0,0,0,0,0
2024-04-02 20:30:00,0,0,0,0,0,0,0,0
2024-04-02 20:40:00,0,0,0,0,0,0,0,0
2024-04-02 20:50:00,0,0,0,0,0,0,0,0
2024-04-02 21:00:00,0,0,0,0,0,0,0,0
2024-04-02 21:10:00,0,0,0,0,0,0,0,0
2024-04-02 21:20:00,0,0,0,0,0,0,0,0
2024-04-02 21:30:00,0,0,0,0,0,0,0,0
2024-04-02 21:40:00,0,0,0,0,0,0,0,0
2024-04-02 21:50:00,0,0,0,0,0,0,0,0
2024-04-02 22:00:00,0,0,0,0,0,0,0,0
2024-04-02 22:10:00,0,0,0,0,0,0,0,0
2024-04-02 22:20:00,0,0,0,0,0,0,0,0
2024-04-02 22:30:00,0,0,0,0,0,0,0,0
2024-04-02 22:40:00,0,0,0,0,0,0,0,0
2024-04-02 22:50:00,0,0,0,0,0,0,0,0
2024-04-02 23:00:00,0,0,0,0,0,0,0,0
2024-04-02 23:10:00,0,0,0,0,0,0,0,0
2024-04-02 23:20:00,0,0,0,0,0,0,0,0
2024-04-02 23:30:00,0,0,0,0,0,0,0,0
2024-04-02 23:40:00,0,0,0,0,0,0,0,0
2024-04-02 23:50:00,0,0,0,0,0,0,0,0
2024-04-03 00:00:00,0,0,0,0,0,0,0,0
2024-04-03 00:10:00,0,0,0,0,0,0,0,0
2024-04-03 00:20:00,0,0,0,0,0,0,0,0
2024-04-03 00:30:00,0,0,0,0,0,0,0,0
2024-04-03 00:40:00,0,0,0,0,0,0,0,0
2024-04-03 00:50:00,0,0,0,0,0,0,0,0
2024-04-03 01:00:00,0,0,0,0,0,0,0,0
2024-04-03 01:10:00,0,0,0,0,0,0,0,0
2024-04-03 01:20:00,0,0,0,0,0,0,0,0
2024-04-03 01:30:00,0,0,0,0,0,0,0,0
2024-04-03 01:40:00,0,0,0,0,0,0,0,0
2024-04-03 01:50:00,0,0,0,0,0,0,0,0
2024-04-03 02:00:00,0,0,0,0,0,0,0,0
2024-04-03 02:10:00,0,0,0,0,0,0,0,0
2024-04-03 02:20:00,0,0,0,0,0,0,0,0
2024-04-03 02:30:00,0,0,0,0,0,0,0,0
2024-04-03 02:40:00,0,0,0,0,0,0,0,0
2024-04-03 02:50:00,0,0,0,0,0,0,0,0
2024-04-03 03:00:00,0,0,0,0,0,0,0,0
2024-04-03 03:10:00,0,0,0,0,0,0,0,0
2024-04-03 03:20:00,0,0,0,0,0,0,0,0
2024-04-03 03:30:00,0,0,0,0,0,0,0,0
2024-04-03 03:40:00,0,0,0,0,0,0,0,0
2024-04-03 03:50:00,0,0,0,0,0,0,0,0
2024-04-03 04:00:00,0,0,0,0,0,0,0,0
2024-04-03 04:10:00,0,0,0,0,0,0,0,0
2024-04-03 04:20:00,0,0,0,0,0,0,0,0
2024-04-03 04:30:00,0,0,0,0,0,0,0,0
2024-04-03 04:40:00,0,0,0,0,0,0,0,0
2024-04-03 04:50:00,0,0,0,0,0,0,0,0
2024-04-03 05:00:00,0,0,0,0,0,0,0,0
2024-04-03 05:10:00,0,0,0,0,0,0,0,0
2024-04-03 05:20:00,0,0,0,0,0,0,0,0
2024-04-03 05:30:00,0,0,0,0,0,0,0,0
2024-04-03 05:40:00,0,0,0,0,0,0,0,0
2024-04-03 05:50:00,0,0,0,0,0,0,0,0
2024-04-03 06:00:00,0,0,0,0,0,0,0,0
2024-04-03 06:10:00,0,0,0,0,0,0,0,0
2024-04-03 06:20:00,0,0,0,0,0,0,0,0
2024-04-03 06:30:00,0,0,0,0,0,0,0,0
2024-04-03 06:40:00,0,0,0,0,0,0,0,0
2024-04-03 06:50:00,0,0,0,0,0,0,0,0
2024-04-03 07:00:00,0,0,0,0,0,0,0,0
2024-04-03 07:10:00,0,0,0,0,0,0,0,0
2024-04-03 07:20:00,0,0,0,0,0,0,0,0
2024-04-03 07:30:00,0,0,0,0,0,0,0,0
2024-04-03 07:40:00,0,0,0,0,0,0,0,0
2024-04-03 07:50:00,0,0,0,0,0,0,0,0
2024-04-03 08:00:00,0,0,0,0,0,0,0,0
2024-04-03 08:10:00,0,0,0,0,0,0,0,0
2024-04-03 08:20:00,0,0,0,0,0,0,0,0
2024-04-03 08:30:00,0,0,0,0,0,0,0,0
2024-04-03 08:40:00,0,0,0,0,0,0,0,0
2024-04-03 08:50:00,0,0,0,0,0,0,0,0
2024-04-03 09:00:00,0,0,0,0,0,0,0,0
2024-04-03 09:10:00,0,0,0,0,0,0,0,0
2024-04-03 09:20:00,0,0,0,0,0,0,0,0
2024-04-03 09:30:00,0,0,0,0,0,0,0,0
2024-04-03 09:40:00,0,0,0,0,0,0,0,0
2024-04-03 09:50:00,0,0,0,0,0,0,0,0
2024-04-03 10:00:00,0,0,0,0,0,0,0,0
2024-04-03 10:10:00,0,0,0,0,0,0,0,0
2024-04-03 10:20:00,0,0,0,0,0,0,0,0
2024-04-03 10:30:00,0,0,0,0,0,0,0,0
2024-04-03 10:40:00,0,0,0,0,0,0,0,0
2024-04-03 10:50:00,0,0,0,0,0,0,0,0
2024-04-03 11:00:00,0,0,0,0,0,0,0,0
2024-04-03 11:10:00,0,0,0,0,0,0,0,0
2024-04-03 11:20:00,0,0,0,0,0,0,0,0
2024-04-03 11:30:00,0,0,0,0,0,0,0,0
2024-04-03 11:40:00,0,0,0,0,0,0,0,0
2024-04-03 11:50:00,0,0,0,0,0,0,0,0
2024-04-03 12:00:00,0,0,0,0,0,0,0,0
2024-04-03 12:10:00,0,0,0,0,0,0,0,0
2024-04-03 12:20:00,0,0,0,0,0,0,0,0
2024-04-03 12:30:00,0,0,0,0,0,0,0,0
2024-04-03 12:40:00,0,0,0,0,0,0,0,0
2024-04-03 12:50:00,0,0,0,0,0,0,0,0
2024-04-03 13:00:00,0,0,0,0,0,0,0,0
2024-04-03 13:10:00,0,0,0,0,0,0,0,0
2024-04-03 13:20:00,0,0,0,0,0,0,0,0
2024-04-03 13:30:00,0,0,0,0,0,0,0,0
2024-04-03 13:40:00,0,0,0,0,0,0,0,0
2024-04-03 13:50:00,0,0,0,0,0,0,0,0
2024-04-03 14:00:00,0,0,0,0,0,0,0,0
2024-04-03 14:10:00,0,0,0,0,0,0,0,0
2024-04-03 14:20:00,0,0,0,0,0,0,0,0
2024-04-03 14:30:00,0,0,0,0,0,0,0,0
2024-04-03 14:40:00,0,0,0,0,0,0,0,0
2024-04-03 14:50:00,0,0,0,0,0,0,0,0
2024-04-03 15:00:00,0,0,0,0,0,0,0,0
2024-04-03 15:10:00,0,0,0,0,0,0,0,0
2024-04-03 15:20:00,0,0,0,0,0,0,0,0
2024-04-03 15:30:00,0,0,0,0,0,0,0,0
2024-04-03 15:40:00,0,0,0,0,0,0,0,0
2024-04-03 15:50:00,0,0,0,0,0,0,0,0
2024-04-03 16:00:00,0,0,0,0,0,0,0,0
2024-04-03 16:10:00,0,0,0,0,0,0,0,0
2024-04-03 16:20:00,0,0,0,0,0,0,0,0
2024-04-03 16:30:00,0,0,0,0,0,0,0,0
2024-04-03 16:40:00,0,0,0,0,0,0,0,0
2024-04-03 16:50:00,0,0,0,0,0,0,0,0
2024-04-03 17:00:00,0,0,0,0,0,0,0,0
2024-04-03 17:10:00,0,0,0,0,0,0,0,0
2024-04-03 17:20:00,0,0,0,0,0,0,0,0
2024-04-03 17:30:00,0,0,0,0,0,0,0,0
2024-04-03 17:40:00,0,0,0,0,0,0,0,0
2024-04-03 17:50:00,0,0,0,0,0,0,0,0
2024-04-03 18:00:00,0,0,0,0,0,0,0,0
2024-04-03 18:10:00,0,0,0,0,0,0,0,0
2024-04-03 18:20:00,0,0,0,0,0,0,0,0
2024-04-03 18:30:00,0,0,0,0,0,0,0,0
2024-04-03 18:40:00,0,0,0,0,0,0,0,0
2024-04-03 18:50:00,0,0,0,0,0,0,0,0
2024-04-03 19:00:00,0,0,0,0,0,0,0,0
2024-04-03 19:10:00,0,0,0,0,0,0,0,0
2024-04-03 19:20:00,0,0,0,0,0,0,0,0
2024-04-03 19:30:00,0,0,0,0,0,0,0,0
2024-04-03 19:40:00,0,0,0,0,0,0,0,0
2024-04-03 19:50:00,0,0,0,0,0,0,0,0
2024-04-03 20:00:00,0,0,0,0,0,0,0,0
2024-04-03 20:10:00,0,0,0,0,0,0,0,0
2024-04-03 20:20:00,0,0,0,0,0,0,0,0
2024-04-03 20:30:00,0,0,0,0,0,0,0,0
2024-04-03 20:40:00,0,0,0,0,0,0,0,0
2024-04-03 20:50:00,0,0,0,0,0,0,0,0
2024-04-03 21:00:00,0,0,0,0,0,0,0,0
2024-04-03 21:10:00,0,0,0,0,0,0,0,0
2024-04-03 21:20:00,0,0,0,0,0,0,0,0
2024-04-03 21:30:00,0,0,0,0,0,0,0,0
2024-04-03 21:40:00,0,0,0,0,0,0,0,0
2024-04-03 21:50:00,0,0,0,0,0,0,0,0
2024-04-03 22:00:00,0,0,0,0,0,0,0,0
2024-04-03 22:10:00,0,0,0,0,0,0,0,0
2024-04-03 22:20:00,0,0,0,0,0,0,0,0
2024-04-03 22:30:00,0,0,0,0,0,0,0,0
2024-04-03 22:40:00,0,0,0,0,0,0,0,0
2024-04-03 22:50:00,0,0,0,0,0,0,0,0
2024-04-03 23:00:00,0,0,0,0,0,0,0,0
2024-04-03 23:10:00,0,0,0,0,0,0,0,0
2024-04-03 23:20:00,0,0,0,0,0,0,0,0
2024-04-03 23:30:00,0,0,0,0,0,0,0,0
2024-04-03 23:40:00,0,0,0,0,0,0,0,0
2024-04-03 23:50:00,0,0,0,0,0,0,0,0
2024-04-04 00:00:00,0,0,0,0,0,0,0,0
2024-04-04 00:10:00,0,0,0,0,0,0,0,0
2024-04-04 00:20:00,0,0,0,0,0,0,0,0
2024-04-04 00:30:00,0,0,0,0,0,0,0,0
2024-04-04 00:40:00,0,0,0,0,0,0,0,0
2024-04-04 00:50:00,0,0,0,0,0,0,0,0
2024-04-04 01:00:00,0,0,0,0,0,0,0,0
2024-04-04 01:10:00,0,0,0,0,0,0,0,0
2024-04-04 01:20:00,0,0,0,0,0,0,0,0
2024-04-04 01:30:00,0,0,0,0,0,0,0,0
2024-04-04 01:40:00,0,0,0,0,0,0,0,0
2024-04-04 01:50:00,0,0,0,0,0,0,0,0
2024-04-04 02:00:00,0,0,0,0,0,0,0,0
2024-04-04 02:10:00,0,0,0,0,0,0,0,0
2024-04-04 02:20:00,0,0,0,0,0,0,0,0
2024-04-04 02:30:00,0,0,0,0,0,0,0,0
2024-04-04 02:40:00,0,0,0,0,0,0,0,0
2024-04-04 02:50:00,0,0,0,0,0,0,0,0
2024-04-04 03:00:00,0,0,0,0,0,0,0,0
2024-04-04 03:10:00,0,0,0,0,0,0,0,0
2024-04-04 03:20:00,0,0,0,0,0,0,0,0
2024-04-04 03:30:00,0,0,0,0,0,0,0,0
2024-04-04 03:40:00,0,0,0,0,0,0,0,0
2024-04-04 03:50:00,0,0,0,0,0,0,0,0
2024-04-04 04:00:00,0,0,0,0,0,0,0,0
2024-04-04 04:10:00,0,0,0,0,0,0,0,0
2024-04-04 04:20:00,0,0,0,0,0,0,0,0
2024-04-04 04:30:00,0,0,0,0,0,0,0,0
2024-04-04 04:40:00,0,0,0,0,0,0,0,0
2024-04-04 04:50:00,0,0,0,0,0,0,0,0
2024-04-04 05:00:00,0,0,0,0,0,0,0,0
2024-04-04 05:10:00,0,0,0,0,0,0,0,0
2024-04-04 05:20:00,0,0,0,0,0,0,0,0
2024-04-04 05:30:00,0,0,0,0,0,0,0,0
2024-04-04 05:40:00,0,0,0,0,0,0,0,0
2024-04-04 05:50:00,0,0,0,0,0,0,0,0
2024-04-04 06:00:00,0,0,0,0,0,0,0,0
2024-04-04 06:10:00,0,0,0,0,0,0,0,0
2024-04-04 06:20:00,0,0,0,0,0,0,0,0
2024-04-04 06:30:00,0,0,0,0,0,0,0,0
2024-04-04 06:40:00,0,0,0,0,0,0,0,0
2024-04-04 06:50:00,0,0,0,0,0,0,0,0
2024-04-04 07:00:00,0,0,0,0,0,0,0,0
2024-04-04 07:10:00,0,0,0,0,0,0,0,0
2024-04-04 07:20:00,0,0,0,0,0,0,0,0
2024-04-04 07:30:00,0,0,0,0,0,0,0,0
2024-04-04 07:40:00,0,0,0,0,0,0,0,0
2024-04-04 07:50:00,0,0,0,0,0,0,0,0
2024-04-04 08:00:00,0,0,0,0,0,0,0,0
2024-04-04 08:10:00,0,0,0,0,0,0,0,0
2024-04-04 08:20:00,0,0,0,0,0,0,0,0
2024-04-04 08:30:00,0,0,0,0,0,0,0,0
2024-04-04 08:40:00,0,0,0,0,0,0,0,0
2024-04-04 08:50:00,0,0,0,0,0,0,0,0
2024-04-04 09:00:00,0,0,0,0,0,0,0,0
2024-04-04 09:10:00,0,0,0,0,0,0,0,0
2024-04-04 09:20:00,0,0,0,0,0,0,0,0
2024-04-04 09:30:00,0,0,0,0,0,0,0,0
2024-04-04 09:40:00,0,0,0,0,0,0,0,0
2024-04-04 09:50:00,0,0,0,0,0,0,0,0
2024-04-04 10:00:00,0,0,0,0,0,0,0,0
2024-04-04 10:10:00,0,0,0,0,0,0,0,0
2024-04-04 10:20:00,0,0,0,0,0,0,0,0
2024-04-04 10:30:00,0,0,0,0,0,0,0,0
2024-04-04 10:40:00,0,0,0,0,0,0,0,0
2024-04-04 10:50:00,0,0,0,0,0,0,0,0
2024-04-04 11:00:00,0,0,0,0,0,0,0,0
2024-04-04 11:10:00,0,0,0,0,0,0,0,0
2024-04-04 11:20:00,0,0,0,0,0,0,0,0
2024-04-04 11:30:00,0,0,0,0,0,0,0,0
2024-04-04 11:40:00,0,0,0,0,0,0,0,0
2024-04-04 11:50:00,0,0,0,0,0,0,0,0
2024-04-04 12:00:00,0,0,0,0,0,0,0,0
2024-04-04 12:10:00,0,0,0,0,0,0,0,0
2024-04-04 12:20:00,0,0,0,0,0,0,0,0
2024-04-04 12:30:00,0,0,0,0,0,0,0,0
2024-04-04 12:40:00,0,0,0,0,0,0,0,0
2024-04-04 12:50:00,0,0,0,0,0,0,0,0
2024-04-04 13:00:00,0,0,0,0,0,0,0,0
2024-04-04 13:10:00,0,0,0,0,0,0,0,0
2024-04-04 13:20:00,0,0,0,0,0,0,0,0
2024-04-04 13:30:00,0,0,0,0,0,0,0,0
2024-04-04 13:40:00,0,0,0,0,0,0,0,0
2024-04-04 13:50:00,0,0,0,0,0,0,0,0
2024-04-04 14:00:00,0,0,0,0,0,0,0,0
2024-04-04 14:10:00,0,0,0,0,0,0,0,0
2024-04-04 14:20:00,0,0,0,0,0,0,0,0
2024-04-04 14:30:00,0,0,0,0,0,0,0,0
2024-04-04 14:40:00,0,0,0,0,0,0,0,0
2024-04-04 14:50:00,0,0,0,0,0,0,0,0
2024-04-04 15:00:00,0,0,0,0,0,0,0,0
2024-04-04 15:10:00,0,0,0,0,0,0,0,0
2024-04-04 15:20:00,0,0,0,0,0,0,0,0
2024-04-04 15:30:00,0,0,0,0,0,0,0,0
2024-04-04 15:40:00,0,0,0,0,0,0,0,0
2024-04-04 15:50:00,0,0,0,0,0,0,0,0
2024-04-04 16:00:00,0,0,0,0,0,0,0,0
2024-04-04 16:10:00,0,0,0,0,0,0,0,0
2024-04-04 16:20:00,0,0,0,0,0,0,0,0
2024-04-04 16:30:00,0,0,0,0,0,0,0,0
2024-04-04 16:40:00,0,0,0,0,0,0,0,0
2024-04-04 16:50:00,0,0,0,0,0,0,0,0
2024-04-04 17:00:00,0,0,0,0,0,0,0,0
2024-04-04 17:10:00,0,0,0,0,0,0,0,0
2024-04-04 17:20:00,0,0,0,0,0,0,0,0
2024-04-04 17:30:00,0,0,0,0,0,0,0,0
2024-04-04 17:40:00,0,0,0,0,0,0,0,0
2024-04-04 17:50:00,0,0,0,0,0,0,0,0
2024-04-04 18:00:00,0,0,0,0,0,0,0,0
2024-04-04 18:10:00,0,0,0,0,0,0,0,0
2024-04-04 18:20:00,0,0,0,0,0,0,0,0
2024-04-04 18:30:00,0,0,0,0,0,0,0,0
2024-04-04 18:40:00,0,0,0,0,0,0,0,0
2024-04-04 18:50:00,0,0,0,0,0,0,0,0
2024-04-04 19:00:00,0,0,0,0,0,0,0,0
2024-04-04 19:10:00,0,0,0,0,0,0,0,0
2024-04-04 19:20:00,0,0,0,0,0,0,0,0
2024-04-04 19:30:00,0,0,0,0,0,0,0,0
2024-04-04 19:40:00,0,0,0,0,0,0,0,0
2024-04-04 19:50:00,0,0,0,0,0,0,0,0
2024-04-04 20:00:00,0,0,0,0,0,0,0,0
2024-04-04 20:10:00,0,0,0,0,0,0,0,0
2024-04-04 20:20:00,0,0,0,0,0,0,0,0
2024-04-04 20:30:00,0,0,0,0,0,0,0,0
2024-04-04 20:40:00,0,0,0,0,0,0,0,0
2024-04-04 20:50:00,0,0,0,0,0,0,0,0
2024-04-04 21:00:00,0,0,0,0,0,0,0,0
2024-04-04 21:10:00,0,0,0,0,0,0,0,0
2024-04-04 21:20:00,0,0,0,0,0,0,0,0
2024-04-04 21:30:00,0,0,0,0,0,0,0,0
2024-04-04 21:40:00,0,0,0,0,0,0,0,0
2024-04-04 21:50:00,0,0,0,0,0,0,0,0
2024-04-04 22:00:00,0,0,0,0,0,0,0,0
2024-04-04 22:10:00,0,0,0,0,0,0,0,0
2024-04-04 22:20:00,0,0,0,0,0,0,0,0
2024-04-04 22:30:00,0,0,0,0,0,0,0,0
2024-04-04 22:40:00,0,0,0,0,0,0,0,0
2024-04-04 22:50:00,0,0,0,0,0,0,0,0
2024-04-04 23:00:00,0,0,0,0,0,0,0,0
2024-04-04 23:10:00,0,0,0,0,0,0,0,0
2024-04-04 23:20:00,0,0,0,0,0,0,0,0
2024-04-04 23:30:00,0,0,0,0,0,0,0,0
2024-04-04 23:40:00,0,0,0,0,0,0,0,0
2024-04-04 23:50:00,0,0,0,0,0,0,0,0
2024-04-05 00:00:00,0,0,0,0,0,0,0,0
2024-04-05 00:10:00,0,0,0,0,0,0,0,0
2024-04-05 00:20:00,0,0,0,0,0,0,0,0
2024-04-05 00:30:00,0,0,0,0,0,0,0,0
2024-04-05 00:40:00,0,0,0,0,0,0,0,0
2024-04-05 00:50:00,0,0,0,0,0,0,0,0
2024-04-05 01:00:00,0,0,0,0,0,0,0,0
2024-04-05 01:10:00,0,0,0,0,0,0,0,0
2024-04-05 01:20:00,0,0,0,0,0,0,0,0
2024-04-05 01:30:00,0,0,0,0,0,0,0,0
2024-04-05 01:40:00,0,0,0,0,0,0,0,0
2024-04-05 01:50:00,0,0,0,0,0,0,0,0
2024-04-05 02:00:00,0,0,0,0,0,0,0,0
