datetime,V51Z,V52Z,V111Z,V112Z,D53Z,D113Z,Total
2024-03-01 01:00:00,0,3,5,2,2,3,15
2024-03-01 01:10:00,0,13,4,0,6,1,24
2024-03-01 01:20:00,0,3,13,1,2,8,27
2024-03-01 01:30:00,0,4,4,1,2,4,15
2024-03-01 01:40:00,0,3,6,0,2,3,14
2024-03-01 01:50:00,0,0,6,1,0,4,11
2024-03-01 02:00:00,0,0,4,3,0,2,9
2024-03-01 02:10:00,0,0,7,2,0,3,12
2024-03-01 02:20:00,0,2,4,2,1,2,11
2024-03-01 02:30:00,0,3,1,0,3,1,8
2024-03-01 02:40:00,1,0,2,0,0,1,4
2024-03-01 02:50:00,0,1,3,4,1,1,10
2024-03-01 03:00:00,0,2,2,0,1,1,6
2024-03-01 03:10:00,0,1,5,0,1,2,9
2024-03-01 03:20:00,0,3,4,0,2,3,12
2024-03-01 03:30:00,0,2,3,1,1,1,8
2024-03-01 03:40:00,0,7,5,2,4,3,21
2024-03-01 03:50:00,2,3,4,2,3,2,16
2024-03-01 04:00:00,0,6,2,2,4,1,15
2024-03-01 04:10:00,3,8,6,0,5,4,26
2024-03-01 04:20:00,0,3,2,0,2,1,8
2024-03-01 04:30:00,1,16,3,5,10,3,38
2024-03-01 04:40:00,0,10,2,1,6,1,20
2024-03-01 04:50:00,0,20,11,1,11,6,49
2024-03-01 05:00:00,1,27,7,1,13,7,56
2024-03-01 05:10:00,2,32,16,0,20,12,82
2024-03-01 05:20:00,2,38,16,1,22,9,88
2024-03-01 05:30:00,1,41,11,3,25,6,87
2024-03-01 05:40:00,1,68,11,1,42,9,132
2024-03-01 05:50:00,1,56,16,3,35,9,120
2024-03-01 06:00:00,7,38,18,3,21,10,97
2024-03-01 06:10:00,4,67,15,2,44,11,143
2024-03-01 06:20:00,1,65,24,8,47,13,158
2024-03-01 06:30:00,2,128,39,5,80,32,286
2024-03-01 06:40:00,2,105,39,6,69,34,255
2024-03-01 06:50:00,3,79,31,5,66,30,214
2024-03-01 07:00:00,2,57,24,8,84,35,210
2024-03-01 07:10:00,4,52,25,5,86,33,205
2024-03-01 07:20:00,3,64,30,7,95,38,237
2024-03-01 07:30:00,1,58,37,6,96,46,244
2024-03-01 07:40:00,2,60,40,11,118,54,285
2024-03-01 07:50:00,2,52,39,17,100,48,258
2024-03-01 08:00:00,2,44,28,11,63,40,188
2024-03-01 08:10:00,1,37,37,9,66,42,192
2024-03-01 08:20:00,1,60,26,10,79,29,205
2024-03-01 08:30:00,4,48,28,10,70,36,196
2024-03-01 08:40:00,2,45,17,8,80,26,178
2024-03-01 08:50:00,2,30,18,7,48,22,127
2024-03-01 09:00:00,4,40,26,8,53,30,161
2024-03-01 09:10:00,4,32,26,11,71,27,171
2024-03-01 09:20:00,1,30,35,5,49,38,158
2024-03-01 09:30:00,3,41,35,10,50,48,187
2024-03-01 09:40:00,1,36,38,12,55,34,176
2024-03-01 09:50:00,1,37,37,18,46,33,172
2024-03-01 10:00:00,3,37,28,14,44,35,161
2024-03-01 10:10:00,2,34,32,16,43,37,164
2024-03-01 10:20:00,3,37,24,15,57,24,160
2024-03-01 10:30:00,2,26,41,9,30,45,153
2024-03-01 10:40:00,5,39,33,15,48,39,179
2024-03-01 10:50:00,3,40,33,14,48,43,181
2024-03-01 11:00:00,3,29,30,15,34,39,150
2024-03-01 11:10:00,2,35,40,11,41,39,168
2024-03-01 11:20:00,2,29,43,14,37,47,172
2024-03-01 11:30:00,3,28,39,13,30,53,166
2024-03-01 11:40:00,3,34,29,17,54,39,176
2024-03-01 11:50:00,2,34,39,11,42,49,177
2024-03-01 12:00:00,3,33,43,19,38,49,185
2024-03-01 12:10:00,7,33,32,14,39,53,178
2024-03-01 12:20:00,3,50,34,14,61,50,212
2024-03-01 12:30:00,4,26,49,17,27,60,183
2024-03-01 12:40:00,4,46,53,13,60,61,237
2024-03-01 12:50:00,2,40,43,20,58,63,226
2024-03-01 13:00:00,1,40,51,24,54,69,239
2024-03-01 13:10:00,1,21,33,12,23,41,131
2024-03-01 13:20:00,3,30,40,22,52,63,210
2024-03-01 13:30:00,1,36,48,20,44,66,215
2024-03-01 13:40:00,3,34,44,18,52,69,220
2024-03-01 13:50:00,2,40,49,15,48,60,214
2024-03-01 14:00:00,1,32,69,16,42,85,245
2024-03-01 14:10:00,1,32,56,12,48,86,235
2024-03-01 14:20:00,8,37,54,21,58,84,262
2024-03-01 14:30:00,3,37,53,15,47,88,243
2024-03-01 14:40:00,1,36,54,16,52,84,243
2024-03-01 14:50:00,5,55,59,19,58,70,266
2024-03-01 15:00:00,4,36,49,14,42,69,214
2024-03-01 15:10:00,0,37,69,18,46,85,255
2024-03-01 15:20:00,2,28,56,14,54,84,238
2024-03-01 15:30:00,1,44,72,16,60,94,287
2024-03-01 15:40:00,5,24,72,17,36,85,239
2024-03-01 15:50:00,1,34,41,13,43,50,182
2024-03-01 16:00:00,2,24,42,12,34,53,167
2024-03-01 16:10:00,3,39,67,23,51,82,265
2024-03-01 16:20:00,3,39,58,22,47,87,256
2024-03-01 16:30:00,7,45,56,18,66,81,273
2024-03-01 16:40:00,5,36,53,12,53,74,233
2024-03-01 16:50:00,4,44,45,16,58,63,230
2024-03-01 17:00:00,5,48,58,22,56,78,267
2024-03-01 17:10:00,4,45,73,17,52,95,286
2024-03-01 17:20:00,2,33,46,14,47,65,207
2024-03-01 17:30:00,2,47,50,17,50,62,228
2024-03-01 17:40:00,2,42,51,15,49,74,233
2024-03-01 17:50:00,1,39,52,12,53,75,232
2024-03-01 18:00:00,3,31,36,12,41,58,181
2024-03-01 18:10:00,3,29,51,8,36,75,202
2024-03-01 18:20:00,4,69,47,20,57,66,263
2024-03-01 18:30:00,4,83,59,18,56,64,284
2024-03-01 18:40:00,2,76,64,17,53,68,280
2024-03-01 18:50:00,3,63,60,14,39,65,244
2024-03-01 19:00:00,5,55,44,20,40,46,210
2024-03-01 19:10:00,5,52,40,11,31,46,185
2024-03-01 19:20:00,8,65,58,17,39,53,240
2024-03-01 19:30:00,7,65,41,17,51,40,221
2024-03-01 19:40:00,3,59,45,18,34,50,209
2024-03-01 19:50:00,4,48,53,14,28,45,192
2024-03-01 20:00:00,0,43,36,10,22,35,146
2024-03-01 20:10:00,3,37,49,12,21,38,160
2024-03-01 20:20:00,2,28,27,9,16,28,110
2024-03-01 20:30:00,3,23,34,7,14,32,113
2024-03-01 20:40:00,3,39,39,6,23,27,137
2024-03-01 20:50:00,0,30,27,9,16,22,104
2024-03-01 21:00:00,1,35,38,17,21,32,144
2024-03-01 21:10:00,8,49,28,9,34,31,159
2024-03-01 21:20:00,0,26,41,11,14,32,124
2024-03-01 21:30:00,2,25,28,8,15,19,97
2024-03-01 21:40:00,3,18,36,5,10,36,108
2024-03-01 21:50:00,3,31,23,6,17,17,97
2024-03-01 22:00:00,1,26,23,7,14,17,88
2024-03-01 22:10:00,3,39,37,11,22,30,142
2024-03-01 22:20:00,2,40,40,3,23,31,139
2024-03-01 22:30:00,2,35,31,5,22,25,120
2024-03-01 22:40:00,4,12,33,7,7,27,90
2024-03-01 22:50:00,1,27,26,4,17,25,100
2024-03-01 23:00:00,2,16,32,4,10,24,88
2024-03-01 23:10:00,1,14,20,5,9,14,63
2024-03-01 23:20:00,2,12,23,4,8,16,65
2024-03-01 23:30:00,2,25,30,3,13,21,94
2024-03-01 23:40:00,0,17,24,6,10,19,76
2024-03-01 23:50:00,0,17,21,6,10,14,68
2024-03-02 00:00:00,1,18,20,4,13,14,70
2024-03-02 00:10:00,0,15,16,4,10,10,55
2024-03-02 00:20:00,2,10,23,6,6,13,60
2024-03-02 00:30:00,0,4,18,1,2,15,40
2024-03-02 00:40:00,0,8,14,1,4,10,37
2024-03-02 00:50:00,0,13,14,1,7,11,46
2024-03-02 01:00:00,2,10,14,2,5,10,43
2024-03-02 01:10:00,1,10,12,2,5,7,37
2024-03-02 01:20:00,0,2,12,3,1,8,26
2024-03-02 01:30:00,1,4,9,5,2,4,25
2024-03-02 01:40:00,0,3,9,1,2,7,22
2024-03-02 01:50:00,0,8,7,1,4,8,28
2024-03-02 02:00:00,0,5,5,4,3,4,21
2024-03-02 02:10:00,2,2,9,1,1,4,19
2024-03-02 02:20:00,0,10,6,3,5,3,27
2024-03-02 02:30:00,0,4,6,2,2,4,18
2024-03-02 02:40:00,0,2,4,2,2,2,12
2024-03-02 02:50:00,0,2,12,1,2,8,25
2024-03-02 03:00:00,0,8,10,5,4,6,33
2024-03-02 03:10:00,0,5,5,1,3,4,18
2024-03-02 03:20:00,1,2,7,0,1,4,15
2024-03-02 03:30:00,0,8,0,0,4,0,12
2024-03-02 03:40:00,0,2,5,1,1,2,11
2024-03-02 03:50:00,0,8,5,1,4,4,22
2024-03-02 04:00:00,0,8,6,2,4,2,22
2024-03-02 04:10:00,0,4,7,3,2,3,19
2024-03-02 04:20:00,1,5,10,2,7,6,31
2024-03-02 04:30:00,0,4,4,2,2,2,14
2024-03-02 04:40:00,0,4,1,1,2,1,9
2024-03-02 04:50:00,0,8,2,0,5,2,17
2024-03-02 05:00:00,1,18,16,1,11,11,58
2024-03-02 05:10:00,1,17,7,3,10,4,42
2024-03-02 05:20:00,1,21,8,3,12,5,50
2024-03-02 05:30:00,0,17,10,3,9,4,43
2024-03-02 05:40:00,1,17,5,1,11,4,39
2024-03-02 05:50:00,1,11,8,0,9,7,36
2024-03-02 06:00:00,0,12,11,4,7,7,41
2024-03-02 06:10:00,1,10,20,5,5,10,51
2024-03-02 06:20:00,1,24,13,2,15,7,62
2024-03-02 06:30:00,2,21,7,1,12,5,48
2024-03-02 06:40:00,2,17,12,2,11,6,50
2024-03-02 06:50:00,1,17,13,3,12,11,57
2024-03-02 07:00:00,0,23,6,1,25,6,61
2024-03-02 07:10:00,1,20,6,6,15,6,54
2024-03-02 07:20:00,3,19,13,2,17,14,68
2024-03-02 07:30:00,0,20,16,5,18,20,79
2024-03-02 07:40:00,2,27,18,1,32,17,97
2024-03-02 07:50:00,1,24,17,3,31,14,90
2024-03-02 08:00:00,1,17,11,6,16,13,64
2024-03-02 08:10:00,1,31,17,2,29,20,100
2024-03-02 08:20:00,3,28,12,7,28,14,92
2024-03-02 08:30:00,1,24,17,5,27,19,93
2024-03-02 08:40:00,1,31,23,2,33,23,113
2024-03-02 08:50:00,3,25,27,4,29,29,117
2024-03-02 09:00:00,0,30,21,4,35,21,111
2024-03-02 09:10:00,3,36,19,5,42,25,130
2024-03-02 09:20:00,1,42,28,9,55,29,164
2024-03-02 09:30:00,1,36,30,6,48,33,154
2024-03-02 09:40:00,4,42,35,13,49,43,186
2024-03-02 09:50:00,7,37,34,16,43,35,172
2024-03-02 10:00:00,1,62,29,15,75,32,214
2024-03-02 10:10:00,1,40,31,12,54,34,172
2024-03-02 10:20:00,3,45,31,10,59,43,191
2024-03-02 10:30:00,0,38,30,17,54,35,174
2024-03-02 10:40:00,2,41,39,8,69,43,202
2024-03-02 10:50:00,2,45,37,13,72,45,214
2024-03-02 11:00:00,2,35,39,7,64,48,195
2024-03-02 11:10:00,1,48,30,11,58,38,186
2024-03-02 11:20:00,5,46,33,7,49,41,181
2024-03-02 11:30:00,2,37,28,18,42,34,161
2024-03-02 11:40:00,2,36,41,18,46,42,185
2024-03-02 11:50:00,2,43,32,10,46,58,191
2024-03-02 12:00:00,4,41,38,18,49,48,198
2024-03-02 12:10:00,4,39,45,13,49,65,215
2024-03-02 12:20:00,4,33,30,13,49,45,174
2024-03-02 12:30:00,16,14,47,11,20,56,164
2024-03-02 12:40:00,23,8,56,13,20,67,187
2024-03-02 12:50:00,2,36,32,13,56,53,192
2024-03-02 13:00:00,1,38,45,17,75,53,229
2024-03-02 13:10:00,2,41,45,8,41,57,194
2024-03-02 13:20:00,7,59,54,14,79,59,272
2024-03-02 13:30:00,0,29,38,12,46,34,159
2024-03-02 13:40:00,2,53,58,18,61,56,248
2024-03-02 13:50:00,5,57,48,9,80,59,258
2024-03-02 14:00:00,1,28,45,13,37,58,182
2024-03-02 14:10:00,1,50,43,19,74,54,241
2024-03-02 14:20:00,1,34,40,12,42,61,190
2024-03-02 14:30:00,1,42,42,12,51,52,200
2024-03-02 14:40:00,6,42,53,9,52,71,233
2024-03-02 14:50:00,4,38,62,8,46,80,238
2024-03-02 15:00:00,4,40,41,14,44,55,198
2024-03-02 15:10:00,2,34,44,16,59,56,211
2024-03-02 15:20:00,2,49,43,8,48,58,208
2024-03-02 15:30:00,3,41,40,12,45,54,195
2024-03-02 15:40:00,1,36,35,15,45,58,190
2024-03-02 15:50:00,2,24,38,14,39,62,179
2024-03-02 16:00:00,3,30,35,8,45,53,174
2024-03-02 16:10:00,1,40,23,8,47,51,170
2024-03-02 16:20:00,1,31,10,6,31,42,121
2024-03-02 16:30:00,6,30,22,6,36,51,151
2024-03-02 16:40:00,3,36,39,7,43,56,184
2024-03-02 16:50:00,1,43,56,15,53,74,242
2024-03-02 17:00:00,2,33,47,10,54,68,214
2024-03-02 17:10:00,3,27,34,14,42,57,177
2024-03-02 17:20:00,4,32,45,22,37,55,195
2024-03-02 17:30:00,1,41,42,12,47,65,208
2024-03-02 17:40:00,5,48,23,11,55,63,205
2024-03-02 17:50:00,4,43,42,13,42,69,213
2024-03-02 18:00:00,3,44,45,11,61,69,233
2024-03-02 18:10:00,4,40,37,15,51,58,205
2024-03-02 18:20:00,8,53,47,14,53,43,218
2024-03-02 18:30:00,2,81,60,9,50,55,257
2024-03-02 18:40:00,4,73,38,14,42,36,207
2024-03-02 18:50:00,1,47,43,7,28,42,168
2024-03-02 19:00:00,2,63,46,17,41,46,215
2024-03-02 19:10:00,6,64,49,12,36,48,215
2024-03-02 19:20:00,4,53,43,12,39,35,186
2024-03-02 19:30:00,1,36,35,11,21,45,149
2024-03-02 19:40:00,3,43,42,8,23,43,162
2024-03-02 19:50:00,1,33,42,14,23,43,156
2024-03-02 20:00:00,2,37,41,15,20,39,154
2024-03-02 20:10:00,4,39,41,6,21,44,155
2024-03-02 20:20:00,3,27,43,12,18,33,136
2024-03-02 20:30:00,2,23,33,4,14,28,104
2024-03-02 20:40:00,5,40,29,6,22,22,124
2024-03-02 20:50:00,3,30,32,8,18,28,119
2024-03-02 21:00:00,2,37,36,9,19,29,132
2024-03-02 21:10:00,6,33,31,10,22,20,122
2024-03-02 21:20:00,1,22,50,8,12,34,127
2024-03-02 21:30:00,2,13,32,11,7,22,87
2024-03-02 21:40:00,1,21,30,4,11,25,92
2024-03-02 21:50:00,1,20,35,6,10,27,99
2024-03-02 22:00:00,2,19,26,7,13,23,90
2024-03-02 22:10:00,4,16,31,4,10,19,84
2024-03-02 22:20:00,2,26,28,7,16,25,104
2024-03-02 22:30:00,1,27,31,9,18,27,113
2024-03-02 22:40:00,1,17,38,7,13,32,108
2024-03-02 22:50:00,3,29,22,10,16,18,98
2024-03-02 23:00:00,2,32,32,7,18,19,110
2024-03-02 23:10:00,3,15,21,3,8,16,66
2024-03-02 23:20:00,0,17,27,7,8,19,78
2024-03-02 23:30:00,2,16,30,6,10,20,84
2024-03-02 23:40:00,4,18,25,2,10,16,75
2024-03-02 23:50:00,3,13,28,7,11,23,85
2024-03-03 00:00:00,4,12,21,7,8,14,66
2024-03-03 00:10:00,2,25,25,1,13,15,81
2024-03-03 00:20:00,2,17,33,4,9,19,84
2024-03-03 00:30:00,3,16,14,3,10,8,54
2024-03-03 00:40:00,2,11,7,3,7,5,35
2024-03-03 00:50:00,0,8,10,8,4,6,36
2024-03-03 01:00:00,2,12,16,3,7,16,56
2024-03-03 01:10:00,0,10,22,3,5,13,53
2024-03-03 01:20:00,4,5,18,2,3,13,45
2024-03-03 01:30:00,0,7,18,4,4,11,44
2024-03-03 01:40:00,0,15,12,3,8,7,45
2024-03-03 01:50:00,2,5,10,1,3,5,26
2024-03-03 02:00:00,3,10,8,6,6,5,38
2024-03-03 02:10:00,0,10,11,3,6,9,39
2024-03-03 02:20:00,1,19,10,4,12,4,50
2024-03-03 02:30:00,0,8,12,2,4,6,32
2024-03-03 02:40:00,0,2,2,1,1,3,9
2024-03-03 02:50:00,0,3,11,1,2,6,23
2024-03-03 03:00:00,0,10,6,2,6,4,28
2024-03-03 03:10:00,2,7,8,0,4,6,27
2024-03-03 03:20:00,0,15,9,2,9,5,40
2024-03-03 03:30:00,2,11,8,2,6,6,35
2024-03-03 03:40:00,2,16,12,2,8,8,48
2024-03-03 03:50:00,0,8,4,0,4,4,20
2024-03-03 04:00:00,0,3,2,3,2,1,11
2024-03-03 04:10:00,0,4,4,1,2,1,12
2024-03-03 04:20:00,0,0,7,0,0,7,14
2024-03-03 04:30:00,0,2,6,2,1,3,14
2024-03-03 04:40:00,0,5,6,2,3,3,19
2024-03-03 04:50:00,0,9,3,1,5,2,20
2024-03-03 05:00:00,0,9,3,1,4,3,20
2024-03-03 05:10:00,0,10,11,4,5,7,37
2024-03-03 05:20:00,0,13,6,1,8,5,33
2024-03-03 05:30:00,2,11,4,2,7,2,28
2024-03-03 05:40:00,0,8,1,0,4,1,14
2024-03-03 05:50:00,0,6,6,0,3,3,18
2024-03-03 06:00:00,2,3,7,1,2,5,20
2024-03-03 06:10:00,0,6,7,3,3,3,22
2024-03-03 06:20:00,0,6,12,2,3,7,30
2024-03-03 06:30:00,1,0,5,2,0,4,12
2024-03-03 06:40:00,0,8,8,3,4,5,28
2024-03-03 06:50:00,0,4,4,0,3,7,18
2024-03-03 07:00:00,1,5,5,0,5,5,21
2024-03-03 07:10:00,0,5,5,1,5,5,21
2024-03-03 07:20:00,0,6,5,0,7,6,24
2024-03-03 07:30:00,2,10,2,4,12,3,33
2024-03-03 07:40:00,0,7,5,1,7,5,25
2024-03-03 07:50:00,0,5,6,2,5,5,23
2024-03-03 08:00:00,1,10,10,3,9,14,47
2024-03-03 08:10:00,0,9,15,2,9,15,50
2024-03-03 08:20:00,0,14,10,0,14,12,50
2024-03-03 08:30:00,1,9,9,1,8,7,35
2024-03-03 08:40:00,0,15,9,3,12,10,49
2024-03-03 08:50:00,0,23,13,4,22,12,74
2024-03-03 09:00:00,4,13,15,0,13,19,64
2024-03-03 09:10:00,1,20,14,2,20,13,70
2024-03-03 09:20:00,1,29,15,0,37,17,99
2024-03-03 09:30:00,1,35,14,9,39,17,115
2024-03-03 09:40:00,2,29,21,3,31,24,110
2024-03-03 09:50:00,1,26,22,6,30,27,112
2024-03-03 10:00:00,3,38,20,4,35,20,120
2024-03-03 10:10:00,1,18,22,6,18,29,94
2024-03-03 10:20:00,1,35,22,10,38,27,133
2024-03-03 10:30:00,4,28,26,13,26,25,122
2024-03-03 10:40:00,3,36,17,7,44,26,133
2024-03-03 10:50:00,0,22,22,7,26,23,100
2024-03-03 11:00:00,1,37,19,6,40,23,126
2024-03-03 11:10:00,1,39,38,7,41,38,164
2024-03-03 11:20:00,1,32,31,7,38,30,139
2024-03-03 11:30:00,4,35,42,8,41,48,178
2024-03-03 11:40:00,1,23,41,9,24,46,144
2024-03-03 11:50:00,3,38,46,13,38,45,183
2024-03-03 12:00:00,1,37,32,14,40,33,157
2024-03-03 12:10:00,4,30,45,10,38,49,176
2024-03-03 12:20:00,3,31,42,9,38,41,164
2024-03-03 12:30:00,5,27,37,8,32,49,158
2024-03-03 12:40:00,3,39,32,16,43,35,168
2024-03-03 12:50:00,2,33,35,9,37,34,150
2024-03-03 13:00:00,3,38,32,9,40,42,164
2024-03-03 13:10:00,2,35,36,12,40,40,165
2024-03-03 13:20:00,0,53,43,12,57,47,212
2024-03-03 13:30:00,3,47,43,12,52,50,207
2024-03-03 13:40:00,2,39,50,8,42,51,192
2024-03-03 13:50:00,3,35,40,7,49,41,175
2024-03-03 14:00:00,7,42,39,12,44,48,192
2024-03-03 14:10:00,3,39,40,5,45,44,176
2024-03-03 14:20:00,4,42,31,8,42,38,165
2024-03-03 14:30:00,7,38,38,10,49,49,191
2024-03-03 14:40:00,5,43,36,9,41,45,179
2024-03-03 14:50:00,8,41,25,9,51,41,175
2024-03-03 15:00:00,4,62,22,8,60,49,205
2024-03-03 15:10:00,4,30,24,6,44,38,146
2024-03-03 15:20:00,2,30,8,5,34,41,120
2024-03-03 15:30:00,4,35,17,9,46,42,153
2024-03-03 15:40:00,2,50,17,5,48,44,166
2024-03-03 15:50:00,4,45,8,2,42,47,148
2024-03-03 16:00:00,5,34,20,6,48,52,165
2024-03-03 16:10:00,3,27,7,0,26,37,100
2024-03-03 16:20:00,1,41,4,3,41,46,136
2024-03-03 16:30:00,5,33,6,0,31,43,118
2024-03-03 16:40:00,7,26,5,2,34,46,120
2024-03-03 16:50:00,5,38,29,8,40,44,164
2024-03-03 17:00:00,5,29,25,8,27,53,147
2024-03-03 17:10:00,6,55,23,12,51,50,197
2024-03-03 17:20:00,0,39,29,11,40,52,171
2024-03-03 17:30:00,4,36,24,7,32,57,160
2024-03-03 17:40:00,1,33,22,6,38,46,146
2024-03-03 17:50:00,2,26,43,17,32,52,172
2024-03-03 18:00:00,2,29,34,13,31,42,151
2024-03-03 18:10:00,3,22,43,13,20,52,153
2024-03-03 18:20:00,3,30,41,12,31,42,159
2024-03-03 18:30:00,2,48,35,12,32,34,163
2024-03-03 18:40:00,7,39,41,15,23,31,156
2024-03-03 18:50:00,6,35,44,13,21,41,160
2024-03-03 19:00:00,5,37,41,15,29,38,165
2024-03-03 19:10:00,1,63,39,11,36,28,178
2024-03-03 19:20:00,5,46,27,11,25,24,138
2024-03-03 19:30:00,3,33,27,4,19,23,109
2024-03-03 19:40:00,5,22,34,8,13,34,116
2024-03-03 19:50:00,8,38,34,12,26,25,143
2024-03-03 20:00:00,3,29,22,8,17,23,102
2024-03-03 20:10:00,7,26,42,7,17,37,136
2024-03-03 20:20:00,2,38,31,7,22,20,120
2024-03-03 20:30:00,9,34,26,4,23,24,120
2024-03-03 20:40:00,1,20,28,4,12,25,90
2024-03-03 20:50:00,1,26,41,5,17,24,114
2024-03-03 21:00:00,2,31,28,12,19,23,115
2024-03-03 21:10:00,6,30,45,5,18,31,135
2024-03-03 21:20:00,3,23,22,8,12,17,85
2024-03-03 21:30:00,1,14,23,5,9,15,67
2024-03-03 21:40:00,2,14,20,2,8,13,59
2024-03-03 21:50:00,0,12,25,5,6,17,65
2024-03-03 22:00:00,3,18,26,4,10,18,79
2024-03-03 22:10:00,2,15,32,7,8,21,85
2024-03-03 22:20:00,2,17,25,5,11,16,76
2024-03-03 22:30:00,2,13,21,9,7,14,66
2024-03-03 22:40:00,1,10,22,2,6,17,58
2024-03-03 22:50:00,0,4,24,4,3,14,49
2024-03-03 23:00:00,1,7,10,11,5,7,41
2024-03-03 23:10:00,2,11,22,5,6,12,58
2024-03-03 23:20:00,0,7,12,0,4,8,31
2024-03-03 23:30:00,1,6,13,3,3,9,35
2024-03-03 23:40:00,2,15,2,3,9,3,34
2024-03-03 23:50:00,0,7,10,1,5,5,28
2024-03-04 00:00:00,2,2,10,4,1,5,24
2024-03-04 00:10:00,2,11,0,4,6,2,25
2024-03-04 00:20:00,0,0,2,3,0,2,7
2024-03-04 00:30:00,0,1,11,3,1,6,22
2024-03-04 00:40:00,0,2,0,0,1,0,3
2024-03-04 00:50:00,0,3,3,0,2,2,10
2024-03-04 01:00:00,0,0,3,0,0,1,4
2024-03-04 01:10:00,0,0,4,1,0,1,6
2024-03-04 01:20:00,0,2,4,2,2,3,13
2024-03-04 01:30:00,0,4,5,1,2,2,14
2024-03-04 01:40:00,0,0,5,1,0,5,11
2024-03-04 01:50:00,0,0,3,1,0,2,6
2024-03-04 02:00:00,0,2,3,1,1,1,8
2024-03-04 02:10:00,0,0,3,1,0,1,5
2024-03-04 02:20:00,0,0,0,0,0,0,0
2024-03-04 02:30:00,0,0,2,0,0,1,3
2024-03-04 02:40:00,1,0,0,0,1,0,2
2024-03-04 02:50:00,0,2,0,1,2,0,5
2024-03-04 03:00:00,0,0,6,1,0,4,11
2024-03-04 03:10:00,0,6,0,1,3,0,10
2024-03-04 03:20:00,0,2,2,0,1,2,7
2024-03-04 03:30:00,0,4,0,1,2,0,7
2024-03-04 03:40:00,0,6,1,0,3,1,11
2024-03-04 03:50:00,0,4,4,1,2,2,13
2024-03-04 04:00:00,0,2,2,0,2,1,7
2024-03-04 04:10:00,1,4,1,0,2,1,9
2024-03-04 04:20:00,1,11,4,1,6,2,25
2024-03-04 04:30:00,1,5,3,0,3,3,15
2024-03-04 04:40:00,0,18,6,1,10,3,38
2024-03-04 04:50:00,3,19,5,1,10,3,41
2024-03-04 05:00:00,1,33,14,1,18,10,77
2024-03-04 05:10:00,1,19,12,6,10,6,54
2024-03-04 05:20:00,0,43,8,1,30,6,88
2024-03-04 05:30:00,5,49,12,2,26,9,103
2024-03-04 05:40:00,1,70,18,2,45,14,150
2024-03-04 05:50:00,0,76,24,5,42,11,158
2024-03-04 06:00:00,2,66,27,4,47,20,166
2024-03-04 06:10:00,5,78,24,2,53,18,180
2024-03-04 06:20:00,3,91,31,5,58,23,211
2024-03-04 06:30:00,1,115,35,2,76,27,256
2024-03-04 06:40:00,2,105,39,6,79,23,254
2024-03-04 06:50:00,3,75,20,9,91,45,243
2024-03-04 07:00:00,2,70,31,6,85,36,230
2024-03-04 07:10:00,7,57,32,6,79,45,226
2024-03-04 07:20:00,4,52,29,11,134,37,267
2024-03-04 07:30:00,3,61,34,7,94,48,247
2024-03-04 07:40:00,3,54,34,17,149,53,310
2024-03-04 07:50:00,3,67,39,13,108,44,274
2024-03-04 08:00:00,5,69,30,12,154,34,304
2024-03-04 08:10:00,3,51,28,14,88,37,221
2024-03-04 08:20:00,3,45,25,10,63,40,186
2024-03-04 08:30:00,5,79,29,7,136,38,294
2024-03-04 08:40:00,8,54,32,16,69,46,225
2024-03-04 08:50:00,2,50,38,13,77,38,218
2024-03-04 09:00:00,3,61,37,10,65,43,219
2024-03-04 09:10:00,3,44,23,8,54,32,164
2024-03-04 09:20:00,1,50,33,6,60,37,187
2024-03-04 09:30:00,3,43,24,13,65,25,173
2024-03-04 09:40:00,1,39,34,5,43,38,160
2024-03-04 09:50:00,2,40,33,12,60,43,190
2024-03-04 10:00:00,2,31,25,14,41,29,142
2024-03-04 10:10:00,2,30,28,14,36,32,142
2024-03-04 10:20:00,2,37,32,10,53,35,169
2024-03-04 10:30:00,1,40,28,13,54,30,166
2024-03-04 10:40:00,1,38,28,12,40,33,152
2024-03-04 10:50:00,3,24,27,10,26,26,116
2024-03-04 11:00:00,2,34,31,13,54,37,171
2024-03-04 11:10:00,3,30,30,8,41,39,151
2024-03-04 11:20:00,4,30,35,11,34,51,165
2024-03-04 11:30:00,3,27,43,12,43,50,178
2024-03-04 11:40:00,3,29,40,12,38,52,174
2024-03-04 11:50:00,3,26,50,20,30,54,183
2024-03-04 12:00:00,5,34,41,11,47,50,188
2024-03-04 12:10:00,6,19,37,13,24,49,148
2024-03-04 12:20:00,4,29,36,11,32,48,160
2024-03-04 12:30:00,2,37,37,10,50,57,193
2024-03-04 12:40:00,1,28,41,13,40,43,166
2024-03-04 12:50:00,4,27,40,7,37,45,160
2024-03-04 13:00:00,2,24,32,22,38,44,162
2024-03-04 13:10:00,7,34,41,12,41,64,199
2024-03-04 13:20:00,2,41,34,14,55,49,195
2024-03-04 13:30:00,4,31,35,11,54,40,175
2024-03-04 13:40:00,2,25,40,12,37,64,180
2024-03-04 13:50:00,1,32,33,17,49,41,173
2024-03-04 14:00:00,5,28,33,17,54,47,184
2024-03-04 14:10:00,3,29,33,6,32,59,162
2024-03-04 14:20:00,4,31,38,22,45,59,199
2024-03-04 14:30:00,3,35,39,15,50,62,204
2024-03-04 14:40:00,5,32,44,19,50,60,210
2024-03-04 14:50:00,4,27,44,15,37,60,187
2024-03-04 15:00:00,4,31,49,10,46,78,218
2024-03-04 15:10:00,0,26,51,16,42,93,228
2024-03-04 15:20:00,1,36,57,15,54,88,251
2024-03-04 15:30:00,1,41,60,12,54,82,250
2024-03-04 15:40:00,3,31,59,15,53,96,257
2024-03-04 15:50:00,3,32,56,17,37,110,255
2024-03-04 16:00:00,3,32,47,18,49,90,239
2024-03-04 16:10:00,4,31,45,9,47,106,242
2024-03-04 16:20:00,3,46,67,13,48,98,275
2024-03-04 16:30:00,2,45,57,27,54,106,291
2024-03-04 16:40:00,4,49,50,20,76,94,293
2024-03-04 16:50:00,2,36,59,22,48,93,260
2024-03-04 17:00:00,4,35,46,15,54,112,266
2024-03-04 17:10:00,1,32,41,17,41,94,226
2024-03-04 17:20:00,4,43,54,28,62,107,298
2024-03-04 17:30:00,3,41,46,11,58,95,254
2024-03-04 17:40:00,3,25,63,27,43,98,259
2024-03-04 17:50:00,6,35,48,12,40,84,225
2024-03-04 18:00:00,4,44,39,13,45,89,234
2024-03-04 18:10:00,5,36,38,16,33,65,193
2024-03-04 18:20:00,10,83,54,11,50,69,277
2024-03-04 18:30:00,6,61,66,16,46,65,260
2024-03-04 18:40:00,6,47,54,12,36,51,206
2024-03-04 18:50:00,3,42,47,18,24,51,185
2024-03-04 19:00:00,3,63,45,13,37,46,207
2024-03-04 19:10:00,3,44,63,13,25,56,204
2024-03-04 19:20:00,8,49,50,15,26,50,198
2024-03-04 19:30:00,7,44,42,13,26,40,172
2024-03-04 19:40:00,5,43,42,11,22,39,162
2024-03-04 19:50:00,0,30,43,6,18,38,135
2024-03-04 20:00:00,2,34,44,5,23,31,139
2024-03-04 20:10:00,1,28,47,5,17,43,141
2024-03-04 20:20:00,0,40,34,6,21,29,130
2024-03-04 20:30:00,6,31,41,6,18,26,128
2024-03-04 20:40:00,6,20,42,11,13,35,127
2024-03-04 20:50:00,0,26,37,7,16,30,116
2024-03-04 21:00:00,4,17,35,3,11,26,96
2024-03-04 21:10:00,1,27,31,4,14,23,100
2024-03-04 21:20:00,2,27,35,8,14,25,111
2024-03-04 21:30:00,2,27,22,9,16,22,98
2024-03-04 21:40:00,1,16,25,5,8,18,73
2024-03-04 21:50:00,0,12,24,6,7,22,71
2024-03-04 22:00:00,1,9,21,5,7,20,63
2024-03-04 22:10:00,1,14,27,6,7,26,81
2024-03-04 22:20:00,3,18,36,6,10,27,100
2024-03-04 22:30:00,1,9,21,5,6,20,62
2024-03-04 22:40:00,1,8,26,7,7,23,72
2024-03-04 22:50:00,0,4,14,5,3,8,34
2024-03-04 23:00:00,3,13,7,2,7,7,39
2024-03-04 23:10:00,1,11,31,4,8,17,72
2024-03-04 23:20:00,1,3,22,3,3,13,45
2024-03-04 23:30:00,1,7,6,3,5,5,27
2024-03-04 23:40:00,1,8,5,0,4,5,23
2024-03-04 23:50:00,0,4,8,3,2,9,26
2024-03-05 00:00:00,1,6,9,0,3,7,26
2024-03-05 00:10:00,0,6,5,3,3,6,23
2024-03-05 00:20:00,0,3,10,2,2,8,25
2024-03-05 00:30:00,1,3,2,0,1,2,9
2024-03-05 00:40:00,0,1,5,2,1,4,13
2024-03-05 00:50:00,0,2,4,3,2,2,13
2024-03-05 01:00:00,2,6,8,3,3,3,25
2024-03-05 01:10:00,0,4,5,2,2,7,20
2024-03-05 01:20:00,0,2,4,0,1,3,10
2024-03-05 01:30:00,0,5,9,4,2,7,27
2024-03-05 01:40:00,0,0,8,0,0,5,13
2024-03-05 01:50:00,0,0,3,3,0,5,11
2024-03-05 02:00:00,0,0,5,2,0,2,9
2024-03-05 02:10:00,0,2,2,0,1,1,6
2024-03-05 02:20:00,0,1,0,1,1,0,3
2024-03-05 02:30:00,0,1,4,0,1,2,8
2024-03-05 02:40:00,0,2,4,1,1,2,10
2024-03-05 02:50:00,0,3,1,1,2,1,8
2024-03-05 03:00:00,0,0,0,2,0,0,2
2024-03-05 03:10:00,0,2,5,0,1,3,11
2024-03-05 03:20:00,0,1,2,0,1,2,6
2024-03-05 03:30:00,0,3,5,1,2,2,13
2024-03-05 03:40:00,0,4,6,1,2,3,16
2024-03-05 03:50:00,0,7,6,1,4,3,21
2024-03-05 04:00:00,0,4,4,1,2,2,13
2024-03-05 04:10:00,2,0,3,0,1,1,7
2024-03-05 04:20:00,0,11,1,1,6,1,20
2024-03-05 04:30:00,2,15,5,0,10,3,35
2024-03-05 04:40:00,2,5,4,1,4,2,18
2024-03-05 04:50:00,0,28,7,0,17,4,56
2024-03-05 05:00:00,2,22,7,2,14,5,52
2024-03-05 05:10:00,2,19,14,3,13,8,59
2024-03-05 05:20:00,0,43,6,2,27,4,82
2024-03-05 05:30:00,1,54,10,1,33,6,105
2024-03-05 05:40:00,2,77,14,0,50,13,156
2024-03-05 05:50:00,0,55,30,1,36,16,138
2024-03-05 06:00:00,2,76,18,3,54,10,163
2024-03-05 06:10:00,2,82,30,4,50,23,191
2024-03-05 06:20:00,5,88,31,4,61,28,217
2024-03-05 06:30:00,2,106,35,3,75,29,250
2024-03-05 06:40:00,3,117,28,3,75,26,252
2024-03-05 06:50:00,3,103,33,5,80,31,255
2024-03-05 07:00:00,2,84,28,4,119,39,276
2024-03-05 07:10:00,2,64,27,9,92,33,227
2024-03-05 07:20:00,7,68,36,6,145,46,308
2024-03-05 07:30:00,2,54,29,11,120,33,249
2024-03-05 07:40:00,4,34,20,15,122,37,232
2024-03-05 07:50:00,4,55,32,14,108,37,250
2024-03-05 08:00:00,7,62,24,9,121,36,259
2024-03-05 08:10:00,2,51,31,11,117,36,248
2024-03-05 08:20:00,5,66,33,8,133,44,289
2024-03-05 08:30:00,3,68,32,9,115,50,277
2024-03-05 08:40:00,4,49,32,11,85,34,215
2024-03-05 08:50:00,8,59,29,8,103,39,246
2024-03-05 09:00:00,2,52,36,9,69,37,205
2024-03-05 09:10:00,1,42,33,12,59,38,185
2024-03-05 09:20:00,3,65,39,9,85,46,247
2024-03-05 09:30:00,1,40,38,8,58,39,184
2024-03-05 09:40:00,4,37,30,8,58,38,175
2024-03-05 09:50:00,1,41,37,8,50,43,180
2024-03-05 10:00:00,3,37,29,9,37,32,147
2024-03-05 10:10:00,1,31,24,12,41,31,140
2024-03-05 10:20:00,5,45,32,12,63,32,189
2024-03-05 10:30:00,2,32,34,7,40,35,150
2024-03-05 10:40:00,3,35,37,15,42,40,172
2024-03-05 10:50:00,3,36,28,9,39,34,149
2024-03-05 11:00:00,3,34,26,12,55,26,156
2024-03-05 11:10:00,5,40,38,8,47,42,180
2024-03-05 11:20:00,1,25,26,11,35,34,132
2024-03-05 11:30:00,4,35,36,17,48,47,187
2024-03-05 11:40:00,1,18,43,11,27,54,154
2024-03-05 11:50:00,2,39,28,18,55,48,190
2024-03-05 12:00:00,2,33,32,10,40,43,160
2024-03-05 12:10:00,1,18,33,8,24,40,124
2024-03-05 12:20:00,4,25,37,14,37,53,170
2024-03-05 12:30:00,3,25,36,18,31,51,164
2024-03-05 12:40:00,1,35,38,15,45,53,187
2024-03-05 12:50:00,3,51,46,15,60,52,227
2024-03-05 13:00:00,1,35,38,11,41,46,172
2024-03-05 13:10:00,2,26,33,19,34,53,167
2024-03-05 13:20:00,7,29,42,16,47,65,206
2024-03-05 13:30:00,3,20,38,10,41,51,163
2024-03-05 13:40:00,3,26,44,14,33,62,182
2024-03-05 13:50:00,2,35,35,18,50,57,197
2024-03-05 14:00:00,2,34,31,14,36,59,176
2024-03-05 14:10:00,3,25,33,18,39,40,158
2024-03-05 14:20:00,2,28,36,19,29,57,171
2024-03-05 14:30:00,2,34,42,16,65,61,220
2024-03-05 14:40:00,2,35,50,16,41,75,219
2024-03-05 14:50:00,4,24,38,18,36,58,178
2024-03-05 15:00:00,2,37,47,14,53,71,224
2024-03-05 15:10:00,3,31,43,18,36,89,220
2024-03-05 15:20:00,8,12,43,19,35,97,214
2024-03-05 15:30:00,14,5,61,18,26,84,208
2024-03-05 15:40:00,17,1,55,13,20,101,207
2024-03-05 15:50:00,18,0,66,10,23,117,234
2024-03-05 16:00:00,14,3,66,20,25,100,228
2024-03-05 16:10:00,5,31,61,17,57,104,275
2024-03-05 16:20:00,7,27,71,32,41,125,303
2024-03-05 16:30:00,2,32,56,17,45,109,261
2024-03-05 16:40:00,1,42,69,14,46,94,266
2024-03-05 16:50:00,4,38,51,28,45,85,251
2024-03-05 17:00:00,4,39,63,20,44,103,273
2024-03-05 17:10:00,3,29,45,18,64,116,275
2024-03-05 17:20:00,4,33,57,18,48,100,260
2024-03-05 17:30:00,3,42,59,18,56,95,273
2024-03-05 17:40:00,1,34,55,17,43,83,233
2024-03-05 17:50:00,6,35,70,15,44,97,267
2024-03-05 18:00:00,5,36,52,16,38,85,232
2024-03-05 18:10:00,0,31,42,18,46,85,222
2024-03-05 18:20:00,3,49,46,19,40,68,225
2024-03-05 18:30:00,4,60,52,15,35,65,231
2024-03-05 18:40:00,6,48,54,13,37,64,222
2024-03-05 18:50:00,0,59,51,14,34,53,211
2024-03-05 19:00:00,1,46,59,10,27,57,200
2024-03-05 19:10:00,3,47,71,13,32,60,226
2024-03-05 19:20:00,1,41,64,16,29,50,201
2024-03-05 19:30:00,5,37,51,11,22,56,182
2024-03-05 19:40:00,5,40,46,7,29,42,169
2024-03-05 19:50:00,0,28,50,12,21,43,154
2024-03-05 20:00:00,5,37,34,6,24,31,137
2024-03-05 20:10:00,5,34,49,3,20,41,152
2024-03-05 20:20:00,2,32,42,11,18,34,139
2024-03-05 20:30:00,3,25,33,7,16,26,110
2024-03-05 20:40:00,2,31,49,8,16,31,137
2024-03-05 20:50:00,4,30,37,5,20,27,123
2024-03-05 21:00:00,4,25,56,5,13,49,152
2024-03-05 21:10:00,1,40,32,6,21,22,122
2024-03-05 21:20:00,2,23,32,7,14,22,100
2024-03-05 21:30:00,1,17,23,12,8,17,78
2024-03-05 21:40:00,4,16,31,4,9,26,90
2024-03-05 21:50:00,2,18,30,7,9,23,89
2024-03-05 22:00:00,6,12,30,3,7,23,81
2024-03-05 22:10:00,1,15,32,6,9,33,96
2024-03-05 22:20:00,0,28,37,8,16,25,114
2024-03-05 22:30:00,1,15,32,6,11,20,85
2024-03-05 22:40:00,3,10,17,8,8,18,64
2024-03-05 22:50:00,2,19,26,1,9,17,74
2024-03-05 23:00:00,1,2,31,4,1,19,58
2024-03-05 23:10:00,1,12,23,4,9,16,65
2024-03-05 23:20:00,0,14,18,2,9,11,54
2024-03-05 23:30:00,2,18,16,4,9,11,60
2024-03-05 23:40:00,0,6,12,1,3,7,29
2024-03-05 23:50:00,0,10,17,2,5,10,44
2024-03-06 00:00:00,1,6,8,0,6,3,24
2024-03-06 00:10:00,0,3,10,4,2,6,25
2024-03-06 00:20:00,0,10,18,2,6,10,46
2024-03-06 00:30:00,0,4,6,2,2,2,16
2024-03-06 00:40:00,0,9,7,2,4,4,26
2024-03-06 00:50:00,2,12,14,4,6,7,45
2024-03-06 01:00:00,0,5,11,2,3,8,29
2024-03-06 01:10:00,0,4,6,0,2,5,17
2024-03-06 01:20:00,0,5,3,0,3,2,13
2024-03-06 01:30:00,0,0,5,1,0,3,9
2024-03-06 01:40:00,0,6,4,1,3,1,15
2024-03-06 01:50:00,0,0,4,1,0,3,8
2024-03-06 02:00:00,0,0,3,0,0,2,5
2024-03-06 02:10:00,0,6,3,2,3,2,16
2024-03-06 02:20:00,1,2,2,1,3,1,10
2024-03-06 02:30:00,0,1,4,3,1,2,11
2024-03-06 02:40:00,0,0,3,1,0,2,6
2024-03-06 02:50:00,0,4,3,2,2,3,14
2024-03-06 03:00:00,0,2,4,0,1,2,9
2024-03-06 03:10:00,0,1,0,0,1,0,2
2024-03-06 03:20:00,0,1,3,0,1,3,8
2024-03-06 03:30:00,0,4,4,0,2,2,12
2024-03-06 03:40:00,0,4,2,3,2,1,12
2024-03-06 03:50:00,0,7,8,2,4,4,25
2024-03-06 04:00:00,1,3,5,1,2,4,16
2024-03-06 04:10:00,1,3,5,0,3,3,15
2024-03-06 04:20:00,0,19,4,3,11,2,39
2024-03-06 04:30:00,2,15,4,0,8,3,32
2024-03-06 04:40:00,0,7,3,1,5,1,17
2024-03-06 04:50:00,2,16,8,1,8,7,42
2024-03-06 05:00:00,1,26,4,0,15,3,49
2024-03-06 05:10:00,2,24,15,5,14,9,69
2024-03-06 05:20:00,0,51,12,3,35,8,109
2024-03-06 05:30:00,1,47,14,2,32,10,106
2024-03-06 05:40:00,2,77,12,3,52,13,159
2024-03-06 05:50:00,0,29,22,1,16,15,83
2024-03-06 06:00:00,3,93,24,7,62,15,204
2024-03-06 06:10:00,2,75,19,4,56,16,172
2024-03-06 06:20:00,6,65,33,3,41,32,180
2024-03-06 06:30:00,3,121,33,4,85,29,275
2024-03-06 06:40:00,1,87,42,5,70,29,234
2024-03-06 06:50:00,3,69,27,8,80,31,218
2024-03-06 07:00:00,2,70,29,7,93,33,234
2024-03-06 07:10:00,6,67,29,9,117,37,265
2024-03-06 07:20:00,2,58,39,7,124,50,280
2024-03-06 07:30:00,1,56,35,10,102,36,240
2024-03-06 07:40:00,4,31,29,14,146,35,259
2024-03-06 07:50:00,5,54,34,9,135,44,281
2024-03-06 08:00:00,3,57,29,10,114,43,256
2024-03-06 08:10:00,2,53,33,14,92,41,235
2024-03-06 08:20:00,4,48,38,11,111,37,249
2024-03-06 08:30:00,7,58,34,7,105,36,247
2024-03-06 08:40:00,2,47,26,6,74,32,187
2024-03-06 08:50:00,3,51,30,10,110,35,239
2024-03-06 09:00:00,4,60,22,6,90,31,213
2024-03-06 09:10:00,2,48,33,10,58,38,189
2024-03-06 09:20:00,1,25,26,7,46,33,138
2024-03-06 09:30:00,1,49,33,10,83,34,210
2024-03-06 09:40:00,3,34,32,8,47,39,163
2024-03-06 09:50:00,3,34,43,16,59,44,199
2024-03-06 10:00:00,2,28,28,10,32,30,130
2024-03-06 10:10:00,3,36,28,10,46,34,157
2024-03-06 10:20:00,4,17,35,10,36,39,141
2024-03-06 10:30:00,1,42,38,9,54,39,183
2024-03-06 10:40:00,2,29,25,10,46,36,148
2024-03-06 10:50:00,1,25,30,13,43,40,152
2024-03-06 11:00:00,4,38,36,12,48,37,175
2024-03-06 11:10:00,1,30,33,12,32,35,143
2024-03-06 11:20:00,1,38,35,15,52,39,180
2024-03-06 11:30:00,1,28,35,15,36,45,160
2024-03-06 11:40:00,3,35,31,17,53,35,174
2024-03-06 11:50:00,3,27,36,7,33,53,159
2024-03-06 12:00:00,3,32,45,16,48,61,205
2024-03-06 12:10:00,4,29,34,10,41,49,167
2024-03-06 12:20:00,3,33,39,15,41,56,187
2024-03-06 12:30:00,2,24,43,10,42,46,167
2024-03-06 12:40:00,3,33,37,16,47,46,182
2024-03-06 12:50:00,1,36,47,14,49,50,197
2024-03-06 13:00:00,2,26,45,16,34,57,180
2024-03-06 13:10:00,1,26,45,15,42,59,188
2024-03-06 13:20:00,5,40,42,19,45,62,213
2024-03-06 13:30:00,1,35,46,15,44,63,204
2024-03-06 13:40:00,3,36,40,10,49,52,190
2024-03-06 13:50:00,2,33,36,10,48,65,194
2024-03-06 14:00:00,3,33,56,12,44,69,217
2024-03-06 14:10:00,2,35,43,14,49,70,213
2024-03-06 14:20:00,2,34,49,22,36,56,199
2024-03-06 14:30:00,2,29,46,16,40,71,204
2024-03-06 14:40:00,3,40,50,18,53,58,222
2024-03-06 14:50:00,1,35,40,12,49,66,203
2024-03-06 15:00:00,1,29,65,11,35,98,239
2024-03-06 15:10:00,3,29,55,22,50,88,247
2024-03-06 15:20:00,4,38,45,24,49,73,233
2024-03-06 15:30:00,7,29,59,15,42,85,237
2024-03-06 15:40:00,3,35,52,15,47,100,252
2024-03-06 15:50:00,2,37,57,13,52,103,264
2024-03-06 16:00:00,4,33,59,13,53,108,270
2024-03-06 16:10:00,3,40,61,18,68,96,286
2024-03-06 16:20:00,3,31,50,12,44,117,257
2024-03-06 16:30:00,5,46,52,19,53,99,274
2024-03-06 16:40:00,8,42,61,15,62,93,281
2024-03-06 16:50:00,3,35,52,14,40,93,237
2024-03-06 17:00:00,4,41,59,16,49,101,270
2024-03-06 17:10:00,4,40,54,20,59,94,271
2024-03-06 17:20:00,3,35,51,15,40,102,246
2024-03-06 17:30:00,3,40,60,23,57,112,295
2024-03-06 17:40:00,2,27,53,8,43,88,221
2024-03-06 17:50:00,4,26,41,20,33,84,208
2024-03-06 18:00:00,1,26,40,17,47,88,219
2024-03-06 18:10:00,3,34,38,21,49,74,219
2024-03-06 18:20:00,3,36,40,13,56,96,244
2024-03-06 18:30:00,2,61,34,15,45,81,238
2024-03-06 18:40:00,13,50,54,12,31,74,234
2024-03-06 18:50:00,4,58,48,11,36,74,231
2024-03-06 19:00:00,12,47,41,9,34,64,207
2024-03-06 19:10:00,3,43,47,12,33,46,184
2024-03-06 19:20:00,2,31,51,12,21,57,174
2024-03-06 19:30:00,3,48,41,12,33,41,178
2024-03-06 19:40:00,5,38,50,10,20,45,168
2024-03-06 19:50:00,2,45,44,6,28,53,178
2024-03-06 20:00:00,3,28,45,8,20,35,139
2024-03-06 20:10:00,3,43,33,10,24,24,137
2024-03-06 20:20:00,1,27,23,11,13,27,102
2024-03-06 20:30:00,6,32,33,7,25,29,132
2024-03-06 20:40:00,2,20,46,8,14,31,121
2024-03-06 20:50:00,0,24,38,8,20,30,120
2024-03-06 21:00:00,5,21,31,4,13,25,99
2024-03-06 21:10:00,5,30,33,10,16,21,115
2024-03-06 21:20:00,2,38,32,5,22,24,123
2024-03-06 21:30:00,4,28,36,9,16,38,131
2024-03-06 21:40:00,1,16,37,10,9,33,106
2024-03-06 21:50:00,2,19,36,7,11,24,99
2024-03-06 22:00:00,1,21,33,4,12,27,98
2024-03-06 22:10:00,1,31,40,3,17,29,121
2024-03-06 22:20:00,0,14,30,5,7,18,74
2024-03-06 22:30:00,2,14,28,6,8,20,78
2024-03-06 22:40:00,3,7,25,5,4,22,66
2024-03-06 22:50:00,0,16,30,7,8,20,81
2024-03-06 23:00:00,1,13,16,6,7,15,58
2024-03-06 23:10:00,0,10,13,3,6,8,40
2024-03-06 23:20:00,0,20,26,1,12,19,78
2024-03-06 23:30:00,1,18,23,3,9,13,67
2024-03-06 23:40:00,0,13,15,4,8,8,48
2024-03-06 23:50:00,0,3,16,4,2,8,33
2024-03-07 00:00:00,3,8,12,2,5,8,38
2024-03-07 00:10:00,0,4,11,3,2,8,28
2024-03-07 00:20:00,0,4,11,5,2,8,30
2024-03-07 00:30:00,0,0,8,2,0,4,14
2024-03-07 00:40:00,0,6,9,0,3,6,24
2024-03-07 00:50:00,0,8,9,2,4,7,30
2024-03-07 01:00:00,1,0,3,0,0,2,6
2024-03-07 01:10:00,2,2,6,0,1,4,15
2024-03-07 01:20:00,0,3,7,1,1,4,16
2024-03-07 01:30:00,0,2,4,1,2,2,11
2024-03-07 01:40:00,0,3,1,2,2,1,9
2024-03-07 01:50:00,0,3,7,2,2,3,17
2024-03-07 02:00:00,0,2,9,3,1,6,21
2024-03-07 02:10:00,0,3,2,0,2,1,8
2024-03-07 02:20:00,0,2,1,0,1,1,5
2024-03-07 02:30:00,0,4,6,3,3,3,19
2024-03-07 02:40:00,0,2,0,1,1,0,4
2024-03-07 02:50:00,0,3,2,0,2,1,8
2024-03-07 03:00:00,0,3,1,1,2,3,10
2024-03-07 03:10:00,2,0,1,0,0,0,3
2024-03-07 03:20:00,0,3,2,0,2,2,9
2024-03-07 03:30:00,0,4,4,1,2,2,13
2024-03-07 03:40:00,0,4,5,1,2,3,15
2024-03-07 03:50:00,0,7,2,1,4,0,14
2024-03-07 04:00:00,0,4,2,0,3,2,11
2024-03-07 04:10:00,2,7,6,1,4,3,23
2024-03-07 04:20:00,1,7,5,0,4,3,20
2024-03-07 04:30:00,1,6,4,1,3,3,18
2024-03-07 04:40:00,1,12,5,2,6,4,30
2024-03-07 04:50:00,0,20,5,0,12,5,42
2024-03-07 05:00:00,1,23,4,0,16,3,47
2024-03-07 05:10:00,1,30,12,2,17,9,71
2024-03-07 05:20:00,0,32,13,3,20,8,76
2024-03-07 05:30:00,2,60,8,1,33,8,112
2024-03-07 05:40:00,1,73,12,4,53,12,155
2024-03-07 05:50:00,1,54,17,3,43,12,130
2024-03-07 06:00:00,1,64,25,4,38,14,146
2024-03-07 06:10:00,4,89,24,5,60,15,197
2024-03-07 06:20:00,0,81,31,5,54,23,194
2024-03-07 06:30:00,1,95,35,4,71,30,236
2024-03-07 06:40:00,2,69,35,5,76,31,218
2024-03-07 06:50:00,3,66,27,9,99,36,240
2024-03-07 07:00:00,1,50,25,3,79,33,191
2024-03-07 07:10:00,3,75,28,3,107,40,256
2024-03-07 07:20:00,8,53,35,12,131,41,280
2024-03-07 07:30:00,3,75,30,8,108,42,266
2024-03-07 07:40:00,4,63,34,13,133,41,288
2024-03-07 07:50:00,2,62,38,12,109,44,267
2024-03-07 08:00:00,3,66,30,15,156,48,318
2024-03-07 08:10:00,1,52,36,9,109,46,253
2024-03-07 08:20:00,3,52,33,10,82,36,216
2024-03-07 08:30:00,5,68,36,12,118,34,273
2024-03-07 08:40:00,3,61,33,4,92,38,231
2024-03-07 08:50:00,3,38,30,12,86,33,202
2024-03-07 09:00:00,4,38,19,6,68,25,160
2024-03-07 09:10:00,2,62,45,15,79,53,256
2024-03-07 09:20:00,34,17,27,7,16,33,134
2024-03-07 09:30:00,2,49,33,10,78,31,203
2024-03-07 09:40:00,3,57,35,12,70,36,213
2024-03-07 09:50:00,2,43,33,6,53,32,169
2024-03-07 10:00:00,1,39,26,7,47,30,150
2024-03-07 10:10:00,1,38,27,10,55,36,167
2024-03-07 10:20:00,1,33,35,9,39,40,157
2024-03-07 10:30:00,3,39,24,11,54,35,166
2024-03-07 10:40:00,2,33,28,8,42,31,144
2024-03-07 10:50:00,1,34,40,17,53,45,190
2024-03-07 11:00:00,1,26,43,14,32,44,160
2024-03-07 11:10:00,2,33,27,14,45,35,156
2024-03-07 11:20:00,2,41,34,11,52,47,187
2024-03-07 11:30:00,2,32,40,9,38,41,162
2024-03-07 11:40:00,2,35,35,15,39,42,168
2024-03-07 11:50:00,2,37,53,17,57,58,224
2024-03-07 12:00:00,2,38,42,15,49,45,191
2024-03-07 12:10:00,2,40,45,11,41,56,195
2024-03-07 12:20:00,2,49,48,17,49,56,221
2024-03-07 12:30:00,2,38,40,13,54,45,192
2024-03-07 12:40:00,2,54,43,13,58,67,237
2024-03-07 12:50:00,3,43,42,13,51,58,210
2024-03-07 13:00:00,3,19,32,13,25,55,147
2024-03-07 13:10:00,2,27,47,11,31,62,180
2024-03-07 13:20:00,4,30,45,14,45,46,184
2024-03-07 13:30:00,3,37,58,13,43,66,220
2024-03-07 13:40:00,1,31,38,14,43,39,166
2024-03-07 13:50:00,2,43,42,14,54,56,211
2024-03-07 14:00:00,2,18,45,21,26,55,167
2024-03-07 14:10:00,3,39,55,8,46,79,230
2024-03-07 14:20:00,4,42,64,9,51,79,249
2024-03-07 14:30:00,3,30,58,21,49,70,231
2024-03-07 14:40:00,3,31,60,13,48,76,231
2024-03-07 14:50:00,2,60,68,14,67,76,287
2024-03-07 15:00:00,5,48,68,18,49,95,283
2024-03-07 15:10:00,3,38,65,12,48,90,256
2024-03-07 15:20:00,2,37,64,13,44,106,266
2024-03-07 15:30:00,6,41,60,24,66,94,291
2024-03-07 15:40:00,1,34,49,12,47,92,235
2024-03-07 15:50:00,4,29,73,13,43,117,279
2024-03-07 16:00:00,4,43,55,16,43,92,253
2024-03-07 16:10:00,4,35,60,16,50,118,283
2024-03-07 16:20:00,4,39,52,13,57,106,271
2024-03-07 16:30:00,4,38,81,16,55,124,318
2024-03-07 16:40:00,3,31,60,16,63,105,278
2024-03-07 16:50:00,2,53,66,19,58,103,301
2024-03-07 17:00:00,4,43,49,28,62,109,295
2024-03-07 17:10:00,2,35,55,26,50,92,260
2024-03-07 17:20:00,2,35,65,21,53,113,289
2024-03-07 17:30:00,5,49,56,19,62,87,278
2024-03-07 17:40:00,2,36,64,17,54,96,269
2024-03-07 17:50:00,2,29,57,18,36,89,231
2024-03-07 18:00:00,5,48,44,13,60,87,257
2024-03-07 18:10:00,5,28,40,14,38,82,207
2024-03-07 18:20:00,4,39,28,20,46,91,228
2024-03-07 18:30:00,3,60,41,18,38,70,230
2024-03-07 18:40:00,7,74,50,11,44,78,264
2024-03-07 18:50:00,9,38,71,17,27,73,235
2024-03-07 19:00:00,3,45,49,14,33,54,198
2024-03-07 19:10:00,4,58,58,17,35,53,225
2024-03-07 19:20:00,0,53,51,10,32,63,209
2024-03-07 19:30:00,8,41,41,9,25,48,172
2024-03-07 19:40:00,0,45,41,8,27,29,150
2024-03-07 19:50:00,5,34,54,11,19,50,173
2024-03-07 20:00:00,6,24,46,17,12,33,138
2024-03-07 20:10:00,0,33,51,13,21,53,171
2024-03-07 20:20:00,4,21,38,7,10,34,114
2024-03-07 20:30:00,5,36,31,8,23,25,128
2024-03-07 20:40:00,1,28,41,6,18,28,122
2024-03-07 20:50:00,3,26,35,8,17,27,116
2024-03-07 21:00:00,1,20,39,7,12,32,111
2024-03-07 21:10:00,3,29,44,6,16,31,129
2024-03-07 21:20:00,0,16,34,7,11,26,94
2024-03-07 21:30:00,4,35,29,5,18,22,113
2024-03-07 21:40:00,3,26,36,7,13,27,112
2024-03-07 21:50:00,1,19,41,13,11,25,110
2024-03-07 22:00:00,1,10,34,5,6,23,79
2024-03-07 22:10:00,3,27,24,6,17,20,97
2024-03-07 22:20:00,0,34,35,8,24,23,124
2024-03-07 22:30:00,3,10,36,9,5,24,87
2024-03-07 22:40:00,1,19,39,4,10,28,101
2024-03-07 22:50:00,0,9,16,4,4,14,47
2024-03-07 23:00:00,1,11,19,2,5,15,53
2024-03-07 23:10:00,0,23,14,4,14,13,68
2024-03-07 23:20:00,1,6,22,4,4,14,51
2024-03-07 23:30:00,2,11,11,5,8,7,44
2024-03-07 23:40:00,1,12,11,4,7,6,41
2024-03-07 23:50:00,1,4,15,1,3,10,34
2024-03-08 00:00:00,2,7,17,5,3,9,43
2024-03-08 00:10:00,0,8,13,3,4,5,33
2024-03-08 00:20:00,0,4,15,1,3,11,34
2024-03-08 00:30:00,0,7,8,4,5,5,29
2024-03-08 00:40:00,0,6,10,2,4,7,29
2024-03-08 00:50:00,0,3,9,0,1,8,21
2024-03-08 01:00:00,0,0,11,2,0,5,18
2024-03-08 01:10:00,0,6,7,0,3,5,21
2024-03-08 01:20:00,0,3,6,1,2,3,15
2024-03-08 01:30:00,0,2,5,0,1,3,11
2024-03-08 01:40:00,0,5,5,4,3,4,21
2024-03-08 01:50:00,0,0,4,0,0,3,7
2024-03-08 02:00:00,0,0,4,1,0,2,7
2024-03-08 02:10:00,0,0,4,3,0,2,9
2024-03-08 02:20:00,0,2,9,0,1,5,17
2024-03-08 02:30:00,0,3,0,0,2,0,5
2024-03-08 02:40:00,0,0,5,2,0,2,9
2024-03-08 02:50:00,0,7,1,1,6,1,16
2024-03-08 03:00:00,0,1,9,0,1,5,16
2024-03-08 03:10:00,0,3,4,0,2,2,11
2024-03-08 03:20:00,0,0,3,1,0,2,6
2024-03-08 03:30:00,0,2,2,1,1,1,7
2024-03-08 03:40:00,0,2,9,2,1,5,19
2024-03-08 03:50:00,0,3,1,0,2,1,7
2024-03-08 04:00:00,1,7,6,1,5,4,24
2024-03-08 04:10:00,2,8,3,0,4,3,20
2024-03-08 04:20:00,0,11,2,0,6,1,20
2024-03-08 04:30:00,1,8,3,0,7,2,21
2024-03-08 04:40:00,0,6,4,2,3,3,18
2024-03-08 04:50:00,0,15,9,0,8,7,39
2024-03-08 05:00:00,1,26,1,1,17,2,48
2024-03-08 05:10:00,2,26,9,2,16,6,61
2024-03-08 05:20:00,0,48,12,2,29,8,99
2024-03-08 05:30:00,1,63,8,3,37,6,118
2024-03-08 05:40:00,1,55,6,1,35,9,107
2024-03-08 05:50:00,2,46,19,4,33,13,117
2024-03-08 06:00:00,2,44,16,4,28,10,104
2024-03-08 06:10:00,4,61,15,3,38,14,135
2024-03-08 06:20:00,1,84,29,3,47,27,191
2024-03-08 06:30:00,2,68,26,1,63,23,183
2024-03-08 06:40:00,5,55,32,10,64,35,201
2024-03-08 06:50:00,2,45,25,3,81,29,185
2024-03-08 07:00:00,2,54,28,5,86,38,213
2024-03-08 07:10:00,7,69,22,10,100,30,238
2024-03-08 07:20:00,3,59,29,6,90,33,220
2024-03-08 07:30:00,6,61,19,7,72,26,191
2024-03-08 07:40:00,5,81,47,13,131,59,336
2024-03-08 07:50:00,2,94,41,10,114,54,315
2024-03-08 08:00:00,6,38,32,17,61,41,195
2024-03-08 08:10:00,3,45,32,13,58,33,184
2024-03-08 08:20:00,4,41,29,12,73,35,194
2024-03-08 08:30:00,3,41,25,6,75,30,180
2024-03-08 08:40:00,3,42,33,11,65,35,189
2024-03-08 08:50:00,1,49,33,13,66,39,201
2024-03-08 09:00:00,5,46,32,7,55,39,184
2024-03-08 09:10:00,2,41,36,8,57,44,188
2024-03-08 09:20:00,2,50,38,9,58,33,190
2024-03-08 09:30:00,3,54,27,8,53,37,182
2024-03-08 09:40:00,4,45,37,9,53,47,195
2024-03-08 09:50:00,2,26,36,14,49,40,167
2024-03-08 10:00:00,7,37,36,16,43,43,182
2024-03-08 10:10:00,3,44,36,13,45,36,177
2024-03-08 10:20:00,2,41,23,14,44,28,152
2024-03-08 10:30:00,1,43,35,12,58,44,193
2024-03-08 10:40:00,2,46,36,15,54,52,205
2024-03-08 10:50:00,1,43,33,15,57,43,192
2024-03-08 11:00:00,3,38,32,9,47,34,163
2024-03-08 11:10:00,1,29,32,13,43,37,155
2024-03-08 11:20:00,2,37,36,9,53,44,181
2024-03-08 11:30:00,2,29,52,16,38,56,193
2024-03-08 11:40:00,3,27,46,14,42,57,189
2024-03-08 11:50:00,3,34,40,11,43,50,181
2024-03-08 12:00:00,3,35,46,19,38,61,202
2024-03-08 12:10:00,2,41,39,19,48,55,204
2024-03-08 12:20:00,1,47,47,12,50,63,220
2024-03-08 12:30:00,1,37,53,15,58,75,239
2024-03-08 12:40:00,2,45,36,19,44,62,208
2024-03-08 12:50:00,2,45,60,21,67,70,265
2024-03-08 13:00:00,4,49,47,13,66,80,259
2024-03-08 13:10:00,9,47,62,14,48,83,263
2024-03-08 13:20:00,3,37,65,15,47,70,237
2024-03-08 13:30:00,4,46,61,14,60,63,248
2024-03-08 13:40:00,6,52,55,13,75,62,263
2024-03-08 13:50:00,3,31,61,24,46,85,250
2024-03-08 14:00:00,5,46,70,17,53,94,285
2024-03-08 14:10:00,3,28,59,18,31,92,231
2024-03-08 14:20:00,3,55,64,21,67,101,311
2024-03-08 14:30:00,4,63,73,19,67,98,324
2024-03-08 14:40:00,3,48,70,17,51,83,272
2024-03-08 14:50:00,4,32,60,23,37,78,234
2024-03-08 15:00:00,1,43,66,13,67,99,289
2024-03-08 15:10:00,2,48,44,11,52,78,235
2024-03-08 15:20:00,4,51,75,12,58,112,312
2024-03-08 15:30:00,3,40,56,9,62,94,264
2024-03-08 15:40:00,2,40,59,6,46,95,248
2024-03-08 15:50:00,6,52,65,15,61,97,296
2024-03-08 16:00:00,4,57,43,7,49,83,243
2024-03-08 16:10:00,4,45,47,11,49,96,252
2024-03-08 16:20:00,4,60,38,8,67,88,265
2024-03-08 16:30:00,2,41,32,10,54,89,228
2024-03-08 16:40:00,5,43,37,6,52,80,223
2024-03-08 16:50:00,2,51,33,12,45,80,223
2024-03-08 17:00:00,4,40,35,6,57,93,235
2024-03-08 17:10:00,5,48,20,7,51,93,224
2024-03-08 17:20:00,2,40,14,0,31,105,192
2024-03-08 17:30:00,2,68,19,7,59,88,243
2024-03-08 17:40:00,1,55,26,7,59,65,213
2024-03-08 17:50:00,3,46,61,5,51,90,256
2024-03-08 18:00:00,3,41,53,11,64,78,250
2024-03-08 18:10:00,6,53,46,18,63,90,276
2024-03-08 18:20:00,1,52,49,18,52,91,263
2024-03-08 18:30:00,1,58,44,14,54,71,242
2024-03-08 18:40:00,5,75,46,14,53,70,263
2024-03-08 18:50:00,7,74,44,14,51,85,275
2024-03-08 19:00:00,5,71,54,14,44,56,244
2024-03-08 19:10:00,7,42,61,18,25,62,215
2024-03-08 19:20:00,2,50,47,13,31,53,196
2024-03-08 19:30:00,8,60,52,16,34,50,220
2024-03-08 19:40:00,1,37,42,9,26,49,164
2024-03-08 19:50:00,2,54,66,15,30,51,218
2024-03-08 20:00:00,5,61,41,7,37,33,184
2024-03-08 20:10:00,3,35,56,16,19,50,179
2024-03-08 20:20:00,0,43,50,11,26,43,173
2024-03-08 20:30:00,3,29,33,7,19,27,118
2024-03-08 20:40:00,1,27,32,12,16,25,113
2024-03-08 20:50:00,0,29,35,13,18,30,125
2024-03-08 21:00:00,1,33,43,8,23,32,140
2024-03-08 21:10:00,1,18,44,7,13,37,120
2024-03-08 21:20:00,2,26,22,10,14,19,93
2024-03-08 21:30:00,1,37,48,4,18,40,148
2024-03-08 21:40:00,1,25,31,8,14,23,102
2024-03-08 21:50:00,2,34,24,6,19,27,112
2024-03-08 22:00:00,2,17,38,3,12,30,102
2024-03-08 22:10:00,0,28,37,13,18,30,126
2024-03-08 22:20:00,2,32,31,5,22,24,116
2024-03-08 22:30:00,1,32,39,5,19,34,130
2024-03-08 22:40:00,5,27,43,9,16,36,136
2024-03-08 22:50:00,1,29,23,10,17,18,98
2024-03-08 23:00:00,1,23,42,8,14,31,119
2024-03-08 23:10:00,3,13,33,8,8,25,90
2024-03-08 23:20:00,2,21,36,5,11,24,99
2024-03-08 23:30:00,1,33,31,7,18,31,121
2024-03-08 23:40:00,2,22,21,7,13,13,78
2024-03-08 23:50:00,0,16,17,4,8,12,57
2024-03-09 00:00:00,3,32,30,3,17,23,108
2024-03-09 00:10:00,0,7,18,6,4,12,47
2024-03-09 00:20:00,2,13,12,3,7,7,44
2024-03-09 00:30:00,0,18,8,3,9,10,48
2024-03-09 00:40:00,2,11,8,2,6,5,34
2024-03-09 00:50:00,0,9,15,2,5,10,41
2024-03-09 01:00:00,1,23,17,2,14,12,69
2024-03-09 01:10:00,0,8,14,3,4,9,38
2024-03-09 01:20:00,0,8,13,6,4,6,37
2024-03-09 01:30:00,0,6,14,3,3,5,31
2024-03-09 01:40:00,1,9,9,1,5,7,32
2024-03-09 01:50:00,0,2,8,1,1,5,17
2024-03-09 02:00:00,4,6,2,3,3,2,20
2024-03-09 02:10:00,0,5,13,6,4,11,39
2024-03-09 02:20:00,0,8,11,3,4,5,31
2024-03-09 02:30:00,0,8,3,2,4,2,19
2024-03-09 02:40:00,0,3,9,2,2,6,22
2024-03-09 02:50:00,1,5,6,1,4,5,22
2024-03-09 03:00:00,0,7,4,1,4,2,18
2024-03-09 03:10:00,0,14,8,0,8,3,33
2024-03-09 03:20:00,0,7,6,1,4,4,22
2024-03-09 03:30:00,0,4,8,1,2,7,22
2024-03-09 03:40:00,0,6,8,0,4,6,24
2024-03-09 03:50:00,0,5,1,1,3,2,12
2024-03-09 04:00:00,0,4,4,0,2,2,12
2024-03-09 04:10:00,2,0,3,0,0,3,8
2024-03-09 04:20:00,1,0,9,2,0,7,19
2024-03-09 04:30:00,0,7,3,0,4,1,15
2024-03-09 04:40:00,0,5,8,1,3,3,20
2024-03-09 04:50:00,1,6,3,0,5,3,18
2024-03-09 05:00:00,0,14,5,0,8,3,30
2024-03-09 05:10:00,1,7,12,1,4,6,31
2024-03-09 05:20:00,1,17,7,1,10,6,42
2024-03-09 05:30:00,0,5,3,0,4,2,14
2024-03-09 05:40:00,2,7,12,3,4,6,34
2024-03-09 05:50:00,1,13,18,4,7,10,53
2024-03-09 06:00:00,0,6,9,2,4,5,26
2024-03-09 06:10:00,2,19,6,3,11,2,43
2024-03-09 06:20:00,1,19,10,3,12,6,51
2024-03-09 06:30:00,0,15,9,4,12,6,46
2024-03-09 06:40:00,2,16,12,4,16,9,59
2024-03-09 06:50:00,1,11,8,5,10,9,44
2024-03-09 07:00:00,0,15,6,2,17,6,46
2024-03-09 07:10:00,2,19,10,0,18,9,58
2024-03-09 07:20:00,2,23,16,3,22,12,78
2024-03-09 07:30:00,0,14,18,1,14,13,60
2024-03-09 07:40:00,3,27,13,4,29,18,94
2024-03-09 07:50:00,1,21,11,2,23,13,71
2024-03-09 08:00:00,0,17,18,7,17,17,76
2024-03-09 08:10:00,3,21,15,4,20,17,80
2024-03-09 08:20:00,3,22,24,5,26,22,102
2024-03-09 08:30:00,0,25,22,4,28,28,107
2024-03-09 08:40:00,2,28,32,7,36,36,141
2024-03-09 08:50:00,3,33,24,8,39,24,131
2024-03-09 09:00:00,2,28,31,6,34,38,139
2024-03-09 09:10:00,1,39,30,6,45,28,149
2024-03-09 09:20:00,1,52,27,7,54,31,172
2024-03-09 09:30:00,0,37,25,5,46,25,138
2024-03-09 09:40:00,4,58,35,13,67,35,212
2024-03-09 09:50:00,3,57,37,16,63,37,213
2024-03-09 10:00:00,3,76,27,10,65,28,209
2024-03-09 10:10:00,2,57,26,7,56,35,183
2024-03-09 10:20:00,3,38,34,16,39,34,164
2024-03-09 10:30:00,3,47,32,18,60,37,197
2024-03-09 10:40:00,4,44,35,9,54,41,187
2024-03-09 10:50:00,7,42,32,11,59,37,188
2024-03-09 11:00:00,7,35,29,9,48,32,160
2024-03-09 11:10:00,1,50,42,14,58,54,219
2024-03-09 11:20:00,4,49,31,17,68,42,211
2024-03-09 11:30:00,0,51,43,7,56,46,203
2024-03-09 11:40:00,6,39,41,16,43,61,206
2024-03-09 11:50:00,4,47,41,18,53,65,228
2024-03-09 12:00:00,0,54,40,13,54,55,216
2024-03-09 12:10:00,1,39,42,12,53,49,196
2024-03-09 12:20:00,4,39,36,15,47,57,198
2024-03-09 12:30:00,3,38,33,13,48,50,185
2024-03-09 12:40:00,5,62,48,16,65,57,253
2024-03-09 12:50:00,3,41,36,15,58,51,204
2024-03-09 13:00:00,4,44,47,10,52,68,225
2024-03-09 13:10:00,7,40,36,17,50,51,201
2024-03-09 13:20:00,4,50,43,12,55,51,215
2024-03-09 13:30:00,2,45,45,9,50,68,219
2024-03-09 13:40:00,1,49,58,14,64,62,248
2024-03-09 13:50:00,1,46,60,17,60,71,255
2024-03-09 14:00:00,3,41,49,7,45,62,207
2024-03-09 14:10:00,3,49,44,17,51,54,218
2024-03-09 14:20:00,2,29,40,13,42,55,181
2024-03-09 14:30:00,6,35,47,12,45,62,207
2024-03-09 14:40:00,2,57,50,14,68,59,250
2024-03-09 14:50:00,5,25,56,17,49,57,209
2024-03-09 15:00:00,5,43,50,8,55,64,225
2024-03-09 15:10:00,1,47,40,17,50,51,206
2024-03-09 15:20:00,5,36,43,11,60,59,214
2024-03-09 15:30:00,1,40,46,15,51,60,213
2024-03-09 15:40:00,2,44,50,13,48,56,213
2024-03-09 15:50:00,1,19,56,6,25,75,182
2024-03-09 16:00:00,1,32,39,15,33,58,178
2024-03-09 16:10:00,5,39,43,12,48,54,201
2024-03-09 16:20:00,3,33,38,8,37,54,173
2024-03-09 16:30:00,5,35,41,13,48,49,191
2024-03-09 16:40:00,3,35,45,14,48,52,197
2024-03-09 16:50:00,5,43,44,15,58,57,222
2024-03-09 17:00:00,2,17,47,16,34,63,179
2024-03-09 17:10:00,2,31,60,5,48,78,224
2024-03-09 17:20:00,4,36,42,13,53,68,216
2024-03-09 17:30:00,6,32,35,11,44,43,171
2024-03-09 17:40:00,5,35,43,19,44,66,212
2024-03-09 17:50:00,4,36,43,12,48,67,210
2024-03-09 18:00:00,3,41,36,16,50,53,199
2024-03-09 18:10:00,5,39,42,19,53,49,207
2024-03-09 18:20:00,5,21,32,12,30,42,142
2024-03-09 18:30:00,2,55,34,10,52,41,194
2024-03-09 18:40:00,4,62,43,14,36,52,211
2024-03-09 18:50:00,4,52,40,15,34,50,195
2024-03-09 19:00:00,2,40,40,9,39,39,169
2024-03-09 19:10:00,3,37,48,11,33,42,174
2024-03-09 19:20:00,3,49,39,10,33,42,176
2024-03-09 19:30:00,1,41,37,10,22,30,141
2024-03-09 19:40:00,3,29,43,11,18,42,146
2024-03-09 19:50:00,1,37,45,12,23,37,155
2024-03-09 20:00:00,8,40,46,6,24,43,167
2024-03-09 20:10:00,1,44,29,10,28,33,145
2024-03-09 20:20:00,1,25,34,11,16,31,118
2024-03-09 20:30:00,0,32,29,14,17,28,120
2024-03-09 20:40:00,3,37,35,10,22,30,137
2024-03-09 20:50:00,3,34,38,10,18,33,136
2024-03-09 21:00:00,2,16,24,6,10,16,74
2024-03-09 21:10:00,1,34,37,7,18,28,125
2024-03-09 21:20:00,4,28,28,10,19,15,104
2024-03-09 21:30:00,0,20,32,10,12,27,101
2024-03-09 21:40:00,3,26,13,6,16,12,76
2024-03-09 21:50:00,1,22,29,8,11,23,94
2024-03-09 22:00:00,2,22,16,7,12,25,84
2024-03-09 22:10:00,4,28,27,4,16,17,96
2024-03-09 22:20:00,0,24,35,11,13,29,112
2024-03-09 22:30:00,1,38,38,2,22,28,129
2024-03-09 22:40:00,1,30,20,2,15,11,79
2024-03-09 22:50:00,1,29,20,6,19,21,96
2024-03-09 23:00:00,2,16,20,5,8,20,71
2024-03-09 23:10:00,2,27,39,9,16,27,120
2024-03-09 23:20:00,1,28,20,7,16,16,88
2024-03-09 23:30:00,6,18,27,4,10,16,81
2024-03-09 23:40:00,0,23,24,5,15,12,79
2024-03-09 23:50:00,0,18,29,4,10,24,85
2024-03-10 00:00:00,5,26,27,5,18,23,104
2024-03-10 00:10:00,0,20,9,3,10,15,57
2024-03-10 00:20:00,0,20,25,4,10,16,75
2024-03-10 00:30:00,0,19,16,1,11,11,58
2024-03-10 00:40:00,2,9,18,6,5,12,52
2024-03-10 00:50:00,0,8,15,2,4,8,37
2024-03-10 01:00:00,2,7,10,4,4,11,38
2024-03-10 01:10:00,2,6,16,3,3,11,41
2024-03-10 01:20:00,0,7,19,4,4,11,45
2024-03-10 01:30:00,0,11,13,5,8,10,47
2024-03-10 01:40:00,0,6,8,3,4,5,26
2024-03-10 01:50:00,2,5,13,2,3,8,33
2024-03-10 02:00:00,1,7,10,1,3,8,30
2024-03-10 02:10:00,0,7,3,2,4,4,20
2024-03-10 02:20:00,2,4,11,5,2,5,29
2024-03-10 02:30:00,3,9,8,1,6,3,30
2024-03-10 02:40:00,0,2,14,4,1,6,27
2024-03-10 02:50:00,2,4,7,1,3,5,22
2024-03-10 03:00:00,0,2,6,4,1,3,16
2024-03-10 03:10:00,0,4,4,2,3,2,15
2024-03-10 03:20:00,0,5,2,1,3,1,12
2024-03-10 03:30:00,0,6,7,3,3,6,25
2024-03-10 03:40:00,0,4,9,2,3,5,23
2024-03-10 03:50:00,0,2,3,1,1,1,8
2024-03-10 04:00:00,0,2,8,0,1,4,15
2024-03-10 04:10:00,1,2,4,2,1,2,12
2024-03-10 04:20:00,0,9,5,0,5,3,22
2024-03-10 04:30:00,0,1,4,1,1,2,9
2024-03-10 04:40:00,1,5,4,2,3,2,17
2024-03-10 04:50:00,0,11,0,1,5,0,17
2024-03-10 05:00:00,0,5,9,3,3,5,25
2024-03-10 05:10:00,0,8,3,1,4,2,18
2024-03-10 05:20:00,0,10,6,1,5,4,26
2024-03-10 05:30:00,0,4,4,3,2,1,14
2024-03-10 05:40:00,0,7,4,2,4,1,18
2024-03-10 05:50:00,0,4,10,3,2,2,21
2024-03-10 06:00:00,1,4,9,1,2,7,24
2024-03-10 06:10:00,0,6,4,0,3,3,16
2024-03-10 06:20:00,0,13,5,2,6,4,30
2024-03-10 06:30:00,1,6,8,0,3,5,23
2024-03-10 06:40:00,0,10,10,0,7,8,35
2024-03-10 06:50:00,0,3,9,1,3,10,26
2024-03-10 07:00:00,1,5,4,2,5,3,20
2024-03-10 07:10:00,0,7,6,1,7,6,27
2024-03-10 07:20:00,1,2,6,1,2,5,17
2024-03-10 07:30:00,1,7,8,1,7,9,33
2024-03-10 07:40:00,0,5,12,0,5,11,33
2024-03-10 07:50:00,1,6,16,2,6,17,48
2024-03-10 08:00:00,2,13,14,2,13,16,60
2024-03-10 08:10:00,0,8,15,0,8,18,49
2024-03-10 08:20:00,2,15,16,2,14,16,65
2024-03-10 08:30:00,2,10,8,3,11,11,45
2024-03-10 08:40:00,0,12,15,1,12,15,55
2024-03-10 08:50:00,4,11,19,5,12,22,73
2024-03-10 09:00:00,3,18,15,4,21,17,78
2024-03-10 09:10:00,1,28,18,3,33,26,109
2024-03-10 09:20:00,2,23,19,4,24,18,90
2024-03-10 09:30:00,2,18,23,6,18,24,91
2024-03-10 09:40:00,1,26,16,3,26,17,89
2024-03-10 09:50:00,1,27,22,3,30,25,108
2024-03-10 10:00:00,3,24,16,2,26,19,90
2024-03-10 10:10:00,3,29,14,7,29,18,100
2024-03-10 10:20:00,2,20,24,8,22,30,106
2024-03-10 10:30:00,4,23,20,7,23,22,99
2024-03-10 10:40:00,3,23,26,5,25,26,108
2024-03-10 10:50:00,0,24,20,11,27,20,102
2024-03-10 11:00:00,2,32,36,7,36,33,146
2024-03-10 11:10:00,2,25,25,6,28,28,114
2024-03-10 11:20:00,1,40,28,5,60,33,167
2024-03-10 11:30:00,2,23,29,6,25,32,117
2024-03-10 11:40:00,3,29,38,6,31,40,147
2024-03-10 11:50:00,0,25,25,3,30,27,110
2024-03-10 12:00:00,4,32,34,10,30,43,153
2024-03-10 12:10:00,3,37,40,6,44,52,182
2024-03-10 12:20:00,2,40,40,14,40,42,178
2024-03-10 12:30:00,2,31,35,10,39,39,156
2024-03-10 12:40:00,4,31,28,11,33,35,142
2024-03-10 12:50:00,2,24,27,8,32,35,128
2024-03-10 13:00:00,2,35,26,14,38,29,144
2024-03-10 13:10:00,3,36,32,11,39,40,161
2024-03-10 13:20:00,1,26,34,9,37,36,143
2024-03-10 13:30:00,3,26,30,4,33,35,131
2024-03-10 13:40:00,2,18,45,3,21,55,144
2024-03-10 13:50:00,3,31,36,12,51,31,164
2024-03-10 14:00:00,3,28,31,12,40,51,165
2024-03-10 14:10:00,5,26,28,8,38,39,144
2024-03-10 14:20:00,0,28,35,16,37,47,163
2024-03-10 14:30:00,4,37,29,13,47,48,178
2024-03-10 14:40:00,5,34,39,18,41,45,182
2024-03-10 14:50:00,3,39,36,9,46,45,178
2024-03-10 15:00:00,3,37,27,13,46,38,164
2024-03-10 15:10:00,3,37,29,19,42,35,165
2024-03-10 15:20:00,3,33,41,10,35,46,168
2024-03-10 15:30:00,2,24,41,11,29,49,156
2024-03-10 15:40:00,4,31,34,10,35,46,160
2024-03-10 15:50:00,1,37,29,9,47,37,160
2024-03-10 16:00:00,1,32,30,10,39,37,149
2024-03-10 16:10:00,4,43,38,12,53,46,196
2024-03-10 16:20:00,2,40,28,8,56,38,172
2024-03-10 16:30:00,2,47,35,15,58,42,199
2024-03-10 16:40:00,5,33,35,15,47,45,180
2024-03-10 16:50:00,4,40,37,17,50,40,188
2024-03-10 17:00:00,3,44,38,14,45,47,191
2024-03-10 17:10:00,3,32,28,10,37,38,148
2024-03-10 17:20:00,1,36,33,18,52,46,186
2024-03-10 17:30:00,2,31,29,15,38,45,160
2024-03-10 17:40:00,0,45,35,10,48,52,190
2024-03-10 17:50:00,1,29,35,9,30,48,152
2024-03-10 18:00:00,4,31,35,13,39,36,158
2024-03-10 18:10:00,3,22,24,13,25,36,123
2024-03-10 18:20:00,1,36,20,8,33,30,128
2024-03-10 18:30:00,2,51,43,12,29,29,166
2024-03-10 18:40:00,6,41,19,9,26,28,129
2024-03-10 18:50:00,4,69,30,9,45,29,186
2024-03-10 19:00:00,4,34,39,7,21,42,147
2024-03-10 19:10:00,1,34,33,7,22,33,130
2024-03-10 19:20:00,4,34,30,9,18,26,121
2024-03-10 19:30:00,5,38,34,9,26,27,139
2024-03-10 19:40:00,5,42,25,8,24,19,123
2024-03-10 19:50:00,4,41,31,10,24,22,132
2024-03-10 20:00:00,8,39,32,6,20,26,131
2024-03-10 20:10:00,2,22,34,9,16,26,109
2024-03-10 20:20:00,6,25,25,8,15,21,100
2024-03-10 20:30:00,4,23,27,8,15,21,98
2024-03-10 20:40:00,2,22,27,13,11,29,104
2024-03-10 20:50:00,0,29,26,7,16,20,98
2024-03-10 21:00:00,3,28,40,6,17,28,122
2024-03-10 21:10:00,1,18,35,9,11,19,93
2024-03-10 21:20:00,0,25,34,5,15,21,100
2024-03-10 21:30:00,2,29,32,9,16,19,107
2024-03-10 21:40:00,3,11,19,10,7,12,62
2024-03-10 21:50:00,1,18,26,6,14,16,81
2024-03-10 22:00:00,3,19,37,9,13,19,100
2024-03-10 22:10:00,1,20,24,5,12,17,79
2024-03-10 22:20:00,0,9,22,10,5,20,66
2024-03-10 22:30:00,2,6,16,9,3,13,49
2024-03-10 22:40:00,2,10,13,10,10,16,61
2024-03-10 22:50:00,1,10,9,9,8,8,45
2024-03-10 23:00:00,2,5,5,6,4,9,31
2024-03-10 23:10:00,0,4,13,11,4,18,50
2024-03-10 23:20:00,3,5,12,9,4,15,48
2024-03-10 23:30:00,1,3,5,8,3,4,24
2024-03-10 23:40:00,0,4,7,9,4,7,31
2024-03-10 23:50:00,0,3,8,11,4,7,33
2024-03-11 00:00:00,1,2,3,4,2,3,15
2024-03-11 00:10:00,0,2,3,4,2,3,14
2024-03-11 00:20:00,1,2,7,8,1,4,23
2024-03-11 00:30:00,0,6,2,2,6,3,19
2024-03-11 00:40:00,0,0,6,3,0,4,13
2024-03-11 00:50:00,1,5,5,3,4,3,21
2024-03-11 01:00:00,0,1,9,5,1,6,22
2024-03-11 01:10:00,0,1,1,1,1,1,5
2024-03-11 01:20:00,0,1,3,3,1,3,11
2024-03-11 01:30:00,0,0,1,1,0,1,3
2024-03-11 01:40:00,0,1,2,2,1,2,8
2024-03-11 01:50:00,0,1,0,0,1,0,2
2024-03-11 02:00:00,0,2,2,2,2,2,10
2024-03-11 02:10:00,0,1,2,0,1,2,6
2024-03-11 02:20:00,0,0,1,0,0,1,2
2024-03-11 02:30:00,0,1,1,1,1,2,6
2024-03-11 02:40:00,0,1,2,2,1,1,7
2024-03-11 02:50:00,0,0,0,1,0,0,1
2024-03-11 03:00:00,0,4,1,0,2,0,7
2024-03-11 03:10:00,0,1,2,2,1,2,8
2024-03-11 03:20:00,0,4,5,4,3,4,20
2024-03-11 03:30:00,0,1,0,0,1,0,2
2024-03-11 03:40:00,0,0,3,3,0,2,8
2024-03-11 03:50:00,0,4,2,2,4,0,12
2024-03-11 04:00:00,0,2,3,2,2,2,11
2024-03-11 04:10:00,2,3,2,1,4,3,15
2024-03-11 04:20:00,1,5,5,4,3,4,22
2024-03-11 04:30:00,2,5,7,6,5,5,30
2024-03-11 04:40:00,1,11,3,3,10,3,31
2024-03-11 04:50:00,1,6,1,0,8,1,17
2024-03-11 05:00:00,1,8,7,4,8,5,33
2024-03-11 05:10:00,3,20,9,6,28,11,77
2024-03-11 05:20:00,0,20,9,10,24,10,73
2024-03-11 05:30:00,1,22,10,7,32,9,81
2024-03-11 05:40:00,1,21,8,8,34,8,80
2024-03-11 05:50:00,3,28,18,17,58,15,139
2024-03-11 06:00:00,3,25,16,10,39,14,107
2024-03-11 06:10:00,3,29,12,10,58,14,126
2024-03-11 06:20:00,1,29,19,17,50,28,144
2024-03-11 06:30:00,2,43,18,13,86,31,193
2024-03-11 06:40:00,1,32,23,16,78,24,174
2024-03-11 06:50:00,1,29,26,23,78,42,199
2024-03-11 07:00:00,3,42,27,7,124,35,238
2024-03-11 07:10:00,3,44,32,6,63,41,189
2024-03-11 07:20:00,3,52,27,3,118,44,247
2024-03-11 07:30:00,1,62,37,9,114,37,260
2024-03-11 07:40:00,9,32,32,16,104,47,240
2024-03-11 07:50:00,3,33,33,13,110,29,221
2024-03-11 08:00:00,3,63,28,8,167,39,308
2024-03-11 08:10:00,6,44,37,13,113,47,260
2024-03-11 08:20:00,6,35,32,10,68,37,188
2024-03-11 08:30:00,4,66,31,18,134,49,302
2024-03-11 08:40:00,1,37,31,14,69,38,190
2024-03-11 08:50:00,3,39,34,8,88,36,208
2024-03-11 09:00:00,3,38,30,15,70,39,195
2024-03-11 09:10:00,3,38,32,11,42,41,167
2024-03-11 09:20:00,3,53,24,8,95,31,214
2024-03-11 09:30:00,3,42,31,10,68,31,185
2024-03-11 09:40:00,2,51,24,10,60,24,171
2024-03-11 09:50:00,4,28,31,9,41,29,142
2024-03-11 10:00:00,4,25,32,5,38,46,150
2024-03-11 10:10:00,4,34,26,14,63,32,173
2024-03-11 10:20:00,1,48,29,17,60,31,186
2024-03-11 10:30:00,2,35,24,11,53,33,158
2024-03-11 10:40:00,2,27,28,15,38,40,150
2024-03-11 10:50:00,2,30,25,9,34,23,123
2024-03-11 11:00:00,2,34,34,10,42,30,152
2024-03-11 11:10:00,3,26,25,9,37,39,139
2024-03-11 11:20:00,1,25,33,14,32,34,139
2024-03-11 11:30:00,4,32,45,4,35,43,163
2024-03-11 11:40:00,2,34,34,14,40,52,176
2024-03-11 11:50:00,1,40,30,12,44,41,168
2024-03-11 12:00:00,2,25,31,13,27,42,140
2024-03-11 12:10:00,2,21,29,16,26,49,143
2024-03-11 12:20:00,1,22,40,13,33,52,161
2024-03-11 12:30:00,2,33,42,11,43,53,184
2024-03-11 12:40:00,4,29,31,12,33,38,147
2024-03-11 12:50:00,2,38,37,19,43,56,195
2024-03-11 13:00:00,2,35,42,13,44,60,196
2024-03-11 13:10:00,4,46,34,18,49,64,215
2024-03-11 13:20:00,2,40,42,11,50,50,195
2024-03-11 13:30:00,2,39,37,11,48,39,176
2024-03-11 13:40:00,1,32,44,11,46,57,191
2024-03-11 13:50:00,1,22,33,15,43,44,158
2024-03-11 14:00:00,1,30,42,20,34,60,187
2024-03-11 14:10:00,2,24,45,12,36,59,178
2024-03-11 14:20:00,5,42,39,17,50,64,217
2024-03-11 14:30:00,2,28,63,14,39,81,227
2024-03-11 14:40:00,1,33,48,14,50,76,222
2024-03-11 14:50:00,2,30,42,17,38,61,190
2024-03-11 15:00:00,2,40,50,13,45,67,217
2024-03-11 15:10:00,3,48,52,18,52,65,238
2024-03-11 15:20:00,7,40,69,13,46,86,261
2024-03-11 15:30:00,3,41,40,12,54,81,231
2024-03-11 15:40:00,2,23,49,21,28,78,201
2024-03-11 15:50:00,5,34,49,7,47,86,228
2024-03-11 16:00:00,4,53,29,8,46,90,230
2024-03-11 16:10:00,2,42,73,17,50,104,288
2024-03-11 16:20:00,4,36,71,21,54,95,281
2024-03-11 16:30:00,1,56,74,13,61,107,312
2024-03-11 16:40:00,7,41,72,15,58,105,298
2024-03-11 16:50:00,2,47,68,17,50,90,274
2024-03-11 17:00:00,3,54,6,3,63,95,224
2024-03-11 17:10:00,4,44,52,13,49,105,267
2024-03-11 17:20:00,1,39,55,16,54,98,263
2024-03-11 17:30:00,6,37,49,18,63,107,280
2024-03-11 17:40:00,2,39,61,20,52,99,273
2024-03-11 17:50:00,2,33,55,12,35,85,222
2024-03-11 18:00:00,5,29,61,16,43,89,243
2024-03-11 18:10:00,1,38,41,12,37,76,205
2024-03-11 18:20:00,2,30,57,18,33,85,225
2024-03-11 18:30:00,4,26,41,19,30,57,177
2024-03-11 18:40:00,1,51,37,11,42,50,192
2024-03-11 18:50:00,3,46,62,10,32,45,198
2024-03-11 19:00:00,3,57,58,12,30,54,214
2024-03-11 19:10:00,3,50,54,12,27,45,191
2024-03-11 19:20:00,0,24,54,12,21,59,170
2024-03-11 19:30:00,3,52,33,15,31,31,165
2024-03-11 19:40:00,3,46,40,9,28,46,172
2024-03-11 19:50:00,8,46,33,10,29,24,150
2024-03-11 20:00:00,4,34,28,10,20,24,120
2024-03-11 20:10:00,3,21,47,13,13,34,131
2024-03-11 20:20:00,4,39,33,6,22,37,141
2024-03-11 20:30:00,3,28,36,7,24,26,124
2024-03-11 20:40:00,1,29,34,14,16,27,121
2024-03-11 20:50:00,2,25,25,5,16,18,91
2024-03-11 21:00:00,5,33,25,5,16,21,105
2024-03-11 21:10:00,6,8,45,11,4,33,107
2024-03-11 21:20:00,0,37,32,12,21,30,132
2024-03-11 21:30:00,1,29,24,11,16,15,96
2024-03-11 21:40:00,1,21,31,5,13,25,96
2024-03-11 21:50:00,0,28,24,6,16,18,92
2024-03-11 22:00:00,0,24,23,3,12,22,84
2024-03-11 22:10:00,1,8,23,3,4,17,56
2024-03-11 22:20:00,0,16,30,7,10,25,88
2024-03-11 22:30:00,1,13,21,4,7,18,64
2024-03-11 22:40:00,1,8,15,5,5,13,47
2024-03-11 22:50:00,2,6,9,4,3,5,29
2024-03-11 23:00:00,5,10,25,3,6,14,63
2024-03-11 23:10:00,1,6,10,2,3,9,31
2024-03-11 23:20:00,0,4,13,1,2,12,32
2024-03-11 23:30:00,0,10,8,1,5,9,33
2024-03-11 23:40:00,0,6,13,2,3,8,32
2024-03-11 23:50:00,0,2,11,1,1,8,23
2024-03-12 00:00:00,1,4,19,3,2,10,39
2024-03-12 00:10:00,0,3,4,1,2,4,14
2024-03-12 00:20:00,0,2,8,2,1,8,21
2024-03-12 00:30:00,0,7,10,3,4,9,33
2024-03-12 00:40:00,0,5,3,0,3,2,13
2024-03-12 00:50:00,0,6,5,0,3,1,15
2024-03-12 01:00:00,1,8,5,1,5,3,23
2024-03-12 01:10:00,0,2,4,1,1,2,10
2024-03-12 01:20:00,0,6,7,1,3,4,21
2024-03-12 01:30:00,2,0,5,1,0,4,12
2024-03-12 01:40:00,0,0,3,2,0,0,5
2024-03-12 01:50:00,0,1,0,0,1,0,2
2024-03-12 02:00:00,0,0,5,2,0,4,11
2024-03-12 02:10:00,0,3,2,0,2,1,8
2024-03-12 02:20:00,0,5,1,1,2,1,10
2024-03-12 02:30:00,0,0,1,0,0,1,2
2024-03-12 02:40:00,0,1,1,2,1,1,6
2024-03-12 02:50:00,0,2,6,2,1,2,13
2024-03-12 03:00:00,0,1,1,0,1,0,3
2024-03-12 03:10:00,0,3,2,1,3,1,10
2024-03-12 03:20:00,1,4,2,1,3,1,12
2024-03-12 03:30:00,0,4,4,0,2,2,12
2024-03-12 03:40:00,0,2,5,1,1,3,12
2024-03-12 03:50:00,0,4,1,1,2,2,10
2024-03-12 04:00:00,2,2,3,2,2,2,13
2024-03-12 04:10:00,1,4,4,0,2,4,15
2024-03-12 04:20:00,0,12,6,1,7,3,29
2024-03-12 04:30:00,1,12,2,0,9,1,25
2024-03-12 04:40:00,0,10,4,2,6,4,26
2024-03-12 04:50:00,0,17,5,0,10,4,36
2024-03-12 05:00:00,1,21,7,0,11,5,45
2024-03-12 05:10:00,1,35,9,0,23,8,76
2024-03-12 05:20:00,0,44,12,1,36,8,101
2024-03-12 05:30:00,1,48,8,2,32,5,96
2024-03-12 05:40:00,1,59,15,0,40,14,129
2024-03-12 05:50:00,0,65,20,3,53,16,157
2024-03-12 06:00:00,2,56,22,5,32,18,135
2024-03-12 06:10:00,4,86,20,1,54,13,178
2024-03-12 06:20:00,5,92,37,5,69,37,245
2024-03-12 06:30:00,3,84,28,2,59,24,200
2024-03-12 06:40:00,4,75,26,5,89,28,227
2024-03-12 06:50:00,1,37,17,7,50,31,143
2024-03-12 07:00:00,2,91,31,5,141,40,310
2024-03-12 07:10:00,3,76,30,6,93,41,249
2024-03-12 07:20:00,7,62,31,9,122,39,270
2024-03-12 07:30:00,1,86,39,8,134,43,311
2024-03-12 07:40:00,5,39,37,11,129,48,269
2024-03-12 07:50:00,10,17,30,16,80,35,188
2024-03-12 08:00:00,6,48,35,11,129,49,278
2024-03-12 08:10:00,3,31,38,11,126,56,265
2024-03-12 08:20:00,2,79,33,8,154,39,315
2024-03-12 08:30:00,5,49,26,6,131,45,262
2024-03-12 08:40:00,7,49,27,9,132,48,272
2024-03-12 08:50:00,7,18,38,9,90,52,214
2024-03-12 09:00:00,4,58,37,6,88,45,238
2024-03-12 09:10:00,6,52,39,12,65,33,207
2024-03-12 09:20:00,2,40,32,8,50,42,174
2024-03-12 09:30:00,1,43,22,5,74,34,179
2024-03-12 09:40:00,1,19,37,8,34,44,143
2024-03-12 09:50:00,3,24,27,4,57,26,141
2024-03-12 10:00:00,2,25,24,13,34,37,135
2024-03-12 10:10:00,3,30,32,8,49,45,167
2024-03-12 10:20:00,4,43,26,4,55,30,162
2024-03-12 10:30:00,1,42,30,9,50,31,163
2024-03-12 10:40:00,2,25,33,12,31,42,145
2024-03-12 10:50:00,2,41,35,13,58,35,184
2024-03-12 11:00:00,2,27,32,12,45,33,151
2024-03-12 11:10:00,3,33,38,14,39,47,174
2024-03-12 11:20:00,2,43,32,12,50,43,182
2024-03-12 11:30:00,4,34,40,13,47,52,190
2024-03-12 11:40:00,4,23,34,12,38,40,151
2024-03-12 11:50:00,1,25,33,12,28,48,147
2024-03-12 12:00:00,3,26,34,17,36,48,164
2024-03-12 12:10:00,3,37,38,11,40,53,182
2024-03-12 12:20:00,5,39,22,17,46,32,161
2024-03-12 12:30:00,1,26,41,12,36,59,175
2024-03-12 12:40:00,1,37,38,14,43,53,186
2024-03-12 12:50:00,3,29,34,11,49,46,172
2024-03-12 13:00:00,2,27,43,16,44,57,189
2024-03-12 13:10:00,1,34,43,18,41,48,185
2024-03-12 13:20:00,6,24,23,15,35,58,161
2024-03-12 13:30:00,4,34,42,10,50,48,188
2024-03-12 13:40:00,3,38,35,13,46,61,196
2024-03-12 13:50:00,2,34,38,10,42,53,179
2024-03-12 14:00:00,1,26,39,10,31,67,174
2024-03-12 14:10:00,2,32,32,16,42,62,186
2024-03-12 14:20:00,2,23,35,14,27,79,180
2024-03-12 14:30:00,5,38,49,24,47,69,232
2024-03-12 14:40:00,3,42,52,10,61,89,257
2024-03-12 14:50:00,2,34,66,16,38,80,236
2024-03-12 15:00:00,3,30,41,16,54,65,209
2024-03-12 15:10:00,4,39,45,15,60,83,246
2024-03-12 15:20:00,2,35,47,16,42,75,217
2024-03-12 15:30:00,2,45,57,10,54,80,248
2024-03-12 15:40:00,4,22,54,14,39,104,237
2024-03-12 15:50:00,2,41,49,21,56,102,271
2024-03-12 16:00:00,1,28,47,19,44,99,238
2024-03-12 16:10:00,3,27,66,23,40,106,265
2024-03-12 16:20:00,5,45,36,15,50,116,267
2024-03-12 16:30:00,4,35,50,13,49,119,270
2024-03-12 16:40:00,5,48,64,23,60,98,298
2024-03-12 16:50:00,3,33,49,21,56,101,263
2024-03-12 17:00:00,4,36,67,16,40,110,273
2024-03-12 17:10:00,1,42,58,20,70,131,322
2024-03-12 17:20:00,5,46,49,20,65,106,291
2024-03-12 17:30:00,3,40,51,19,59,116,288
2024-03-12 17:40:00,4,28,39,14,47,91,223
2024-03-12 17:50:00,3,42,48,25,64,87,269
2024-03-12 18:00:00,1,37,32,10,48,86,214
2024-03-12 18:10:00,4,29,52,19,34,90,228
2024-03-12 18:20:00,2,23,39,18,26,89,197
2024-03-12 18:30:00,5,63,70,18,40,82,278
2024-03-12 18:40:00,10,65,50,12,40,55,232
2024-03-12 18:50:00,2,40,39,16,24,47,168
2024-03-12 19:00:00,5,48,52,20,36,47,208
2024-03-12 19:10:00,3,59,38,11,38,45,194
2024-03-12 19:20:00,2,50,43,14,27,51,187
2024-03-12 19:30:00,3,46,48,6,23,43,169
2024-03-12 19:40:00,4,32,31,11,20,34,132
2024-03-12 19:50:00,0,33,42,12,22,37,146
2024-03-12 20:00:00,3,24,25,7,14,29,102
2024-03-12 20:10:00,2,32,27,8,18,27,114
2024-03-12 20:20:00,3,40,24,6,27,28,128
2024-03-12 20:30:00,1,22,33,17,14,37,124
2024-03-12 20:40:00,3,21,20,10,16,34,104
2024-03-12 20:50:00,3,10,20,15,12,25,85
2024-03-12 21:00:00,5,17,21,11,26,26,106
2024-03-12 21:10:00,3,10,22,20,11,25,91
2024-03-12 21:20:00,0,15,18,24,13,29,99
2024-03-12 21:30:00,2,11,21,19,17,24,94
2024-03-12 21:40:00,4,15,15,13,18,18,83
2024-03-12 21:50:00,2,15,22,14,15,29,97
2024-03-12 22:00:00,3,14,18,18,20,20,93
2024-03-12 22:10:00,1,7,14,12,7,19,60
2024-03-12 22:20:00,2,12,12,15,12,22,75
2024-03-12 22:30:00,3,6,13,12,7,17,58
2024-03-12 22:40:00,3,9,11,9,10,16,58
2024-03-12 22:50:00,1,3,14,11,6,17,52
2024-03-12 23:00:00,1,5,8,7,6,15,42
2024-03-12 23:10:00,1,4,11,9,3,10,38
2024-03-12 23:20:00,4,1,15,10,2,11,43
2024-03-12 23:30:00,1,4,3,6,6,6,26
2024-03-12 23:40:00,0,2,7,5,2,8,24
2024-03-12 23:50:00,0,3,5,3,3,7,21
2024-03-13 00:00:00,1,2,6,5,2,5,21
2024-03-13 00:10:00,0,1,7,6,1,6,21
2024-03-13 00:20:00,1,4,8,5,4,5,27
2024-03-13 00:30:00,0,4,3,2,4,4,17
2024-03-13 00:40:00,0,2,3,1,2,3,11
2024-03-13 00:50:00,1,4,5,5,3,5,23
2024-03-13 01:00:00,0,2,1,3,2,1,9
2024-03-13 01:10:00,0,1,3,2,1,1,8
2024-03-13 01:20:00,0,0,2,2,0,3,7
2024-03-13 01:30:00,0,2,4,3,2,5,16
2024-03-13 01:40:00,0,1,3,1,1,3,9
2024-03-13 01:50:00,0,1,4,3,1,3,12
2024-03-13 02:00:00,0,3,4,6,3,4,20
2024-03-13 02:10:00,1,2,2,2,2,2,11
2024-03-13 02:20:00,0,1,1,0,2,1,5
2024-03-13 02:30:00,0,1,3,3,1,3,11
2024-03-13 02:40:00,0,0,3,2,0,2,7
2024-03-13 02:50:00,2,1,3,4,1,4,15
2024-03-13 03:00:00,0,2,0,0,1,0,3
2024-03-13 03:10:00,0,1,1,2,1,1,6
2024-03-13 03:20:00,0,3,3,3,3,2,14
2024-03-13 03:30:00,0,0,3,1,0,2,6
2024-03-13 03:40:00,1,1,1,2,1,1,7
2024-03-13 03:50:00,1,3,3,3,3,3,16
2024-03-13 04:00:00,0,2,6,3,2,5,18
2024-03-13 04:10:00,1,2,5,1,3,3,15
2024-03-13 04:20:00,1,6,4,2,5,4,22
2024-03-13 04:30:00,2,6,1,2,7,1,19
2024-03-13 04:40:00,0,5,3,1,6,2,17
2024-03-13 04:50:00,4,8,4,1,11,3,31
2024-03-13 05:00:00,2,15,3,3,14,3,40
2024-03-13 05:10:00,2,23,8,1,30,8,72
2024-03-13 05:20:00,6,24,9,7,28,9,83
2024-03-13 05:30:00,12,21,15,3,25,11,87
2024-03-13 05:40:00,5,35,9,6,47,9,111
2024-03-13 05:50:00,8,33,14,9,47,19,130
2024-03-13 06:00:00,8,26,16,9,32,13,104
2024-03-13 06:10:00,4,31,21,9,44,19,128
2024-03-13 06:20:00,2,34,20,7,63,25,151
2024-03-13 06:30:00,4,69,23,11,94,27,228
2024-03-13 06:40:00,2,45,22,11,75,27,182
2024-03-13 06:50:00,2,51,23,9,93,37,215
2024-03-13 07:00:00,1,49,25,12,96,33,216
2024-03-13 07:10:00,5,68,30,10,118,30,261
2024-03-13 07:20:00,2,49,27,11,133,36,258
2024-03-13 07:30:00,2,34,30,11,89,41,207
2024-03-13 07:40:00,3,59,30,9,134,39,274
2024-03-13 07:50:00,1,82,31,10,152,47,323
2024-03-13 08:00:00,5,50,28,10,117,50,260
2024-03-13 08:10:00,4,43,30,15,104,45,241
2024-03-13 08:20:00,3,64,27,12,133,42,281
2024-03-13 08:30:00,3,55,33,13,83,51,238
2024-03-13 08:40:00,3,43,27,8,80,39,200
2024-03-13 08:50:00,2,62,29,14,103,33,243
2024-03-13 09:00:00,2,49,32,5,61,33,182
2024-03-13 09:10:00,2,36,37,6,59,52,192
2024-03-13 09:20:00,4,55,32,9,77,35,212
2024-03-13 09:30:00,3,41,39,13,64,36,196
2024-03-13 09:40:00,2,48,34,8,81,34,207
2024-03-13 09:50:00,2,45,33,11,53,43,187
2024-03-13 10:00:00,1,35,24,7,40,27,134
2024-03-13 10:10:00,1,26,25,9,28,36,125
2024-03-13 10:20:00,2,34,33,11,54,39,173
2024-03-13 10:30:00,1,28,24,8,36,40,137
2024-03-13 10:40:00,2,34,29,11,45,39,160
2024-03-13 10:50:00,2,39,30,12,48,41,172
2024-03-13 11:00:00,4,32,28,8,42,35,149
2024-03-13 11:10:00,1,41,28,12,47,34,163
2024-03-13 11:20:00,3,28,29,6,41,43,150
2024-03-13 11:30:00,3,38,36,12,50,49,188
2024-03-13 11:40:00,3,31,39,9,45,49,176
2024-03-13 11:50:00,1,28,32,13,42,38,154
2024-03-13 12:00:00,2,28,41,11,33,47,162
2024-03-13 12:10:00,2,31,31,13,38,44,159
2024-03-13 12:20:00,3,35,35,16,39,53,181
2024-03-13 12:30:00,4,22,36,12,39,60,173
2024-03-13 12:40:00,2,26,30,15,43,38,154
2024-03-13 12:50:00,4,27,30,10,39,48,158
2024-03-13 13:00:00,2,30,43,15,48,62,200
2024-03-13 13:10:00,5,28,41,15,36,58,183
2024-03-13 13:20:00,7,24,36,12,36,44,159
2024-03-13 13:30:00,1,42,37,8,59,52,199
2024-03-13 13:40:00,2,36,41,18,52,49,198
2024-03-13 13:50:00,2,30,31,12,58,50,183
2024-03-13 14:00:00,1,33,39,16,49,62,200
2024-03-13 14:10:00,0,28,29,17,36,61,171
2024-03-13 14:20:00,1,33,55,18,43,71,221
2024-03-13 14:30:00,3,50,40,16,50,71,230
2024-03-13 14:40:00,1,27,53,17,29,75,202
2024-03-13 14:50:00,4,37,49,17,44,85,236
2024-03-13 15:00:00,2,36,50,13,42,78,221
2024-03-13 15:10:00,3,32,49,11,46,91,232
2024-03-13 15:20:00,5,33,40,16,43,96,233
2024-03-13 15:30:00,3,33,42,16,56,73,223
2024-03-13 15:40:00,2,24,52,12,39,104,233
2024-03-13 15:50:00,1,30,77,13,41,100,262
2024-03-13 16:00:00,3,41,44,17,52,96,253
2024-03-13 16:10:00,9,43,51,15,54,93,265
2024-03-13 16:20:00,1,27,56,19,39,109,251
2024-03-13 16:30:00,2,36,44,9,59,94,244
2024-03-13 16:40:00,1,33,48,14,47,120,263
2024-03-13 16:50:00,4,24,60,18,41,116,263
2024-03-13 17:00:00,1,43,72,22,49,98,285
2024-03-13 17:10:00,1,41,61,13,52,110,278
2024-03-13 17:20:00,6,26,39,15,50,113,249
2024-03-13 17:30:00,0,43,71,17,67,109,307
2024-03-13 17:40:00,3,32,50,20,42,87,234
2024-03-13 17:50:00,3,21,42,17,42,81,206
2024-03-13 18:00:00,3,31,44,18,50,94,240
2024-03-13 18:10:00,2,22,33,14,28,93,192
2024-03-13 18:20:00,6,20,33,18,24,102,203
2024-03-13 18:30:00,6,44,35,19,40,68,212
2024-03-13 18:40:00,3,46,49,13,27,61,199
2024-03-13 18:50:00,2,40,55,14,27,62,200
2024-03-13 19:00:00,3,50,45,7,27,36,168
2024-03-13 19:10:00,7,58,50,11,30,54,210
2024-03-13 19:20:00,4,43,42,11,25,46,171
2024-03-13 19:30:00,5,65,50,11,37,47,215
2024-03-13 19:40:00,1,43,37,7,24,39,151
2024-03-13 19:50:00,2,63,49,12,38,35,199
2024-03-13 20:00:00,4,45,36,10,24,32,151
2024-03-13 20:10:00,1,48,36,6,28,27,146
2024-03-13 20:20:00,2,28,36,4,15,28,113
2024-03-13 20:30:00,5,34,28,5,20,27,119
2024-03-13 20:40:00,3,20,27,10,13,17,90
2024-03-13 20:50:00,3,35,28,8,20,26,120
2024-03-13 21:00:00,1,34,25,14,21,17,112
2024-03-13 21:10:00,3,23,30,7,16,33,112
2024-03-13 21:20:00,0,21,41,11,11,30,114
2024-03-13 21:30:00,1,18,31,7,9,24,90
2024-03-13 21:40:00,1,24,38,4,13,28,108
2024-03-13 21:50:00,1,27,27,8,16,16,95
2024-03-13 22:00:00,1,27,17,7,15,17,84
2024-03-13 22:10:00,1,15,33,7,7,22,85
2024-03-13 22:20:00,2,27,33,4,16,19,101
2024-03-13 22:30:00,1,23,32,4,12,23,95
2024-03-13 22:40:00,0,20,25,12,11,20,88
2024-03-13 22:50:00,3,16,27,4,10,20,80
2024-03-13 23:00:00,0,17,19,5,10,11,62
2024-03-13 23:10:00,3,17,30,7,9,21,87
2024-03-13 23:20:00,0,9,18,2,5,10,44
2024-03-13 23:30:00,1,12,12,5,6,6,42
2024-03-13 23:40:00,2,3,7,3,2,3,20
2024-03-13 23:50:00,2,9,7,1,5,9,33
2024-03-14 00:00:00,1,5,11,6,3,13,39
2024-03-14 00:10:00,0,8,17,4,4,9,42
2024-03-14 00:20:00,0,0,11,2,0,6,19
2024-03-14 00:30:00,0,2,8,0,1,4,15
2024-03-14 00:40:00,0,5,11,4,3,7,30
2024-03-14 00:50:00,0,6,1,0,3,0,10
2024-03-14 01:00:00,0,6,6,0,4,3,19
2024-03-14 01:10:00,0,6,5,1,5,4,21
2024-03-14 01:20:00,0,4,6,0,2,4,16
2024-03-14 01:30:00,0,9,6,4,5,3,27
2024-03-14 01:40:00,0,4,11,2,2,8,27
2024-03-14 01:50:00,0,5,8,1,3,6,23
2024-03-14 02:00:00,0,4,10,3,3,5,25
2024-03-14 02:10:00,0,0,4,1,0,3,8
2024-03-14 02:20:00,0,1,4,0,1,2,8
2024-03-14 02:30:00,0,0,1,1,0,1,3
2024-03-14 02:40:00,0,3,1,3,3,0,10
2024-03-14 02:50:00,0,0,7,2,0,5,14
2024-03-14 03:00:00,0,5,2,0,4,1,12
2024-03-14 03:10:00,0,0,4,0,0,3,7
2024-03-14 03:20:00,0,2,4,1,2,2,11
2024-03-14 03:30:00,0,1,4,0,1,2,8
2024-03-14 03:40:00,0,4,5,2,2,2,15
2024-03-14 03:50:00,0,3,4,1,2,3,13
2024-03-14 04:00:00,0,6,2,0,4,1,13
2024-03-14 04:10:00,3,5,3,0,4,3,18
2024-03-14 04:20:00,0,10,8,3,5,4,30
2024-03-14 04:30:00,1,17,7,2,11,4,42
2024-03-14 04:40:00,0,13,4,1,7,4,29
2024-03-14 04:50:00,2,26,7,2,15,6,58
2024-03-14 05:00:00,1,25,3,1,16,2,48
2024-03-14 05:10:00,1,37,8,2,21,7,76
2024-03-14 05:20:00,2,61,22,0,34,13,132
2024-03-14 05:30:00,2,56,11,2,35,10,116
2024-03-14 05:40:00,1,62,12,1,46,10,132
2024-03-14 05:50:00,1,36,21,1,35,15,109
2024-03-14 06:00:00,1,67,21,2,39,21,151
2024-03-14 06:10:00,6,109,19,6,71,16,227
2024-03-14 06:20:00,2,90,32,2,61,34,221
2024-03-14 06:30:00,2,42,18,6,46,29,143
2024-03-14 06:40:00,2,66,22,5,112,26,233
2024-03-14 06:50:00,2,47,25,5,73,33,185
2024-03-14 07:00:00,2,32,31,2,64,40,171
2024-03-14 07:10:00,5,48,28,7,111,41,240
2024-03-14 07:20:00,10,49,24,9,125,34,251
2024-03-14 07:30:00,2,49,41,6,128,51,277
2024-03-14 07:40:00,6,62,33,7,147,47,302
2024-03-14 07:50:00,6,71,36,16,129,45,303
2024-03-14 08:00:00,4,59,37,13,112,44,269
2024-03-14 08:10:00,3,61,40,14,118,42,278
2024-03-14 08:20:00,3,39,29,6,77,40,194
2024-03-14 08:30:00,3,56,35,11,86,42,233
2024-03-14 08:40:00,2,47,32,9,66,33,189
2024-03-14 08:50:00,3,46,20,8,78,30,185
2024-03-14 09:00:00,0,39,24,9,52,27,151
2024-03-14 09:10:00,2,46,29,12,56,39,184
2024-03-14 09:20:00,3,50,28,15,53,34,183
2024-03-14 09:30:00,1,60,26,10,60,32,189
2024-03-14 09:40:00,2,39,28,8,51,39,167
2024-03-14 09:50:00,2,29,41,9,39,54,174
2024-03-14 10:00:00,1,37,25,13,50,23,149
2024-03-14 10:10:00,1,25,35,15,34,44,154
2024-03-14 10:20:00,3,41,21,10,58,21,154
2024-03-14 10:30:00,2,40,30,8,49,42,171
2024-03-14 10:40:00,5,36,30,8,56,36,171
2024-03-14 10:50:00,1,21,35,17,35,44,153
2024-03-14 11:00:00,1,28,39,15,43,52,178
2024-03-14 11:10:00,1,44,37,11,52,40,185
2024-03-14 11:20:00,2,23,37,12,35,46,155
2024-03-14 11:30:00,2,37,38,11,41,47,176
2024-03-14 11:40:00,2,31,45,20,34,59,191
2024-03-14 11:50:00,4,41,38,6,66,39,194
2024-03-14 12:00:00,1,43,42,19,47,45,197
2024-03-14 12:10:00,4,38,39,12,40,41,174
2024-03-14 12:20:00,3,28,36,14,38,55,174
2024-03-14 12:30:00,2,32,40,16,39,51,180
2024-03-14 12:40:00,2,39,28,13,47,44,173
2024-03-14 12:50:00,3,37,43,14,52,59,208
2024-03-14 13:00:00,2,29,47,18,40,62,198
2024-03-14 13:10:00,3,36,39,7,47,53,185
2024-03-14 13:20:00,1,28,36,14,43,57,179
2024-03-14 13:30:00,2,38,41,17,71,60,229
2024-03-14 13:40:00,1,46,44,12,55,52,210
2024-03-14 13:50:00,6,27,48,23,41,61,206
2024-03-14 14:00:00,3,33,42,13,50,47,188
2024-03-14 14:10:00,1,23,40,10,26,59,159
2024-03-14 14:20:00,1,35,46,11,41,63,197
2024-03-14 14:30:00,4,54,46,10,66,66,246
2024-03-14 14:40:00,4,27,38,21,37,63,190
2024-03-14 14:50:00,2,41,47,13,54,66,223
2024-03-14 15:00:00,3,35,61,11,37,79,226
2024-03-14 15:10:00,1,38,70,15,43,95,262
2024-03-14 15:20:00,4,37,59,14,46,91,251
2024-03-14 15:30:00,1,35,57,16,40,113,262
2024-03-14 15:40:00,4,40,66,20,51,94,275
2024-03-14 15:50:00,1,33,83,13,32,103,265
2024-03-14 16:00:00,3,47,78,12,56,115,311
2024-03-14 16:10:00,4,34,63,6,52,91,250
2024-03-14 16:20:00,4,46,62,9,58,118,297
2024-03-14 16:30:00,4,46,57,9,55,108,279
2024-03-14 16:40:00,5,44,34,6,63,106,258
2024-03-14 16:50:00,4,56,21,1,62,92,236
2024-03-14 17:00:00,4,58,8,3,59,97,229
2024-03-14 17:10:00,0,41,20,11,46,100,218
2024-03-14 17:20:00,2,58,43,17,53,98,271
2024-03-14 17:30:00,2,57,67,18,56,92,292
2024-03-14 17:40:00,5,73,44,22,78,86,308
2024-03-14 17:50:00,4,38,65,21,40,95,263
2024-03-14 18:00:00,3,38,39,18,54,85,237
2024-03-14 18:10:00,3,32,56,21,46,89,247
2024-03-14 18:20:00,3,21,49,14,26,99,212
2024-03-14 18:30:00,3,37,38,14,42,78,212
2024-03-14 18:40:00,3,51,35,16,44,69,218
2024-03-14 18:50:00,4,66,51,16,39,55,231
2024-03-14 19:00:00,11,70,46,11,44,51,233
2024-03-14 19:10:00,4,37,50,9,23,45,168
2024-03-14 19:20:00,0,42,42,11,38,47,180
2024-03-14 19:30:00,5,45,39,11,37,42,179
2024-03-14 19:40:00,7,46,50,10,29,45,187
2024-03-14 19:50:00,0,40,46,9,30,43,168
2024-03-14 20:00:00,3,49,55,9,26,44,186
2024-03-14 20:10:00,1,30,36,8,20,42,137
2024-03-14 20:20:00,0,29,42,6,17,34,128
2024-03-14 20:30:00,3,27,24,14,15,18,101
2024-03-14 20:40:00,1,45,21,8,26,16,117
2024-03-14 20:50:00,3,38,40,12,25,36,154
2024-03-14 21:00:00,1,33,36,9,24,27,130
2024-03-14 21:10:00,1,36,31,6,17,28,119
2024-03-14 21:20:00,1,16,34,11,9,35,106
2024-03-14 21:30:00,3,34,35,13,19,36,140
2024-03-14 21:40:00,2,20,32,10,13,25,102
2024-03-14 21:50:00,0,20,31,8,11,22,92
2024-03-14 22:00:00,1,26,39,9,15,32,122
2024-03-14 22:10:00,3,11,31,6,10,23,84
2024-03-14 22:20:00,2,23,37,8,12,26,108
2024-03-14 22:30:00,2,18,23,7,14,16,80
2024-03-14 22:40:00,1,21,21,6,12,21,82
2024-03-14 22:50:00,0,19,31,4,12,18,84
2024-03-14 23:00:00,3,13,20,6,7,12,61
2024-03-14 23:10:00,3,23,23,7,12,16,84
2024-03-14 23:20:00,0,17,33,5,9,19,83
2024-03-14 23:30:00,1,7,12,4,4,6,34
2024-03-14 23:40:00,0,11,16,5,6,12,50
2024-03-14 23:50:00,1,19,9,3,10,10,52
2024-03-15 00:00:00,1,3,7,1,2,5,19
2024-03-15 00:10:00,0,2,10,1,1,6,20
2024-03-15 00:20:00,0,6,13,3,3,8,33
2024-03-15 00:30:00,0,5,7,1,3,5,21
2024-03-15 00:40:00,0,10,10,1,5,5,31
2024-03-15 00:50:00,0,3,13,1,1,8,26
2024-03-15 01:00:00,0,2,7,2,1,4,16
2024-03-15 01:10:00,2,5,2,2,4,4,19
2024-03-15 01:20:00,0,1,4,2,1,2,10
2024-03-15 01:30:00,1,4,3,1,3,3,15
2024-03-15 01:40:00,0,2,9,2,1,4,18
2024-03-15 01:50:00,0,0,3,1,0,1,5
2024-03-15 02:00:00,0,1,4,3,1,2,11
2024-03-15 02:10:00,0,1,1,1,1,0,4
2024-03-15 02:20:00,0,3,7,1,1,6,18
2024-03-15 02:30:00,0,4,4,0,2,3,13
2024-03-15 02:40:00,0,0,2,2,0,1,5
2024-03-15 02:50:00,0,0,1,0,0,0,1
2024-03-15 03:00:00,0,2,3,3,1,1,10
2024-03-15 03:10:00,0,4,0,0,3,0,7
2024-03-15 03:20:00,0,0,8,1,0,4,13
2024-03-15 03:30:00,0,8,4,3,4,2,21
2024-03-15 03:40:00,0,2,1,3,1,2,9
2024-03-15 03:50:00,0,4,0,0,2,0,6
2024-03-15 04:00:00,0,3,1,1,2,1,8
2024-03-15 04:10:00,2,6,2,1,3,2,16
2024-03-15 04:20:00,0,5,4,0,4,2,15
2024-03-15 04:30:00,1,11,4,0,7,2,25
2024-03-15 04:40:00,0,12,4,1,7,3,27
2024-03-15 04:50:00,0,19,2,0,10,3,34
2024-03-15 05:00:00,1,33,5,0,18,3,60
2024-03-15 05:10:00,1,39,7,1,23,6,77
2024-03-15 05:20:00,4,39,18,4,32,12,109
2024-03-15 05:30:00,1,57,14,1,35,9,117
2024-03-15 05:40:00,1,36,19,2,24,12,94
2024-03-15 05:50:00,1,60,25,6,36,16,144
2024-03-15 06:00:00,3,50,17,0,30,10,110
2024-03-15 06:10:00,3,67,14,5,47,13,149
2024-03-15 06:20:00,1,58,37,5,60,28,189
2024-03-15 06:30:00,2,51,29,7,59,35,183
2024-03-15 06:40:00,1,72,24,6,81,30,214
2024-03-15 06:50:00,1,56,30,7,66,30,190
2024-03-15 07:00:00,1,48,34,7,68,35,193
2024-03-15 07:10:00,2,90,22,7,123,28,272
2024-03-15 07:20:00,2,43,31,9,72,48,205
2024-03-15 07:30:00,1,41,36,11,56,47,192
2024-03-15 07:40:00,3,65,43,14,131,52,308
2024-03-15 07:50:00,7,57,32,10,111,41,258
2024-03-15 08:00:00,2,49,38,11,84,37,221
2024-03-15 08:10:00,3,46,27,12,64,39,191
2024-03-15 08:20:00,2,36,30,18,73,36,195
2024-03-15 08:30:00,3,28,22,12,42,22,129
2024-03-15 08:40:00,3,47,25,9,95,29,208
2024-03-15 08:50:00,2,48,26,10,64,28,178
2024-03-15 09:00:00,5,40,24,10,49,31,159
2024-03-15 09:10:00,1,40,31,8,42,36,158
2024-03-15 09:20:00,1,44,34,11,46,37,173
2024-03-15 09:30:00,4,27,24,4,29,26,114
2024-03-15 09:40:00,5,52,29,15,76,38,215
2024-03-15 09:50:00,4,41,30,12,52,41,180
2024-03-15 10:00:00,2,28,29,11,40,34,144
2024-03-15 10:10:00,4,35,24,8,45,34,150
2024-03-15 10:20:00,1,37,31,9,51,31,160
2024-03-15 10:30:00,4,41,26,14,48,32,165
2024-03-15 10:40:00,1,43,36,20,52,37,189
2024-03-15 10:50:00,4,34,32,9,46,40,165
2024-03-15 11:00:00,4,28,36,14,37,39,158
2024-03-15 11:10:00,4,31,37,11,39,48,170
2024-03-15 11:20:00,2,27,23,15,33,37,137
2024-03-15 11:30:00,5,26,41,12,34,54,172
2024-03-15 11:40:00,6,31,34,8,44,54,177
2024-03-15 11:50:00,3,29,26,16,42,58,174
2024-03-15 12:00:00,2,38,34,13,43,41,171
2024-03-15 12:10:00,4,30,35,5,38,47,159
2024-03-15 12:20:00,3,35,33,16,39,55,181
2024-03-15 12:30:00,3,26,38,13,47,75,202
2024-03-15 12:40:00,1,32,29,11,53,69,195
2024-03-15 12:50:00,2,31,33,9,51,61,187
2024-03-15 13:00:00,4,37,50,18,53,80,242
2024-03-15 13:10:00,3,24,31,16,36,66,176
2024-03-15 13:20:00,2,35,33,12,51,54,187
2024-03-15 13:30:00,4,37,39,17,49,76,222
2024-03-15 13:40:00,1,22,41,12,44,67,187
2024-03-15 13:50:00,1,45,48,12,60,69,235
2024-03-15 14:00:00,2,29,41,18,43,70,203
2024-03-15 14:10:00,2,43,50,22,51,63,231
2024-03-15 14:20:00,5,22,48,23,56,109,263
2024-03-15 14:30:00,4,56,57,20,62,92,291
2024-03-15 14:40:00,2,31,52,15,44,94,238
2024-03-15 14:50:00,1,33,38,17,53,77,219
2024-03-15 15:00:00,4,30,40,15,44,102,235
2024-03-15 15:10:00,3,31,37,18,57,75,221
2024-03-15 15:20:00,4,35,60,18,48,94,259
2024-03-15 15:30:00,3,43,46,12,47,82,233
2024-03-15 15:40:00,2,46,58,10,47,86,249
2024-03-15 15:50:00,6,40,52,16,45,103,262
2024-03-15 16:00:00,3,35,53,20,66,82,259
2024-03-15 16:10:00,2,32,57,16,46,94,247
2024-03-15 16:20:00,1,39,46,23,59,79,247
2024-03-15 16:30:00,2,41,49,23,49,75,239
2024-03-15 16:40:00,5,35,59,18,53,82,252
2024-03-15 16:50:00,3,50,42,20,72,66,253
2024-03-15 17:00:00,3,38,62,14,53,80,250
2024-03-15 17:10:00,2,50,58,17,61,81,269
2024-03-15 17:20:00,6,46,47,19,67,70,255
2024-03-15 17:30:00,5,35,48,15,46,85,234
2024-03-15 17:40:00,3,39,40,18,44,67,211
2024-03-15 17:50:00,3,35,28,13,47,56,182
2024-03-15 18:00:00,4,40,38,10,57,63,212
2024-03-15 18:10:00,4,30,43,17,37,73,204
2024-03-15 18:20:00,3,30,29,13,43,74,192
2024-03-15 18:30:00,4,33,35,22,45,84,223
2024-03-15 18:40:00,12,41,45,19,41,54,212
2024-03-15 18:50:00,1,30,38,15,35,50,169
2024-03-15 19:00:00,8,38,37,11,32,38,164
2024-03-15 19:10:00,3,70,38,12,41,42,206
2024-03-15 19:20:00,2,27,31,4,17,45,126
2024-03-15 19:30:00,5,42,41,10,25,50,173
2024-03-15 19:40:00,1,68,39,3,39,48,198
2024-03-15 19:50:00,4,45,53,10,27,42,181
2024-03-15 20:00:00,1,46,46,11,28,43,175
2024-03-15 20:10:00,4,53,37,8,35,39,176
2024-03-15 20:20:00,2,19,27,13,16,35,112
2024-03-15 20:30:00,4,15,17,13,19,15,83
2024-03-15 20:40:00,8,24,19,4,20,24,99
2024-03-15 20:50:00,4,14,22,8,10,30,88
2024-03-15 21:00:00,4,18,33,14,16,33,118
2024-03-15 21:10:00,3,25,23,12,20,31,114
2024-03-15 21:20:00,0,16,26,9,12,30,93
2024-03-15 21:30:00,4,16,21,3,18,24,86
2024-03-15 21:40:00,4,20,25,4,13,30,96
2024-03-15 21:50:00,2,9,18,8,8,22,67
2024-03-15 22:00:00,3,17,21,6,16,24,87
2024-03-15 22:10:00,1,15,21,4,17,29,87
2024-03-15 22:20:00,4,23,22,4,20,21,94
2024-03-15 22:30:00,2,22,19,7,14,21,85
2024-03-15 22:40:00,3,13,24,7,10,37,94
2024-03-15 22:50:00,0,22,20,7,16,17,82
2024-03-15 23:00:00,3,13,22,8,10,14,70
2024-03-15 23:10:00,0,21,27,3,13,33,97
2024-03-15 23:20:00,0,15,17,7,9,18,66
2024-03-15 23:30:00,5,21,18,3,14,13,74
2024-03-15 23:40:00,0,13,22,2,10,19,66
2024-03-15 23:50:00,0,16,17,8,8,12,61
2024-03-16 00:00:00,2,5,15,4,4,13,43
2024-03-16 00:10:00,0,14,23,6,8,12,63
2024-03-16 00:20:00,2,11,20,3,6,11,53
2024-03-16 00:30:00,2,23,13,2,13,7,60
2024-03-16 00:40:00,0,9,20,4,6,12,51
2024-03-16 00:50:00,0,3,13,3,2,5,26
2024-03-16 01:00:00,1,16,9,1,9,10,46
2024-03-16 01:10:00,0,7,15,3,4,9,38
2024-03-16 01:20:00,0,7,13,2,3,10,35
2024-03-16 01:30:00,0,9,9,4,5,7,34
2024-03-16 01:40:00,0,1,10,3,1,6,21
2024-03-16 01:50:00,0,7,9,2,4,10,32
2024-03-16 02:00:00,2,11,2,2,6,1,24
2024-03-16 02:10:00,0,8,9,0,6,7,30
2024-03-16 02:20:00,0,3,11,2,2,8,26
2024-03-16 02:30:00,1,9,8,2,5,3,28
2024-03-16 02:40:00,0,8,7,0,5,3,23
2024-03-16 02:50:00,0,4,6,0,2,4,16
2024-03-16 03:00:00,0,8,6,2,5,4,25
2024-03-16 03:10:00,0,6,5,4,4,3,22
2024-03-16 03:20:00,1,3,6,5,3,6,24
2024-03-16 03:30:00,1,1,5,3,1,5,16
2024-03-16 03:40:00,2,5,1,3,4,1,16
2024-03-16 03:50:00,4,2,1,1,2,1,11
2024-03-16 04:00:00,1,2,5,3,2,4,17
2024-03-16 04:10:00,0,2,6,3,2,5,18
2024-03-16 04:20:00,3,3,1,2,2,1,12
2024-03-16 04:30:00,0,2,4,3,2,4,15
2024-03-16 04:40:00,0,3,2,1,2,2,10
2024-03-16 04:50:00,2,11,2,0,9,2,26
2024-03-16 05:00:00,2,15,4,0,12,3,36
2024-03-16 05:10:00,2,11,5,1,12,4,35
2024-03-16 05:20:00,2,10,7,1,8,3,31
2024-03-16 05:30:00,1,14,6,6,13,6,46
2024-03-16 05:40:00,2,6,5,2,7,5,27
2024-03-16 05:50:00,3,9,7,4,5,7,35
2024-03-16 06:00:00,1,8,8,3,6,8,34
2024-03-16 06:10:00,1,14,6,2,12,5,40
2024-03-16 06:20:00,4,15,7,3,12,8,49
2024-03-16 06:30:00,0,9,10,10,10,9,48
2024-03-16 06:40:00,2,11,7,4,12,8,44
2024-03-16 06:50:00,1,10,11,0,11,11,44
2024-03-16 07:00:00,1,12,13,2,12,10,50
2024-03-16 07:10:00,1,18,4,1,20,2,46
2024-03-16 07:20:00,3,22,16,2,22,18,83
2024-03-16 07:30:00,0,20,9,3,25,13,70
2024-03-16 07:40:00,2,17,12,6,20,13,70
2024-03-16 07:50:00,2,37,14,6,40,11,110
2024-03-16 08:00:00,2,15,18,2,21,19,77
2024-03-16 08:10:00,1,23,11,4,26,16,81
2024-03-16 08:20:00,1,26,21,6,26,21,101
2024-03-16 08:30:00,0,24,17,4,25,19,89
2024-03-16 08:40:00,2,27,20,12,35,17,113
2024-03-16 08:50:00,5,25,25,11,25,24,115
2024-03-16 09:00:00,3,28,20,9,29,27,116
2024-03-16 09:10:00,3,32,23,5,32,27,122
2024-03-16 09:20:00,1,24,22,5,36,26,114
2024-03-16 09:30:00,2,32,28,5,50,29,146
2024-03-16 09:40:00,2,39,25,9,52,22,149
2024-03-16 09:50:00,4,50,37,18,63,38,210
2024-03-16 10:00:00,2,48,31,13,56,32,182
2024-03-16 10:10:00,1,41,31,6,54,33,166
2024-03-16 10:20:00,3,40,32,15,53,36,179
2024-03-16 10:30:00,0,32,27,9,40,34,142
2024-03-16 10:40:00,2,37,22,7,59,29,156
2024-03-16 10:50:00,3,57,38,12,64,43,217
2024-03-16 11:00:00,2,45,32,8,52,31,170
2024-03-16 11:10:00,4,36,38,16,53,34,181
2024-03-16 11:20:00,4,33,38,12,50,47,184
2024-03-16 11:30:00,2,35,33,14,36,40,160
2024-03-16 11:40:00,6,36,47,15,60,54,218
2024-03-16 11:50:00,4,26,29,15,32,30,136
2024-03-16 12:00:00,4,36,35,13,46,58,192
2024-03-16 12:10:00,2,37,27,15,62,47,190
2024-03-16 12:20:00,1,39,32,21,46,49,188
2024-03-16 12:30:00,3,50,37,11,56,50,207
2024-03-16 12:40:00,3,27,43,13,43,68,197
2024-03-16 12:50:00,4,29,40,12,57,54,196
2024-03-16 13:00:00,1,38,31,9,54,47,180
2024-03-16 13:10:00,2,39,54,9,47,68,219
2024-03-16 13:20:00,3,37,41,11,62,54,208
2024-03-16 13:30:00,3,49,53,12,62,62,241
2024-03-16 13:40:00,4,42,38,17,52,52,205
2024-03-16 13:50:00,3,38,37,15,48,40,181
2024-03-16 14:00:00,0,27,33,15,61,66,202
2024-03-16 14:10:00,2,31,44,16,52,62,207
2024-03-16 14:20:00,3,32,43,15,39,61,193
2024-03-16 14:30:00,4,46,25,16,69,48,208
2024-03-16 14:40:00,2,36,38,20,43,65,204
2024-03-16 14:50:00,3,37,45,14,48,59,206
2024-03-16 15:00:00,5,20,41,13,38,55,172
2024-03-16 15:10:00,5,26,24,10,31,49,145
2024-03-16 15:20:00,2,27,29,19,48,37,162
2024-03-16 15:30:00,2,32,34,16,33,45,162
2024-03-16 15:40:00,2,43,40,7,54,69,215
2024-03-16 15:50:00,3,30,34,10,41,48,166
2024-03-16 16:00:00,1,28,35,13,45,42,164
2024-03-16 16:10:00,2,34,26,16,42,42,162
2024-03-16 16:20:00,3,28,47,16,35,66,195
2024-03-16 16:30:00,8,40,31,8,52,41,180
2024-03-16 16:40:00,4,30,39,10,36,50,169
2024-03-16 16:50:00,6,34,38,18,36,52,184
2024-03-16 17:00:00,2,33,36,14,44,51,180
2024-03-16 17:10:00,1,35,41,13,37,64,191
2024-03-16 17:20:00,3,35,44,16,41,54,193
2024-03-16 17:30:00,1,33,35,11,49,54,183
2024-03-16 17:40:00,5,33,44,8,44,66,200
2024-03-16 17:50:00,3,23,45,16,41,80,208
2024-03-16 18:00:00,3,23,61,22,28,73,210
2024-03-16 18:10:00,3,35,35,18,58,64,213
2024-03-16 18:20:00,4,25,43,19,31,60,182
2024-03-16 18:30:00,2,23,39,25,31,66,186
2024-03-16 18:40:00,2,36,29,7,31,42,147
2024-03-16 18:50:00,7,72,48,10,51,55,243
2024-03-16 19:00:00,2,47,32,9,33,34,157
2024-03-16 19:10:00,4,44,45,10,29,41,173
2024-03-16 19:20:00,4,52,44,9,27,41,177
2024-03-16 19:30:00,8,62,33,8,34,35,180
2024-03-16 19:40:00,4,38,52,14,21,45,174
2024-03-16 19:50:00,3,72,40,9,50,43,217
2024-03-16 20:00:00,2,39,40,13,21,36,151
2024-03-16 20:10:00,4,24,31,12,18,27,116
2024-03-16 20:20:00,3,35,24,11,21,26,120
2024-03-16 20:30:00,3,24,20,7,15,16,85
2024-03-16 20:40:00,3,18,31,1,12,22,87
2024-03-16 20:50:00,3,27,25,11,18,22,106
2024-03-16 21:00:00,2,28,29,8,16,25,108
2024-03-16 21:10:00,2,38,29,8,19,22,118
2024-03-16 21:20:00,2,25,26,7,14,23,97
2024-03-16 21:30:00,1,31,25,8,18,18,101
2024-03-16 21:40:00,4,30,36,6,18,28,122
2024-03-16 21:50:00,1,45,35,11,25,24,141
2024-03-16 22:00:00,2,20,34,6,12,22,96
2024-03-16 22:10:00,2,25,38,8,15,26,114
2024-03-16 22:20:00,0,40,28,7,21,28,124
2024-03-16 22:30:00,3,19,29,3,10,27,91
2024-03-16 22:40:00,1,27,25,10,14,23,100
2024-03-16 22:50:00,0,14,27,4,7,19,71
2024-03-16 23:00:00,1,21,22,4,11,12,71
2024-03-16 23:10:00,1,23,28,4,13,20,89
2024-03-16 23:20:00,0,11,21,8,7,13,60
2024-03-16 23:30:00,3,16,22,7,10,18,76
2024-03-16 23:40:00,5,25,27,3,13,15,88
2024-03-16 23:50:00,1,13,18,2,7,13,54
2024-03-17 00:00:00,1,9,23,7,6,16,62
2024-03-17 00:10:00,0,8,19,5,4,10,46
2024-03-17 00:20:00,2,14,14,1,7,7,45
2024-03-17 00:30:00,0,16,14,7,8,6,51
2024-03-17 00:40:00,0,18,17,2,11,11,59
2024-03-17 00:50:00,4,16,12,4,8,10,54
2024-03-17 01:00:00,2,4,17,3,2,12,40
2024-03-17 01:10:00,0,9,14,5,5,7,40
2024-03-17 01:20:00,0,9,13,3,5,10,40
2024-03-17 01:30:00,0,8,9,0,4,7,28
2024-03-17 01:40:00,1,8,20,1,5,13,48
2024-03-17 01:50:00,2,6,16,1,5,10,40
2024-03-17 02:00:00,1,11,10,2,7,8,39
2024-03-17 02:10:00,0,6,8,3,3,4,24
2024-03-17 02:20:00,0,5,17,3,3,10,38
2024-03-17 02:30:00,2,3,6,2,2,4,19
2024-03-17 02:40:00,0,5,5,2,3,2,17
2024-03-17 02:50:00,0,6,6,2,3,6,23
2024-03-17 03:00:00,0,8,8,1,4,4,25
2024-03-17 03:10:00,0,0,9,0,0,5,14
2024-03-17 03:20:00,2,2,3,0,1,2,10
2024-03-17 03:30:00,0,9,7,5,5,3,29
2024-03-17 03:40:00,0,0,8,3,0,5,16
2024-03-17 03:50:00,0,5,8,3,3,5,24
2024-03-17 04:00:00,0,0,6,2,0,4,12
2024-03-17 04:10:00,0,1,9,2,1,5,18
2024-03-17 04:20:00,0,4,2,1,2,0,9
2024-03-17 04:30:00,0,4,5,0,2,3,14
2024-03-17 04:40:00,0,6,7,2,3,3,21
2024-03-17 04:50:00,0,10,0,1,5,0,16
2024-03-17 05:00:00,0,7,0,0,4,0,11
2024-03-17 05:10:00,0,15,6,0,8,4,33
2024-03-17 05:20:00,2,10,3,1,5,1,22
2024-03-17 05:30:00,0,12,10,4,6,5,37
2024-03-17 05:40:00,0,11,4,7,5,1,28
2024-03-17 05:50:00,0,3,4,1,2,3,13
2024-03-17 06:00:00,1,0,11,2,0,4,18
2024-03-17 06:10:00,0,10,4,2,5,1,22
2024-03-17 06:20:00,0,4,5,2,3,3,17
2024-03-17 06:30:00,1,4,7,1,4,7,24
2024-03-17 06:40:00,0,5,5,3,5,7,25
2024-03-17 06:50:00,0,2,7,0,2,7,18
2024-03-17 07:00:00,3,7,5,0,8,4,27
2024-03-17 07:10:00,1,10,3,1,10,1,26
2024-03-17 07:20:00,0,5,6,1,4,7,23
2024-03-17 07:30:00,1,8,7,3,10,9,38
2024-03-17 07:40:00,1,19,4,0,19,4,47
2024-03-17 07:50:00,0,15,9,0,13,8,45
2024-03-17 08:00:00,1,2,5,0,2,6,16
2024-03-17 08:10:00,0,10,13,2,11,13,49
2024-03-17 08:20:00,0,8,10,0,8,9,35
2024-03-17 08:30:00,2,13,8,2,13,8,46
2024-03-17 08:40:00,2,14,6,4,14,7,47
2024-03-17 08:50:00,0,18,7,1,18,8,52
2024-03-17 09:00:00,1,13,11,3,15,11,54
2024-03-17 09:10:00,4,25,10,3,24,8,74
2024-03-17 09:20:00,0,37,10,5,32,12,96
2024-03-17 09:30:00,1,30,11,2,31,12,87
2024-03-17 09:40:00,3,20,22,9,31,25,110
2024-03-17 09:50:00,2,24,18,3,33,26,106
2024-03-17 10:00:00,4,35,23,7,35,21,125
2024-03-17 10:10:00,2,24,16,6,25,17,90
2024-03-17 10:20:00,1,34,19,7,38,22,121
2024-03-17 10:30:00,2,24,21,1,27,25,100
2024-03-17 10:40:00,2,31,19,4,39,31,126
2024-03-17 10:50:00,0,21,27,6,27,36,117
2024-03-17 11:00:00,2,31,31,7,33,34,138
2024-03-17 11:10:00,7,22,30,7,24,42,132
2024-03-17 11:20:00,0,36,28,11,36,35,146
2024-03-17 11:30:00,1,32,31,9,34,39,146
2024-03-17 11:40:00,3,27,38,11,31,45,155
2024-03-17 11:50:00,1,29,31,9,42,43,155
2024-03-17 12:00:00,3,27,38,13,29,38,148
2024-03-17 12:10:00,2,30,39,12,33,48,164
2024-03-17 12:20:00,3,30,33,10,39,53,168
2024-03-17 12:30:00,2,30,39,12,33,39,155
2024-03-17 12:40:00,1,27,23,8,38,31,128
2024-03-17 12:50:00,1,25,26,13,33,33,131
2024-03-17 13:00:00,3,34,37,9,43,46,172
2024-03-17 13:10:00,2,26,38,6,34,44,150
2024-03-17 13:20:00,3,36,28,12,55,41,175
2024-03-17 13:30:00,3,37,28,5,43,33,149
2024-03-17 13:40:00,1,20,35,8,30,45,139
2024-03-17 13:50:00,0,36,41,10,40,49,176
2024-03-17 14:00:00,6,30,36,9,36,39,156
2024-03-17 14:10:00,3,31,37,15,46,48,180
2024-03-17 14:20:00,3,34,36,11,39,43,166
2024-03-17 14:30:00,1,33,37,13,37,43,164
2024-03-17 14:40:00,2,26,30,11,34,51,154
2024-03-17 14:50:00,1,47,40,13,53,43,197
2024-03-17 15:00:00,5,33,32,9,43,44,166
2024-03-17 15:10:00,2,23,37,12,27,55,156
2024-03-17 15:20:00,1,31,41,9,46,45,173
2024-03-17 15:30:00,3,31,37,11,40,43,165
2024-03-17 15:40:00,3,32,37,7,38,47,164
2024-03-17 15:50:00,2,32,34,15,42,41,166
2024-03-17 16:00:00,5,30,28,17,36,31,147
2024-03-17 16:10:00,5,30,33,8,33,40,149
2024-03-17 16:20:00,2,26,38,13,28,54,161
2024-03-17 16:30:00,1,39,45,15,47,62,209
2024-03-17 16:40:00,2,27,24,15,30,30,128
2024-03-17 16:50:00,3,39,36,7,40,44,169
2024-03-17 17:00:00,6,40,23,4,43,27,143
2024-03-17 17:10:00,1,27,26,10,45,36,145
2024-03-17 17:20:00,2,37,45,10,43,54,191
2024-03-17 17:30:00,5,37,32,13,45,40,172
2024-03-17 17:40:00,4,36,43,13,41,52,189
2024-03-17 17:50:00,3,27,44,15,40,54,183
2024-03-17 18:00:00,3,29,41,12,40,60,185
2024-03-17 18:10:00,2,26,29,12,27,45,141
2024-03-17 18:20:00,1,20,38,12,27,41,139
2024-03-17 18:30:00,2,25,37,16,30,54,164
2024-03-17 18:40:00,4,38,32,14,27,44,159
2024-03-17 18:50:00,3,33,33,15,21,29,134
2024-03-17 19:00:00,2,37,30,18,22,18,127
2024-03-17 19:10:00,1,26,22,11,20,21,101
2024-03-17 19:20:00,2,31,31,11,16,25,116
2024-03-17 19:30:00,3,43,37,10,25,34,152
2024-03-17 19:40:00,6,29,23,8,15,32,113
2024-03-17 19:50:00,2,35,31,7,18,28,121
2024-03-17 20:00:00,2,41,34,9,25,26,137
2024-03-17 20:10:00,1,45,26,7,25,18,122
2024-03-17 20:20:00,2,32,31,8,18,25,116
2024-03-17 20:30:00,4,40,34,10,26,23,137
2024-03-17 20:40:00,2,21,33,5,12,21,94
2024-03-17 20:50:00,4,27,29,3,12,23,98
2024-03-17 21:00:00,2,19,31,10,11,22,95
2024-03-17 21:10:00,0,13,26,9,10,18,76
2024-03-17 21:20:00,2,22,36,10,13,29,112
2024-03-17 21:30:00,1,20,24,8,12,20,85
2024-03-17 21:40:00,1,24,25,7,16,17,90
2024-03-17 21:50:00,1,24,21,5,13,16,80
2024-03-17 22:00:00,1,19,26,6,12,12,76
2024-03-17 22:10:00,3,14,16,6,8,15,62
2024-03-17 22:20:00,0,41,12,10,22,12,97
2024-03-17 22:30:00,5,36,13,7,22,4,87
2024-03-17 22:40:00,1,18,13,5,10,14,61
2024-03-17 22:50:00,1,13,19,10,7,13,63
2024-03-17 23:00:00,1,13,12,2,7,11,46
2024-03-17 23:10:00,8,7,14,3,4,11,47
2024-03-17 23:20:00,2,16,14,2,8,14,56
2024-03-17 23:30:00,1,8,9,4,6,11,39
2024-03-17 23:40:00,0,8,9,1,4,5,27
2024-03-17 23:50:00,0,1,5,2,1,8,17
2024-03-18 00:00:00,1,2,7,6,2,6,24
2024-03-18 00:10:00,0,4,9,3,4,9,29
2024-03-18 00:20:00,0,2,5,3,2,5,17
2024-03-18 00:30:00,1,2,6,1,2,5,17
2024-03-18 00:40:00,0,1,4,2,1,4,12
2024-03-18 00:50:00,2,5,8,4,4,8,31
2024-03-18 01:00:00,0,1,8,2,1,8,20
2024-03-18 01:10:00,0,0,4,2,0,2,8
2024-03-18 01:20:00,0,1,1,2,1,1,6
2024-03-18 01:30:00,1,2,1,0,2,1,7
2024-03-18 01:40:00,0,0,0,0,0,0,0
2024-03-18 01:50:00,0,1,2,1,1,2,7
2024-03-18 02:00:00,1,2,2,2,1,2,10
2024-03-18 02:10:00,0,3,1,0,2,0,6
2024-03-18 02:20:00,0,0,1,0,0,2,3
2024-03-18 02:30:00,0,0,0,0,0,1,1
2024-03-18 02:40:00,0,0,2,1,0,2,5
2024-03-18 02:50:00,0,1,3,1,1,2,8
2024-03-18 03:00:00,2,4,3,1,3,3,16
2024-03-18 03:10:00,0,0,3,1,0,3,7
2024-03-18 03:20:00,0,1,0,1,1,0,3
2024-03-18 03:30:00,1,2,1,1,2,1,8
2024-03-18 03:40:00,1,1,3,2,1,3,11
2024-03-18 03:50:00,1,2,2,1,2,1,9
2024-03-18 04:00:00,0,2,2,1,1,2,8
2024-03-18 04:10:00,4,5,4,0,3,3,19
2024-03-18 04:20:00,4,5,3,1,5,2,20
2024-03-18 04:30:00,1,5,5,2,4,4,21
2024-03-18 04:40:00,4,9,1,0,6,1,21
2024-03-18 04:50:00,6,11,2,1,9,3,32
2024-03-18 05:00:00,4,22,3,2,19,4,54
2024-03-18 05:10:00,5,22,7,3,18,5,60
2024-03-18 05:20:00,4,21,10,5,17,9,66
2024-03-18 05:30:00,8,52,9,4,45,7,125
2024-03-18 05:40:00,9,27,14,3,39,12,104
2024-03-18 05:50:00,14,48,12,3,42,16,135
2024-03-18 06:00:00,3,50,20,7,52,20,152
2024-03-18 06:10:00,1,43,17,4,50,17,132
2024-03-18 06:20:00,9,33,15,2,65,15,139
2024-03-18 06:30:00,0,53,23,7,81,23,187
2024-03-18 06:40:00,1,63,19,6,86,27,202
2024-03-18 06:50:00,0,59,24,1,97,35,216
2024-03-18 07:00:00,1,52,33,9,77,45,217
2024-03-18 07:10:00,6,89,27,7,125,39,293
2024-03-18 07:20:00,5,49,28,2,89,39,212
2024-03-18 07:30:00,1,68,35,7,114,36,261
2024-03-18 07:40:00,4,52,38,13,121,43,271
2024-03-18 07:50:00,5,57,31,17,124,45,279
2024-03-18 08:00:00,5,58,32,14,147,38,294
2024-03-18 08:10:00,1,49,33,10,92,39,224
2024-03-18 08:20:00,1,75,34,9,111,41,271
2024-03-18 08:30:00,2,49,38,15,81,55,240
2024-03-18 08:40:00,4,48,29,7,78,33,199
2024-03-18 08:50:00,3,49,20,12,77,24,185
2024-03-18 09:00:00,2,46,33,10,60,36,187
2024-03-18 09:10:00,1,38,38,8,53,45,183
2024-03-18 09:20:00,4,51,23,9,73,28,188
2024-03-18 09:30:00,2,48,13,5,60,15,143
2024-03-18 09:40:00,1,19,30,13,33,39,135
2024-03-18 09:50:00,4,47,36,7,70,37,201
2024-03-18 10:00:00,2,37,25,6,41,37,148
2024-03-18 10:10:00,2,30,25,12,39,31,139
2024-03-18 10:20:00,2,57,35,11,57,35,197
2024-03-18 10:30:00,1,27,30,12,38,36,144
2024-03-18 10:40:00,3,45,36,10,53,41,188
2024-03-18 10:50:00,2,25,29,9,43,42,150
2024-03-18 11:00:00,3,45,26,11,53,34,172
2024-03-18 11:10:00,4,42,29,13,49,41,178
2024-03-18 11:20:00,4,27,37,11,38,41,158
2024-03-18 11:30:00,3,38,33,14,52,43,183
2024-03-18 11:40:00,2,41,31,13,42,34,163
2024-03-18 11:50:00,4,32,28,16,41,48,169
2024-03-18 12:00:00,1,33,37,11,37,47,166
2024-03-18 12:10:00,3,21,42,14,27,50,157
2024-03-18 12:20:00,2,21,34,13,35,37,142
2024-03-18 12:30:00,3,30,37,12,39,54,175
2024-03-18 12:40:00,3,26,41,12,41,51,174
2024-03-18 12:50:00,3,40,40,8,46,46,183
2024-03-18 13:00:00,2,21,36,17,32,59,167
2024-03-18 13:10:00,0,28,29,17,48,38,160
2024-03-18 13:20:00,6,34,31,11,35,54,171
2024-03-18 13:30:00,4,52,30,12,51,42,191
2024-03-18 13:40:00,3,22,32,9,36,50,152
2024-03-18 13:50:00,2,35,35,11,42,49,174
2024-03-18 14:00:00,3,30,40,11,35,59,178
2024-03-18 14:10:00,3,30,44,13,52,69,211
2024-03-18 14:20:00,4,32,42,11,41,63,193
2024-03-18 14:30:00,2,36,44,19,49,55,205
2024-03-18 14:40:00,2,28,39,10,43,48,170
2024-03-18 14:50:00,4,44,56,17,48,70,239
2024-03-18 15:00:00,2,41,64,20,40,99,266
2024-03-18 15:10:00,2,47,58,19,49,73,248
2024-03-18 15:20:00,5,41,51,19,59,72,247
2024-03-18 15:30:00,2,20,56,15,31,83,207
2024-03-18 15:40:00,1,27,50,20,36,78,212
2024-03-18 15:50:00,3,26,59,23,60,87,258
2024-03-18 16:00:00,3,33,69,24,38,82,249
2024-03-18 16:10:00,4,40,57,13,61,113,288
2024-03-18 16:20:00,5,35,64,17,50,99,270
2024-03-18 16:30:00,3,51,79,18,60,117,328
2024-03-18 16:40:00,3,36,56,13,48,105,261
2024-03-18 16:50:00,5,55,63,11,53,97,284
2024-03-18 17:00:00,2,48,49,16,46,102,263
2024-03-18 17:10:00,4,52,67,13,70,113,319
2024-03-18 17:20:00,1,39,56,16,50,93,255
2024-03-18 17:30:00,3,43,68,23,49,99,285
2024-03-18 17:40:00,2,44,55,24,43,77,245
2024-03-18 17:50:00,2,45,43,12,54,81,237
2024-03-18 18:00:00,3,23,44,11,34,76,191
2024-03-18 18:10:00,2,27,55,22,34,80,220
2024-03-18 18:20:00,4,30,53,14,42,79,222
2024-03-18 18:30:00,2,28,40,15,32,61,178
2024-03-18 18:40:00,3,28,37,22,35,74,199
2024-03-18 18:50:00,1,71,50,11,43,56,232
2024-03-18 19:00:00,6,25,34,9,14,50,138
2024-03-18 19:10:00,6,41,48,17,28,39,179
2024-03-18 19:20:00,5,54,36,16,32,42,185
2024-03-18 19:30:00,4,51,38,4,30,42,169
2024-03-18 19:40:00,7,41,39,9,30,41,167
2024-03-18 19:50:00,2,59,48,7,35,40,191
2024-03-18 20:00:00,3,29,41,5,20,34,132
2024-03-18 20:10:00,7,25,41,9,14,33,129
2024-03-18 20:20:00,3,26,30,5,15,21,100
2024-03-18 20:30:00,0,16,41,9,10,23,99
2024-03-18 20:40:00,1,23,30,5,14,26,99
2024-03-18 20:50:00,2,23,26,7,14,15,87
2024-03-18 21:00:00,3,13,32,6,9,23,86
2024-03-18 21:10:00,1,25,20,6,13,23,88
2024-03-18 21:20:00,0,17,26,14,10,29,96
2024-03-18 21:30:00,1,28,21,11,22,17,100
2024-03-18 21:40:00,2,15,18,11,10,22,78
2024-03-18 21:50:00,1,11,24,6,7,20,69
2024-03-18 22:00:00,2,18,20,8,12,28,88
2024-03-18 22:10:00,4,18,18,7,13,16,76
2024-03-18 22:20:00,0,12,20,7,7,22,68
2024-03-18 22:30:00,0,7,14,9,6,16,52
2024-03-18 22:40:00,2,18,11,2,13,14,60
2024-03-18 22:50:00,0,20,11,4,10,12,57
2024-03-18 23:00:00,2,12,9,1,8,7,39
2024-03-18 23:10:00,2,9,14,4,7,10,46
2024-03-18 23:20:00,0,2,10,3,2,10,27
2024-03-18 23:30:00,1,7,11,2,5,10,36
2024-03-18 23:40:00,1,10,2,1,9,3,26
2024-03-18 23:50:00,0,7,12,2,4,12,37
2024-03-19 00:00:00,1,5,10,5,4,9,34
2024-03-19 00:10:00,1,4,4,3,2,4,18
2024-03-19 00:20:00,0,3,7,1,3,5,19
2024-03-19 00:30:00,0,4,6,6,2,6,24
2024-03-19 00:40:00,0,0,3,2,0,3,8
2024-03-19 00:50:00,0,5,2,1,3,2,13
2024-03-19 01:00:00,1,0,8,0,0,4,13
2024-03-19 01:10:00,1,6,2,0,3,2,14
2024-03-19 01:20:00,2,4,8,2,3,8,27
2024-03-19 01:30:00,0,2,6,0,1,5,14
2024-03-19 01:40:00,0,2,3,1,1,4,11
2024-03-19 01:50:00,0,0,1,1,0,1,3
2024-03-19 02:00:00,0,0,1,0,0,0,1
2024-03-19 02:10:00,0,3,1,1,2,1,8
2024-03-19 02:20:00,0,2,2,0,1,3,8
2024-03-19 02:30:00,0,5,2,0,3,3,13
2024-03-19 02:40:00,0,3,3,2,3,2,13
2024-03-19 02:50:00,0,2,1,1,1,1,6
2024-03-19 03:00:00,0,1,0,0,1,0,2
2024-03-19 03:10:00,0,5,1,2,3,1,12
2024-03-19 03:20:00,0,2,7,0,1,3,13
2024-03-19 03:30:00,0,9,4,3,5,6,27
2024-03-19 03:40:00,1,3,6,2,2,2,16
2024-03-19 03:50:00,2,2,1,0,1,0,6
2024-03-19 04:00:00,0,0,4,1,0,2,7
2024-03-19 04:10:00,1,0,9,0,0,6,16
2024-03-19 04:20:00,2,7,8,0,5,5,27
2024-03-19 04:30:00,1,10,4,0,6,4,25
2024-03-19 04:40:00,0,10,6,1,5,6,28
2024-03-19 04:50:00,0,17,4,0,10,3,34
2024-03-19 05:00:00,1,28,8,1,17,7,62
2024-03-19 05:10:00,1,25,8,0,15,6,55
2024-03-19 05:20:00,0,57,17,1,37,13,125
2024-03-19 05:30:00,1,53,10,2,35,6,107
2024-03-19 05:40:00,1,46,12,1,35,8,103
2024-03-19 05:50:00,0,66,23,4,39,17,149
2024-03-19 06:00:00,3,67,23,0,43,16,152
2024-03-19 06:10:00,3,81,25,2,54,20,185
2024-03-19 06:20:00,4,78,36,6,65,23,212
2024-03-19 06:30:00,2,66,20,4,98,31,221
2024-03-19 06:40:00,2,59,23,5,78,27,194
2024-03-19 06:50:00,1,75,23,2,102,29,232
2024-03-19 07:00:00,2,48,30,5,93,36,214
2024-03-19 07:10:00,4,90,27,8,120,43,292
2024-03-19 07:20:00,3,54,34,8,131,43,273
2024-03-19 07:30:00,3,58,36,7,103,33,240
2024-03-19 07:40:00,4,41,28,9,144,45,271
2024-03-19 07:50:00,7,48,25,13,110,47,250
2024-03-19 08:00:00,9,54,36,9,146,45,299
2024-03-19 08:10:00,3,48,30,11,93,42,227
2024-03-19 08:20:00,3,62,41,12,96,48,262
2024-03-19 08:30:00,2,69,36,11,105,44,267
2024-03-19 08:40:00,2,51,31,14,101,36,235
2024-03-19 08:50:00,4,75,30,9,97,42,257
2024-03-19 09:00:00,1,36,32,7,47,41,164
2024-03-19 09:10:00,3,59,42,9,93,42,248
2024-03-19 09:20:00,6,45,36,7,71,45,210
2024-03-19 09:30:00,4,36,27,6,56,32,161
2024-03-19 09:40:00,3,30,27,12,53,38,163
2024-03-19 09:50:00,3,35,31,10,41,46,166
2024-03-19 10:00:00,1,35,28,11,56,39,170
2024-03-19 10:10:00,3,26,31,13,37,43,153
2024-03-19 10:20:00,5,49,24,8,58,34,178
2024-03-19 10:30:00,2,35,33,8,52,36,166
2024-03-19 10:40:00,3,36,31,12,43,38,163
2024-03-19 10:50:00,4,25,28,17,44,29,147
2024-03-19 11:00:00,1,38,29,16,48,37,169
2024-03-19 11:10:00,2,29,37,11,41,42,162
2024-03-19 11:20:00,2,31,43,12,51,49,188
2024-03-19 11:30:00,5,33,50,13,45,58,204
2024-03-19 11:40:00,3,35,36,10,45,45,174
2024-03-19 11:50:00,2,19,43,16,26,56,162
2024-03-19 12:00:00,1,27,35,14,44,44,165
2024-03-19 12:10:00,3,26,35,12,39,46,161
2024-03-19 12:20:00,2,28,30,14,47,56,177
2024-03-19 12:30:00,1,25,48,22,34,50,180
2024-03-19 12:40:00,5,29,46,14,50,69,213
2024-03-19 12:50:00,2,33,34,15,46,52,182
2024-03-19 13:00:00,2,29,33,11,35,55,165
2024-03-19 13:10:00,2,38,42,7,47,62,198
2024-03-19 13:20:00,5,29,34,6,37,54,165
2024-03-19 13:30:00,0,36,31,12,57,55,191
2024-03-19 13:40:00,3,23,33,16,28,49,152
2024-03-19 13:50:00,2,37,49,18,49,59,214
2024-03-19 14:00:00,4,35,45,11,47,73,215
2024-03-19 14:10:00,2,23,51,19,31,70,196
2024-03-19 14:20:00,4,34,46,16,43,67,210
2024-03-19 14:30:00,2,44,57,21,55,74,253
2024-03-19 14:40:00,3,46,65,20,46,89,269
2024-03-19 14:50:00,4,35,45,15,43,53,195
2024-03-19 15:00:00,2,34,57,16,39,79,227
2024-03-19 15:10:00,3,30,65,20,48,101,267
2024-03-19 15:20:00,7,31,52,9,49,91,239
2024-03-19 15:30:00,1,41,60,12,53,86,253
2024-03-19 15:40:00,4,37,51,12,42,82,228
2024-03-19 15:50:00,4,33,81,13,38,105,274
2024-03-19 16:00:00,4,49,65,12,54,99,283
2024-03-19 16:10:00,1,18,77,17,16,116,245
2024-03-19 16:20:00,5,60,68,13,77,99,322
2024-03-19 16:30:00,3,37,78,15,52,106,291
2024-03-19 16:40:00,2,49,78,14,57,101,301
2024-03-19 16:50:00,4,46,72,13,60,125,320
2024-03-19 17:00:00,4,43,63,15,47,90,262
2024-03-19 17:10:00,5,56,86,20,62,115,344
2024-03-19 17:20:00,5,34,75,18,36,102,270
2024-03-19 17:30:00,5,58,54,13,59,95,284
2024-03-19 17:40:00,2,49,82,7,51,93,284
2024-03-19 17:50:00,4,55,65,8,48,90,270
2024-03-19 18:00:00,7,50,63,18,59,80,277
2024-03-19 18:10:00,5,35,43,17,39,69,208
2024-03-19 18:20:00,6,28,58,19,39,98,248
2024-03-19 18:30:00,4,26,62,17,41,91,241
2024-03-19 18:40:00,4,30,42,17,32,86,211
2024-03-19 18:50:00,4,45,38,15,37,65,204
2024-03-19 19:00:00,6,41,59,10,29,48,193
2024-03-19 19:10:00,3,44,54,15,29,56,201
2024-03-19 19:20:00,5,46,48,15,32,47,193
2024-03-19 19:30:00,7,40,46,8,24,48,173
2024-03-19 19:40:00,2,39,39,8,23,49,160
2024-03-19 19:50:00,2,52,41,12,33,39,179
2024-03-19 20:00:00,2,52,37,7,30,42,170
2024-03-19 20:10:00,3,56,21,9,29,19,137
2024-03-19 20:20:00,0,39,34,5,20,29,127
2024-03-19 20:30:00,1,17,30,10,12,24,94
2024-03-19 20:40:00,1,31,27,7,20,21,107
2024-03-19 20:50:00,0,20,32,8,10,24,94
2024-03-19 21:00:00,1,30,37,4,16,35,123
2024-03-19 21:10:00,1,25,31,5,18,30,110
2024-03-19 21:20:00,0,25,34,13,16,32,120
2024-03-19 21:30:00,0,18,31,15,10,27,101
2024-03-19 21:40:00,1,39,30,11,22,31,134
2024-03-19 21:50:00,0,29,32,2,16,25,104
2024-03-19 22:00:00,1,30,36,6,16,30,119
2024-03-19 22:10:00,1,25,27,9,14,19,95
2024-03-19 22:20:00,0,27,33,5,16,25,106
2024-03-19 22:30:00,1,22,27,4,13,22,89
2024-03-19 22:40:00,2,17,25,6,9,21,80
2024-03-19 22:50:00,0,14,14,9,7,7,51
2024-03-19 23:00:00,2,8,16,2,5,13,46
2024-03-19 23:10:00,1,14,11,5,9,8,48
2024-03-19 23:20:00,1,10,16,4,5,13,49
2024-03-19 23:30:00,1,13,10,9,7,9,49
2024-03-19 23:40:00,0,11,8,6,6,4,35
2024-03-19 23:50:00,0,4,8,3,2,7,24
2024-03-20 00:00:00,1,2,14,3,1,10,31
2024-03-20 00:10:00,0,11,7,3,5,5,31
2024-03-20 00:20:00,1,4,13,1,2,7,28
2024-03-20 00:30:00,0,9,7,3,5,4,28
2024-03-20 00:40:00,2,6,10,2,3,5,28
2024-03-20 00:50:00,5,10,14,2,6,10,47
2024-03-20 01:00:00,0,4,10,0,2,7,23
2024-03-20 01:10:00,0,9,6,0,5,3,23
2024-03-20 01:20:00,0,0,5,1,0,4,10
2024-03-20 01:30:00,0,0,6,1,0,6,13
2024-03-20 01:40:00,0,6,5,2,3,2,18
2024-03-20 01:50:00,0,1,4,3,1,1,10
2024-03-20 02:00:00,0,0,1,1,0,1,3
2024-03-20 02:10:00,0,1,0,0,1,0,2
2024-03-20 02:20:00,0,3,3,1,2,3,12
2024-03-20 02:30:00,0,5,2,2,3,3,15
2024-03-20 02:40:00,0,0,3,3,0,2,8
2024-03-20 02:50:00,0,3,4,0,2,3,12
2024-03-20 03:00:00,0,3,2,2,2,1,10
2024-03-20 03:10:00,0,2,5,1,1,4,13
2024-03-20 03:20:00,0,2,3,3,1,1,10
2024-03-20 03:30:00,0,2,2,1,1,1,7
2024-03-20 03:40:00,0,0,6,2,0,5,13
2024-03-20 03:50:00,0,4,6,1,2,4,17
2024-03-20 04:00:00,0,0,6,3,0,3,12
2024-03-20 04:10:00,2,3,5,1,2,4,17
2024-03-20 04:20:00,0,5,4,0,3,3,15
2024-03-20 04:30:00,2,10,3,1,6,2,24
2024-03-20 04:40:00,0,12,3,0,6,2,23
2024-03-20 04:50:00,0,9,8,1,6,6,30
2024-03-20 05:00:00,0,35,2,1,23,5,66
2024-03-20 05:10:00,1,38,12,0,23,6,80
2024-03-20 05:20:00,0,45,18,0,27,12,102
2024-03-20 05:30:00,1,38,14,3,23,8,87
2024-03-20 05:40:00,1,73,13,4,45,12,148
2024-03-20 05:50:00,2,67,28,5,39,19,160
2024-03-20 06:00:00,4,69,27,3,44,16,163
2024-03-20 06:10:00,1,58,15,1,52,16,143
2024-03-20 06:20:00,4,64,12,2,66,17,165
2024-03-20 06:30:00,2,53,26,5,60,28,174
2024-03-20 06:40:00,1,103,23,7,104,25,263
2024-03-20 06:50:00,3,69,27,9,86,36,230
2024-03-20 07:00:00,2,119,33,4,99,37,294
2024-03-20 07:10:00,6,88,40,12,117,37,300
2024-03-20 07:20:00,3,91,37,6,121,39,297
2024-03-20 07:30:00,1,54,40,11,118,42,266
2024-03-20 07:40:00,2,74,39,9,99,50,273
2024-03-20 07:50:00,2,73,36,12,142,47,312
2024-03-20 08:00:00,5,89,27,11,136,32,300
2024-03-20 08:10:00,4,57,34,11,137,37,280
2024-03-20 08:20:00,4,56,30,9,103,42,244
2024-03-20 08:30:00,2,68,33,9,121,43,276
2024-03-20 08:40:00,3,57,28,11,111,34,244
2024-03-20 08:50:00,6,51,35,10,87,34,223
2024-03-20 09:00:00,5,71,33,7,107,34,257
2024-03-20 09:10:00,3,56,35,9,65,39,207
2024-03-20 09:20:00,4,54,40,7,52,43,200
2024-03-20 09:30:00,4,54,35,9,61,46,209
2024-03-20 09:40:00,5,69,27,9,68,46,224
2024-03-20 09:50:00,2,40,35,12,57,34,180
2024-03-20 10:00:00,2,31,33,16,41,40,163
2024-03-20 10:10:00,3,36,22,13,42,31,147
2024-03-20 10:20:00,2,49,31,9,51,40,182
2024-03-20 10:30:00,1,29,32,13,33,43,151
2024-03-20 10:40:00,3,42,22,12,59,26,164
2024-03-20 10:50:00,4,32,32,19,46,39,172
2024-03-20 11:00:00,1,16,27,8,26,40,118
2024-03-20 11:10:00,3,26,26,9,45,34,143
2024-03-20 11:20:00,3,44,38,10,57,39,191
2024-03-20 11:30:00,2,30,42,12,40,60,186
2024-03-20 11:40:00,7,38,49,17,43,53,207
2024-03-20 11:50:00,2,22,29,14,30,55,152
2024-03-20 12:00:00,5,37,32,12,51,41,178
2024-03-20 12:10:00,3,36,27,11,40,56,173
2024-03-20 12:20:00,1,33,33,15,56,47,185
2024-03-20 12:30:00,2,32,34,19,53,51,191
2024-03-20 12:40:00,2,26,35,15,30,52,160
2024-03-20 12:50:00,2,42,48,12,58,53,215
2024-03-20 13:00:00,2,34,44,15,47,63,205
2024-03-20 13:10:00,1,32,37,14,39,54,177
2024-03-20 13:20:00,5,31,55,12,36,79,218
2024-03-20 13:30:00,1,40,46,18,51,62,218
2024-03-20 13:40:00,4,39,39,16,53,57,208
2024-03-20 13:50:00,2,36,39,12,44,53,186
2024-03-20 14:00:00,4,26,45,12,36,53,176
2024-03-20 14:10:00,2,24,45,19,33,64,187
2024-03-20 14:20:00,2,30,37,10,41,66,186
2024-03-20 14:30:00,6,51,46,18,48,71,240
2024-03-20 14:40:00,4,27,52,21,37,70,211
2024-03-20 14:50:00,4,33,45,18,44,75,219
2024-03-20 15:00:00,3,38,53,19,49,90,252
2024-03-20 15:10:00,3,28,60,7,36,95,229
2024-03-20 15:20:00,3,36,69,17,38,98,261
2024-03-20 15:30:00,1,42,57,15,43,96,254
2024-03-20 15:40:00,1,34,56,10,51,95,247
2024-03-20 15:50:00,6,43,62,15,53,125,304
2024-03-20 16:00:00,3,41,61,7,54,100,266
2024-03-20 16:10:00,1,45,62,8,66,106,288
2024-03-20 16:20:00,2,47,66,6,63,97,281
2024-03-20 16:30:00,4,54,66,8,54,106,292
2024-03-20 16:40:00,3,38,55,10,42,104,252
2024-03-20 16:50:00,2,34,64,12,57,130,299
2024-03-20 17:00:00,3,48,65,9,52,103,280
2024-03-20 17:10:00,1,55,86,18,62,120,342
2024-03-20 17:20:00,2,46,73,15,63,111,310
2024-03-20 17:30:00,3,36,63,18,36,109,265
2024-03-20 17:40:00,4,46,46,19,54,89,258
2024-03-20 17:50:00,4,35,61,20,56,114,290
2024-03-20 18:00:00,2,31,53,16,64,90,256
2024-03-20 18:10:00,2,36,63,10,50,93,254
2024-03-20 18:20:00,3,40,52,20,43,75,233
2024-03-20 18:30:00,4,33,35,21,52,92,237
2024-03-20 18:40:00,4,20,30,16,25,49,144
2024-03-20 18:50:00,3,36,45,17,40,52,193
2024-03-20 19:00:00,2,36,56,10,22,48,174
2024-03-20 19:10:00,1,56,62,12,30,61,222
2024-03-20 19:20:00,5,32,52,14,21,61,185
2024-03-20 19:30:00,5,44,51,14,28,54,196
2024-03-20 19:40:00,8,37,45,13,24,47,174
2024-03-20 19:50:00,2,47,55,9,33,38,184
2024-03-20 20:00:00,4,44,30,4,31,28,141
2024-03-20 20:10:00,2,44,46,13,26,34,165
2024-03-20 20:20:00,0,28,34,7,20,26,115
2024-03-20 20:30:00,2,31,37,6,18,31,125
2024-03-20 20:40:00,5,31,36,6,18,29,125
2024-03-20 20:50:00,2,26,31,8,17,24,108
2024-03-20 21:00:00,3,28,30,12,16,25,114
2024-03-20 21:10:00,3,44,55,15,25,43,185
2024-03-20 21:20:00,1,31,40,8,19,29,128
2024-03-20 21:30:00,3,23,37,5,14,21,103
2024-03-20 21:40:00,2,19,31,7,10,24,93
2024-03-20 21:50:00,1,19,33,7,11,26,97
2024-03-20 22:00:00,1,17,34,7,9,27,95
2024-03-20 22:10:00,1,13,33,10,8,25,90
2024-03-20 22:20:00,0,22,42,9,11,35,119
2024-03-20 22:30:00,1,13,26,11,7,23,81
2024-03-20 22:40:00,2,15,28,3,9,22,79
2024-03-20 22:50:00,1,9,24,8,6,21,69
2024-03-20 23:00:00,4,14,16,4,11,13,62
2024-03-20 23:10:00,0,16,23,5,8,19,71
2024-03-20 23:20:00,0,5,12,2,4,7,30
2024-03-20 23:30:00,3,8,7,3,4,6,31
2024-03-20 23:40:00,0,4,9,2,2,4,21
2024-03-20 23:50:00,0,2,11,2,1,5,21
2024-03-21 00:00:00,1,2,12,2,1,9,27
2024-03-21 00:10:00,0,5,16,3,3,10,37
2024-03-21 00:20:00,2,9,18,1,5,8,43
2024-03-21 00:30:00,0,3,12,2,2,9,28
2024-03-21 00:40:00,0,5,11,1,3,7,27
2024-03-21 00:50:00,0,4,8,0,2,5,19
2024-03-21 01:00:00,1,0,8,3,0,3,15
2024-03-21 01:10:00,0,8,7,2,4,5,26
2024-03-21 01:20:00,0,6,7,2,3,4,22
2024-03-21 01:30:00,0,0,3,1,0,3,7
2024-03-21 01:40:00,0,2,6,2,2,2,14
2024-03-21 01:50:00,0,0,2,2,0,1,5
2024-03-21 02:00:00,0,2,4,2,1,5,14
2024-03-21 02:10:00,0,3,4,0,2,5,14
2024-03-21 02:20:00,0,2,3,1,1,2,9
2024-03-21 02:30:00,0,2,9,1,2,4,18
2024-03-21 02:40:00,2,4,2,3,3,1,15
2024-03-21 02:50:00,0,3,8,3,2,5,21
2024-03-21 03:00:00,0,0,1,1,0,1,3
2024-03-21 03:10:00,0,2,2,1,1,2,8
2024-03-21 03:20:00,0,7,3,1,4,1,16
2024-03-21 03:30:00,0,0,5,2,0,3,10
2024-03-21 03:40:00,0,4,5,1,2,3,15
2024-03-21 03:50:00,0,3,9,2,2,4,20
2024-03-21 04:00:00,0,1,0,0,1,0,2
2024-03-21 04:10:00,2,2,2,0,1,1,8
2024-03-21 04:20:00,0,8,11,2,5,5,31
2024-03-21 04:30:00,3,4,0,0,3,0,10
2024-03-21 04:40:00,0,16,4,2,9,3,34
2024-03-21 04:50:00,0,24,4,1,14,4,47
2024-03-21 05:00:00,2,17,5,1,11,4,40
2024-03-21 05:10:00,1,31,8,1,17,7,65
2024-03-21 05:20:00,0,24,17,2,13,10,66
2024-03-21 05:30:00,2,60,12,6,41,8,129
2024-03-21 05:40:00,2,63,18,4,46,12,145
2024-03-21 05:50:00,1,43,28,1,27,17,117
2024-03-21 06:00:00,2,66,22,2,43,19,154
2024-03-21 06:10:00,2,33,29,3,31,20,118
2024-03-21 06:20:00,1,68,18,6,91,23,207
2024-03-21 06:30:00,1,48,25,5,61,25,165
2024-03-21 06:40:00,6,69,36,7,97,36,251
2024-03-21 06:50:00,2,61,34,2,64,32,195
2024-03-21 07:00:00,2,86,25,8,98,33,252
2024-03-21 07:10:00,3,50,27,6,75,35,196
2024-03-21 07:20:00,6,80,41,10,112,44,293
2024-03-21 07:30:00,5,89,31,9,174,36,344
2024-03-21 07:40:00,1,48,30,9,97,37,222
2024-03-21 07:50:00,4,56,34,15,92,40,241
2024-03-21 08:00:00,5,63,32,8,134,40,282
2024-03-21 08:10:00,1,46,33,18,98,37,233
2024-03-21 08:20:00,3,27,42,13,41,52,178
2024-03-21 08:30:00,7,63,34,13,140,47,304
2024-03-21 08:40:00,4,40,24,7,91,40,206
2024-03-21 08:50:00,4,35,30,10,50,35,164
2024-03-21 09:00:00,4,49,21,12,70,36,192
2024-03-21 09:10:00,5,63,41,9,72,36,226
2024-03-21 09:20:00,5,42,26,8,54,30,165
2024-03-21 09:30:00,3,41,24,10,58,29,165
2024-03-21 09:40:00,1,25,33,14,48,41,162
2024-03-21 09:50:00,1,34,50,8,46,49,188
2024-03-21 10:00:00,1,36,23,8,50,34,152
2024-03-21 10:10:00,2,27,30,8,39,34,140
2024-03-21 10:20:00,3,35,24,12,45,26,145
2024-03-21 10:30:00,3,45,42,8,55,45,198
2024-03-21 10:40:00,3,29,30,13,37,38,150
2024-03-21 10:50:00,4,45,24,12,57,23,165
2024-03-21 11:00:00,4,28,30,14,42,39,157
2024-03-21 11:10:00,1,26,29,13,42,44,155
2024-03-21 11:20:00,1,23,29,10,25,31,119
2024-03-21 11:30:00,1,36,42,21,42,53,195
2024-03-21 11:40:00,6,35,42,13,53,49,198
2024-03-21 11:50:00,1,17,29,9,24,52,132
2024-03-21 12:00:00,2,38,37,14,48,50,189
2024-03-21 12:10:00,2,26,48,9,31,56,172
2024-03-21 12:20:00,5,29,43,13,38,53,181
2024-03-21 12:30:00,2,30,29,11,38,60,170
2024-03-21 12:40:00,3,29,47,21,44,63,207
2024-03-21 12:50:00,3,33,42,11,56,52,197
2024-03-21 13:00:00,2,40,46,13,59,69,229
2024-03-21 13:10:00,2,35,47,16,43,61,204
2024-03-21 13:20:00,3,34,38,18,58,67,218
2024-03-21 13:30:00,2,37,37,18,48,52,194
2024-03-21 13:40:00,6,28,44,16,40,55,189
2024-03-21 13:50:00,2,27,43,16,34,46,168
2024-03-21 14:00:00,4,48,39,15,49,49,204
2024-03-21 14:10:00,1,33,46,8,43,67,198
2024-03-21 14:20:00,5,22,53,12,44,77,213
2024-03-21 14:30:00,2,34,46,23,43,67,215
2024-03-21 14:40:00,4,31,51,16,37,76,215
2024-03-21 14:50:00,2,28,53,20,44,63,210
2024-03-21 15:00:00,6,44,51,14,55,92,262
2024-03-21 15:10:00,7,34,61,7,57,89,255
2024-03-21 15:20:00,1,23,70,19,38,87,238
2024-03-21 15:30:00,5,33,56,17,34,89,234
2024-03-21 15:40:00,5,42,53,16,49,88,253
2024-03-21 15:50:00,3,34,49,19,38,85,228
2024-03-21 16:00:00,6,60,71,18,69,114,338
2024-03-21 16:10:00,2,37,66,10,57,102,274
2024-03-21 16:20:00,4,28,74,18,45,125,294
2024-03-21 16:30:00,3,45,72,20,71,111,322
2024-03-21 16:40:00,3,34,65,22,52,90,266
2024-03-21 16:50:00,7,49,52,22,65,99,294
2024-03-21 17:00:00,2,53,81,12,61,119,328
2024-03-21 17:10:00,3,53,71,16,61,111,315
2024-03-21 17:20:00,3,37,65,22,54,111,292
2024-03-21 17:30:00,7,49,48,15,65,94,278
2024-03-21 17:40:00,4,46,53,15,60,94,272
2024-03-21 17:50:00,7,50,56,18,68,75,274
2024-03-21 18:00:00,2,39,46,18,49,71,225
2024-03-21 18:10:00,5,29,49,17,41,94,235
2024-03-21 18:20:00,3,38,41,22,53,76,233
2024-03-21 18:30:00,4,21,35,20,29,99,208
2024-03-21 18:40:00,6,38,50,17,38,62,211
2024-03-21 18:50:00,2,55,39,18,48,48,210
2024-03-21 19:00:00,5,63,53,13,38,62,234
2024-03-21 19:10:00,6,36,41,9,30,52,174
2024-03-21 19:20:00,3,49,41,10,30,51,184
2024-03-21 19:30:00,4,56,45,18,36,47,206
2024-03-21 19:40:00,6,42,55,16,24,45,188
2024-03-21 19:50:00,0,47,41,12,28,42,170
2024-03-21 20:00:00,1,48,43,12,29,36,169
2024-03-21 20:10:00,4,45,44,11,29,30,163
2024-03-21 20:20:00,1,37,35,10,24,36,143
2024-03-21 20:30:00,1,26,28,8,15,29,107
2024-03-21 20:40:00,1,21,23,8,15,25,93
2024-03-21 20:50:00,0,24,30,7,15,26,102
2024-03-21 21:00:00,1,38,34,6,24,21,124
2024-03-21 21:10:00,3,35,41,10,22,33,144
2024-03-21 21:20:00,0,17,39,7,9,31,103
2024-03-21 21:30:00,4,19,41,15,10,40,129
2024-03-21 21:40:00,11,19,25,8,12,22,97
2024-03-21 21:50:00,1,28,36,8,21,29,123
2024-03-21 22:00:00,1,16,36,9,12,26,100
2024-03-21 22:10:00,2,17,32,6,12,27,96
2024-03-21 22:20:00,0,26,37,7,14,24,108
2024-03-21 22:30:00,1,15,32,7,9,25,89
2024-03-21 22:40:00,2,16,28,5,10,21,82
2024-03-21 22:50:00,2,11,26,3,7,21,70
2024-03-21 23:00:00,3,10,32,3,6,21,75
2024-03-21 23:10:00,2,11,32,6,6,24,81
2024-03-21 23:20:00,0,13,23,6,7,16,65
2024-03-21 23:30:00,1,7,17,2,4,14,45
2024-03-21 23:40:00,0,8,8,1,4,6,27
2024-03-21 23:50:00,0,12,13,5,7,7,44
2024-03-22 00:00:00,1,6,13,3,4,10,37
2024-03-22 00:10:00,1,8,15,2,4,8,38
2024-03-22 00:20:00,0,9,12,5,5,5,36
2024-03-22 00:30:00,0,5,5,3,3,4,20
2024-03-22 00:40:00,0,6,12,5,4,9,36
2024-03-22 00:50:00,0,4,9,2,2,3,20
2024-03-22 01:00:00,0,8,5,1,4,2,20
2024-03-22 01:10:00,0,5,3,1,3,2,14
2024-03-22 01:20:00,0,5,5,0,3,4,17
2024-03-22 01:30:00,0,2,3,1,1,3,10
2024-03-22 01:40:00,0,0,2,1,0,2,5
2024-03-22 01:50:00,0,4,4,1,2,2,13
2024-03-22 02:00:00,0,4,9,5,2,8,28
2024-03-22 02:10:00,2,1,4,3,1,2,13
2024-03-22 02:20:00,0,0,1,1,0,2,4
2024-03-22 02:30:00,0,1,4,3,1,2,11
2024-03-22 02:40:00,0,4,8,0,3,5,20
2024-03-22 02:50:00,0,3,1,2,2,0,8
2024-03-22 03:00:00,0,2,3,0,1,2,8
2024-03-22 03:10:00,0,2,5,0,2,4,13
2024-03-22 03:20:00,0,2,2,0,1,1,6
2024-03-22 03:30:00,0,6,4,5,3,2,20
2024-03-22 03:40:00,2,4,3,0,2,3,14
2024-03-22 03:50:00,0,8,2,0,4,1,15
2024-03-22 04:00:00,0,5,10,1,3,5,24
2024-03-22 04:10:00,1,0,3,2,0,1,7
2024-03-22 04:20:00,0,8,6,0,5,4,23
2024-03-22 04:30:00,1,8,4,3,5,1,22
2024-03-22 04:40:00,0,16,2,1,10,1,30
2024-03-22 04:50:00,0,12,6,1,7,5,31
2024-03-22 05:00:00,1,36,8,0,22,6,73
2024-03-22 05:10:00,2,22,7,1,13,6,51
2024-03-22 05:20:00,0,34,10,0,26,10,80
2024-03-22 05:30:00,1,55,19,3,37,10,125
2024-03-22 05:40:00,2,57,11,3,34,13,120
2024-03-22 05:50:00,1,55,23,2,40,17,138
2024-03-22 06:00:00,2,52,29,1,32,17,133
2024-03-22 06:10:00,3,44,18,2,55,18,140
2024-03-22 06:20:00,2,64,25,4,77,26,198
2024-03-22 06:30:00,3,58,24,5,65,27,182
2024-03-22 06:40:00,2,39,22,6,73,20,162
2024-03-22 06:50:00,2,71,22,5,77,25,202
2024-03-22 07:00:00,2,42,20,6,70,28,168
2024-03-22 07:10:00,2,33,36,8,80,42,201
2024-03-22 07:20:00,4,61,37,10,117,42,271
2024-03-22 07:30:00,1,67,34,6,101,42,251
2024-03-22 07:40:00,8,61,31,19,124,36,279
2024-03-22 07:50:00,6,39,30,14,75,34,198
2024-03-22 08:00:00,5,51,23,10,74,27,190
2024-03-22 08:10:00,8,48,28,10,65,33,192
2024-03-22 08:20:00,2,30,29,9,51,34,155
2024-03-22 08:30:00,5,45,28,7,66,35,186
2024-03-22 08:40:00,1,55,32,11,66,28,193
2024-03-22 08:50:00,5,40,25,6,81,28,185
2024-03-22 09:00:00,2,37,32,14,48,36,169
2024-03-22 09:10:00,3,28,34,6,37,33,141
2024-03-22 09:20:00,1,39,27,2,44,32,145
2024-03-22 09:30:00,4,37,29,11,58,38,177
2024-03-22 09:40:00,2,38,30,11,49,36,166
2024-03-22 09:50:00,2,29,46,18,52,56,203
2024-03-22 10:00:00,1,34,36,9,51,43,174
2024-03-22 10:10:00,2,45,31,9,59,30,176
2024-03-22 10:20:00,1,52,36,13,58,39,199
2024-03-22 10:30:00,2,27,34,11,39,47,160
2024-03-22 10:40:00,4,35,35,21,66,56,217
2024-03-22 10:50:00,2,36,37,17,51,52,195
2024-03-22 11:00:00,6,30,32,6,32,34,140
2024-03-22 11:10:00,1,30,35,14,46,43,169
2024-03-22 11:20:00,2,26,34,12,34,42,150
2024-03-22 11:30:00,2,39,41,14,53,54,203
2024-03-22 11:40:00,5,35,53,19,45,55,212
2024-03-22 11:50:00,1,25,48,14,39,56,183
2024-03-22 12:00:00,1,30,44,10,39,58,182
2024-03-22 12:10:00,7,32,51,12,50,81,233
2024-03-22 12:20:00,3,43,47,11,65,68,237
2024-03-22 12:30:00,5,40,47,19,50,64,225
2024-03-22 12:40:00,1,30,40,13,30,71,185
2024-03-22 12:50:00,3,29,55,17,62,72,238
2024-03-22 13:00:00,3,26,54,18,33,70,204
2024-03-22 13:10:00,2,35,48,20,48,72,225
2024-03-22 13:20:00,2,44,60,17,49,73,245
2024-03-22 13:30:00,3,39,45,16,56,64,223
2024-03-22 13:40:00,4,32,44,26,52,68,226
2024-03-22 13:50:00,3,33,41,23,37,67,204
2024-03-22 14:00:00,4,30,43,22,51,81,231
2024-03-22 14:10:00,3,34,60,14,41,101,253
2024-03-22 14:20:00,1,27,64,14,35,89,230
2024-03-22 14:30:00,3,44,55,19,61,80,262
2024-03-22 14:40:00,4,33,71,13,44,95,260
2024-03-22 14:50:00,3,26,57,15,41,94,236
2024-03-22 15:00:00,2,39,53,16,48,104,262
2024-03-22 15:10:00,3,37,66,12,51,100,269
2024-03-22 15:20:00,4,40,71,14,59,105,293
2024-03-22 15:30:00,2,25,58,19,38,109,251
2024-03-22 15:40:00,4,40,52,10,54,112,272
2024-03-22 15:50:00,8,40,50,14,61,104,277
2024-03-22 16:00:00,2,44,56,19,61,107,289
2024-03-22 16:10:00,2,28,44,17,40,88,219
2024-03-22 16:20:00,8,36,86,10,46,126,312
2024-03-22 16:30:00,3,43,55,11,62,97,271
2024-03-22 16:40:00,5,46,70,16,53,103,293
2024-03-22 16:50:00,4,40,53,24,51,84,256
2024-03-22 17:00:00,6,41,68,18,39,92,264
2024-03-22 17:10:00,3,50,52,22,52,75,254
2024-03-22 17:20:00,6,36,60,17,45,78,242
2024-03-22 17:30:00,8,35,75,16,43,89,266
2024-03-22 17:40:00,1,48,70,6,46,79,250
2024-03-22 17:50:00,2,49,51,12,43,69,226
2024-03-22 18:00:00,5,48,56,15,71,70,265
2024-03-22 18:10:00,2,35,45,13,47,55,197
2024-03-22 18:20:00,2,32,62,21,38,73,228
2024-03-22 18:30:00,3,15,23,10,22,34,107
2024-03-22 18:40:00,0,13,17,7,14,18,69
2024-03-22 18:50:00,0,23,22,8,21,25,99
2024-03-22 19:00:00,4,49,40,20,45,52,210
2024-03-22 19:10:00,2,50,58,9,31,62,212
2024-03-22 19:20:00,3,48,56,16,27,38,188
2024-03-22 19:30:00,4,48,50,11,40,40,193
2024-03-22 19:40:00,6,48,40,10,32,40,176
2024-03-22 19:50:00,0,50,46,6,29,38,169
2024-03-22 20:00:00,7,59,42,12,37,40,197
2024-03-22 20:10:00,2,74,55,8,43,42,224
2024-03-22 20:20:00,1,53,26,4,32,31,147
2024-03-22 20:30:00,1,30,39,12,19,30,131
2024-03-22 20:40:00,2,29,33,11,17,34,126
2024-03-22 20:50:00,1,25,38,9,14,28,115
2024-03-22 21:00:00,1,33,27,7,17,22,107
2024-03-22 21:10:00,1,16,42,12,12,31,114
2024-03-22 21:20:00,0,26,31,12,15,20,104
2024-03-22 21:30:00,6,29,30,10,17,27,119
2024-03-22 21:40:00,7,33,35,8,23,25,131
2024-03-22 21:50:00,1,18,37,7,14,31,108
2024-03-22 22:00:00,2,19,36,11,10,29,107
2024-03-22 22:10:00,1,23,36,8,13,30,111
2024-03-22 22:20:00,0,24,39,4,13,29,109
2024-03-22 22:30:00,2,7,33,5,5,25,77
2024-03-22 22:40:00,1,29,27,6,20,21,104
2024-03-22 22:50:00,0,34,43,6,17,28,128
2024-03-22 23:00:00,1,21,32,5,11,21,91
2024-03-22 23:10:00,1,15,27,8,9,20,80
2024-03-22 23:20:00,0,23,35,5,14,22,99
2024-03-22 23:30:00,3,18,20,6,10,16,73
2024-03-22 23:40:00,0,30,19,6,15,16,86
2024-03-22 23:50:00,0,12,19,5,7,9,52
2024-03-23 00:00:00,2,9,20,3,5,12,51
2024-03-23 00:10:00,0,16,14,6,8,11,55
2024-03-23 00:20:00,0,14,14,4,7,11,50
2024-03-23 00:30:00,1,13,13,3,7,10,47
2024-03-23 00:40:00,0,13,17,3,6,11,50
2024-03-23 00:50:00,0,9,13,2,5,7,36
2024-03-23 01:00:00,1,6,11,4,4,8,34
2024-03-23 01:10:00,0,9,12,2,6,7,36
2024-03-23 01:20:00,0,2,5,1,1,2,11
2024-03-23 01:30:00,3,2,16,3,1,8,33
2024-03-23 01:40:00,0,6,11,2,4,6,29
2024-03-23 01:50:00,0,14,10,1,8,4,37
2024-03-23 02:00:00,1,3,8,7,2,6,27
2024-03-23 02:10:00,0,7,10,1,4,5,27
2024-03-23 02:20:00,0,4,4,3,3,2,16
2024-03-23 02:30:00,0,11,4,4,6,2,27
2024-03-23 02:40:00,0,9,7,2,5,4,27
2024-03-23 02:50:00,0,3,3,3,2,3,14
2024-03-23 03:00:00,0,7,3,2,4,1,17
2024-03-23 03:10:00,0,11,7,2,5,4,29
2024-03-23 03:20:00,1,2,7,2,3,7,22
2024-03-23 03:30:00,0,4,3,2,3,3,15
2024-03-23 03:40:00,0,3,4,1,2,6,16
2024-03-23 03:50:00,0,3,6,1,2,5,17
2024-03-23 04:00:00,0,1,6,1,1,3,12
2024-03-23 04:10:00,0,6,7,1,3,4,21
2024-03-23 04:20:00,1,3,3,0,1,1,9
2024-03-23 04:30:00,0,4,5,3,3,4,19
2024-03-23 04:40:00,0,9,5,1,7,3,25
2024-03-23 04:50:00,0,9,5,0,5,3,22
2024-03-23 05:00:00,0,14,4,0,8,3,29
2024-03-23 05:10:00,2,12,9,2,8,4,37
2024-03-23 05:20:00,1,14,19,2,7,10,53
2024-03-23 05:30:00,2,18,8,4,11,3,46
2024-03-23 05:40:00,1,7,6,6,8,5,33
2024-03-23 05:50:00,1,8,4,6,8,5,32
2024-03-23 06:00:00,1,6,13,7,6,15,48
2024-03-23 06:10:00,1,10,4,3,12,3,33
2024-03-23 06:20:00,2,9,6,1,11,7,36
2024-03-23 06:30:00,0,7,4,6,8,6,31
2024-03-23 06:40:00,3,11,11,9,14,11,59
2024-03-23 06:50:00,1,8,8,7,9,10,43
2024-03-23 07:00:00,0,19,9,9,20,11,68
2024-03-23 07:10:00,1,12,12,1,13,11,50
2024-03-23 07:20:00,2,21,11,0,21,10,65
2024-03-23 07:30:00,2,23,13,4,27,12,81
2024-03-23 07:40:00,1,14,19,6,14,16,70
2024-03-23 07:50:00,1,23,10,1,28,10,73
2024-03-23 08:00:00,0,16,11,5,15,8,55
2024-03-23 08:10:00,3,32,9,5,34,12,95
2024-03-23 08:20:00,0,21,14,6,24,15,80
2024-03-23 08:30:00,1,35,20,0,36,24,116
2024-03-23 08:40:00,2,18,19,6,18,25,88
2024-03-23 08:50:00,1,24,14,5,35,13,92
2024-03-23 09:00:00,1,45,19,3,48,23,139
2024-03-23 09:10:00,1,28,19,8,30,20,106
2024-03-23 09:20:00,0,34,26,7,45,23,135
2024-03-23 09:30:00,0,39,34,6,40,36,155
2024-03-23 09:40:00,2,48,35,10,55,36,186
2024-03-23 09:50:00,1,44,33,11,44,31,164
2024-03-23 10:00:00,2,48,32,11,63,36,192
2024-03-23 10:10:00,3,40,32,11,48,39,173
2024-03-23 10:20:00,2,37,31,12,50,31,163
2024-03-23 10:30:00,3,49,28,15,55,35,185
2024-03-23 10:40:00,2,37,28,14,54,33,168
2024-03-23 10:50:00,1,21,34,11,42,48,157
2024-03-23 11:00:00,2,39,38,6,42,42,169
2024-03-23 11:10:00,1,43,27,12,56,32,171
2024-03-23 11:20:00,2,47,36,13,62,51,211
2024-03-23 11:30:00,1,39,40,10,47,48,185
2024-03-23 11:40:00,4,31,37,10,59,53,194
2024-03-23 11:50:00,3,37,40,15,61,52,208
2024-03-23 12:00:00,3,38,36,18,46,47,188
2024-03-23 12:10:00,3,37,39,7,40,42,168
2024-03-23 12:20:00,4,31,46,15,44,56,196
2024-03-23 12:30:00,5,30,35,9,31,48,158
2024-03-23 12:40:00,2,34,38,15,51,44,184
2024-03-23 12:50:00,5,26,40,12,50,68,201
2024-03-23 13:00:00,0,27,46,8,51,60,192
2024-03-23 13:10:00,6,43,34,15,51,50,199
2024-03-23 13:20:00,3,43,35,10,61,55,207
2024-03-23 13:30:00,2,33,49,13,37,58,192
2024-03-23 13:40:00,5,37,34,17,57,49,199
2024-03-23 13:50:00,3,37,38,17,44,47,186
2024-03-23 14:00:00,1,40,42,13,58,56,210
2024-03-23 14:10:00,4,44,47,20,47,63,225
2024-03-23 14:20:00,7,22,39,14,45,58,185
2024-03-23 14:30:00,4,29,35,14,37,52,171
2024-03-23 14:40:00,8,41,41,12,57,58,217
2024-03-23 14:50:00,1,29,45,10,31,50,166
2024-03-23 15:00:00,0,38,40,10,50,47,185
2024-03-23 15:10:00,2,59,44,16,62,51,234
2024-03-23 15:20:00,2,48,34,15,51,42,192
2024-03-23 15:30:00,0,43,20,13,43,42,161
2024-03-23 15:40:00,2,21,43,11,35,50,162
2024-03-23 15:50:00,4,43,40,15,49,53,204
2024-03-23 16:00:00,1,37,34,16,39,60,187
2024-03-23 16:10:00,2,37,45,7,37,50,178
2024-03-23 16:20:00,1,38,41,8,40,44,172
2024-03-23 16:30:00,2,39,51,11,46,65,214
2024-03-23 16:40:00,6,23,40,18,32,50,169
2024-03-23 16:50:00,3,32,42,18,39,51,185
2024-03-23 17:00:00,2,33,40,15,41,61,192
2024-03-23 17:10:00,3,44,40,20,48,48,203
2024-03-23 17:20:00,5,28,46,9,29,54,171
2024-03-23 17:30:00,3,43,40,9,47,46,188
2024-03-23 17:40:00,3,41,43,9,49,61,206
2024-03-23 17:50:00,3,49,40,10,49,65,216
2024-03-23 18:00:00,2,34,45,18,40,51,190
2024-03-23 18:10:00,6,19,25,13,35,42,140
2024-03-23 18:20:00,3,27,34,12,35,56,167
2024-03-23 18:30:00,2,26,38,10,29,54,159
2024-03-23 18:40:00,4,30,35,13,39,52,173
2024-03-23 18:50:00,5,28,28,11,29,32,133
2024-03-23 19:00:00,3,34,41,5,18,42,143
2024-03-23 19:10:00,4,60,49,6,40,36,195
2024-03-23 19:20:00,1,49,46,5,32,34,167
2024-03-23 19:30:00,6,53,31,10,30,33,163
2024-03-23 19:40:00,1,38,22,12,21,22,116
2024-03-23 19:50:00,5,54,44,9,32,50,194
2024-03-23 20:00:00,2,30,53,15,20,43,163
2024-03-23 20:10:00,5,33,33,9,17,26,123
2024-03-23 20:20:00,1,38,39,8,21,38,145
2024-03-23 20:30:00,3,33,38,5,20,32,131
2024-03-23 20:40:00,1,29,29,5,23,26,113
2024-03-23 20:50:00,1,23,27,5,16,27,99
2024-03-23 21:00:00,0,43,28,4,25,29,129
2024-03-23 21:10:00,1,29,27,3,15,24,99
2024-03-23 21:20:00,3,22,26,7,13,15,86
2024-03-23 21:30:00,2,19,34,2,10,28,95
2024-03-23 21:40:00,1,31,43,7,16,32,130
2024-03-23 21:50:00,3,31,36,9,19,24,122
2024-03-23 22:00:00,4,25,25,6,13,22,95
2024-03-23 22:10:00,5,46,26,8,25,30,140
2024-03-23 22:20:00,4,38,30,5,21,24,122
2024-03-23 22:30:00,2,26,28,5,14,25,100
2024-03-23 22:40:00,3,23,37,8,13,23,107
2024-03-23 22:50:00,2,10,35,0,5,27,79
2024-03-23 23:00:00,1,20,34,2,11,27,95
2024-03-23 23:10:00,0,27,32,12,15,28,114
2024-03-23 23:20:00,0,12,36,2,6,28,84
2024-03-23 23:30:00,1,31,21,6,16,19,94
2024-03-23 23:40:00,2,19,32,7,12,19,91
2024-03-23 23:50:00,5,15,31,6,7,26,90
2024-03-24 00:00:00,5,20,19,7,15,19,85
2024-03-24 00:10:00,2,19,14,3,13,12,63
2024-03-24 00:20:00,0,5,20,1,3,16,45
2024-03-24 00:30:00,1,19,8,2,11,12,53
2024-03-24 00:40:00,0,10,5,2,5,6,28
2024-03-24 00:50:00,0,9,11,4,5,9,38
2024-03-24 01:00:00,3,12,10,2,8,10,45
2024-03-24 01:10:00,0,11,8,4,6,7,36
2024-03-24 01:20:00,0,9,8,2,6,7,32
2024-03-24 01:30:00,0,5,9,5,2,6,27
2024-03-24 01:40:00,0,12,9,2,7,7,37
2024-03-24 01:50:00,0,17,9,2,9,5,42
2024-03-24 02:00:00,1,7,7,4,5,5,29
2024-03-24 02:10:00,0,6,12,2,3,6,29
2024-03-24 02:20:00,0,8,17,1,4,11,41
2024-03-24 02:30:00,2,9,7,1,5,7,31
2024-03-24 02:40:00,2,6,10,2,3,5,28
2024-03-24 02:50:00,2,3,2,0,2,1,10
2024-03-24 03:00:00,0,6,3,1,3,2,15
2024-03-24 03:10:00,0,3,3,1,1,1,9
2024-03-24 03:20:00,0,8,7,1,5,4,25
2024-03-24 03:30:00,2,6,4,0,4,2,18
2024-03-24 03:40:00,0,6,10,2,4,6,28
2024-03-24 03:50:00,0,8,8,2,4,5,27
2024-03-24 04:00:00,1,6,7,1,3,3,21
2024-03-24 04:10:00,0,9,5,1,5,2,22
2024-03-24 04:20:00,0,12,4,1,6,3,26
2024-03-24 04:30:00,0,4,3,1,3,2,13
2024-03-24 04:40:00,0,2,2,0,1,1,6
2024-03-24 04:50:00,1,11,4,0,5,2,23
2024-03-24 05:00:00,0,12,5,1,6,3,27
2024-03-24 05:10:00,0,7,9,1,4,5,26
2024-03-24 05:20:00,0,5,3,0,3,3,14
2024-03-24 05:30:00,0,12,5,1,7,2,27
2024-03-24 05:40:00,0,2,11,2,1,5,21
2024-03-24 05:50:00,0,2,11,1,1,8,23
2024-03-24 06:00:00,2,0,13,1,0,6,22
2024-03-24 06:10:00,0,7,2,1,6,2,18
2024-03-24 06:20:00,0,3,5,2,3,5,18
2024-03-24 06:30:00,1,3,3,0,3,3,13
2024-03-24 06:40:00,0,6,6,0,6,6,24
2024-03-24 06:50:00,0,3,4,2,3,4,16
2024-03-24 07:00:00,1,6,2,1,6,1,17
2024-03-24 07:10:00,0,7,4,0,7,4,22
2024-03-24 07:20:00,1,5,1,1,5,1,14
2024-03-24 07:30:00,1,4,2,2,4,2,15
2024-03-24 07:40:00,0,9,5,1,10,6,31
2024-03-24 07:50:00,0,7,7,2,7,8,31
2024-03-24 08:00:00,1,6,7,1,7,7,29
2024-03-24 08:10:00,0,7,7,1,7,7,29
2024-03-24 08:20:00,3,8,10,0,9,9,39
2024-03-24 08:30:00,1,14,6,0,14,7,42
2024-03-24 08:40:00,0,6,9,3,6,8,32
2024-03-24 08:50:00,1,14,8,1,14,9,47
2024-03-24 09:00:00,2,15,10,3,15,7,52
2024-03-24 09:10:00,1,12,14,4,12,16,59
2024-03-24 09:20:00,0,16,8,3,17,11,55
2024-03-24 09:30:00,2,23,15,7,25,16,88
2024-03-24 09:40:00,1,43,16,4,48,17,129
2024-03-24 09:50:00,0,32,17,5,31,19,104
2024-03-24 10:00:00,1,22,15,2,24,17,81
2024-03-24 10:10:00,2,17,12,5,19,14,69
2024-03-24 10:20:00,4,23,14,6,26,15,88
2024-03-24 10:30:00,1,31,17,3,31,21,104
2024-03-24 10:40:00,2,22,27,7,25,29,112
2024-03-24 10:50:00,0,21,21,3,23,23,91
2024-03-24 11:00:00,3,16,19,3,22,22,85
2024-03-24 11:10:00,3,21,19,9,24,21,97
2024-03-24 11:20:00,3,23,29,4,25,36,120
2024-03-24 11:30:00,6,32,21,9,35,25,128
2024-03-24 11:40:00,3,17,32,14,19,38,123
2024-03-24 11:50:00,1,27,29,4,38,34,133
2024-03-24 12:00:00,1,15,24,9,24,33,106
2024-03-24 12:10:00,2,33,29,10,46,34,154
2024-03-24 12:20:00,0,29,38,6,24,42,139
2024-03-24 12:30:00,1,22,24,10,26,32,115
2024-03-24 12:40:00,2,24,33,7,28,43,137
2024-03-24 12:50:00,0,39,25,5,43,30,142
2024-03-24 13:00:00,3,23,37,6,22,39,130
2024-03-24 13:10:00,4,28,29,11,23,31,126
2024-03-24 13:20:00,1,38,28,6,37,37,147
2024-03-24 13:30:00,3,23,28,5,24,36,119
2024-03-24 13:40:00,6,32,36,8,31,39,152
2024-03-24 13:50:00,5,24,27,10,25,39,130
2024-03-24 14:00:00,4,32,36,5,34,33,144
2024-03-24 14:10:00,3,36,27,13,42,28,149
2024-03-24 14:20:00,2,26,27,6,30,39,130
2024-03-24 14:30:00,4,32,29,15,29,36,145
2024-03-24 14:40:00,5,27,42,5,30,41,150
2024-03-24 14:50:00,1,35,36,11,43,36,162
2024-03-24 15:00:00,3,37,33,14,39,36,162
2024-03-24 15:10:00,1,30,34,6,35,48,154
2024-03-24 15:20:00,2,24,36,3,26,45,136
2024-03-24 15:30:00,3,29,30,8,30,35,135
2024-03-24 15:40:00,2,30,31,10,32,29,134
2024-03-24 15:50:00,1,21,30,11,28,30,121
2024-03-24 16:00:00,2,23,22,5,27,29,108
2024-03-24 16:10:00,3,31,31,14,35,34,148
2024-03-24 16:20:00,5,25,29,8,29,32,128
2024-03-24 16:30:00,3,30,25,9,30,28,125
2024-03-24 16:40:00,2,27,21,18,28,27,123
2024-03-24 16:50:00,4,40,21,6,42,35,148
2024-03-24 17:00:00,3,29,32,10,36,36,146
2024-03-24 17:10:00,4,23,24,10,26,33,120
2024-03-24 17:20:00,1,30,29,8,33,40,141
2024-03-24 17:30:00,4,30,33,12,37,46,162
2024-03-24 17:40:00,3,32,41,9,32,44,161
2024-03-24 17:50:00,0,38,36,3,33,36,146
2024-03-24 18:00:00,6,35,26,1,33,33,134
2024-03-24 18:10:00,8,33,22,1,30,43,137
2024-03-24 18:20:00,3,26,24,10,30,34,127
2024-03-24 18:30:00,3,25,27,10,26,34,125
2024-03-24 18:40:00,6,24,24,8,24,32,118
2024-03-24 18:50:00,3,22,20,13,24,21,103
2024-03-24 19:00:00,2,42,18,8,25,22,117
2024-03-24 19:10:00,5,32,45,7,20,28,137
2024-03-24 19:20:00,2,33,35,6,22,25,123
2024-03-24 19:30:00,1,36,28,11,21,20,117
2024-03-24 19:40:00,2,35,38,8,22,25,130
2024-03-24 19:50:00,2,27,47,7,15,27,125
2024-03-24 20:00:00,1,32,36,5,21,27,122
2024-03-24 20:10:00,4,39,35,12,24,28,142
2024-03-24 20:20:00,6,28,26,4,17,19,100
2024-03-24 20:30:00,2,36,26,6,20,22,112
2024-03-24 20:40:00,9,38,32,7,20,27,133
2024-03-24 20:50:00,3,28,39,3,19,25,117
2024-03-24 21:00:00,5,17,29,7,9,25,92
2024-03-24 21:10:00,2,22,33,6,12,22,97
2024-03-24 21:20:00,1,41,24,8,24,17,115
2024-03-24 21:30:00,2,24,18,12,13,11,80
2024-03-24 21:40:00,5,24,31,3,13,23,99
2024-03-24 21:50:00,4,24,24,5,14,14,85
2024-03-24 22:00:00,1,20,20,4,12,18,75
2024-03-24 22:10:00,1,23,32,7,13,19,95
2024-03-24 22:20:00,1,7,30,11,4,22,75
2024-03-24 22:30:00,3,12,17,3,8,12,55
2024-03-24 22:40:00,2,13,20,2,10,12,59
2024-03-24 22:50:00,0,6,18,5,3,10,42
2024-03-24 23:00:00,1,11,11,3,6,9,41
2024-03-24 23:10:00,1,8,18,3,6,12,48
2024-03-24 23:20:00,0,9,26,6,5,17,63
2024-03-24 23:30:00,1,3,19,7,5,10,45
2024-03-24 23:40:00,0,13,7,2,6,4,32
2024-03-24 23:50:00,0,4,12,4,2,7,29
2024-03-25 00:00:00,1,4,4,7,2,4,22
2024-03-25 00:10:00,0,3,12,3,2,7,27
2024-03-25 00:20:00,0,5,10,2,3,5,25
2024-03-25 00:30:00,2,5,6,1,3,4,21
2024-03-25 00:40:00,0,6,7,3,3,4,23
2024-03-25 00:50:00,2,7,11,1,5,9,35
2024-03-25 01:00:00,0,13,5,3,7,2,30
2024-03-25 01:10:00,0,2,5,2,1,3,13
2024-03-25 01:20:00,2,4,4,1,3,1,15
2024-03-25 01:30:00,0,0,6,0,0,3,9
2024-03-25 01:40:00,0,2,6,3,1,3,15
2024-03-25 01:50:00,0,2,2,1,1,1,7
2024-03-25 02:00:00,0,1,4,3,1,3,12
2024-03-25 02:10:00,0,0,6,0,0,4,10
2024-03-25 02:20:00,0,2,3,0,1,3,9
2024-03-25 02:30:00,0,2,8,0,1,4,15
2024-03-25 02:40:00,0,0,2,0,0,2,4
2024-03-25 02:50:00,0,2,2,0,1,1,6
2024-03-25 03:00:00,0,2,4,1,1,1,9
2024-03-25 03:10:00,0,1,0,0,1,0,2
2024-03-25 03:20:00,0,2,1,1,1,2,7
2024-03-25 03:30:00,0,7,0,0,4,0,11
2024-03-25 03:40:00,0,4,1,0,2,1,8
2024-03-25 03:50:00,0,2,3,0,1,1,7
2024-03-25 04:00:00,0,3,7,1,2,4,17
2024-03-25 04:10:00,1,0,2,0,0,1,4
2024-03-25 04:20:00,2,8,2,1,4,2,19
2024-03-25 04:30:00,4,10,2,2,6,1,25
2024-03-25 04:40:00,0,17,6,1,11,3,38
2024-03-25 04:50:00,2,14,11,4,9,8,48
2024-03-25 05:00:00,3,20,12,3,14,6,58
2024-03-25 05:10:00,1,25,7,1,16,7,57
2024-03-25 05:20:00,0,45,9,1,27,7,89
2024-03-25 05:30:00,1,29,12,0,20,10,72
2024-03-25 05:40:00,2,32,16,4,20,9,83
2024-03-25 05:50:00,2,92,19,4,59,14,190
2024-03-25 06:00:00,2,38,19,6,40,13,118
2024-03-25 06:10:00,4,28,11,2,24,15,84
2024-03-25 06:20:00,5,78,15,1,104,20,223
2024-03-25 06:30:00,0,72,23,3,70,25,193
2024-03-25 06:40:00,3,53,22,6,52,24,160
2024-03-25 06:50:00,3,39,29,3,92,31,197
2024-03-25 07:00:00,2,70,21,4,87,25,209
2024-03-25 07:10:00,3,31,27,8,67,29,165
2024-03-25 07:20:00,6,121,27,2,138,28,322
2024-03-25 07:30:00,2,96,34,6,101,35,274
2024-03-25 07:40:00,2,106,43,9,103,48,311
2024-03-25 07:50:00,6,95,31,14,101,37,284
2024-03-25 08:00:00,2,69,37,11,97,41,257
2024-03-25 08:10:00,2,61,25,11,83,28,210
2024-03-25 08:20:00,1,66,38,8,89,34,236
2024-03-25 08:30:00,1,39,26,7,84,27,184
2024-03-25 08:40:00,7,39,31,11,68,44,200
2024-03-25 08:50:00,1,57,20,9,74,32,193
2024-03-25 09:00:00,2,59,36,3,69,43,212
2024-03-25 09:10:00,5,33,41,8,46,49,182
2024-03-25 09:20:00,1,64,32,10,74,33,214
2024-03-25 09:30:00,2,64,28,8,65,31,198
2024-03-25 09:40:00,2,55,37,7,45,38,184
2024-03-25 09:50:00,1,56,36,8,63,47,211
2024-03-25 10:00:00,3,34,30,16,49,29,161
2024-03-25 10:10:00,4,35,36,5,57,44,181
2024-03-25 10:20:00,4,39,34,11,44,34,166
2024-03-25 10:30:00,2,39,33,12,50,40,176
2024-03-25 10:40:00,1,27,35,12,35,43,153
2024-03-25 10:50:00,3,50,33,13,58,46,203
2024-03-25 11:00:00,5,29,47,16,44,47,188
2024-03-25 11:10:00,2,41,39,12,58,42,194
2024-03-25 11:20:00,6,42,24,16,49,27,164
2024-03-25 11:30:00,2,38,34,9,51,44,178
2024-03-25 11:40:00,1,30,24,13,38,40,146
2024-03-25 11:50:00,4,44,48,14,50,54,214
2024-03-25 12:00:00,2,38,34,13,42,44,173
2024-03-25 12:10:00,3,33,27,6,35,45,149
2024-03-25 12:20:00,3,35,44,9,46,57,194
2024-03-25 12:30:00,2,32,46,12,33,50,175
2024-03-25 12:40:00,2,34,29,12,34,38,149
2024-03-25 12:50:00,2,25,44,15,47,57,190
2024-03-25 13:00:00,4,22,28,12,41,52,159
2024-03-25 13:10:00,3,29,38,17,42,46,175
2024-03-25 13:20:00,4,35,35,7,48,54,183
2024-03-25 13:30:00,6,32,37,16,48,59,198
2024-03-25 13:40:00,4,29,40,11,32,52,168
2024-03-25 13:50:00,6,38,46,9,48,55,202
2024-03-25 14:00:00,3,40,48,13,49,56,209
2024-03-25 14:10:00,3,32,50,17,48,70,220
2024-03-25 14:20:00,3,21,45,13,28,67,177
2024-03-25 14:30:00,3,49,49,15,58,60,234
2024-03-25 14:40:00,1,36,63,18,35,72,225
2024-03-25 14:50:00,3,40,49,20,45,70,227
2024-03-25 15:00:00,3,26,53,19,28,74,203
2024-03-25 15:10:00,4,51,51,13,63,88,270
2024-03-25 15:20:00,3,48,61,25,52,87,276
2024-03-25 15:30:00,4,32,54,14,38,80,222
2024-03-25 15:40:00,3,33,67,9,35,92,239
2024-03-25 15:50:00,7,41,53,5,55,89,250
2024-03-25 16:00:00,4,52,39,9,51,94,249
2024-03-25 16:10:00,2,39,78,9,50,112,290
2024-03-25 16:20:00,3,45,72,7,47,105,279
2024-03-25 16:30:00,7,49,22,8,59,85,230
2024-03-25 16:40:00,5,52,81,13,55,101,307
2024-03-25 16:50:00,2,39,57,14,44,82,238
2024-03-25 17:00:00,3,37,56,21,41,81,239
2024-03-25 17:10:00,2,42,56,18,51,90,259
2024-03-25 17:20:00,3,50,68,13,52,99,285
2024-03-25 17:30:00,3,51,75,15,54,88,286
2024-03-25 17:40:00,5,39,68,7,51,84,254
2024-03-25 17:50:00,4,33,77,7,37,99,257
2024-03-25 18:00:00,2,46,49,1,50,64,212
2024-03-25 18:10:00,3,26,28,3,47,77,184
2024-03-25 18:20:00,7,28,48,19,37,75,214
2024-03-25 18:30:00,1,31,48,12,33,63,188
2024-03-25 18:40:00,2,24,35,21,40,68,190
2024-03-25 18:50:00,3,26,48,18,36,61,192
2024-03-25 19:00:00,2,31,32,10,27,48,150
2024-03-25 19:10:00,5,46,42,16,31,48,188
2024-03-25 19:20:00,0,46,52,10,27,52,187
2024-03-25 19:30:00,3,46,42,11,29,46,177
2024-03-25 19:40:00,1,53,34,8,31,38,165
2024-03-25 19:50:00,3,29,40,7,18,35,132
2024-03-25 20:00:00,1,45,34,7,23,34,144
2024-03-25 20:10:00,3,31,38,6,20,28,126
2024-03-25 20:20:00,5,32,33,14,18,30,132
2024-03-25 20:30:00,1,28,29,6,17,27,108
2024-03-25 20:40:00,1,24,33,3,12,24,97
2024-03-25 20:50:00,2,29,30,9,16,25,111
2024-03-25 21:00:00,1,19,23,9,12,27,91
2024-03-25 21:10:00,2,21,26,6,11,20,86
2024-03-25 21:20:00,2,17,30,11,13,21,94
2024-03-25 21:30:00,3,19,28,9,12,21,92
2024-03-25 21:40:00,5,20,24,6,13,22,90
2024-03-25 21:50:00,4,18,43,7,9,30,111
2024-03-25 22:00:00,3,6,20,9,3,23,64
2024-03-25 22:10:00,2,16,26,5,10,19,78
2024-03-25 22:20:00,0,13,27,2,8,24,74
2024-03-25 22:30:00,2,14,32,7,9,26,90
2024-03-25 22:40:00,6,14,30,9,8,21,88
2024-03-25 22:50:00,0,6,18,3,4,14,45
2024-03-25 23:00:00,1,16,18,6,10,10,61
2024-03-25 23:10:00,1,13,23,7,8,16,68
2024-03-25 23:20:00,0,4,19,4,2,10,39
2024-03-25 23:30:00,2,7,7,3,5,10,34
2024-03-25 23:40:00,0,7,7,2,4,5,25
2024-03-25 23:50:00,0,2,17,3,1,11,34
2024-03-26 00:00:00,1,5,12,3,3,7,31
2024-03-26 00:10:00,0,6,4,2,3,3,18
2024-03-26 00:20:00,0,2,10,4,1,6,23
2024-03-26 00:30:00,1,4,8,3,2,3,21
2024-03-26 00:40:00,0,10,2,1,5,3,21
2024-03-26 00:50:00,0,8,8,2,4,5,27
2024-03-26 01:00:00,0,0,11,1,0,6,18
2024-03-26 01:10:00,0,2,1,3,1,0,7
2024-03-26 01:20:00,0,2,5,2,2,1,12
2024-03-26 01:30:00,0,2,6,1,1,6,16
2024-03-26 01:40:00,0,3,5,0,2,3,13
2024-03-26 01:50:00,2,4,3,2,2,1,14
2024-03-26 02:00:00,0,2,3,0,1,2,8
2024-03-26 02:10:00,0,0,4,1,0,3,8
2024-03-26 02:20:00,0,0,4,4,0,3,11
2024-03-26 02:30:00,0,5,1,2,3,0,11
2024-03-26 02:40:00,0,0,1,0,0,0,1
2024-03-26 02:50:00,0,2,1,1,1,1,6
2024-03-26 03:00:00,0,0,0,2,0,0,2
2024-03-26 03:10:00,0,3,3,2,2,1,11
2024-03-26 03:20:00,0,3,6,1,2,2,14
2024-03-26 03:30:00,0,7,3,0,4,3,17
2024-03-26 03:40:00,0,3,8,1,2,5,19
2024-03-26 03:50:00,0,2,2,0,1,1,6
2024-03-26 04:00:00,0,1,3,0,1,2,7
2024-03-26 04:10:00,1,0,2,0,0,1,4
2024-03-26 04:20:00,1,7,7,2,4,2,23
2024-03-26 04:30:00,1,5,1,2,3,1,13
2024-03-26 04:40:00,0,19,6,0,10,5,40
2024-03-26 04:50:00,0,12,3,2,6,2,25
2024-03-26 05:00:00,2,27,6,1,18,5,59
2024-03-26 05:10:00,1,31,17,4,19,10,82
2024-03-26 05:20:00,0,45,6,1,27,5,84
2024-03-26 05:30:00,1,37,17,1,21,12,89
2024-03-26 05:40:00,1,64,10,2,39,8,124
2024-03-26 05:50:00,2,65,14,4,45,11,141
2024-03-26 06:00:00,2,37,8,2,37,9,95
2024-03-26 06:10:00,2,56,13,4,53,15,143
2024-03-26 06:20:00,1,46,26,3,63,30,169
2024-03-26 06:30:00,1,68,21,4,97,21,212
2024-03-26 06:40:00,2,86,32,5,79,33,237
2024-03-26 06:50:00,2,81,25,9,87,30,234
2024-03-26 07:00:00,2,60,20,5,75,20,182
2024-03-26 07:10:00,1,66,31,5,84,34,221
2024-03-26 07:20:00,1,88,35,6,122,38,290
2024-03-26 07:30:00,4,60,24,5,98,25,216
2024-03-26 07:40:00,2,54,30,17,93,38,234
2024-03-26 07:50:00,4,69,30,5,92,27,227
2024-03-26 08:00:00,3,66,35,9,105,34,252
2024-03-26 08:10:00,3,47,24,10,74,28,186
2024-03-26 08:20:00,5,70,22,7,111,29,244
2024-03-26 08:30:00,6,41,29,12,76,39,203
2024-03-26 08:40:00,1,34,26,4,79,45,189
2024-03-26 08:50:00,3,60,30,13,84,34,224
2024-03-26 09:00:00,1,28,23,11,46,31,140
2024-03-26 09:10:00,4,53,29,14,84,27,211
2024-03-26 09:20:00,3,50,25,12,58,36,184
2024-03-26 09:30:00,3,40,23,10,55,26,157
2024-03-26 09:40:00,0,49,24,10,67,27,177
2024-03-26 09:50:00,5,31,26,9,56,33,160
2024-03-26 10:00:00,1,37,37,23,41,44,183
2024-03-26 10:10:00,0,39,23,11,42,28,143
2024-03-26 10:20:00,4,33,36,10,47,41,171
2024-03-26 10:30:00,4,45,33,7,65,31,185
2024-03-26 10:40:00,3,32,27,10,59,35,166
2024-03-26 10:50:00,3,21,36,13,39,34,146
2024-03-26 11:00:00,1,31,29,15,43,44,163
2024-03-26 11:10:00,3,42,36,12,58,44,195
2024-03-26 11:20:00,3,35,27,22,48,31,166
2024-03-26 11:30:00,2,26,27,13,44,39,151
2024-03-26 11:40:00,5,30,36,15,51,44,181
2024-03-26 11:50:00,2,31,32,9,36,38,148
2024-03-26 12:00:00,2,39,40,8,51,58,198
2024-03-26 12:10:00,2,18,39,9,30,52,150
2024-03-26 12:20:00,1,37,44,18,43,47,190
2024-03-26 12:30:00,4,23,38,12,32,55,164
2024-03-26 12:40:00,2,22,43,9,42,46,164
2024-03-26 12:50:00,4,35,44,13,45,53,194
2024-03-26 13:00:00,3,33,48,21,38,58,201
2024-03-26 13:10:00,4,30,41,12,37,54,178
2024-03-26 13:20:00,4,30,39,17,34,64,188
2024-03-26 13:30:00,4,32,49,11,42,65,203
2024-03-26 13:40:00,1,30,40,20,41,50,182
2024-03-26 13:50:00,5,32,41,6,36,54,174
2024-03-26 14:00:00,4,41,39,19,52,54,209
2024-03-26 14:10:00,1,24,55,18,33,75,206
2024-03-26 14:20:00,1,52,51,18,55,71,248
2024-03-26 14:30:00,4,37,55,18,55,81,250
2024-03-26 14:40:00,3,29,53,21,36,70,212
2024-03-26 14:50:00,4,32,52,15,40,61,204
2024-03-26 15:00:00,1,46,50,15,46,77,235
2024-03-26 15:10:00,2,27,39,14,38,65,185
2024-03-26 15:20:00,3,46,59,15,55,77,255
2024-03-26 15:30:00,2,39,46,14,50,80,231
2024-03-26 15:40:00,2,31,50,11,45,100,239
2024-03-26 15:50:00,3,41,73,10,48,101,276
2024-03-26 16:00:00,6,42,54,18,55,77,252
2024-03-26 16:10:00,2,39,75,13,49,107,285
2024-03-26 16:20:00,2,43,78,12,45,119,299
2024-03-26 16:30:00,2,32,83,17,47,104,285
2024-03-26 16:40:00,8,40,64,21,43,94,270
2024-03-26 16:50:00,6,54,64,26,44,91,285
2024-03-26 17:00:00,7,39,72,20,35,89,262
2024-03-26 17:10:00,3,55,70,15,55,98,296
2024-03-26 17:20:00,3,44,81,28,58,121,335
2024-03-26 17:30:00,3,44,63,15,51,84,260
2024-03-26 17:40:00,2,39,59,13,46,96,255
2024-03-26 17:50:00,3,22,73,18,31,90,237
2024-03-26 18:00:00,4,60,56,15,70,89,294
2024-03-26 18:10:00,3,26,53,14,34,74,204
2024-03-26 18:20:00,3,33,53,14,44,76,223
2024-03-26 18:30:00,1,19,52,22,20,73,187
2024-03-26 18:40:00,3,25,34,17,34,71,184
2024-03-26 18:50:00,1,28,44,18,27,61,179
2024-03-26 19:00:00,7,37,30,8,31,49,162
2024-03-26 19:10:00,5,39,38,12,24,47,165
2024-03-26 19:20:00,4,58,35,4,39,44,184
2024-03-26 19:30:00,2,39,35,15,22,50,163
2024-03-26 19:40:00,3,35,30,8,22,37,135
2024-03-26 19:50:00,0,40,41,4,26,39,150
2024-03-26 20:00:00,4,46,35,15,32,39,171
2024-03-26 20:10:00,4,52,26,7,34,29,152
2024-03-26 20:20:00,2,34,37,9,20,26,128
2024-03-26 20:30:00,4,24,27,13,17,23,108
2024-03-26 20:40:00,3,30,27,8,17,23,108
2024-03-26 20:50:00,3,24,26,4,13,21,91
2024-03-26 21:00:00,3,22,21,7,13,19,85
2024-03-26 21:10:00,5,21,27,7,14,30,104
2024-03-26 21:20:00,0,29,30,7,15,21,102
2024-03-26 21:30:00,2,26,26,2,14,20,90
2024-03-26 21:40:00,3,21,25,6,11,20,86
2024-03-26 21:50:00,0,19,24,10,10,18,81
2024-03-26 22:00:00,2,25,25,6,17,20,95
2024-03-26 22:10:00,4,13,32,5,7,22,83
2024-03-26 22:20:00,0,24,32,9,11,21,97
2024-03-26 22:30:00,1,20,18,6,12,10,67
2024-03-26 22:40:00,1,29,29,5,16,23,103
2024-03-26 22:50:00,3,14,32,1,8,26,84
2024-03-26 23:00:00,2,19,16,4,10,14,65
2024-03-26 23:10:00,0,23,30,2,12,17,84
2024-03-26 23:20:00,0,6,14,5,4,7,36
2024-03-26 23:30:00,1,6,14,6,3,10,40
2024-03-26 23:40:00,1,8,13,3,4,8,37
2024-03-26 23:50:00,0,11,11,5,6,10,43
2024-03-27 00:00:00,1,7,10,6,6,7,37
2024-03-27 00:10:00,2,5,13,7,3,8,38
2024-03-27 00:20:00,0,6,3,1,4,1,15
2024-03-27 00:30:00,0,7,8,4,4,5,28
2024-03-27 00:40:00,0,5,4,3,3,4,19
2024-03-27 00:50:00,0,8,6,2,4,6,26
2024-03-27 01:00:00,1,1,6,3,1,4,16
2024-03-27 01:10:00,0,6,6,1,3,3,19
2024-03-27 01:20:00,0,7,2,0,4,1,14
2024-03-27 01:30:00,0,0,5,0,0,3,8
2024-03-27 01:40:00,0,4,3,1,2,2,12
2024-03-27 01:50:00,0,3,3,0,2,2,10
2024-03-27 02:00:00,0,4,2,4,2,4,16
2024-03-27 02:10:00,0,5,3,2,3,1,14
2024-03-27 02:20:00,0,3,6,1,2,4,16
2024-03-27 02:30:00,1,2,3,3,2,3,14
2024-03-27 02:40:00,2,7,9,3,5,5,31
2024-03-27 02:50:00,0,5,7,1,3,3,19
2024-03-27 03:00:00,0,0,0,0,0,0,0
2024-03-27 03:10:00,0,1,4,2,1,2,10
2024-03-27 03:20:00,0,5,0,3,2,0,10
2024-03-27 03:30:00,0,4,1,4,2,1,12
2024-03-27 03:40:00,0,0,5,1,0,7,13
2024-03-27 03:50:00,0,2,1,0,1,0,4
2024-03-27 04:00:00,1,2,7,0,1,4,15
2024-03-27 04:10:00,1,7,2,1,5,1,17
2024-03-27 04:20:00,0,6,3,2,3,1,15
2024-03-27 04:30:00,1,8,2,0,5,1,17
2024-03-27 04:40:00,0,14,6,2,9,5,36
2024-03-27 04:50:00,0,25,6,0,13,4,48
2024-03-27 05:00:00,1,21,6,1,15,4,48
2024-03-27 05:10:00,1,30,9,4,22,9,75
2024-03-27 05:20:00,0,49,9,2,27,6,93
2024-03-27 05:30:00,3,36,18,0,29,15,101
2024-03-27 05:40:00,1,48,13,4,27,12,105
2024-03-27 05:50:00,1,67,14,3,49,10,144
2024-03-27 06:00:00,2,28,16,3,29,16,94
2024-03-27 06:10:00,1,68,16,3,70,15,173
2024-03-27 06:20:00,3,53,22,6,50,24,158
2024-03-27 06:30:00,1,64,26,6,69,32,198
2024-03-27 06:40:00,4,75,27,5,78,24,213
2024-03-27 06:50:00,3,69,29,7,72,31,211
2024-03-27 07:00:00,2,105,22,6,88,23,246
2024-03-27 07:10:00,2,90,29,5,72,30,228
2024-03-27 07:20:00,2,77,25,6,105,37,252
2024-03-27 07:30:00,3,55,33,7,71,28,197
2024-03-27 07:40:00,4,69,37,8,112,40,270
2024-03-27 07:50:00,5,59,30,10,99,36,239
2024-03-27 08:00:00,3,29,34,7,54,38,165
2024-03-27 08:10:00,5,35,32,18,87,30,207
2024-03-27 08:20:00,4,58,34,13,104,34,247
2024-03-27 08:30:00,3,61,29,8,98,37,236
2024-03-27 08:40:00,3,52,27,7,77,30,196
2024-03-27 08:50:00,3,29,22,12,51,30,147
2024-03-27 09:00:00,3,34,35,10,76,41,199
2024-03-27 09:10:00,1,40,32,10,81,35,199
2024-03-27 09:20:00,1,33,31,12,49,34,160
2024-03-27 09:30:00,2,46,41,11,69,42,211
2024-03-27 09:40:00,2,54,31,15,72,35,209
2024-03-27 09:50:00,4,50,35,19,74,39,221
2024-03-27 10:00:00,4,56,32,12,65,37,206
2024-03-27 10:10:00,5,25,32,12,47,41,162
2024-03-27 10:20:00,4,35,32,10,40,39,160
2024-03-27 10:30:00,4,29,40,15,52,44,184
2024-03-27 10:40:00,1,34,32,10,47,39,163
2024-03-27 10:50:00,4,39,34,8,45,37,167
2024-03-27 11:00:00,3,39,35,8,53,40,178
2024-03-27 11:10:00,2,31,32,17,50,36,168
2024-03-27 11:20:00,2,28,30,12,35,42,149
2024-03-27 11:30:00,1,22,38,16,37,50,164
2024-03-27 11:40:00,6,45,36,14,54,46,201
2024-03-27 11:50:00,4,24,51,17,33,67,196
2024-03-27 12:00:00,4,39,37,13,58,53,204
2024-03-27 12:10:00,9,34,32,18,41,52,186
2024-03-27 12:20:00,1,28,35,13,39,40,156
2024-03-27 12:30:00,4,26,32,15,36,45,158
2024-03-27 12:40:00,2,23,39,17,35,63,179
2024-03-27 12:50:00,2,27,37,15,37,53,171
2024-03-27 13:00:00,3,19,34,11,34,52,153
2024-03-27 13:10:00,3,36,38,14,38,55,184
2024-03-27 13:20:00,2,36,38,12,51,54,193
2024-03-27 13:30:00,3,35,26,14,43,38,159
2024-03-27 13:40:00,2,24,51,26,37,70,210
2024-03-27 13:50:00,1,25,29,18,29,55,157
2024-03-27 14:00:00,5,29,48,21,57,66,226
2024-03-27 14:10:00,2,21,46,20,34,56,179
2024-03-27 14:20:00,4,26,47,17,39,69,202
2024-03-27 14:30:00,3,29,40,8,40,72,192
2024-03-27 14:40:00,1,39,39,15,49,61,204
2024-03-27 14:50:00,1,18,41,13,32,66,171
2024-03-27 15:00:00,3,32,40,17,39,59,190
2024-03-27 15:10:00,3,34,38,14,49,77,215
2024-03-27 15:20:00,1,35,65,24,57,94,276
2024-03-27 15:30:00,3,33,54,13,45,75,223
2024-03-27 15:40:00,2,30,51,13,58,110,264
2024-03-27 15:50:00,3,28,54,17,49,102,253
2024-03-27 16:00:00,1,43,50,15,54,97,260
2024-03-27 16:10:00,5,38,67,19,58,109,296
2024-03-27 16:20:00,4,42,50,14,52,80,242
2024-03-27 16:30:00,5,26,48,21,49,103,252
2024-03-27 16:40:00,5,29,53,20,50,98,255
2024-03-27 16:50:00,2,25,53,16,32,92,220
2024-03-27 17:00:00,3,24,33,16,50,88,214
2024-03-27 17:10:00,4,37,44,12,60,105,262
2024-03-27 17:20:00,5,29,44,18,41,89,226
2024-03-27 17:30:00,5,32,31,18,66,103,255
2024-03-27 17:40:00,2,37,33,17,54,85,228
2024-03-27 17:50:00,4,21,40,22,47,100,234
2024-03-27 18:00:00,2,30,34,25,52,76,219
2024-03-27 18:10:00,7,22,27,29,49,87,221
2024-03-27 18:20:00,3,17,33,44,27,69,193
2024-03-27 18:30:00,7,22,39,34,36,78,216
2024-03-27 18:40:00,4,17,37,35,37,68,198
2024-03-27 18:50:00,10,22,30,14,29,39,144
2024-03-27 19:00:00,5,32,35,9,33,56,170
2024-03-27 19:10:00,7,40,30,13,46,51,187
2024-03-27 19:20:00,8,22,32,11,24,58,155
2024-03-27 19:30:00,6,27,32,16,28,54,163
2024-03-27 19:40:00,7,32,25,11,34,49,158
2024-03-27 19:50:00,6,14,25,14,19,29,107
2024-03-27 20:00:00,8,18,25,12,15,33,111
2024-03-27 20:10:00,9,21,20,11,21,31,113
2024-03-27 20:20:00,6,25,23,8,25,26,113
2024-03-27 20:30:00,3,26,19,9,22,19,98
2024-03-27 20:40:00,5,24,24,5,21,22,101
2024-03-27 20:50:00,5,7,20,8,10,24,74
2024-03-27 21:00:00,6,16,29,10,18,41,120
2024-03-27 21:10:00,2,14,20,6,13,20,75
2024-03-27 21:20:00,0,13,20,11,12,26,82
2024-03-27 21:30:00,4,22,22,9,19,25,101
2024-03-27 21:40:00,3,15,17,8,9,24,76
2024-03-27 21:50:00,2,29,22,7,23,27,110
2024-03-27 22:00:00,2,17,22,4,13,26,84
2024-03-27 22:10:00,3,18,26,8,14,27,96
2024-03-27 22:20:00,2,21,23,9,12,21,88
2024-03-27 22:30:00,1,21,25,7,12,22,88
2024-03-27 22:40:00,1,25,29,6,14,27,102
2024-03-27 22:50:00,0,3,17,4,3,9,36
2024-03-27 23:00:00,3,5,25,4,3,15,55
2024-03-27 23:10:00,0,10,22,4,6,12,54
2024-03-27 23:20:00,0,6,22,5,3,14,50
2024-03-27 23:30:00,1,8,11,4,6,8,38
2024-03-27 23:40:00,1,14,9,5,11,7,47
2024-03-27 23:50:00,0,12,12,3,8,7,42
2024-03-28 00:00:00,1,3,16,4,2,10,36
2024-03-28 00:10:00,0,12,15,1,6,10,44
2024-03-28 00:20:00,0,3,14,6,2,9,34
2024-03-28 00:30:00,0,7,14,3,4,6,34
2024-03-28 00:40:00,0,2,6,3,1,3,15
2024-03-28 00:50:00,0,2,5,2,1,4,14
2024-03-28 01:00:00,0,11,5,2,5,2,25
2024-03-28 01:10:00,0,2,14,0,1,8,25
2024-03-28 01:20:00,0,3,3,2,2,3,13
2024-03-28 01:30:00,0,2,9,3,1,5,20
2024-03-28 01:40:00,0,0,9,5,0,5,19
2024-03-28 01:50:00,0,2,3,2,2,2,11
2024-03-28 02:00:00,0,3,0,2,2,0,7
2024-03-28 02:10:00,2,0,6,3,0,4,15
2024-03-28 02:20:00,0,4,3,1,2,2,12
2024-03-28 02:30:00,0,2,4,2,1,2,11
2024-03-28 02:40:00,0,2,3,1,2,1,9
2024-03-28 02:50:00,1,3,3,1,2,2,12
2024-03-28 03:00:00,0,2,3,1,1,2,9
2024-03-28 03:10:00,0,1,2,2,1,1,7
2024-03-28 03:20:00,0,4,6,0,2,2,14
2024-03-28 03:30:00,0,2,4,2,1,2,11
2024-03-28 03:40:00,0,5,3,1,3,2,14
2024-03-28 03:50:00,0,4,4,0,2,2,12
2024-03-28 04:00:00,0,5,9,0,3,6,23
2024-03-28 04:10:00,1,9,5,3,7,5,30
2024-03-28 04:20:00,0,5,2,1,3,1,12
2024-03-28 04:30:00,1,5,3,2,4,2,17
2024-03-28 04:40:00,0,24,1,0,13,1,39
2024-03-28 04:50:00,0,19,5,1,11,2,38
2024-03-28 05:00:00,6,13,11,1,9,8,48
2024-03-28 05:10:00,1,21,12,2,12,9,57
2024-03-28 05:20:00,0,44,8,3,27,6,88
2024-03-28 05:30:00,1,51,20,1,29,12,114
2024-03-28 05:40:00,1,50,12,4,38,8,113
2024-03-28 05:50:00,2,38,13,3,32,12,100
2024-03-28 06:00:00,3,30,12,3,37,15,100
2024-03-28 06:10:00,2,17,11,6,21,13,70
2024-03-28 06:20:00,5,88,28,5,80,27,233
2024-03-28 06:30:00,3,75,19,4,68,20,189
2024-03-28 06:40:00,2,8,27,5,65,28,135
2024-03-28 06:50:00,1,14,22,5,34,28,104
2024-03-28 07:00:00,7,56,26,7,116,28,240
2024-03-28 07:10:00,2,66,27,9,65,27,196
2024-03-28 07:20:00,4,70,25,7,85,26,217
2024-03-28 07:30:00,2,63,33,6,88,40,232
2024-03-28 07:40:00,2,78,39,14,85,40,258
2024-03-28 07:50:00,1,40,31,13,82,36,203
2024-03-28 08:00:00,3,27,24,7,46,24,131
2024-03-28 08:10:00,4,60,21,9,100,31,225
2024-03-28 08:20:00,3,56,28,8,77,29,201
2024-03-28 08:30:00,1,29,29,10,47,36,152
2024-03-28 08:40:00,3,55,23,10,102,33,226
2024-03-28 08:50:00,2,27,26,10,50,37,152
2024-03-28 09:00:00,4,41,37,11,61,39,193
2024-03-28 09:10:00,3,71,21,8,92,31,226
2024-03-28 09:20:00,1,35,24,8,57,32,157
2024-03-28 09:30:00,3,52,30,5,76,34,200
2024-03-28 09:40:00,3,43,21,17,54,25,163
2024-03-28 09:50:00,4,31,27,15,51,29,157
2024-03-28 10:00:00,5,27,29,13,39,36,149
2024-03-28 10:10:00,1,31,36,13,39,39,159
2024-03-28 10:20:00,2,31,20,15,48,31,147
2024-03-28 10:30:00,3,26,22,12,49,33,145
2024-03-28 10:40:00,4,44,35,9,64,53,209
2024-03-28 10:50:00,3,29,38,10,38,38,156
2024-03-28 11:00:00,2,28,29,13,37,40,149
2024-03-28 11:10:00,2,41,32,13,45,31,164
2024-03-28 11:20:00,2,22,37,21,27,44,153
2024-03-28 11:30:00,2,33,40,9,41,53,178
2024-03-28 11:40:00,3,41,36,8,50,46,184
2024-03-28 11:50:00,1,29,38,19,42,51,180
2024-03-28 12:00:00,1,33,24,13,40,47,158
2024-03-28 12:10:00,3,27,45,21,37,55,188
2024-03-28 12:20:00,4,36,39,14,47,62,202
2024-03-28 12:30:00,1,36,41,14,38,53,183
2024-03-28 12:40:00,2,37,25,10,45,45,164
2024-03-28 12:50:00,3,24,34,14,28,55,158
2024-03-28 13:00:00,2,28,39,20,36,59,184
2024-03-28 13:10:00,2,44,37,10,68,59,220
2024-03-28 13:20:00,4,37,30,18,52,63,204
2024-03-28 13:30:00,4,39,39,16,49,60,207
2024-03-28 13:40:00,5,36,43,19,43,52,198
2024-03-28 13:50:00,1,29,45,16,51,72,214
2024-03-28 14:00:00,3,33,49,22,42,70,219
2024-03-28 14:10:00,3,31,47,13,47,71,212
2024-03-28 14:20:00,2,27,65,12,45,80,231
2024-03-28 14:30:00,3,39,52,14,47,75,230
2024-03-28 14:40:00,6,35,48,25,57,86,257
2024-03-28 14:50:00,2,28,42,18,38,77,205
2024-03-28 15:00:00,2,37,46,16,45,72,218
2024-03-28 15:10:00,6,56,54,11,64,75,266
2024-03-28 15:20:00,2,28,69,21,40,90,250
2024-03-28 15:30:00,4,37,39,18,54,95,247
2024-03-28 15:40:00,3,44,52,16,64,92,271
2024-03-28 15:50:00,4,33,61,18,43,85,244
2024-03-28 16:00:00,1,28,50,22,39,74,214
2024-03-28 16:10:00,7,46,42,21,55,90,261
2024-03-28 16:20:00,3,43,49,16,55,84,250
2024-03-28 16:30:00,1,34,56,13,51,77,232
2024-03-28 16:40:00,3,40,75,18,57,87,280
2024-03-28 16:50:00,4,30,58,15,43,78,228
2024-03-28 17:00:00,3,46,61,20,54,85,269
2024-03-28 17:10:00,2,54,64,17,52,83,272
2024-03-28 17:20:00,4,35,54,19,44,97,253
2024-03-28 17:30:00,5,41,60,22,49,81,258
2024-03-28 17:40:00,3,36,44,12,53,66,214
2024-03-28 17:50:00,3,16,49,13,34,73,188
2024-03-28 18:00:00,12,42,53,13,63,84,267
2024-03-28 18:10:00,4,34,50,14,54,73,229
2024-03-28 18:20:00,3,42,52,17,58,71,243
2024-03-28 18:30:00,3,33,40,16,37,52,181
2024-03-28 18:40:00,2,40,39,16,48,69,214
2024-03-28 18:50:00,3,28,36,22,26,59,174
2024-03-28 19:00:00,6,31,44,16,37,53,187
2024-03-28 19:10:00,4,40,27,18,22,46,157
2024-03-28 19:20:00,5,64,46,10,39,47,211
2024-03-28 19:30:00,7,33,44,15,18,47,164
2024-03-28 19:40:00,6,31,42,6,19,49,153
2024-03-28 19:50:00,5,46,37,19,27,29,163
2024-03-28 20:00:00,6,42,38,8,22,34,150
2024-03-28 20:10:00,2,47,50,16,27,47,189
2024-03-28 20:20:00,0,49,51,10,29,51,190
2024-03-28 20:30:00,4,39,26,17,29,31,146
2024-03-28 20:40:00,1,27,37,12,21,25,123
2024-03-28 20:50:00,0,20,43,6,15,36,120
2024-03-28 21:00:00,2,24,41,14,16,26,123
2024-03-28 21:10:00,6,12,26,9,9,21,83
2024-03-28 21:20:00,1,19,42,15,15,29,121
2024-03-28 21:30:00,1,39,17,15,21,20,113
2024-03-28 21:40:00,1,18,21,5,12,18,75
2024-03-28 21:50:00,0,31,32,9,16,22,110
2024-03-28 22:00:00,1,35,49,11,19,32,147
2024-03-28 22:10:00,2,19,35,8,16,28,108
2024-03-28 22:20:00,1,42,38,9,22,31,143
2024-03-28 22:30:00,3,27,27,7,17,22,103
2024-03-28 22:40:00,3,20,27,10,11,24,95
2024-03-28 22:50:00,0,32,21,3,19,14,89
2024-03-28 23:00:00,2,17,19,3,11,19,71
2024-03-28 23:10:00,2,35,25,5,20,18,105
2024-03-28 23:20:00,0,13,23,6,9,13,64
2024-03-28 23:30:00,3,16,22,8,10,16,75
2024-03-28 23:40:00,2,19,18,6,12,12,69
2024-03-28 23:50:00,2,11,14,5,6,10,48
2024-03-29 00:00:00,3,15,10,5,10,7,50
2024-03-29 00:10:00,2,3,7,3,2,4,21
2024-03-29 00:20:00,0,3,16,4,2,11,36
2024-03-29 00:30:00,2,11,15,7,5,10,50
2024-03-29 00:40:00,1,9,16,4,5,11,46
2024-03-29 00:50:00,0,4,16,3,2,9,34
2024-03-29 01:00:00,3,5,18,7,4,10,47
2024-03-29 01:10:00,0,7,12,2,4,9,34
2024-03-29 01:20:00,3,5,16,5,4,9,42
2024-03-29 01:30:00,2,4,10,4,2,4,26
2024-03-29 01:40:00,0,2,12,5,1,7,27
2024-03-29 01:50:00,0,5,4,0,3,3,15
2024-03-29 02:00:00,1,7,8,2,6,5,29
2024-03-29 02:10:00,0,2,7,2,2,7,20
2024-03-29 02:20:00,0,12,4,1,5,3,25
2024-03-29 02:30:00,0,2,5,2,1,3,13
2024-03-29 02:40:00,3,2,7,3,1,4,20
2024-03-29 02:50:00,0,0,7,1,0,5,13
2024-03-29 03:00:00,0,0,4,5,0,1,10
2024-03-29 03:10:00,0,8,2,2,4,4,20
2024-03-29 03:20:00,0,4,5,0,2,2,13
2024-03-29 03:30:00,0,1,5,1,1,3,11
2024-03-29 03:40:00,0,1,3,1,1,2,8
2024-03-29 03:50:00,0,6,5,1,3,5,20
2024-03-29 04:00:00,0,2,8,1,1,4,16
2024-03-29 04:10:00,0,0,9,2,0,5,16
2024-03-29 04:20:00,0,5,5,1,4,3,18
2024-03-29 04:30:00,0,3,5,1,2,4,15
2024-03-29 04:40:00,0,8,2,1,5,1,17
2024-03-29 04:50:00,0,7,4,0,3,2,16
2024-03-29 05:00:00,0,9,3,0,5,2,19
2024-03-29 05:10:00,0,5,5,3,3,7,23
2024-03-29 05:20:00,0,16,4,2,13,5,40
2024-03-29 05:30:00,1,11,1,1,9,3,26
2024-03-29 05:40:00,0,5,1,0,4,1,11
2024-03-29 05:50:00,0,5,6,1,4,4,20
2024-03-29 06:00:00,2,3,4,4,5,4,22
2024-03-29 06:10:00,0,1,1,0,1,1,4
2024-03-29 06:20:00,0,7,9,9,7,9,41
2024-03-29 06:30:00,1,8,8,6,7,7,37
2024-03-29 06:40:00,0,4,4,1,4,5,18
2024-03-29 06:50:00,0,1,8,1,1,5,16
2024-03-29 07:00:00,1,6,4,6,6,3,26
2024-03-29 07:10:00,2,7,4,1,8,4,26
2024-03-29 07:20:00,0,5,6,1,5,3,20
2024-03-29 07:30:00,1,5,5,1,6,6,24
2024-03-29 07:40:00,1,10,9,3,10,10,43
2024-03-29 07:50:00,0,3,8,3,5,6,25
2024-03-29 08:00:00,1,9,1,4,10,2,27
2024-03-29 08:10:00,0,5,6,0,5,9,25
2024-03-29 08:20:00,1,9,10,2,9,11,42
2024-03-29 08:30:00,2,12,13,2,12,13,54
2024-03-29 08:40:00,0,8,13,2,8,10,41
2024-03-29 08:50:00,0,7,12,1,7,12,39
2024-03-29 09:00:00,2,13,9,2,15,13,54
2024-03-29 09:10:00,2,12,6,3,12,5,40
2024-03-29 09:20:00,0,12,10,5,14,13,54
2024-03-29 09:30:00,0,26,17,0,27,21,91
2024-03-29 09:40:00,3,13,16,4,15,21,72
2024-03-29 09:50:00,0,19,18,5,21,13,76
2024-03-29 10:00:00,2,19,18,4,22,14,79
2024-03-29 10:10:00,1,29,17,7,27,16,97
2024-03-29 10:20:00,3,17,23,8,20,17,88
2024-03-29 10:30:00,3,14,15,2,16,23,73
2024-03-29 10:40:00,1,26,18,9,31,21,106
2024-03-29 10:50:00,1,19,17,9,23,13,82
2024-03-29 11:00:00,1,25,25,6,28,30,115
2024-03-29 11:10:00,1,11,18,10,15,19,74
2024-03-29 11:20:00,1,16,21,6,16,22,82
2024-03-29 11:30:00,2,20,20,7,21,24,94
2024-03-29 11:40:00,5,28,25,8,30,31,127
2024-03-29 11:50:00,1,19,30,7,25,30,112
2024-03-29 12:00:00,5,22,18,10,29,30,114
2024-03-29 12:10:00,3,24,21,4,27,18,97
2024-03-29 12:20:00,1,30,22,4,40,24,121
2024-03-29 12:30:00,1,25,19,8,28,22,103
2024-03-29 12:40:00,4,26,24,5,31,25,115
2024-03-29 12:50:00,0,15,25,14,17,31,102
2024-03-29 13:00:00,1,34,24,7,42,31,139
2024-03-29 13:10:00,2,22,17,7,25,23,96
2024-03-29 13:20:00,0,30,23,7,32,20,112
2024-03-29 13:30:00,3,22,23,9,28,31,116
2024-03-29 13:40:00,2,21,21,10,26,27,107
2024-03-29 13:50:00,2,35,31,15,36,32,151
2024-03-29 14:00:00,3,24,24,12,26,42,131
2024-03-29 14:10:00,2,32,41,12,39,46,172
2024-03-29 14:20:00,0,30,27,11,39,29,136
2024-03-29 14:30:00,2,26,40,17,30,47,162
2024-03-29 14:40:00,2,22,42,11,25,42,144
2024-03-29 14:50:00,1,26,28,7,27,32,121
2024-03-29 15:00:00,4,23,29,11,23,33,123
2024-03-29 15:10:00,5,27,26,8,32,35,133
2024-03-29 15:20:00,1,15,25,7,23,34,105
2024-03-29 15:30:00,4,26,28,12,31,40,141
2024-03-29 15:40:00,1,30,31,9,34,33,138
2024-03-29 15:50:00,3,18,22,12,19,22,96
2024-03-29 16:00:00,3,21,27,9,24,32,116
2024-03-29 16:10:00,3,22,23,12,29,33,122
2024-03-29 16:20:00,0,26,21,5,30,19,101
2024-03-29 16:30:00,5,26,29,7,28,31,126
2024-03-29 16:40:00,2,32,30,11,38,32,145
2024-03-29 16:50:00,0,24,21,6,27,25,103
2024-03-29 17:00:00,1,32,25,9,37,36,140
2024-03-29 17:10:00,2,26,25,11,25,26,115
2024-03-29 17:20:00,1,26,33,8,29,41,138
2024-03-29 17:30:00,4,23,34,10,25,40,136
2024-03-29 17:40:00,3,25,14,15,30,19,106
2024-03-29 17:50:00,2,22,20,7,22,20,93
2024-03-29 18:00:00,1,21,24,12,25,40,123
2024-03-29 18:10:00,2,22,29,6,24,38,121
2024-03-29 18:20:00,0,31,20,12,34,33,130
2024-03-29 18:30:00,3,26,29,7,30,36,131
2024-03-29 18:40:00,2,18,19,11,25,33,108
2024-03-29 18:50:00,3,21,18,14,33,29,118
2024-03-29 19:00:00,8,20,19,14,24,25,110
2024-03-29 19:10:00,6,24,16,14,22,20,102
2024-03-29 19:20:00,0,23,19,9,23,29,103
2024-03-29 19:30:00,3,16,21,10,13,29,92
2024-03-29 19:40:00,10,25,17,5,29,22,108
2024-03-29 19:50:00,6,18,18,9,18,23,92
2024-03-29 20:00:00,3,20,20,8,19,24,94
2024-03-29 20:10:00,2,25,17,9,25,21,99
2024-03-29 20:20:00,4,28,20,12,26,18,108
2024-03-29 20:30:00,4,19,19,13,22,21,98
2024-03-29 20:40:00,7,20,22,9,17,21,96
2024-03-29 20:50:00,3,24,10,7,20,12,76
2024-03-29 21:00:00,4,19,13,4,20,16,76
2024-03-29 21:10:00,2,25,16,7,17,18,85
2024-03-29 21:20:00,2,20,21,12,16,18,89
2024-03-29 21:30:00,4,19,18,9,12,19,81
2024-03-29 21:40:00,4,22,23,9,20,21,99
2024-03-29 21:50:00,3,11,18,10,10,24,76
2024-03-29 22:00:00,5,10,25,9,13,32,94
2024-03-29 22:10:00,6,13,21,15,14,25,94
2024-03-29 22:20:00,1,16,20,8,10,18,73
2024-03-29 22:30:00,3,21,17,11,16,22,90
2024-03-29 22:40:00,6,15,16,9,12,16,74
2024-03-29 22:50:00,2,9,9,11,7,9,47
2024-03-29 23:00:00,5,17,16,6,12,20,76
2024-03-29 23:10:00,0,6,14,8,5,11,44
2024-03-29 23:20:00,0,13,11,5,10,12,51
2024-03-29 23:30:00,2,7,14,7,11,14,55
2024-03-29 23:40:00,0,3,9,8,3,10,33
2024-03-29 23:50:00,1,8,11,4,7,11,42
2024-03-30 00:00:00,2,9,7,9,6,5,38
2024-03-30 00:10:00,3,9,7,8,6,9,42
2024-03-30 00:20:00,1,9,9,5,7,7,38
2024-03-30 00:30:00,2,9,9,6,7,7,40
2024-03-30 00:40:00,2,5,10,5,4,11,37
2024-03-30 00:50:00,0,3,7,7,2,5,24
2024-03-30 01:00:00,4,14,7,2,9,5,41
2024-03-30 01:10:00,0,10,5,3,8,4,30
2024-03-30 01:20:00,2,5,5,6,4,7,29
2024-03-30 01:30:00,0,2,5,3,2,9,21
2024-03-30 01:40:00,1,1,5,1,1,4,13
2024-03-30 01:50:00,2,3,2,2,1,3,13
2024-03-30 02:00:00,2,5,6,2,3,6,24
2024-03-30 02:10:00,0,3,5,4,2,5,19
2024-03-30 02:20:00,0,0,6,2,0,6,14
2024-03-30 02:30:00,2,6,6,2,4,3,23
2024-03-30 02:40:00,0,7,2,0,8,2,19
2024-03-30 02:50:00,0,5,4,1,3,4,17
2024-03-30 03:00:00,2,3,4,2,2,3,16
2024-03-30 03:10:00,0,2,2,2,2,2,10
2024-03-30 03:20:00,0,3,5,1,2,4,15
2024-03-30 03:30:00,1,3,4,1,2,3,14
2024-03-30 03:40:00,0,2,6,3,2,6,19
2024-03-30 03:50:00,1,2,2,0,1,2,8
2024-03-30 04:00:00,1,3,4,3,2,3,16
2024-03-30 04:10:00,4,2,4,1,2,3,16
2024-03-30 04:20:00,1,2,5,3,2,3,16
2024-03-30 04:30:00,0,3,2,1,2,2,10
2024-03-30 04:40:00,0,5,1,0,5,1,12
2024-03-30 04:50:00,3,8,1,1,5,1,19
2024-03-30 05:00:00,0,11,7,4,12,4,38
2024-03-30 05:10:00,1,2,9,7,4,7,30
2024-03-30 05:20:00,1,6,9,6,7,5,34
2024-03-30 05:30:00,0,10,6,6,9,6,37
2024-03-30 05:40:00,2,9,5,5,7,2,30
2024-03-30 05:50:00,3,8,5,6,5,5,32
2024-03-30 06:00:00,0,6,5,0,6,8,25
2024-03-30 06:10:00,1,3,6,4,4,5,23
2024-03-30 06:20:00,2,13,9,4,15,5,48
2024-03-30 06:30:00,0,7,5,3,7,3,25
2024-03-30 06:40:00,2,13,7,3,14,7,46
2024-03-30 06:50:00,2,10,10,6,11,9,48
2024-03-30 07:00:00,0,12,5,1,12,5,35
2024-03-30 07:10:00,1,13,11,2,14,13,54
2024-03-30 07:20:00,3,26,4,5,24,4,66
2024-03-30 07:30:00,0,11,10,7,11,11,50
2024-03-30 07:40:00,1,11,18,2,12,21,65
2024-03-30 07:50:00,2,15,10,3,17,9,56
2024-03-30 08:00:00,0,11,23,4,12,23,73
2024-03-30 08:10:00,1,22,14,11,23,17,88
2024-03-30 08:20:00,4,16,23,7,19,20,89
2024-03-30 08:30:00,1,26,14,6,28,17,92
2024-03-30 08:40:00,2,22,15,5,27,19,90
2024-03-30 08:50:00,2,26,15,6,33,19,101
2024-03-30 09:00:00,2,26,15,3,27,18,91
2024-03-30 09:10:00,3,31,10,11,30,13,98
2024-03-30 09:20:00,2,30,17,9,44,19,121
2024-03-30 09:30:00,1,44,20,10,53,21,149
2024-03-30 09:40:00,8,34,22,9,38,31,142
2024-03-30 09:50:00,3,37,31,15,47,34,167
2024-03-30 10:00:00,2,38,24,8,45,30,147
2024-03-30 10:10:00,2,42,28,12,55,32,171
2024-03-30 10:20:00,5,38,22,9,53,33,160
2024-03-30 10:30:00,0,38,31,13,58,28,168
2024-03-30 10:40:00,2,33,28,18,62,37,180
2024-03-30 10:50:00,2,31,29,15,42,43,162
2024-03-30 11:00:00,1,25,30,13,33,30,132
2024-03-30 11:10:00,3,38,35,9,50,49,184
2024-03-30 11:20:00,5,25,41,9,37,51,168
2024-03-30 11:30:00,3,47,40,18,62,48,218
2024-03-30 11:40:00,1,34,37,15,42,49,178
2024-03-30 11:50:00,2,39,53,11,46,62,213
2024-03-30 12:00:00,1,27,40,9,43,53,173
2024-03-30 12:10:00,4,24,43,12,39,50,172
2024-03-30 12:20:00,1,41,31,13,48,42,176
2024-03-30 12:30:00,3,34,31,17,43,41,169
2024-03-30 12:40:00,3,37,35,15,50,58,198
2024-03-30 12:50:00,5,28,33,9,48,49,172
2024-03-30 13:00:00,3,40,37,6,54,59,199
2024-03-30 13:10:00,1,32,44,9,39,53,178
2024-03-30 13:20:00,4,30,32,8,46,56,176
2024-03-30 13:30:00,3,44,40,17,52,57,213
2024-03-30 13:40:00,1,32,46,9,40,58,186
2024-03-30 13:50:00,2,47,46,22,52,62,231
2024-03-30 14:00:00,3,28,37,12,43,46,169
2024-03-30 14:10:00,3,27,25,13,44,38,150
2024-03-30 14:20:00,1,40,36,11,50,62,200
2024-03-30 14:30:00,3,43,50,18,48,75,237
2024-03-30 14:40:00,1,36,33,18,45,44,177
2024-03-30 14:50:00,3,29,44,13,37,49,175
2024-03-30 15:00:00,1,22,38,20,31,55,167
2024-03-30 15:10:00,3,21,31,19,31,59,164
2024-03-30 15:20:00,2,24,27,19,39,55,166
2024-03-30 15:30:00,4,26,34,19,30,45,158
2024-03-30 15:40:00,2,41,40,13,52,49,197
2024-03-30 15:50:00,4,20,38,10,36,43,151
2024-03-30 16:00:00,0,27,35,13,32,53,160
2024-03-30 16:10:00,5,27,34,7,33,55,161
2024-03-30 16:20:00,3,31,35,12,47,44,172
2024-03-30 16:30:00,1,33,32,17,50,52,185
2024-03-30 16:40:00,3,36,26,7,47,37,156
2024-03-30 16:50:00,2,37,41,12,40,58,190
2024-03-30 17:00:00,0,39,31,11,42,37,160
2024-03-30 17:10:00,3,21,33,11,28,51,147
2024-03-30 17:20:00,5,41,39,15,50,51,201
2024-03-30 17:30:00,1,38,40,15,43,51,188
2024-03-30 17:40:00,4,34,39,10,34,53,174
2024-03-30 17:50:00,4,38,39,13,36,50,180
2024-03-30 18:00:00,4,31,32,16,30,40,153
2024-03-30 18:10:00,4,31,26,19,38,42,160
2024-03-30 18:20:00,3,29,36,18,33,37,156
2024-03-30 18:30:00,4,29,38,16,33,47,167
2024-03-30 18:40:00,3,33,36,14,36,39,161
2024-03-30 18:50:00,2,23,25,11,25,29,115
2024-03-30 19:00:00,3,30,42,15,29,43,162
2024-03-30 19:10:00,2,40,42,8,28,40,160
2024-03-30 19:20:00,1,43,22,11,26,17,120
2024-03-30 19:30:00,2,18,37,7,10,27,101
2024-03-30 19:40:00,3,52,37,8,33,31,164
2024-03-30 19:50:00,4,49,41,10,28,34,166
2024-03-30 20:00:00,0,43,40,9,22,33,147
2024-03-30 20:10:00,1,48,36,9,28,32,154
2024-03-30 20:20:00,3,35,18,9,19,18,102
2024-03-30 20:30:00,1,32,36,8,20,24,121
2024-03-30 20:40:00,4,33,24,13,19,26,119
2024-03-30 20:50:00,1,32,29,12,18,23,115
2024-03-30 21:00:00,0,27,32,6,16,25,106
2024-03-30 21:10:00,6,25,33,15,13,20,112
2024-03-30 21:20:00,7,21,21,9,13,16,87
2024-03-30 21:30:00,5,26,28,9,13,17,98
2024-03-30 21:40:00,5,18,22,9,11,21,86
2024-03-30 21:50:00,1,25,23,5,13,24,91
2024-03-30 22:00:00,0,45,30,6,24,23,128
2024-03-30 22:10:00,3,32,29,9,19,28,120
2024-03-30 22:20:00,2,33,17,8,19,14,93
2024-03-30 22:30:00,4,11,29,6,8,24,82
2024-03-30 22:40:00,6,24,22,5,14,15,86
2024-03-30 22:50:00,0,10,30,3,10,23,76
2024-03-30 23:00:00,7,28,38,8,17,29,127
2024-03-30 23:10:00,2,36,32,6,18,27,121
2024-03-30 23:20:00,4,32,20,4,16,20,96
2024-03-30 23:30:00,4,18,19,2,12,19,74
2024-03-30 23:40:00,3,19,8,4,10,5,49
2024-03-30 23:50:00,0,21,17,4,11,10,63
2024-03-31 00:00:00,1,9,21,3,8,14,56
2024-03-31 00:10:00,1,9,12,5,5,8,40
2024-03-31 00:20:00,0,8,13,1,4,9,35
2024-03-31 00:30:00,0,5,14,2,3,14,38
2024-03-31 00:40:00,1,14,16,3,9,11,54
2024-03-31 00:50:00,1,7,16,9,4,11,48
2024-03-31 01:00:00,5,7,8,3,6,9,38
2024-03-31 01:10:00,0,5,13,1,3,11,33
2024-03-31 01:20:00,0,10,13,5,5,11,44
2024-03-31 01:30:00,0,6,7,5,4,7,29
2024-03-31 01:40:00,1,9,5,2,6,2,25
2024-03-31 01:50:00,0,3,6,2,2,9,22
2024-03-31 02:00:00,0,0,0,0,0,0,0
2024-03-31 02:10:00,0,0,0,0,0,0,0
2024-03-31 02:20:00,0,0,0,0,0,0,0
2024-03-31 02:30:00,0,0,0,0,0,0,0
2024-03-31 02:40:00,0,0,0,0,0,0,0
2024-03-31 02:50:00,0,0,0,0,0,0,0
2024-03-31 03:00:00,0,0,0,0,0,0,0
2024-03-31 03:10:00,0,0,0,0,0,0,0
2024-03-31 03:20:00,0,0,0,0,0,0,0
2024-03-31 03:30:00,0,0,0,0,0,0,0
2024-03-31 03:40:00,0,0,0,0,0,0,0
2024-03-31 03:50:00,0,0,0,0,0,0,0
2024-03-31 04:00:00,2,4,6,6,4,6,28
2024-03-31 04:10:00,0,3,10,6,3,10,32
2024-03-31 04:20:00,1,1,5,4,1,3,15
2024-03-31 04:30:00,0,4,2,3,3,3,15
2024-03-31 04:40:00,0,3,6,3,3,5,20
2024-03-31 04:50:00,0,2,1,1,2,1,7
2024-03-31 05:00:00,0,4,9,4,5,8,30
2024-03-31 05:10:00,0,3,7,7,3,8,28
2024-03-31 05:20:00,2,5,2,2,6,4,21
2024-03-31 05:30:00,0,4,1,1,4,1,11
2024-03-31 05:40:00,0,8,3,10,8,2,31
2024-03-31 05:50:00,1,4,4,1,3,3,16
2024-03-31 06:00:00,1,1,11,4,1,11,29
2024-03-31 06:10:00,2,5,2,4,5,2,20
2024-03-31 06:20:00,1,6,10,10,6,9,42
2024-03-31 06:30:00,1,2,8,4,5,8,28
2024-03-31 06:40:00,0,3,7,2,3,5,20
2024-03-31 06:50:00,0,8,4,3,6,3,24
2024-03-31 07:00:00,3,2,2,2,5,2,16
2024-03-31 07:10:00,0,7,2,1,7,1,18
2024-03-31 07:20:00,0,4,4,3,4,4,19
2024-03-31 07:30:00,1,5,6,1,7,5,25
2024-03-31 07:40:00,0,3,5,1,3,3,15
2024-03-31 07:50:00,0,6,6,3,6,6,27
2024-03-31 08:00:00,1,7,9,1,7,11,36
2024-03-31 08:10:00,0,7,9,1,7,8,32
2024-03-31 08:20:00,0,14,16,4,15,23,72
2024-03-31 08:30:00,2,8,13,3,11,18,55
2024-03-31 08:40:00,1,10,10,4,11,12,48
2024-03-31 08:50:00,0,14,12,1,14,8,49
2024-03-31 09:00:00,4,11,11,2,11,9,48
2024-03-31 09:10:00,2,18,15,2,18,17,72
2024-03-31 09:20:00,0,15,18,8,16,17,74
2024-03-31 09:30:00,2,19,17,0,20,17,75
2024-03-31 09:40:00,2,18,23,3,24,25,95
2024-03-31 09:50:00,0,21,21,2,21,20,85
2024-03-31 10:00:00,2,23,16,6,23,17,87
2024-03-31 10:10:00,6,28,24,3,23,23,107
2024-03-31 10:20:00,0,23,19,7,20,19,88
2024-03-31 10:30:00,1,21,20,6,22,21,91
2024-03-31 10:40:00,4,29,29,5,32,31,130
2024-03-31 10:50:00,0,22,33,13,25,40,133
2024-03-31 11:00:00,2,23,27,8,25,24,109
2024-03-31 11:10:00,3,24,32,10,20,30,119
2024-03-31 11:20:00,0,27,29,5,27,32,120
2024-03-31 11:30:00,3,33,28,6,33,34,137
2024-03-31 11:40:00,2,35,26,10,37,29,139
2024-03-31 11:50:00,0,33,41,5,37,50,166
2024-03-31 12:00:00,2,36,45,15,41,49,188
2024-03-31 12:10:00,3,38,34,8,40,37,160
2024-03-31 12:20:00,4,31,30,9,34,34,142
2024-03-31 12:30:00,3,27,37,6,29,43,145
2024-03-31 12:40:00,2,20,36,10,20,39,127
2024-03-31 12:50:00,1,39,37,11,31,41,160
2024-03-31 13:00:00,2,46,27,12,41,37,165
2024-03-31 13:10:00,2,21,30,10,19,38,120
2024-03-31 13:20:00,2,43,27,6,38,32,148
2024-03-31 13:30:00,4,28,29,6,32,42,141
2024-03-31 13:40:00,4,42,28,11,44,36,165
2024-03-31 13:50:00,0,20,35,11,35,51,152
2024-03-31 14:00:00,4,27,28,8,38,32,137
2024-03-31 14:10:00,3,37,34,15,47,48,184
2024-03-31 14:20:00,2,31,34,11,36,44,158
2024-03-31 14:30:00,5,42,42,9,43,45,186
2024-03-31 14:40:00,4,34,39,13,33,40,163
2024-03-31 14:50:00,0,34,40,11,39,54,178
2024-03-31 15:00:00,4,31,37,10,55,45,182
2024-03-31 15:10:00,2,32,26,14,35,39,148
2024-03-31 15:20:00,0,34,27,13,45,39,158
2024-03-31 15:30:00,3,37,32,11,37,36,156
2024-03-31 15:40:00,4,36,33,13,49,37,172
2024-03-31 15:50:00,4,32,24,8,31,23,122
2024-03-31 16:00:00,3,28,28,13,32,38,142
2024-03-31 16:10:00,4,30,29,8,41,40,152
2024-03-31 16:20:00,0,21,28,10,31,34,124
2024-03-31 16:30:00,1,36,29,12,48,37,163
2024-03-31 16:40:00,4,25,26,11,28,33,127
2024-03-31 16:50:00,1,26,34,9,32,38,140
2024-03-31 17:00:00,3,28,34,7,28,37,137
2024-03-31 17:10:00,2,26,33,15,31,40,147
2024-03-31 17:20:00,3,35,30,15,33,34,150
2024-03-31 17:30:00,3,28,31,10,29,38,139
2024-03-31 17:40:00,3,32,26,9,35,37,142
2024-03-31 17:50:00,4,34,39,11,32,45,165
2024-03-31 18:00:00,1,27,19,13,27,26,113
2024-03-31 18:10:00,3,32,26,11,37,32,141
2024-03-31 18:20:00,1,36,25,10,41,33,146
2024-03-31 18:30:00,1,25,32,12,24,32,126
2024-03-31 18:40:00,3,38,32,10,38,32,153
2024-03-31 18:50:00,3,21,40,5,22,46,137
2024-03-31 19:00:00,7,26,33,3,37,45,151
2024-03-31 19:10:00,5,20,29,11,25,41,131
2024-03-31 19:20:00,5,27,25,14,43,40,154
2024-03-31 19:30:00,8,30,33,11,39,35,156
2024-03-31 19:40:00,4,22,33,13,33,39,144
2024-03-31 19:50:00,0,24,22,15,25,30,116
2024-03-31 20:00:00,4,17,27,12,15,27,102
2024-03-31 20:10:00,4,22,31,11,18,24,110
2024-03-31 20:20:00,2,34,27,9,19,20,111
2024-03-31 20:30:00,3,44,28,8,27,20,130
2024-03-31 20:40:00,5,49,36,5,28,22,145
2024-03-31 20:50:00,0,33,31,7,17,24,112
2024-03-31 21:00:00,3,44,29,3,25,17,121
2024-03-31 21:10:00,3,37,29,10,22,19,120
2024-03-31 21:20:00,0,45,28,7,29,21,130
2024-03-31 21:30:00,3,24,18,10,17,10,82
2024-03-31 21:40:00,5,34,31,5,22,22,119
2024-03-31 21:50:00,0,35,30,2,22,23,112
2024-03-31 22:00:00,1,33,19,6,18,17,94
2024-03-31 22:10:00,6,34,25,5,22,16,108
2024-03-31 22:20:00,2,32,22,6,19,19,100
2024-03-31 22:30:00,1,22,31,8,15,26,103
2024-03-31 22:40:00,2,22,23,11,14,18,90
2024-03-31 22:50:00,2,22,36,9,13,34,116
2024-03-31 23:00:00,2,14,19,8,9,19,71
2024-03-31 23:10:00,4,13,21,16,12,28,94
2024-03-31 23:20:00,1,11,11,11,7,14,55
2024-03-31 23:30:00,4,8,14,8,12,16,62
2024-03-31 23:40:00,0,7,23,2,5,19,56
2024-03-31 23:50:00,1,12,8,8,10,11,50
2024-04-01 00:00:00,2,6,13,11,7,13,52
2024-04-01 00:10:00,0,4,11,6,5,10,36
2024-04-01 00:20:00,2,8,9,4,6,9,38
2024-04-01 00:30:00,1,6,7,5,7,8,34
2024-04-01 00:40:00,0,4,7,8,5,7,31
2024-04-01 00:50:00,2,7,9,8,6,7,39
2024-04-01 01:00:00,4,5,12,7,4,11,43
2024-04-01 01:10:00,3,10,6,2,7,7,35
2024-04-01 01:20:00,1,8,5,2,5,8,29
2024-04-01 01:30:00,1,7,8,3,7,7,33
2024-04-01 01:40:00,4,5,4,4,5,4,26
2024-04-01 01:50:00,1,2,3,4,2,2,14
2024-04-01 02:00:00,4,7,8,6,6,4,35
2024-04-01 02:10:00,1,2,5,5,1,4,18
2024-04-01 02:20:00,0,7,6,5,5,7,30
2024-04-01 02:30:00,2,8,4,3,6,7,30
2024-04-01 02:40:00,2,3,6,5,3,6,25
2024-04-01 02:50:00,0,2,1,2,2,2,9
2024-04-01 03:00:00,1,3,7,3,3,3,20
2024-04-01 03:10:00,1,5,1,0,5,1,13
2024-04-01 03:20:00,0,0,2,3,0,2,7
2024-04-01 03:30:00,1,3,2,4,3,2,15
2024-04-01 03:40:00,0,4,4,1,3,4,16
2024-04-01 03:50:00,1,3,5,4,4,5,22
2024-04-01 04:00:00,1,3,1,2,3,2,12
2024-04-01 04:10:00,1,1,3,3,1,3,12
2024-04-01 04:20:00,3,3,1,1,3,1,12
2024-04-01 04:30:00,1,1,5,3,2,5,17
2024-04-01 04:40:00,1,2,1,0,3,1,8
2024-04-01 04:50:00,1,2,4,8,2,3,20
2024-04-01 05:00:00,0,2,4,4,3,3,16
2024-04-01 05:10:00,0,2,3,1,3,3,12
2024-04-01 05:20:00,0,7,2,1,9,2,21
2024-04-01 05:30:00,1,6,3,3,5,2,20
2024-04-01 05:40:00,1,10,3,2,11,3,30
2024-04-01 05:50:00,1,3,7,4,3,6,24
2024-04-01 06:00:00,1,3,11,8,5,10,38
2024-04-01 06:10:00,0,2,3,4,3,6,18
2024-04-01 06:20:00,0,6,7,4,5,5,27
2024-04-01 06:30:00,1,5,3,6,6,4,25
2024-04-01 06:40:00,1,7,7,4,6,9,34
2024-04-01 06:50:00,0,0,4,3,0,4,11
2024-04-01 07:00:00,1,4,4,4,5,3,21
2024-04-01 07:10:00,0,3,1,2,3,1,10
2024-04-01 07:20:00,0,5,4,5,5,3,22
2024-04-01 07:30:00,2,3,7,7,5,8,32
2024-04-01 07:40:00,1,9,2,3,9,1,25
2024-04-01 07:50:00,0,1,4,2,1,2,10
2024-04-01 08:00:00,2,1,2,1,3,1,10
2024-04-01 08:10:00,0,3,4,2,4,4,17
2024-04-01 08:20:00,0,4,2,4,4,2,16
2024-04-01 08:30:00,1,9,8,3,9,8,38
2024-04-01 08:40:00,0,7,6,4,9,4,30
2024-04-01 08:50:00,1,8,9,3,8,8,37
2024-04-01 09:00:00,2,10,5,1,10,5,33
2024-04-01 09:10:00,0,13,8,6,13,8,48
2024-04-01 09:20:00,2,13,9,1,15,13,53
2024-04-01 09:30:00,1,12,12,2,13,14,54
2024-04-01 09:40:00,2,14,12,3,19,14,64
2024-04-01 09:50:00,0,19,7,2,21,8,57
2024-04-01 10:00:00,1,14,16,5,14,14,64
2024-04-01 10:10:00,1,14,10,5,17,10,57
2024-04-01 10:20:00,4,20,18,4,22,19,87
2024-04-01 10:30:00,2,13,8,3,16,9,51
2024-04-01 10:40:00,1,18,21,5,22,31,98
2024-04-01 10:50:00,3,19,19,3,23,26,93
2024-04-01 11:00:00,4,18,18,4,19,20,83
2024-04-01 11:10:00,2,21,19,7,25,25,99
2024-04-01 11:20:00,0,18,22,8,18,25,91
2024-04-01 11:30:00,2,28,25,4,31,26,116
2024-04-01 11:40:00,2,31,30,6,41,34,144
2024-04-01 11:50:00,1,27,24,9,27,31,119
2024-04-01 12:00:00,3,21,29,5,21,27,106
2024-04-01 12:10:00,2,28,29,9,29,36,133
2024-04-01 12:20:00,2,29,13,3,36,15,98
2024-04-01 12:30:00,2,29,26,11,30,23,121
2024-04-01 12:40:00,3,29,29,14,34,29,138
2024-04-01 12:50:00,1,23,16,3,24,20,87
2024-04-01 13:00:00,2,31,22,8,35,23,121
2024-04-01 13:10:00,6,17,35,8,17,41,124
2024-04-01 13:20:00,2,24,22,8,27,31,114
2024-04-01 13:30:00,3,28,33,4,29,36,133
2024-04-01 13:40:00,3,25,20,8,28,26,110
2024-04-01 13:50:00,2,26,25,15,26,22,116
2024-04-01 14:00:00,1,29,30,9,35,37,141
2024-04-01 14:10:00,2,31,29,6,35,35,138
2024-04-01 14:20:00,2,32,21,10,38,23,126
2024-04-01 14:30:00,3,23,33,11,29,38,137
2024-04-01 14:40:00,5,36,31,12,42,36,162
2024-04-01 14:50:00,2,25,34,16,28,41,146
2024-04-01 15:00:00,3,23,30,7,30,35,128
2024-04-01 15:10:00,1,17,28,7,19,38,110
2024-04-01 15:20:00,0,32,29,9,33,32,135
2024-04-01 15:30:00,3,26,30,4,32,34,129
2024-04-01 15:40:00,2,18,25,12,18,34,109
2024-04-01 15:50:00,4,28,17,13,32,23,117
2024-04-01 16:00:00,1,28,24,12,32,30,127
2024-04-01 16:10:00,4,30,22,12,34,30,132
2024-04-01 16:20:00,1,28,24,13,30,25,121
2024-04-01 16:30:00,2,20,18,5,28,21,94
2024-04-01 16:40:00,7,25,31,4,27,37,131
2024-04-01 16:50:00,1,25,29,12,35,32,134
2024-04-01 17:00:00,2,29,22,5,30,21,109
2024-04-01 17:10:00,2,27,34,15,30,41,149
2024-04-01 17:20:00,4,32,36,14,35,35,156
2024-04-01 17:30:00,3,26,33,12,27,34,135
2024-04-01 17:40:00,2,34,29,12,32,32,141
2024-04-01 17:50:00,3,26,33,13,28,33,136
2024-04-01 18:00:00,3,23,28,13,26,32,125
2024-04-01 18:10:00,5,31,38,9,34,38,155
2024-04-01 18:20:00,3,30,26,13,31,26,129
2024-04-01 18:30:00,1,24,30,15,25,31,126
2024-04-01 18:40:00,1,23,23,9,35,27,118
2024-04-01 18:50:00,2,19,29,5,22,30,107
2024-04-01 19:00:00,2,17,28,13,21,31,112
2024-04-01 19:10:00,5,18,26,17,25,32,123
2024-04-01 19:20:00,4,26,27,9,27,29,122
2024-04-01 19:30:00,3,22,28,11,30,39,133
2024-04-01 19:40:00,6,23,30,15,23,38,135
2024-04-01 19:50:00,1,28,32,12,30,35,138
2024-04-01 20:00:00,2,18,20,14,17,27,98
2024-04-01 20:10:00,3,28,29,11,21,21,113
2024-04-01 20:20:00,0,30,27,9,18,21,105
2024-04-01 20:30:00,2,35,18,2,24,14,95
2024-04-01 20:40:00,1,38,27,9,21,24,120
2024-04-01 20:50:00,0,31,12,7,18,14,82
2024-04-01 21:00:00,1,43,20,8,25,15,112
2024-04-01 21:10:00,4,57,26,3,33,24,147
2024-04-01 21:20:00,7,52,31,6,30,24,150
2024-04-01 21:30:00,3,42,29,10,24,23,131
2024-04-01 21:40:00,3,17,20,6,10,13,69
2024-04-01 21:50:00,0,15,33,5,8,21,82
2024-04-01 22:00:00,4,27,21,8,15,16,91
2024-04-01 22:10:00,1,13,31,6,7,21,79
2024-04-01 22:20:00,0,25,29,6,14,19,93
2024-04-01 22:30:00,4,19,32,6,11,21,93
2024-04-01 22:40:00,4,21,23,7,11,13,79
2024-04-01 22:50:00,2,14,20,5,9,15,65
2024-04-01 23:00:00,3,11,27,9,6,24,80
2024-04-01 23:10:00,1,18,20,4,11,11,65
2024-04-01 23:20:00,0,4,28,3,2,18,55
2024-04-01 23:30:00,1,13,15,4,8,16,57
2024-04-01 23:40:00,2,7,21,9,4,12,55
2024-04-01 23:50:00,0,13,14,7,10,9,53
2024-04-02 00:00:00,3,19,18,2,12,13,67
2024-04-02 00:10:00,0,5,10,5,3,5,28
2024-04-02 00:20:00,0,10,9,1,5,5,30
2024-04-02 00:30:00,0,4,11,3,2,7,27
2024-04-02 00:40:00,0,1,6,1,1,3,12
2024-04-02 00:50:00,0,2,7,1,1,4,15
2024-04-02 01:00:00,0,12,8,2,7,4,33
2024-04-02 01:10:00,0,0,7,3,0,4,14
2024-04-02 01:20:00,0,11,14,3,5,7,40
2024-04-02 01:30:00,2,6,5,2,4,2,21
2024-04-02 01:40:00,1,4,3,3,2,1,14
2024-04-02 01:50:00,0,4,5,1,2,4,16
2024-04-02 02:00:00,0,2,8,2,1,4,17
2024-04-02 02:10:00,0,1,1,0,1,1,4
2024-04-02 02:20:00,0,2,8,1,1,4,16
2024-04-02 02:30:00,0,0,5,4,0,2,11
2024-04-02 02:40:00,2,4,3,0,2,4,15
2024-04-02 02:50:00,0,2,5,2,1,3,13
2024-04-02 03:00:00,0,4,2,0,2,1,9
2024-04-02 03:10:00,0,0,4,2,0,2,8
2024-04-02 03:20:00,1,9,1,0,6,0,17
2024-04-02 03:30:00,0,9,6,0,5,3,23
2024-04-02 03:40:00,0,4,5,0,2,4,15
2024-04-02 03:50:00,2,4,4,0,3,2,15
2024-04-02 04:00:00,1,7,3,1,5,1,18
2024-04-02 04:10:00,2,2,6,2,1,2,15
2024-04-02 04:20:00,0,6,4,1,4,3,18
2024-04-02 04:30:00,1,11,2,3,7,0,24
2024-04-02 04:40:00,0,14,6,2,8,4,34
2024-04-02 04:50:00,2,8,8,2,4,4,28
2024-04-02 05:00:00,1,17,13,3,14,7,55
2024-04-02 05:10:00,1,27,12,0,15,8,63
2024-04-02 05:20:00,2,37,10,1,25,10,85
2024-04-02 05:30:00,1,58,20,1,35,13,128
2024-04-02 05:40:00,2,41,17,5,27,13,105
2024-04-02 05:50:00,1,47,22,7,33,15,125
2024-04-02 06:00:00,3,66,22,4,44,18,157
2024-04-02 06:10:00,3,59,23,4,53,21,163
2024-04-02 06:20:00,5,108,31,6,70,24,244
2024-04-02 06:30:00,1,91,34,5,58,31,220
2024-04-02 06:40:00,1,81,21,5,52,20,180
2024-04-02 06:50:00,2,78,34,9,74,25,222
2024-04-02 07:00:00,1,76,21,8,77,25,208
2024-04-02 07:10:00,2,81,24,3,90,30,230
2024-04-02 07:20:00,3,78,16,3,98,24,222
2024-04-02 07:30:00,3,56,32,12,82,26,211
2024-04-02 07:40:00,2,58,30,10,96,29,225
2024-04-02 07:50:00,2,65,22,8,86,25,208
2024-04-02 08:00:00,1,45,30,8,65,31,180
2024-04-02 08:10:00,2,50,32,10,67,37,198
2024-04-02 08:20:00,2,41,19,6,92,26,186
2024-04-02 08:30:00,5,35,40,9,42,44,175
2024-04-02 08:40:00,5,69,40,8,104,46,272
2024-04-02 08:50:00,1,52,18,5,72,23,171
2024-04-02 09:00:00,3,26,24,8,40,26,127
2024-04-02 09:10:00,3,41,35,5,52,36,172
2024-04-02 09:20:00,3,34,27,10,57,29,160
2024-04-02 09:30:00,2,35,27,7,59,28,158
2024-04-02 09:40:00,1,40,30,7,44,33,155
2024-04-02 09:50:00,4,41,22,10,48,30,155
2024-04-02 10:00:00,4,30,25,12,33,28,132
2024-04-02 10:10:00,3,39,31,13,49,33,168
2024-04-02 10:20:00,1,26,30,9,41,28,135
2024-04-02 10:30:00,1,36,26,7,47,33,150
2024-04-02 10:40:00,2,37,42,8,46,44,179
2024-04-02 10:50:00,2,40,103,12,50,37,244
2024-04-02 11:00:00,3,33,31,16,52,35,170
2024-04-02 11:10:00,3,19,30,16,29,39,136
2024-04-02 11:20:00,3,41,31,15,48,35,173
2024-04-02 11:30:00,2,42,45,15,50,45,199
2024-04-02 11:40:00,4,38,29,11,43,45,170
2024-04-02 11:50:00,4,26,40,10,30,53,163
2024-04-02 12:00:00,2,29,38,12,42,55,178
2024-04-02 12:10:00,2,34,36,12,46,39,169
2024-04-02 12:20:00,5,30,33,13,53,42,176
2024-04-02 12:30:00,7,37,37,14,45,35,175
2024-04-02 12:40:00,2,27,33,12,36,49,159
2024-04-02 12:50:00,1,26,39,14,37,47,164
2024-04-02 13:00:00,2,19,39,10,22,40,132
2024-04-02 13:10:00,2,23,39,10,56,50,180
2024-04-02 13:20:00,2,34,30,15,44,47,172
2024-04-02 13:30:00,6,33,33,9,54,46,181
2024-04-02 13:40:00,1,36,48,11,42,65,203
2024-04-02 13:50:00,3,40,40,13,54,52,202
2024-04-02 14:00:00,6,27,45,16,33,50,177
2024-04-02 14:10:00,4,35,39,15,48,48,189
2024-04-02 14:20:00,4,39,37,11,44,51,186
2024-04-02 14:30:00,4,40,47,27,47,70,235
2024-04-02 14:40:00,1,26,36,20,30,50,163
2024-04-02 14:50:00,3,28,34,14,37,54,170
2024-04-02 15:00:00,3,49,56,13,48,64,233
2024-04-02 15:10:00,1,39,60,12,49,82,243
2024-04-02 15:20:00,3,38,52,14,48,75,230
2024-04-02 15:30:00,3,36,51,17,48,101,256
2024-04-02 15:40:00,3,40,54,20,44,97,258
2024-04-02 15:50:00,2,25,49,15,31,82,204
2024-04-02 16:00:00,4,33,50,22,43,78,230
2024-04-02 16:10:00,3,38,59,23,50,98,271
2024-04-02 16:20:00,5,44,65,20,54,86,274
2024-04-02 16:30:00,4,26,52,23,43,82,230
2024-04-02 16:40:00,2,27,61,16,33,103,242
2024-04-02 16:50:00,6,33,70,17,45,106,277
2024-04-02 17:00:00,2,30,54,17,48,97,248
2024-04-02 17:10:00,6,40,51,14,44,86,241
2024-04-02 17:20:00,3,37,71,21,40,100,272
2024-04-02 17:30:00,3,37,37,14,39,79,209
2024-04-02 17:40:00,1,45,41,17,48,71,223
2024-04-02 17:50:00,4,39,53,15,43,69,223
2024-04-02 18:00:00,4,35,58,17,33,67,214
2024-04-02 18:10:00,3,43,55,28,36,69,234
2024-04-02 18:20:00,4,40,41,20,35,74,214
2024-04-02 18:30:00,5,48,49,16,41,51,210
2024-04-02 18:40:00,2,31,39,13,39,63,187
2024-04-02 18:50:00,0,23,42,20,24,59,168
2024-04-02 19:00:00,3,22,39,18,23,50,155
2024-04-02 19:10:00,2,27,34,8,33,58,162
2024-04-02 19:20:00,1,19,38,16,26,40,140
2024-04-02 19:30:00,3,18,43,12,19,58,153
2024-04-02 19:40:00,2,26,30,17,35,42,152
2024-04-02 19:50:00,2,27,30,9,30,31,129
2024-04-02 20:00:00,3,28,28,13,27,31,130
2024-04-02 20:10:00,4,32,26,14,23,34,133
2024-04-02 20:20:00,2,31,25,9,16,22,105
2024-04-02 20:30:00,1,28,29,7,20,21,106
2024-04-02 20:40:00,5,28,30,8,21,23,115
2024-04-02 20:50:00,0,46,31,9,24,18,128
2024-04-02 21:00:00,3,31,17,10,20,13,94
2024-04-02 21:10:00,1,41,18,11,21,14,106
2024-04-02 21:20:00,0,24,23,5,15,15,82
2024-04-02 21:30:00,3,32,23,8,20,16,102
2024-04-02 21:40:00,7,29,19,9,19,16,99
2024-04-02 21:50:00,3,14,21,7,9,20,74
2024-04-02 22:00:00,3,32,25,10,19,17,106
2024-04-02 22:10:00,1,27,21,8,17,19,93
2024-04-02 22:20:00,0,22,32,7,10,24,95
2024-04-02 22:30:00,1,21,23,7,15,23,90
2024-04-02 22:40:00,1,11,24,9,7,18,70
2024-04-02 22:50:00,2,13,31,7,8,16,77
2024-04-02 23:00:00,3,21,23,4,13,19,83
2024-04-02 23:10:00,4,18,23,3,10,18,76
2024-04-02 23:20:00,0,8,22,5,4,13,52
2024-04-02 23:30:00,3,16,25,6,9,18,77
2024-04-02 23:40:00,0,10,8,8,5,4,35
2024-04-02 23:50:00,0,10,14,4,5,10,43
2024-04-03 00:00:00,1,4,9,2,2,6,24
2024-04-03 00:10:00,0,10,10,3,6,4,33
2024-04-03 00:20:00,0,5,5,1,3,6,20
2024-04-03 00:30:00,0,4,6,4,2,3,19
2024-04-03 00:40:00,0,5,6,6,3,5,25
2024-04-03 00:50:00,0,3,6,2,2,4,17
2024-04-03 01:00:00,0,7,7,3,3,7,27
2024-04-03 01:10:00,0,2,3,2,2,4,13
2024-04-03 01:20:00,0,11,3,3,7,3,27
2024-04-03 01:30:00,0,3,4,2,2,3,14
2024-04-03 01:40:00,0,2,5,4,2,7,20
2024-04-03 01:50:00,0,3,1,2,2,1,9
2024-04-03 02:00:00,0,4,5,3,2,3,17
2024-04-03 02:10:00,0,2,2,2,1,2,9
2024-04-03 02:20:00,0,4,4,2,3,4,17
2024-04-03 02:30:00,0,0,2,1,0,2,5
2024-04-03 02:40:00,1,2,3,1,1,3,11
2024-04-03 02:50:00,0,5,3,3,3,2,16
2024-04-03 03:00:00,0,0,1,1,0,2,4
2024-04-03 03:10:00,0,5,3,0,3,3,14
2024-04-03 03:20:00,0,4,5,3,3,3,18
2024-04-03 03:30:00,0,5,0,0,3,0,8
2024-04-03 03:40:00,1,8,4,2,4,4,23
2024-04-03 03:50:00,0,10,2,0,5,2,19
2024-04-03 04:00:00,0,0,1,3,0,1,5
2024-04-03 04:10:00,2,7,3,5,7,3,27
2024-04-03 04:20:00,0,6,4,1,4,3,18
2024-04-03 04:30:00,1,7,3,4,5,3,23
2024-04-03 04:40:00,0,7,4,1,6,3,21
2024-04-03 04:50:00,2,8,4,1,5,4,24
2024-04-03 05:00:00,0,15,4,2,10,6,37
2024-04-03 05:10:00,0,24,4,2,17,4,51
2024-04-03 05:20:00,0,26,7,3,20,7,63
2024-04-03 05:30:00,2,44,10,6,39,11,112
2024-04-03 05:40:00,3,32,15,5,31,11,97
2024-04-03 05:50:00,1,42,13,9,35,8,108
2024-04-03 06:00:00,2,32,21,7,32,21,115
2024-04-03 06:10:00,1,40,12,7,47,11,118
2024-04-03 06:20:00,2,43,18,14,53,21,151
2024-04-03 06:30:00,2,56,22,6,50,31,167
2024-04-03 06:40:00,2,40,17,8,76,20,163
2024-04-03 06:50:00,3,30,19,13,43,26,134
2024-04-03 07:00:00,2,64,19,8,98,16,207
2024-04-03 07:10:00,2,49,22,7,84,28,192
2024-04-03 07:20:00,2,63,24,6,78,26,199
2024-04-03 07:30:00,1,78,24,8,110,30,251
2024-04-03 07:40:00,3,52,37,8,82,43,225
2024-04-03 07:50:00,1,47,30,8,72,31,189
2024-04-03 08:00:00,4,60,33,7,89,39,232
2024-04-03 08:10:00,2,56,22,8,74,28,190
2024-04-03 08:20:00,2,48,38,7,75,33,203
2024-04-03 08:30:00,3,40,19,5,63,29,159
2024-04-03 08:40:00,2,40,25,11,63,39,180
2024-04-03 08:50:00,1,54,24,6,76,34,195
2024-04-03 09:00:00,4,36,28,8,42,34,152
2024-04-03 09:10:00,2,38,32,11,56,39,178
2024-04-03 09:20:00,5,39,26,9,46,28,153
2024-04-03 09:30:00,1,33,25,12,55,32,158
2024-04-03 09:40:00,2,36,24,14,53,19,148
2024-04-03 09:50:00,2,36,36,7,50,43,174
2024-04-03 10:00:00,2,27,24,9,37,28,127
2024-04-03 10:10:00,2,50,28,9,59,31,179
2024-04-03 10:20:00,4,40,27,13,50,35,169
2024-04-03 10:30:00,3,32,41,17,40,34,167
2024-04-03 10:40:00,6,50,28,4,53,38,179
2024-04-03 10:50:00,4,38,22,13,52,32,161
2024-04-03 11:00:00,2,29,35,13,39,42,160
2024-04-03 11:10:00,4,27,26,14,40,33,144
2024-04-03 11:20:00,3,31,32,11,51,42,170
2024-04-03 11:30:00,1,30,41,14,38,48,172
2024-04-03 11:40:00,3,35,49,14,40,54,195
2024-04-03 11:50:00,3,38,29,8,54,39,171
2024-04-03 12:00:00,4,22,36,10,37,39,148
2024-04-03 12:10:00,4,29,33,12,42,48,168
2024-04-03 12:20:00,3,36,37,12,38,39,165
2024-04-03 12:30:00,1,25,32,18,40,36,152
2024-04-03 12:40:00,1,25,37,14,32,44,153
2024-04-03 12:50:00,1,37,45,15,46,53,197
2024-04-03 13:00:00,1,25,23,17,36,33,135
2024-04-03 13:10:00,5,28,43,14,39,56,185
2024-04-03 13:20:00,4,21,38,15,26,56,160
2024-04-03 13:30:00,1,35,29,11,61,41,178
2024-04-03 13:40:00,1,38,37,11,51,47,185
2024-04-03 13:50:00,3,24,49,15,33,65,189
2024-04-03 14:00:00,3,23,32,14,43,42,157
2024-04-03 14:10:00,3,23,35,14,33,56,164
2024-04-03 14:20:00,2,37,38,7,54,71,209
2024-04-03 14:30:00,5,28,41,14,36,61,185
2024-04-03 14:40:00,4,31,58,13,39,80,225
2024-04-03 14:50:00,3,16,42,19,24,66,170
2024-04-03 15:00:00,4,36,54,9,50,62,215
2024-04-03 15:10:00,3,34,45,11,44,82,219
2024-04-03 15:20:00,2,35,49,15,47,86,234
2024-04-03 15:30:00,1,19,51,14,39,78,202
2024-04-03 15:40:00,3,26,35,20,47,93,224
2024-04-03 15:50:00,4,32,45,18,38,93,230
2024-04-03 16:00:00,4,32,39,12,40,106,233
2024-04-03 16:10:00,1,44,46,16,52,96,255
2024-04-03 16:20:00,1,25,43,13,39,98,219
2024-04-03 16:30:00,3,28,44,18,59,99,251
2024-04-03 16:40:00,4,38,43,20,40,87,232
2024-04-03 16:50:00,2,25,48,15,46,97,233
2024-04-03 17:00:00,3,43,69,15,50,97,277
2024-04-03 17:10:00,3,41,59,12,55,104,274
2024-04-03 17:20:00,4,33,54,20,38,107,256
2024-04-03 17:30:00,5,23,52,19,38,110,247
2024-04-03 17:40:00,2,37,56,19,57,98,269
2024-04-03 17:50:00,1,20,50,21,35,106,233
2024-04-03 18:00:00,4,26,53,18,50,82,233
2024-04-03 18:10:00,2,31,60,16,40,72,221
2024-04-03 18:20:00,1,23,37,18,37,74,190
2024-04-03 18:30:00,5,25,41,15,33,62,181
2024-04-03 18:40:00,2,25,39,16,33,52,167
2024-04-03 18:50:00,1,23,44,15,22,59,164
2024-04-03 19:00:00,2,24,38,12,34,45,155
2024-04-03 19:10:00,3,21,34,14,29,44,145
2024-04-03 19:20:00,1,30,37,14,40,47,169
2024-04-03 19:30:00,1,19,39,9,18,57,143
2024-04-03 19:40:00,1,20,33,12,31,42,139
2024-04-03 19:50:00,0,12,27,15,14,41,109
2024-04-03 20:00:00,4,18,29,11,20,36,118
2024-04-03 20:10:00,2,13,26,9,13,33,96
2024-04-03 20:20:00,1,32,28,11,18,18,108
2024-04-03 20:30:00,4,29,33,8,25,25,124
2024-04-03 20:40:00,4,23,35,8,22,32,124
2024-04-03 20:50:00,5,24,26,9,12,22,98
2024-04-03 21:00:00,1,24,30,10,19,18,102
2024-04-03 21:10:00,1,31,18,9,22,20,101
2024-04-03 21:20:00,3,33,28,5,20,22,111
2024-04-03 21:30:00,3,38,12,4,27,11,95
2024-04-03 21:40:00,6,15,23,8,14,21,87
2024-04-03 21:50:00,0,20,16,8,12,20,76
2024-04-03 22:00:00,2,11,12,9,11,22,67
2024-04-03 22:10:00,2,20,17,11,22,22,94
2024-04-03 22:20:00,2,16,18,8,15,18,77
2024-04-03 22:30:00,4,7,22,12,7,24,76
2024-04-03 22:40:00,6,19,16,10,16,22,89
2024-04-03 22:50:00,3,5,24,14,6,25,77
2024-04-03 23:00:00,2,5,17,6,3,21,54
2024-04-03 23:10:00,1,9,15,10,8,12,55
2024-04-03 23:20:00,3,5,10,8,6,12,44
2024-04-03 23:30:00,1,8,11,6,8,12,46
2024-04-03 23:40:00,0,4,12,4,3,12,35
2024-04-03 23:50:00,1,1,13,4,1,14,34
2024-04-04 00:00:00,1,4,7,1,3,6,22
2024-04-04 00:10:00,0,4,4,5,3,5,21
2024-04-04 00:20:00,0,4,6,1,5,9,25
2024-04-04 00:30:00,3,4,6,4,3,6,26
2024-04-04 00:40:00,0,6,9,5,4,10,34
2024-04-04 00:50:00,0,2,3,1,2,2,10
2024-04-04 01:00:00,2,6,8,5,4,8,33
2024-04-04 01:10:00,1,7,6,2,5,5,26
2024-04-04 01:20:00,1,2,5,2,2,3,15
2024-04-04 01:30:00,0,2,6,3,2,5,18
2024-04-04 01:40:00,0,0,4,4,0,5,13
2024-04-04 01:50:00,1,5,3,0,3,1,13
2024-04-04 02:00:00,0,0,5,2,0,6,13
2024-04-04 02:10:00,2,4,1,0,3,1,11
2024-04-04 02:20:00,1,5,4,1,3,3,17
2024-04-04 02:30:00,3,2,3,2,2,3,15
2024-04-04 02:40:00,2,5,1,0,4,1,13
2024-04-04 02:50:00,1,1,2,1,2,2,9
2024-04-04 03:00:00,0,3,4,1,2,3,13
2024-04-04 03:10:00,0,0,1,0,0,1,2
2024-04-04 03:20:00,3,7,3,1,4,5,23
2024-04-04 03:30:00,0,1,5,5,1,4,16
2024-04-04 03:40:00,1,3,3,1,3,2,13
2024-04-04 03:50:00,2,3,3,1,3,2,14
2024-04-04 04:00:00,3,4,1,1,4,2,15
2024-04-04 04:10:00,2,3,3,4,3,4,19
2024-04-04 04:20:00,1,1,0,1,1,0,4
2024-04-04 04:30:00,3,9,3,0,8,3,26
2024-04-04 04:40:00,0,5,1,1,4,2,13
2024-04-04 04:50:00,1,11,6,3,8,5,34
2024-04-04 05:00:00,3,10,7,2,8,8,38
2024-04-04 05:10:00,2,26,1,1,23,1,54
2024-04-04 05:20:00,2,28,8,9,21,7,75
2024-04-04 05:30:00,2,40,12,4,29,12,99
2024-04-04 05:40:00,2,44,11,2,37,10,106
2024-04-04 05:50:00,3,20,15,2,24,18,82
2024-04-04 06:00:00,3,23,17,6,33,16,98
2024-04-04 06:10:00,2,37,21,5,34,16,115
2024-04-04 06:20:00,3,65,17,4,53,20,162
2024-04-04 06:30:00,3,62,22,6,69,38,200
2024-04-04 06:40:00,3,50,20,6,71,19,169
2024-04-04 06:50:00,2,47,21,7,63,27,167
2024-04-04 07:00:00,4,68,22,9,79,34,216
2024-04-04 07:10:00,1,59,28,2,76,28,194
2024-04-04 07:20:00,1,74,25,7,92,30,229
2024-04-04 07:30:00,2,61,43,8,78,44,236
2024-04-04 07:40:00,3,55,18,8,80,20,184
2024-04-04 07:50:00,1,50,36,14,73,39,213
2024-04-04 08:00:00,4,65,36,9,86,45,245
2024-04-04 08:10:00,2,57,24,10,82,26,201
2024-04-04 08:20:00,4,41,33,11,73,33,195
2024-04-04 08:30:00,3,56,24,9,82,36,210
2024-04-04 08:40:00,3,49,27,5,75,35,194
2024-04-04 08:50:00,3,49,30,8,65,30,185
2024-04-04 09:00:00,3,36,25,5,46,28,143
2024-04-04 09:10:00,3,28,38,15,40,38,162
2024-04-04 09:20:00,3,42,26,2,45,27,145
2024-04-04 09:30:00,3,42,32,11,62,33,183
2024-04-04 09:40:00,1,41,28,10,64,35,179
2024-04-04 09:50:00,1,29,26,12,35,29,132
2024-04-04 10:00:00,2,47,27,12,61,31,180
2024-04-04 10:10:00,2,34,40,9,40,41,166
2024-04-04 10:20:00,2,38,34,14,42,33,163
2024-04-04 10:30:00,2,31,40,16,43,46,178
2024-04-04 10:40:00,4,36,26,16,47,40,169
2024-04-04 10:50:00,4,31,33,10,42,33,153
2024-04-04 11:00:00,2,31,33,13,39,37,155
2024-04-04 11:10:00,2,31,29,17,48,35,162
2024-04-04 11:20:00,1,21,30,11,25,46,134
2024-04-04 11:30:00,2,29,30,8,32,35,136
2024-04-04 11:40:00,2,32,39,9,45,46,173
2024-04-04 11:50:00,0,39,31,12,49,38,169
2024-04-04 12:00:00,5,29,22,14,39,35,144
2024-04-04 12:10:00,3,31,26,1,36,27,124
2024-04-04 12:20:00,1,22,36,11,43,45,158
2024-04-04 12:30:00,2,28,39,17,39,47,172
2024-04-04 12:40:00,4,23,27,11,31,40,136
2024-04-04 12:50:00,2,28,37,9,50,48,174
2024-04-04 13:00:00,1,41,41,11,52,49,195
2024-04-04 13:10:00,5,23,37,8,36,45,154
2024-04-04 13:20:00,1,32,36,16,43,59,187
2024-04-04 13:30:00,6,24,37,14,47,49,177
2024-04-04 13:40:00,3,32,30,22,39,56,182
2024-04-04 13:50:00,4,34,43,12,41,57,191
2024-04-04 14:00:00,3,25,29,17,37,48,159
2024-04-04 14:10:00,1,29,38,10,40,48,166
2024-04-04 14:20:00,2,35,46,18,56,71,228
2024-04-04 14:30:00,1,23,36,16,35,50,161
2024-04-04 14:40:00,2,27,32,13,50,45,169
2024-04-04 14:50:00,3,12,41,17,23,55,151
2024-04-04 15:00:00,3,37,54,14,45,69,222
2024-04-04 15:10:00,2,44,40,17,57,73,233
2024-04-04 15:20:00,3,41,41,22,53,87,247
2024-04-04 15:30:00,3,30,51,16,48,96,244
2024-04-04 15:40:00,3,26,58,14,42,94,237
2024-04-04 15:50:00,3,27,48,15,44,87,224
2024-04-04 16:00:00,1,32,40,18,45,94,230
2024-04-04 16:10:00,2,32,47,17,46,96,240
2024-04-04 16:20:00,2,45,60,16,60,99,282
2024-04-04 16:30:00,7,45,48,21,40,98,259
2024-04-04 16:40:00,3,46,53,17,54,106,279
2024-04-04 16:50:00,4,44,41,14,39,86,228
2024-04-04 17:00:00,2,37,48,12,43,77,219
2024-04-04 17:10:00,2,40,37,18,42,77,216
2024-04-04 17:20:00,2,31,51,15,52,89,240
2024-04-04 17:30:00,4,35,58,10,35,89,231
2024-04-04 17:40:00,3,42,52,21,48,93,259
2024-04-04 17:50:00,4,55,56,22,54,89,280
2024-04-04 18:00:00,3,31,57,18,36,78,223
2024-04-04 18:10:00,3,19,48,14,28,61,173
2024-04-04 18:20:00,7,31,49,12,49,64,212
2024-04-04 18:30:00,1,24,42,17,32,75,191
2024-04-04 18:40:00,3,39,41,15,43,70,211
2024-04-04 18:50:00,3,20,36,15,26,58,158
2024-04-04 19:00:00,3,23,40,19,27,59,171
2024-04-04 19:10:00,5,21,33,19,26,58,162
2024-04-04 19:20:00,2,21,39,12,29,54,157
2024-04-04 19:30:00,2,17,30,15,21,62,147
2024-04-04 19:40:00,1,23,39,16,25,37,141
2024-04-04 19:50:00,2,15,23,14,16,30,100
2024-04-04 20:00:00,2,10,25,12,11,27,87
2024-04-04 20:10:00,4,17,25,23,22,35,126
2024-04-04 20:20:00,6,12,19,2,12,20,71
2024-04-04 20:30:00,1,5,21,10,10,26,73
2024-04-04 20:40:00,3,17,21,7,15,29,92
2024-04-04 20:50:00,3,30,22,10,30,30,125
2024-04-04 21:00:00,4,18,19,9,22,24,96
2024-04-04 21:10:00,3,30,22,7,24,20,106
2024-04-04 21:20:00,4,24,14,8,26,20,96
2024-04-04 21:30:00,5,18,19,12,20,23,97
2024-04-04 21:40:00,6,15,15,12,19,18,85
2024-04-04 21:50:00,1,11,21,9,14,21,77
2024-04-04 22:00:00,2,8,21,13,9,23,76
2024-04-04 22:10:00,5,16,25,14,17,29,106
2024-04-04 22:20:00,4,10,18,13,14,22,81
2024-04-04 22:30:00,2,14,9,5,13,10,53
2024-04-04 22:40:00,4,10,24,8,11,33,90
2024-04-04 22:50:00,0,7,15,10,6,16,54
2024-04-04 23:00:00,5,4,12,7,9,11,48
2024-04-04 23:10:00,1,12,21,6,15,20,75
2024-04-04 23:20:00,1,5,13,5,3,14,41
2024-04-04 23:30:00,3,6,10,3,8,8,38
2024-04-04 23:40:00,1,5,11,5,5,12,39
2024-04-04 23:50:00,1,10,12,4,10,11,48
2024-04-05 00:00:00,2,6,10,6,4,13,41
2024-04-05 00:10:00,1,4,8,5,3,6,27
2024-04-05 00:20:00,1,5,11,6,5,14,42
2024-04-05 00:30:00,1,6,6,5,5,6,29
2024-04-05 00:40:00,1,9,5,0,6,6,27
2024-04-05 00:50:00,0,0,4,0,0,3,7
2024-04-05 01:00:00,1,2,4,5,3,4,19
2024-04-05 01:10:00,1,9,3,2,7,5,27
2024-04-05 01:20:00,1,5,3,3,4,5,21
2024-04-05 01:30:00,0,6,5,2,4,3,20
2024-04-05 01:40:00,0,2,1,0,2,2,7
2024-04-05 01:50:00,1,2,6,3,2,5,19
2024-04-05 02:00:00,0,0,1,0,0,0,1
