datetime,D11Z,D12Z,D21Z,D41Z,D42Z,Total
2024-03-01 01:00:00,0,0,10,7,7,24
2024-03-01 01:10:00,0,0,7,3,4,14
2024-03-01 01:20:00,0,0,8,2,4,14
2024-03-01 01:30:00,0,0,9,7,2,18
2024-03-01 01:40:00,0,0,10,7,6,23
2024-03-01 01:50:00,0,0,9,3,7,19
2024-03-01 02:00:00,0,0,11,3,9,23
2024-03-01 02:10:00,0,0,4,5,1,10
2024-03-01 02:20:00,0,0,10,5,6,21
2024-03-01 02:30:00,0,0,9,3,5,17
2024-03-01 02:40:00,0,0,5,6,1,12
2024-03-01 02:50:00,1,0,7,4,3,15
2024-03-01 03:00:00,0,0,6,5,4,15
2024-03-01 03:10:00,0,0,6,3,2,11
2024-03-01 03:20:00,0,0,6,4,1,11
2024-03-01 03:30:00,1,0,7,5,3,16
2024-03-01 03:40:00,1,0,11,6,5,23
2024-03-01 03:50:00,0,0,10,6,8,24
2024-03-01 04:00:00,0,0,10,8,5,23
2024-03-01 04:10:00,0,0,8,8,2,18
2024-03-01 04:20:00,0,0,6,6,4,16
2024-03-01 04:30:00,0,0,14,10,5,29
2024-03-01 04:40:00,0,0,18,12,8,38
2024-03-01 04:50:00,0,0,18,24,9,51
2024-03-01 05:00:00,0,0,19,15,9,43
2024-03-01 05:10:00,0,0,18,25,3,46
2024-03-01 05:20:00,1,0,47,36,20,104
2024-03-01 05:30:00,1,0,50,54,14,119
2024-03-01 05:40:00,0,0,56,49,12,117
2024-03-01 05:50:00,1,0,62,57,26,146
2024-03-01 06:00:00,1,0,65,65,14,145
2024-03-01 06:10:00,1,0,68,68,24,161
2024-03-01 06:20:00,0,0,89,87,25,201
2024-03-01 06:30:00,4,0,91,83,26,204
2024-03-01 06:40:00,1,0,98,83,21,203
2024-03-01 06:50:00,0,0,118,90,28,236
2024-03-01 07:00:00,2,1,95,104,22,224
2024-03-01 07:10:00,3,0,121,137,18,279
2024-03-01 07:20:00,4,0,131,121,18,274
2024-03-01 07:30:00,4,0,144,169,22,339
2024-03-01 07:40:00,3,0,143,164,18,328
2024-03-01 07:50:00,1,0,152,115,32,300
2024-03-01 08:00:00,3,0,115,99,29,246
2024-03-01 08:10:00,2,0,106,113,22,243
2024-03-01 08:20:00,1,0,104,120,19,244
2024-03-01 08:30:00,0,0,112,106,34,252
2024-03-01 08:40:00,4,2,109,108,18,241
2024-03-01 08:50:00,4,3,126,105,31,269
2024-03-01 09:00:00,1,0,131,101,25,258
2024-03-01 09:10:00,2,0,99,97,13,211
2024-03-01 09:20:00,2,0,107,125,28,262
2024-03-01 09:30:00,5,0,117,93,18,233
2024-03-01 09:40:00,7,0,110,103,28,248
2024-03-01 09:50:00,2,0,99,118,32,251
2024-03-01 10:00:00,2,0,116,98,19,235
2024-03-01 10:10:00,1,0,119,94,29,243
2024-03-01 10:20:00,7,1,96,103,17,224
2024-03-01 10:30:00,5,0,127,95,24,251
2024-03-01 10:40:00,3,4,138,134,22,301
2024-03-01 10:50:00,2,2,126,113,22,265
2024-03-01 11:00:00,3,0,117,112,17,249
2024-03-01 11:10:00,1,1,127,125,26,280
2024-03-01 11:20:00,3,1,116,113,28,261
2024-03-01 11:30:00,1,1,134,111,33,280
2024-03-01 11:40:00,4,0,131,115,23,273
2024-03-01 11:50:00,4,1,139,115,18,277
2024-03-01 12:00:00,2,2,124,114,26,268
2024-03-01 12:10:00,5,1,130,137,29,302
2024-03-01 12:20:00,4,2,129,135,16,286
2024-03-01 12:30:00,4,1,60,150,16,231
2024-03-01 12:40:00,5,1,86,133,16,241
2024-03-01 12:50:00,6,2,148,152,18,326
2024-03-01 13:00:00,2,0,150,123,23,298
2024-03-01 13:10:00,6,0,157,110,14,287
2024-03-01 13:20:00,2,1,126,87,14,230
2024-03-01 13:30:00,3,0,177,115,12,307
2024-03-01 13:40:00,8,1,126,135,11,281
2024-03-01 13:50:00,4,1,139,157,23,324
2024-03-01 14:00:00,6,0,142,127,16,291
2024-03-01 14:10:00,5,1,170,118,20,314
2024-03-01 14:20:00,8,0,149,130,18,305
2024-03-01 14:30:00,3,0,138,131,13,285
2024-03-01 14:40:00,6,1,145,113,21,286
2024-03-01 14:50:00,0,1,160,91,3,255
2024-03-01 15:00:00,3,0,153,151,20,327
2024-03-01 15:10:00,9,0,144,141,11,305
2024-03-01 15:20:00,4,0,175,165,20,364
2024-03-01 15:30:00,3,0,148,126,17,294
2024-03-01 15:40:00,2,1,156,140,10,309
2024-03-01 15:50:00,6,1,142,141,21,311
2024-03-01 16:00:00,6,1,147,147,21,322
2024-03-01 16:10:00,5,0,142,126,18,291
2024-03-01 16:20:00,4,0,135,139,9,287
2024-03-01 16:30:00,5,0,125,125,11,266
2024-03-01 16:40:00,4,1,154,120,5,284
2024-03-01 16:50:00,4,0,146,150,18,318
2024-03-01 17:00:00,7,0,151,120,8,286
2024-03-01 17:10:00,7,0,150,139,17,313
2024-03-01 17:20:00,4,0,155,148,12,319
2024-03-01 17:30:00,4,0,161,136,22,323
2024-03-01 17:40:00,4,2,117,133,17,273
2024-03-01 17:50:00,1,3,127,123,21,275
2024-03-01 18:00:00,4,2,139,111,20,276
2024-03-01 18:10:00,6,1,144,128,18,297
2024-03-01 18:20:00,5,4,125,149,32,315
2024-03-01 18:30:00,4,0,133,100,17,254
2024-03-01 18:40:00,7,0,127,96,11,241
2024-03-01 18:50:00,7,1,131,123,22,284
2024-03-01 19:00:00,4,0,108,96,27,235
2024-03-01 19:10:00,3,0,120,131,18,272
2024-03-01 19:20:00,8,0,95,107,16,226
2024-03-01 19:30:00,3,0,90,99,29,221
2024-03-01 19:40:00,3,0,79,83,23,188
2024-03-01 19:50:00,0,0,79,66,27,172
2024-03-01 20:00:00,1,0,66,76,23,166
2024-03-01 20:10:00,2,0,63,83,26,174
2024-03-01 20:20:00,0,0,65,63,24,152
2024-03-01 20:30:00,6,0,66,57,18,147
2024-03-01 20:40:00,2,0,53,49,22,126
2024-03-01 20:50:00,0,0,48,51,15,114
2024-03-01 21:00:00,0,0,55,61,19,135
2024-03-01 21:10:00,3,1,55,54,15,128
2024-03-01 21:20:00,1,0,55,60,24,140
2024-03-01 21:30:00,2,0,63,46,20,131
2024-03-01 21:40:00,2,1,58,53,21,135
2024-03-01 21:50:00,2,0,37,48,24,111
2024-03-01 22:00:00,0,0,48,37,20,105
2024-03-01 22:10:00,9,0,45,43,15,112
2024-03-01 22:20:00,1,0,44,50,18,113
2024-03-01 22:30:00,1,0,41,42,15,99
2024-03-01 22:40:00,0,0,41,35,19,95
2024-03-01 22:50:00,0,0,48,42,21,111
2024-03-01 23:00:00,0,1,41,34,20,96
2024-03-01 23:10:00,0,0,30,17,17,64
2024-03-01 23:20:00,0,0,32,28,14,74
2024-03-01 23:30:00,0,0,42,23,21,86
2024-03-01 23:40:00,0,0,23,25,11,59
2024-03-01 23:50:00,3,0,36,25,12,76
2024-03-02 00:00:00,0,0,24,25,11,60
2024-03-02 00:10:00,0,0,19,22,10,51
2024-03-02 00:20:00,0,0,17,20,8,45
2024-03-02 00:30:00,0,0,19,17,8,44
2024-03-02 00:40:00,0,0,18,8,12,38
2024-03-02 00:50:00,1,0,19,16,14,50
2024-03-02 01:00:00,2,0,14,13,6,35
2024-03-02 01:10:00,0,0,20,22,9,51
2024-03-02 01:20:00,0,0,16,15,8,39
2024-03-02 01:30:00,1,0,12,8,3,24
2024-03-02 01:40:00,1,0,17,7,10,35
2024-03-02 01:50:00,0,0,16,7,5,28
2024-03-02 02:00:00,0,0,8,3,2,13
2024-03-02 02:10:00,0,0,10,8,4,22
2024-03-02 02:20:00,0,0,10,4,6,20
2024-03-02 02:30:00,0,0,10,3,8,21
2024-03-02 02:40:00,0,0,11,6,7,24
2024-03-02 02:50:00,0,0,13,10,7,30
2024-03-02 03:00:00,0,0,7,1,4,12
2024-03-02 03:10:00,0,0,9,3,2,14
2024-03-02 03:20:00,1,0,9,7,6,23
2024-03-02 03:30:00,0,0,14,8,7,29
2024-03-02 03:40:00,0,0,10,11,3,24
2024-03-02 03:50:00,0,0,17,9,9,35
2024-03-02 04:00:00,0,0,10,4,4,18
2024-03-02 04:10:00,0,0,7,5,4,16
2024-03-02 04:20:00,0,0,9,5,6,20
2024-03-02 04:30:00,0,0,10,11,5,26
2024-03-02 04:40:00,0,0,2,5,0,7
2024-03-02 04:50:00,0,0,5,10,4,19
2024-03-02 05:00:00,0,0,14,9,8,31
2024-03-02 05:10:00,0,0,17,14,9,40
2024-03-02 05:20:00,0,0,21,16,8,45
2024-03-02 05:30:00,0,0,13,22,4,39
2024-03-02 05:40:00,0,0,27,19,9,55
2024-03-02 05:50:00,1,0,24,21,12,58
2024-03-02 06:00:00,3,0,17,12,8,40
2024-03-02 06:10:00,1,1,31,13,12,58
2024-03-02 06:20:00,0,0,17,10,7,34
2024-03-02 06:30:00,2,0,26,23,12,63
2024-03-02 06:40:00,1,0,28,26,14,69
2024-03-02 06:50:00,1,0,40,24,8,73
2024-03-02 07:00:00,0,0,32,16,12,60
2024-03-02 07:10:00,0,0,35,27,11,73
2024-03-02 07:20:00,2,1,39,34,16,92
2024-03-02 07:30:00,3,0,40,34,15,92
2024-03-02 07:40:00,2,0,59,32,22,115
2024-03-02 07:50:00,0,0,50,39,20,109
2024-03-02 08:00:00,2,0,44,35,18,99
2024-03-02 08:10:00,0,0,42,55,12,109
2024-03-02 08:20:00,0,0,61,45,22,128
2024-03-02 08:30:00,1,0,66,62,24,153
2024-03-02 08:40:00,2,0,75,60,26,163
2024-03-02 08:50:00,3,1,88,83,36,211
2024-03-02 09:00:00,2,0,92,72,28,194
2024-03-02 09:10:00,1,0,77,85,18,181
2024-03-02 09:20:00,1,1,78,83,14,177
2024-03-02 09:30:00,3,0,110,102,28,243
2024-03-02 09:40:00,2,0,109,97,17,225
2024-03-02 09:50:00,4,0,109,96,14,223
2024-03-02 10:00:00,2,0,88,99,16,205
2024-03-02 10:10:00,0,0,120,108,32,260
2024-03-02 10:20:00,3,0,90,120,18,231
2024-03-02 10:30:00,1,0,112,117,21,251
2024-03-02 10:40:00,1,0,118,131,27,277
2024-03-02 10:50:00,3,0,111,147,17,278
2024-03-02 11:00:00,3,0,110,122,24,259
2024-03-02 11:10:00,2,1,123,103,26,255
2024-03-02 11:20:00,4,0,137,116,13,270
2024-03-02 11:30:00,1,1,36,109,24,171
2024-03-02 11:40:00,2,1,42,116,18,179
2024-03-02 11:50:00,0,0,111,105,10,226
2024-03-02 12:00:00,3,0,129,144,26,302
2024-03-02 12:10:00,4,0,118,115,19,256
2024-03-02 12:20:00,4,2,148,121,33,308
2024-03-02 12:30:00,5,0,138,128,13,284
2024-03-02 12:40:00,4,0,124,123,20,271
2024-03-02 12:50:00,1,0,90,132,17,240
2024-03-02 13:00:00,3,0,65,120,13,201
2024-03-02 13:10:00,2,0,155,107,13,277
2024-03-02 13:20:00,7,0,140,96,11,254
2024-03-02 13:30:00,2,0,153,108,9,272
2024-03-02 13:40:00,4,0,131,108,13,256
2024-03-02 13:50:00,6,0,138,121,16,281
2024-03-02 14:00:00,3,1,143,139,14,300
2024-03-02 14:10:00,5,0,146,114,18,283
2024-03-02 14:20:00,2,2,134,126,17,281
2024-03-02 14:30:00,2,0,141,122,20,285
2024-03-02 14:40:00,2,0,111,110,17,240
2024-03-02 14:50:00,1,0,122,126,18,267
2024-03-02 15:00:00,3,0,125,128,14,270
2024-03-02 15:10:00,3,0,117,131,17,268
2024-03-02 15:20:00,3,0,133,96,17,249
2024-03-02 15:30:00,2,0,111,117,12,242
2024-03-02 15:40:00,3,1,109,97,15,225
2024-03-02 15:50:00,6,1,103,123,15,248
2024-03-02 16:00:00,4,1,107,100,18,230
2024-03-02 16:10:00,2,1,83,98,13,197
2024-03-02 16:20:00,1,1,115,107,13,237
2024-03-02 16:30:00,1,1,121,112,16,251
2024-03-02 16:40:00,1,0,105,98,32,236
2024-03-02 16:50:00,3,2,107,111,19,242
2024-03-02 17:00:00,1,0,135,96,16,248
2024-03-02 17:10:00,5,2,96,120,28,251
2024-03-02 17:20:00,4,0,113,108,25,250
2024-03-02 17:30:00,1,1,120,135,26,283
2024-03-02 17:40:00,5,0,130,119,19,273
2024-03-02 17:50:00,5,2,143,126,24,300
2024-03-02 18:00:00,5,1,135,107,28,276
2024-03-02 18:10:00,4,2,124,101,33,264
2024-03-02 18:20:00,4,1,138,100,20,263
2024-03-02 18:30:00,0,0,94,106,24,224
2024-03-02 18:40:00,5,1,105,98,31,240
2024-03-02 18:50:00,2,0,108,100,30,240
2024-03-02 19:00:00,3,1,88,84,29,205
2024-03-02 19:10:00,2,2,96,92,24,216
2024-03-02 19:20:00,3,2,88,94,27,214
2024-03-02 19:30:00,0,0,73,84,29,186
2024-03-02 19:40:00,0,0,62,78,22,162
2024-03-02 19:50:00,1,1,74,86,29,191
2024-03-02 20:00:00,2,0,64,72,16,154
2024-03-02 20:10:00,1,0,81,63,26,171
2024-03-02 20:20:00,1,0,46,70,17,134
2024-03-02 20:30:00,0,0,57,54,25,136
2024-03-02 20:40:00,2,0,57,54,12,125
2024-03-02 20:50:00,1,0,41,54,16,112
2024-03-02 21:00:00,2,0,62,51,31,146
2024-03-02 21:10:00,0,0,41,42,17,100
2024-03-02 21:20:00,0,0,44,38,20,102
2024-03-02 21:30:00,4,0,44,38,17,103
2024-03-02 21:40:00,0,0,30,46,13,89
2024-03-02 21:50:00,3,0,36,35,11,85
2024-03-02 22:00:00,0,0,26,39,5,70
2024-03-02 22:10:00,0,0,44,29,12,85
2024-03-02 22:20:00,1,0,51,31,27,110
2024-03-02 22:30:00,0,0,32,34,13,79
2024-03-02 22:40:00,0,0,34,37,20,91
2024-03-02 22:50:00,0,0,40,26,20,86
2024-03-02 23:00:00,0,1,28,26,6,61
2024-03-02 23:10:00,0,0,44,19,20,83
2024-03-02 23:20:00,0,0,33,22,15,70
2024-03-02 23:30:00,1,0,24,35,10,70
2024-03-02 23:40:00,1,1,29,26,15,72
2024-03-02 23:50:00,0,1,28,20,13,62
2024-03-03 00:00:00,0,0,25,20,12,57
2024-03-03 00:10:00,2,0,27,21,9,59
2024-03-03 00:20:00,2,1,28,21,8,60
2024-03-03 00:30:00,0,0,28,22,12,62
2024-03-03 00:40:00,0,0,22,21,10,53
2024-03-03 00:50:00,0,0,20,19,9,48
2024-03-03 01:00:00,1,0,35,20,14,70
2024-03-03 01:10:00,1,0,19,21,5,46
2024-03-03 01:20:00,0,0,20,14,7,41
2024-03-03 01:30:00,0,0,16,12,6,34
2024-03-03 01:40:00,0,0,18,9,11,38
2024-03-03 01:50:00,0,0,12,12,7,31
2024-03-03 02:00:00,0,0,14,7,7,28
2024-03-03 02:10:00,1,0,15,8,4,28
2024-03-03 02:20:00,0,0,14,12,7,33
2024-03-03 02:30:00,0,0,14,10,7,31
2024-03-03 02:40:00,2,0,11,12,3,28
2024-03-03 02:50:00,0,0,11,6,5,22
2024-03-03 03:00:00,0,0,10,5,6,21
2024-03-03 03:10:00,0,0,10,7,7,24
2024-03-03 03:20:00,1,0,10,4,6,21
2024-03-03 03:30:00,0,0,13,8,9,30
2024-03-03 03:40:00,0,0,6,5,2,13
2024-03-03 03:50:00,0,0,6,10,2,18
2024-03-03 04:00:00,0,0,11,5,3,19
2024-03-03 04:10:00,1,0,7,4,4,16
2024-03-03 04:20:00,0,0,4,3,2,9
2024-03-03 04:30:00,0,0,6,13,2,21
2024-03-03 04:40:00,0,0,12,13,6,31
2024-03-03 04:50:00,0,0,9,8,4,21
2024-03-03 05:00:00,0,0,7,12,3,22
2024-03-03 05:10:00,0,0,9,14,6,29
2024-03-03 05:20:00,1,0,19,12,10,42
2024-03-03 05:30:00,0,0,16,13,9,38
2024-03-03 05:40:00,0,0,14,11,9,34
2024-03-03 05:50:00,0,0,11,11,7,29
2024-03-03 06:00:00,1,0,5,7,3,16
2024-03-03 06:10:00,0,0,8,7,3,18
2024-03-03 06:20:00,0,0,8,6,3,17
2024-03-03 06:30:00,0,0,12,12,9,33
2024-03-03 06:40:00,0,0,9,8,3,20
2024-03-03 06:50:00,0,0,11,7,7,25
2024-03-03 07:00:00,0,0,11,12,4,27
2024-03-03 07:10:00,1,0,7,8,5,21
2024-03-03 07:20:00,0,0,9,6,3,18
2024-03-03 07:30:00,0,0,7,12,3,22
2024-03-03 07:40:00,0,0,12,16,6,34
2024-03-03 07:50:00,3,0,15,13,10,41
2024-03-03 08:00:00,1,1,15,13,3,33
2024-03-03 08:10:00,0,0,9,8,1,18
2024-03-03 08:20:00,0,0,14,15,7,36
2024-03-03 08:30:00,0,0,18,15,8,41
2024-03-03 08:40:00,1,0,22,22,8,53
2024-03-03 08:50:00,0,0,27,25,7,59
2024-03-03 09:00:00,0,0,27,30,9,66
2024-03-03 09:10:00,1,0,46,44,18,109
2024-03-03 09:20:00,2,0,50,48,11,111
2024-03-03 09:30:00,3,0,51,56,12,122
2024-03-03 09:40:00,3,0,47,59,12,121
2024-03-03 09:50:00,3,0,63,67,14,147
2024-03-03 10:00:00,1,0,51,48,20,120
2024-03-03 10:10:00,0,0,47,49,14,110
2024-03-03 10:20:00,2,1,48,52,24,127
2024-03-03 10:30:00,4,0,46,54,11,115
2024-03-03 10:40:00,4,0,66,69,13,152
2024-03-03 10:50:00,1,0,61,76,15,153
2024-03-03 11:00:00,3,0,57,37,16,113
2024-03-03 11:10:00,0,2,61,44,19,126
2024-03-03 11:20:00,0,0,92,56,23,171
2024-03-03 11:30:00,3,0,73,65,14,155
2024-03-03 11:40:00,1,0,71,75,21,168
2024-03-03 11:50:00,1,0,83,78,23,185
2024-03-03 12:00:00,2,0,82,73,24,181
2024-03-03 12:10:00,0,0,81,88,19,188
2024-03-03 12:20:00,4,0,77,62,12,155
2024-03-03 12:30:00,3,0,68,64,18,153
2024-03-03 12:40:00,2,0,92,68,26,188
2024-03-03 12:50:00,0,0,86,96,30,212
2024-03-03 13:00:00,1,0,65,78,17,161
2024-03-03 13:10:00,2,0,95,85,23,205
2024-03-03 13:20:00,3,0,91,96,23,213
2024-03-03 13:30:00,2,0,107,87,20,216
2024-03-03 13:40:00,2,0,113,87,28,230
2024-03-03 13:50:00,1,1,96,85,20,203
2024-03-03 14:00:00,1,0,104,104,24,233
2024-03-03 14:10:00,3,0,82,80,22,187
2024-03-03 14:20:00,2,1,90,93,23,209
2024-03-03 14:30:00,0,0,106,84,24,214
2024-03-03 14:40:00,2,0,128,108,27,265
2024-03-03 14:50:00,1,1,99,85,23,209
2024-03-03 15:00:00,2,1,84,95,15,197
2024-03-03 15:10:00,2,0,93,92,18,205
2024-03-03 15:20:00,2,0,95,99,19,215
2024-03-03 15:30:00,3,0,68,89,12,172
2024-03-03 15:40:00,3,0,100,97,14,214
2024-03-03 15:50:00,1,0,92,91,24,208
2024-03-03 16:00:00,2,0,85,105,13,205
2024-03-03 16:10:00,1,1,64,88,18,172
2024-03-03 16:20:00,2,0,90,79,12,183
2024-03-03 16:30:00,2,0,82,94,6,184
2024-03-03 16:40:00,3,0,89,104,18,214
2024-03-03 16:50:00,1,0,85,76,13,175
2024-03-03 17:00:00,0,2,88,112,17,219
2024-03-03 17:10:00,3,1,94,101,20,219
2024-03-03 17:20:00,1,1,79,109,22,212
2024-03-03 17:30:00,6,0,89,101,15,211
2024-03-03 17:40:00,5,2,99,83,19,208
2024-03-03 17:50:00,3,0,109,77,28,217
2024-03-03 18:00:00,0,2,69,81,20,172
2024-03-03 18:10:00,3,0,85,81,25,194
2024-03-03 18:20:00,3,0,70,85,22,180
2024-03-03 18:30:00,0,0,71,70,16,157
2024-03-03 18:40:00,0,0,78,76,30,184
2024-03-03 18:50:00,0,0,72,85,26,183
2024-03-03 19:00:00,3,1,71,81,24,180
2024-03-03 19:10:00,2,0,74,71,21,168
2024-03-03 19:20:00,3,1,75,81,29,189
2024-03-03 19:30:00,2,0,40,67,19,128
2024-03-03 19:40:00,2,0,74,55,13,144
2024-03-03 19:50:00,0,0,59,55,16,130
2024-03-03 20:00:00,0,0,57,59,23,139
2024-03-03 20:10:00,0,0,54,44,18,116
2024-03-03 20:20:00,1,0,47,48,25,121
2024-03-03 20:30:00,1,0,43,37,16,97
2024-03-03 20:40:00,1,2,52,27,22,104
2024-03-03 20:50:00,0,0,47,30,20,97
2024-03-03 21:00:00,1,0,39,38,11,89
2024-03-03 21:10:00,1,0,41,32,18,92
2024-03-03 21:20:00,1,0,41,27,16,85
2024-03-03 21:30:00,0,0,33,24,15,72
2024-03-03 21:40:00,2,0,26,25,9,62
2024-03-03 21:50:00,0,0,28,29,15,72
2024-03-03 22:00:00,0,0,25,22,12,59
2024-03-03 22:10:00,0,0,22,17,8,47
2024-03-03 22:20:00,0,0,17,16,7,40
2024-03-03 22:30:00,1,0,16,15,5,37
2024-03-03 22:40:00,0,0,21,18,7,46
2024-03-03 22:50:00,0,0,19,17,13,49
2024-03-03 23:00:00,0,0,17,10,12,39
2024-03-03 23:10:00,2,0,27,15,11,55
2024-03-03 23:20:00,0,0,13,11,7,31
2024-03-03 23:30:00,0,0,10,11,4,25
2024-03-03 23:40:00,0,0,12,3,7,22
2024-03-03 23:50:00,1,0,17,7,9,34
2024-03-04 00:00:00,0,0,7,8,7,22
2024-03-04 00:10:00,0,0,18,9,4,31
2024-03-04 00:20:00,0,0,9,5,4,18
2024-03-04 00:30:00,0,0,7,10,2,19
2024-03-04 00:40:00,2,0,7,1,4,14
2024-03-04 00:50:00,0,0,10,6,3,19
2024-03-04 01:00:00,0,0,7,4,4,15
2024-03-04 01:10:00,0,0,6,3,5,14
2024-03-04 01:20:00,0,0,4,1,2,7
2024-03-04 01:30:00,0,0,4,2,2,8
2024-03-04 01:40:00,0,0,6,3,3,12
2024-03-04 01:50:00,0,0,5,2,2,9
2024-03-04 02:00:00,0,0,3,4,3,10
2024-03-04 02:10:00,1,0,3,1,1,6
2024-03-04 02:20:00,0,0,5,1,3,9
2024-03-04 02:30:00,0,0,6,4,5,15
2024-03-04 02:40:00,0,0,4,3,3,10
2024-03-04 02:50:00,0,0,3,3,1,7
2024-03-04 03:00:00,0,0,5,7,1,13
2024-03-04 03:10:00,0,0,6,4,4,14
2024-03-04 03:20:00,1,0,8,3,4,16
2024-03-04 03:30:00,0,0,6,7,2,15
2024-03-04 03:40:00,0,0,10,7,5,22
2024-03-04 03:50:00,0,0,6,9,2,17
2024-03-04 04:00:00,0,0,10,12,3,25
2024-03-04 04:10:00,1,0,7,7,3,18
2024-03-04 04:20:00,0,0,9,7,2,18
2024-03-04 04:30:00,0,1,14,13,11,39
2024-03-04 04:40:00,1,0,10,19,2,32
2024-03-04 04:50:00,0,0,14,15,8,37
2024-03-04 05:00:00,0,0,20,30,11,61
2024-03-04 05:10:00,0,0,19,35,12,66
2024-03-04 05:20:00,0,0,28,38,15,81
2024-03-04 05:30:00,0,0,51,66,20,137
2024-03-04 05:40:00,2,0,47,71,19,139
2024-03-04 05:50:00,0,0,49,67,13,129
2024-03-04 06:00:00,2,1,42,60,16,121
2024-03-04 06:10:00,0,1,72,67,16,156
2024-03-04 06:20:00,2,0,77,76,28,183
2024-03-04 06:30:00,3,1,86,85,24,199
2024-03-04 06:40:00,2,1,108,94,26,231
2024-03-04 06:50:00,2,0,118,110,33,263
2024-03-04 07:00:00,6,0,108,119,21,254
2024-03-04 07:10:00,3,0,103,134,29,269
2024-03-04 07:20:00,2,1,152,152,16,323
2024-03-04 07:30:00,5,1,111,168,9,294
2024-03-04 07:40:00,4,2,128,169,18,321
2024-03-04 07:50:00,1,0,144,129,24,298
2024-03-04 08:00:00,0,0,101,134,41,276
2024-03-04 08:10:00,4,0,95,136,15,250
2024-03-04 08:20:00,3,0,54,132,32,221
2024-03-04 08:30:00,2,0,112,110,27,251
2024-03-04 08:40:00,2,0,117,110,18,247
2024-03-04 08:50:00,3,0,109,106,17,235
2024-03-04 09:00:00,2,0,58,98,22,180
2024-03-04 09:10:00,4,2,117,109,18,250
2024-03-04 09:20:00,2,0,91,113,22,228
2024-03-04 09:30:00,11,0,0,119,19,149
2024-03-04 09:40:00,5,0,0,114,16,135
2024-03-04 09:50:00,4,0,0,111,24,139
2024-03-04 10:00:00,2,0,65,86,23,176
2024-03-04 10:10:00,3,0,107,110,21,241
2024-03-04 10:20:00,2,0,109,109,22,242
2024-03-04 10:30:00,1,0,123,98,29,251
2024-03-04 10:40:00,1,2,110,100,17,230
2024-03-04 10:50:00,0,2,120,115,25,262
2024-03-04 11:00:00,2,0,115,91,23,231
2024-03-04 11:10:00,2,0,121,104,24,251
2024-03-04 11:20:00,2,1,125,93,31,252
2024-03-04 11:30:00,1,0,128,96,21,246
2024-03-04 11:40:00,4,0,139,112,34,289
2024-03-04 11:50:00,2,0,119,113,31,265
2024-03-04 12:00:00,2,0,126,113,20,261
2024-03-04 12:10:00,2,0,109,105,21,237
2024-03-04 12:20:00,3,0,126,130,28,287
2024-03-04 12:30:00,4,0,127,106,27,264
2024-03-04 12:40:00,5,0,112,108,23,248
2024-03-04 12:50:00,4,0,122,126,18,270
2024-03-04 13:00:00,1,0,112,115,25,253
2024-03-04 13:10:00,8,0,152,127,16,303
2024-03-04 13:20:00,5,1,143,111,25,285
2024-03-04 13:30:00,5,0,75,117,21,218
2024-03-04 13:40:00,0,1,134,105,17,257
2024-03-04 13:50:00,5,0,112,142,19,278
2024-03-04 14:00:00,4,1,120,122,25,272
2024-03-04 14:10:00,2,1,126,97,23,249
2024-03-04 14:20:00,3,0,135,121,23,282
2024-03-04 14:30:00,3,0,132,136,18,289
2024-03-04 14:40:00,5,3,119,131,17,275
2024-03-04 14:50:00,0,1,139,124,26,290
2024-03-04 15:00:00,6,0,148,112,19,285
2024-03-04 15:10:00,1,1,142,129,20,293
2024-03-04 15:20:00,5,0,137,125,12,279
2024-03-04 15:30:00,3,0,160,151,17,331
2024-03-04 15:40:00,8,1,126,155,14,304
2024-03-04 15:50:00,5,0,152,128,17,302
2024-03-04 16:00:00,3,0,159,144,11,317
2024-03-04 16:10:00,10,0,149,146,16,321
2024-03-04 16:20:00,7,0,147,143,8,305
2024-03-04 16:30:00,8,1,147,147,22,325
2024-03-04 16:40:00,12,1,143,127,17,300
2024-03-04 16:50:00,7,2,147,161,19,336
2024-03-04 17:00:00,11,1,151,152,6,321
2024-03-04 17:10:00,4,2,152,155,17,330
2024-03-04 17:20:00,6,1,164,142,10,323
2024-03-04 17:30:00,3,1,170,140,17,331
2024-03-04 17:40:00,5,0,141,126,16,288
2024-03-04 17:50:00,6,0,134,113,18,271
2024-03-04 18:00:00,7,1,124,115,16,263
2024-03-04 18:10:00,6,1,132,128,22,289
2024-03-04 18:20:00,4,0,117,116,27,264
2024-03-04 18:30:00,3,0,102,102,35,242
2024-03-04 18:40:00,6,2,107,100,29,244
2024-03-04 18:50:00,0,0,99,93,31,223
2024-03-04 19:00:00,0,0,103,89,34,226
2024-03-04 19:10:00,7,2,80,94,18,201
2024-03-04 19:20:00,8,0,71,82,21,182
2024-03-04 19:30:00,1,0,84,75,25,185
2024-03-04 19:40:00,4,0,59,58,27,148
2024-03-04 19:50:00,3,0,67,54,25,149
2024-03-04 20:00:00,0,0,49,70,13,132
2024-03-04 20:10:00,0,0,64,62,19,145
2024-03-04 20:20:00,0,0,60,35,24,119
2024-03-04 20:30:00,1,0,46,52,17,116
2024-03-04 20:40:00,0,0,55,39,20,114
2024-03-04 20:50:00,3,0,43,45,12,103
2024-03-04 21:00:00,1,1,42,41,16,101
2024-03-04 21:10:00,3,0,73,42,23,141
2024-03-04 21:20:00,0,0,44,45,17,106
2024-03-04 21:30:00,4,0,41,28,18,91
2024-03-04 21:40:00,3,0,41,29,13,86
2024-03-04 21:50:00,1,0,33,30,16,80
2024-03-04 22:00:00,0,0,29,33,11,73
2024-03-04 22:10:00,3,0,40,33,15,91
2024-03-04 22:20:00,1,0,28,18,12,59
2024-03-04 22:30:00,0,0,36,22,18,76
2024-03-04 22:40:00,0,0,40,21,13,74
2024-03-04 22:50:00,2,0,31,30,10,73
2024-03-04 23:00:00,1,1,15,14,5,36
2024-03-04 23:10:00,0,0,19,8,8,35
2024-03-04 23:20:00,1,0,9,17,1,28
2024-03-04 23:30:00,0,0,13,9,8,30
2024-03-04 23:40:00,1,0,12,4,4,21
2024-03-04 23:50:00,0,0,13,5,4,22
2024-03-05 00:00:00,0,0,10,7,5,22
2024-03-05 00:10:00,1,0,15,6,5,27
2024-03-05 00:20:00,0,0,9,3,5,17
2024-03-05 00:30:00,0,0,10,4,6,20
2024-03-05 00:40:00,1,0,6,7,2,16
2024-03-05 00:50:00,0,0,6,4,5,15
2024-03-05 01:00:00,0,0,6,2,3,11
2024-03-05 01:10:00,1,0,4,1,2,8
2024-03-05 01:20:00,0,0,3,4,1,8
2024-03-05 01:30:00,0,0,2,4,2,8
2024-03-05 01:40:00,0,0,2,4,2,8
2024-03-05 01:50:00,0,0,3,5,1,9
2024-03-05 02:00:00,0,0,5,4,4,13
2024-03-05 02:10:00,0,0,9,5,5,19
2024-03-05 02:20:00,0,0,7,4,4,15
2024-03-05 02:30:00,0,0,8,4,4,16
2024-03-05 02:40:00,0,0,5,0,3,8
2024-03-05 02:50:00,0,0,7,5,4,16
2024-03-05 03:00:00,0,0,5,1,5,11
2024-03-05 03:10:00,0,0,3,2,2,7
2024-03-05 03:20:00,0,0,8,3,7,18
2024-03-05 03:30:00,1,0,5,3,3,12
2024-03-05 03:40:00,0,0,7,11,2,20
2024-03-05 03:50:00,0,0,6,6,1,13
2024-03-05 04:00:00,0,0,8,5,3,16
2024-03-05 04:10:00,0,0,10,10,7,27
2024-03-05 04:20:00,0,0,14,12,8,34
2024-03-05 04:30:00,0,0,9,9,4,22
2024-03-05 04:40:00,0,0,12,17,6,35
2024-03-05 04:50:00,0,0,15,18,5,38
2024-03-05 05:00:00,0,0,15,33,7,55
2024-03-05 05:10:00,2,1,32,31,13,79
2024-03-05 05:20:00,0,0,28,36,11,75
2024-03-05 05:30:00,0,0,33,60,18,111
2024-03-05 05:40:00,1,0,51,58,21,131
2024-03-05 05:50:00,0,0,53,58,22,133
2024-03-05 06:00:00,2,0,52,62,11,127
2024-03-05 06:10:00,0,0,67,75,18,160
2024-03-05 06:20:00,3,1,99,77,18,198
2024-03-05 06:30:00,2,0,86,94,27,209
2024-03-05 06:40:00,0,0,108,106,39,253
2024-03-05 06:50:00,2,0,122,92,26,242
2024-03-05 07:00:00,3,0,96,117,16,232
2024-03-05 07:10:00,6,0,112,138,20,276
2024-03-05 07:20:00,3,0,127,155,21,306
2024-03-05 07:30:00,0,0,116,165,22,303
2024-03-05 07:40:00,4,1,142,177,22,346
2024-03-05 07:50:00,3,0,152,145,28,328
2024-03-05 08:00:00,4,0,154,131,36,325
2024-03-05 08:10:00,4,0,124,143,16,287
2024-03-05 08:20:00,2,2,116,121,22,263
2024-03-05 08:30:00,4,0,117,116,25,262
2024-03-05 08:40:00,1,0,116,111,16,244
2024-03-05 08:50:00,5,1,118,104,24,252
2024-03-05 09:00:00,4,1,123,103,21,252
2024-03-05 09:10:00,2,1,98,117,11,229
2024-03-05 09:20:00,1,1,98,90,26,216
2024-03-05 09:30:00,7,2,104,101,20,234
2024-03-05 09:40:00,5,1,106,121,16,249
2024-03-05 09:50:00,2,0,118,79,24,223
2024-03-05 10:00:00,4,0,109,108,25,246
2024-03-05 10:10:00,1,1,112,97,24,235
2024-03-05 10:20:00,2,0,120,92,27,241
2024-03-05 10:30:00,1,0,109,96,22,228
2024-03-05 10:40:00,4,0,112,116,14,246
2024-03-05 10:50:00,5,0,101,98,17,221
2024-03-05 11:00:00,0,0,89,101,19,209
2024-03-05 11:10:00,4,0,107,101,14,226
2024-03-05 11:20:00,2,0,119,96,25,242
2024-03-05 11:30:00,0,1,102,100,16,219
2024-03-05 11:40:00,2,0,117,129,25,273
2024-03-05 11:50:00,1,0,133,92,30,256
2024-03-05 12:00:00,2,0,122,88,22,234
2024-03-05 12:10:00,5,0,112,97,21,235
2024-03-05 12:20:00,4,0,123,119,17,263
2024-03-05 12:30:00,5,0,130,118,22,275
2024-03-05 12:40:00,2,1,100,106,12,221
2024-03-05 12:50:00,1,0,127,115,28,271
2024-03-05 13:00:00,5,0,124,113,17,259
2024-03-05 13:10:00,5,0,124,135,15,279
2024-03-05 13:20:00,4,1,124,110,25,264
2024-03-05 13:30:00,2,0,116,99,26,243
2024-03-05 13:40:00,2,0,120,104,22,248
2024-03-05 13:50:00,3,1,121,123,15,263
2024-03-05 14:00:00,2,1,113,112,21,249
2024-03-05 14:10:00,1,2,133,127,7,270
2024-03-05 14:20:00,3,2,144,109,13,271
2024-03-05 14:30:00,2,0,144,120,20,286
2024-03-05 14:40:00,3,1,138,115,14,271
2024-03-05 14:50:00,4,0,151,135,15,305
2024-03-05 15:00:00,5,0,156,128,20,309
2024-03-05 15:10:00,2,0,155,132,14,303
2024-03-05 15:20:00,1,0,134,144,18,297
2024-03-05 15:30:00,5,1,139,142,14,301
2024-03-05 15:40:00,9,1,149,148,11,318
2024-03-05 15:50:00,5,0,150,150,13,318
2024-03-05 16:00:00,7,0,169,135,16,327
2024-03-05 16:10:00,11,0,155,130,9,305
2024-03-05 16:20:00,3,0,159,132,15,309
2024-03-05 16:30:00,11,2,169,132,11,325
2024-03-05 16:40:00,6,0,153,93,6,258
2024-03-05 16:50:00,10,0,161,165,11,347
2024-03-05 17:00:00,9,0,166,149,14,338
2024-03-05 17:10:00,9,1,164,143,7,324
2024-03-05 17:20:00,6,2,152,130,13,303
2024-03-05 17:30:00,6,0,157,120,18,301
2024-03-05 17:40:00,4,0,153,126,11,294
2024-03-05 17:50:00,5,1,119,119,20,264
2024-03-05 18:00:00,4,0,150,117,24,295
2024-03-05 18:10:00,7,0,139,114,11,271
2024-03-05 18:20:00,5,0,126,128,15,274
2024-03-05 18:30:00,3,0,119,121,28,271
2024-03-05 18:40:00,2,0,129,108,17,256
2024-03-05 18:50:00,0,0,111,109,32,252
2024-03-05 19:00:00,4,0,103,82,20,209
2024-03-05 19:10:00,5,1,85,96,23,210
2024-03-05 19:20:00,6,0,82,71,14,173
2024-03-05 19:30:00,1,0,67,72,16,156
2024-03-05 19:40:00,2,0,85,65,18,170
2024-03-05 19:50:00,1,1,73,82,22,179
2024-03-05 20:00:00,1,0,71,68,20,160
2024-03-05 20:10:00,2,0,65,65,16,148
2024-03-05 20:20:00,1,0,56,58,23,138
2024-03-05 20:30:00,2,1,52,42,20,117
2024-03-05 20:40:00,0,0,50,50,18,118
2024-03-05 20:50:00,7,1,56,55,19,138
2024-03-05 21:00:00,2,0,53,52,24,131
2024-03-05 21:10:00,1,0,52,61,24,138
2024-03-05 21:20:00,0,0,46,52,16,114
2024-03-05 21:30:00,4,0,48,54,14,120
2024-03-05 21:40:00,3,0,39,44,16,102
2024-03-05 21:50:00,0,0,34,42,14,90
2024-03-05 22:00:00,1,0,48,31,17,97
2024-03-05 22:10:00,1,0,41,42,18,102
2024-03-05 22:20:00,0,0,31,29,10,70
2024-03-05 22:30:00,1,0,36,23,16,76
2024-03-05 22:40:00,1,0,31,29,10,71
2024-03-05 22:50:00,0,0,27,28,10,65
2024-03-05 23:00:00,2,1,21,14,12,50
2024-03-05 23:10:00,0,0,19,10,11,40
2024-03-05 23:20:00,1,0,13,13,8,35
2024-03-05 23:30:00,1,0,17,14,9,41
2024-03-05 23:40:00,2,0,13,8,6,29
2024-03-05 23:50:00,1,0,11,6,7,25
2024-03-06 00:00:00,2,0,11,4,7,24
2024-03-06 00:10:00,0,0,9,8,3,20
2024-03-06 00:20:00,0,0,13,11,5,29
2024-03-06 00:30:00,1,0,9,10,6,26
2024-03-06 00:40:00,0,0,11,5,4,20
2024-03-06 00:50:00,0,0,10,6,7,23
2024-03-06 01:00:00,0,0,11,5,5,21
2024-03-06 01:10:00,0,0,5,4,1,10
2024-03-06 01:20:00,0,0,7,3,6,16
2024-03-06 01:30:00,0,0,8,5,3,16
2024-03-06 01:40:00,0,0,3,1,2,6
2024-03-06 01:50:00,0,0,1,1,0,2
2024-03-06 02:00:00,0,0,4,1,3,8
2024-03-06 02:10:00,0,0,7,4,3,14
2024-03-06 02:20:00,0,0,11,3,8,22
2024-03-06 02:30:00,0,0,6,3,4,13
2024-03-06 02:40:00,0,0,3,6,1,10
2024-03-06 02:50:00,0,0,7,3,4,14
2024-03-06 03:00:00,0,0,5,4,2,11
2024-03-06 03:10:00,0,0,5,3,5,13
2024-03-06 03:20:00,0,0,9,3,7,19
2024-03-06 03:30:00,1,0,3,5,2,11
2024-03-06 03:40:00,0,0,8,10,6,24
2024-03-06 03:50:00,0,0,5,2,3,10
2024-03-06 04:00:00,0,0,14,8,6,28
2024-03-06 04:10:00,0,0,5,6,2,13
2024-03-06 04:20:00,0,0,11,13,4,28
2024-03-06 04:30:00,0,0,11,10,3,24
2024-03-06 04:40:00,0,0,20,18,14,52
2024-03-06 04:50:00,0,0,12,23,7,42
2024-03-06 05:00:00,0,0,28,21,15,64
2024-03-06 05:10:00,1,0,19,32,9,61
2024-03-06 05:20:00,0,0,30,49,13,92
2024-03-06 05:30:00,0,0,38,61,17,116
2024-03-06 05:40:00,0,0,42,62,10,114
2024-03-06 05:50:00,0,0,46,64,25,135
2024-03-06 06:00:00,1,0,56,68,24,149
2024-03-06 06:10:00,1,0,72,68,26,167
2024-03-06 06:20:00,2,0,81,81,21,185
2024-03-06 06:30:00,3,0,74,97,16,190
2024-03-06 06:40:00,3,0,111,93,35,242
2024-03-06 06:50:00,3,0,111,91,17,222
2024-03-06 07:00:00,2,0,99,91,21,213
2024-03-06 07:10:00,4,0,119,159,30,312
2024-03-06 07:20:00,4,1,132,143,22,302
2024-03-06 07:30:00,4,0,127,172,16,319
2024-03-06 07:40:00,3,0,132,169,19,323
2024-03-06 07:50:00,3,1,160,149,14,327
2024-03-06 08:00:00,4,0,142,128,18,292
2024-03-06 08:10:00,4,0,126,127,18,275
2024-03-06 08:20:00,0,0,123,131,21,275
2024-03-06 08:30:00,6,1,117,109,20,253
2024-03-06 08:40:00,5,1,109,112,22,249
2024-03-06 08:50:00,2,0,112,124,23,261
2024-03-06 09:00:00,6,1,108,99,18,232
2024-03-06 09:10:00,7,1,133,100,23,264
2024-03-06 09:20:00,0,1,104,114,19,238
2024-03-06 09:30:00,5,0,118,96,27,246
2024-03-06 09:40:00,4,0,42,122,20,188
2024-03-06 09:50:00,2,1,111,92,25,231
2024-03-06 10:00:00,8,0,97,97,23,225
2024-03-06 10:10:00,3,0,98,98,21,220
2024-03-06 10:20:00,5,2,100,99,23,229
2024-03-06 10:30:00,2,1,93,92,19,207
2024-03-06 10:40:00,1,0,90,95,25,211
2024-03-06 10:50:00,2,1,95,110,21,229
2024-03-06 11:00:00,1,1,133,84,24,243
2024-03-06 11:10:00,0,0,104,121,30,255
2024-03-06 11:20:00,4,0,105,104,22,235
2024-03-06 11:30:00,3,0,107,103,31,244
2024-03-06 11:40:00,4,0,124,101,28,257
2024-03-06 11:50:00,6,0,113,99,26,244
2024-03-06 12:00:00,3,1,118,91,18,231
2024-03-06 12:10:00,3,0,131,99,27,260
2024-03-06 12:20:00,1,0,115,118,23,257
2024-03-06 12:30:00,3,1,108,105,30,247
2024-03-06 12:40:00,5,1,134,109,23,272
2024-03-06 12:50:00,2,1,113,117,20,253
2024-03-06 13:00:00,6,3,107,116,11,243
2024-03-06 13:10:00,3,1,136,100,134,374
2024-03-06 13:20:00,2,1,132,111,131,377
2024-03-06 13:30:00,4,0,114,85,82,285
2024-03-06 13:40:00,1,0,115,114,52,282
2024-03-06 13:50:00,5,0,110,124,28,267
2024-03-06 14:00:00,2,0,135,118,32,287
2024-03-06 14:10:00,1,1,138,115,13,268
2024-03-06 14:20:00,3,0,138,131,26,298
2024-03-06 14:30:00,4,1,134,109,29,277
2024-03-06 14:40:00,6,1,142,129,16,294
2024-03-06 14:50:00,0,0,128,132,18,278
2024-03-06 15:00:00,7,0,150,122,26,305
2024-03-06 15:10:00,2,6,146,117,16,287
2024-03-06 15:20:00,5,1,137,127,21,291
2024-03-06 15:30:00,3,0,163,137,19,322
2024-03-06 15:40:00,4,0,126,139,13,282
2024-03-06 15:50:00,2,0,134,141,18,295
2024-03-06 16:00:00,8,1,120,144,22,295
2024-03-06 16:10:00,8,0,141,143,20,312
2024-03-06 16:20:00,10,1,165,143,17,336
2024-03-06 16:30:00,12,1,156,140,21,330
2024-03-06 16:40:00,14,0,146,123,16,299
2024-03-06 16:50:00,10,0,170,152,7,339
2024-03-06 17:00:00,10,0,159,139,12,320
2024-03-06 17:10:00,11,1,158,134,9,313
2024-03-06 17:20:00,3,0,149,152,18,322
2024-03-06 17:30:00,3,0,173,124,15,315
2024-03-06 17:40:00,6,1,127,118,11,263
2024-03-06 17:50:00,5,1,146,128,21,301
2024-03-06 18:00:00,3,0,126,134,34,297
2024-03-06 18:10:00,2,1,135,121,14,273
2024-03-06 18:20:00,3,0,115,125,23,266
2024-03-06 18:30:00,4,0,130,125,18,277
2024-03-06 18:40:00,4,0,100,125,32,261
2024-03-06 18:50:00,6,1,100,94,31,232
2024-03-06 19:00:00,3,0,92,101,34,230
2024-03-06 19:10:00,3,0,104,101,35,243
2024-03-06 19:20:00,1,0,88,79,22,190
2024-03-06 19:30:00,5,0,85,74,26,190
2024-03-06 19:40:00,2,2,94,78,35,211
2024-03-06 19:50:00,2,0,84,58,37,181
2024-03-06 20:00:00,2,0,70,56,27,155
2024-03-06 20:10:00,0,0,63,78,26,167
2024-03-06 20:20:00,0,0,78,66,32,176
2024-03-06 20:30:00,4,0,49,48,16,117
2024-03-06 20:40:00,0,0,54,32,27,113
2024-03-06 20:50:00,2,0,49,43,11,105
2024-03-06 21:00:00,0,0,45,48,22,115
2024-03-06 21:10:00,11,1,65,52,26,155
2024-03-06 21:20:00,0,1,54,50,17,122
2024-03-06 21:30:00,0,1,52,41,18,112
2024-03-06 21:40:00,2,1,42,32,17,94
2024-03-06 21:50:00,0,0,43,41,14,98
2024-03-06 22:00:00,2,1,41,42,25,111
2024-03-06 22:10:00,3,0,48,33,23,107
2024-03-06 22:20:00,2,0,32,24,16,74
2024-03-06 22:30:00,3,0,42,34,21,100
2024-03-06 22:40:00,1,0,24,27,14,66
2024-03-06 22:50:00,0,1,32,27,17,77
2024-03-06 23:00:00,1,1,29,25,15,71
2024-03-06 23:10:00,4,2,28,24,9,67
2024-03-06 23:20:00,1,0,14,11,6,32
2024-03-06 23:30:00,1,1,25,7,14,48
2024-03-06 23:40:00,1,0,17,6,5,29
2024-03-06 23:50:00,1,0,14,10,7,32
2024-03-07 00:00:00,0,0,10,10,5,25
2024-03-07 00:10:00,0,0,16,8,6,30
2024-03-07 00:20:00,0,0,4,7,3,14
2024-03-07 00:30:00,2,0,8,1,6,17
2024-03-07 00:40:00,1,0,6,4,2,13
2024-03-07 00:50:00,1,0,7,7,2,17
2024-03-07 01:00:00,0,0,12,9,5,26
2024-03-07 01:10:00,0,0,4,5,1,10
2024-03-07 01:20:00,0,1,6,5,3,15
2024-03-07 01:30:00,0,0,11,4,6,21
2024-03-07 01:40:00,0,0,5,3,1,9
2024-03-07 01:50:00,0,0,6,1,5,12
2024-03-07 02:00:00,0,0,7,3,4,14
2024-03-07 02:10:00,0,0,4,4,4,12
2024-03-07 02:20:00,0,0,10,6,6,22
2024-03-07 02:30:00,0,0,8,2,5,15
2024-03-07 02:40:00,0,0,5,6,5,16
2024-03-07 02:50:00,0,0,9,3,6,18
2024-03-07 03:00:00,0,0,6,2,2,10
2024-03-07 03:10:00,0,0,5,3,1,9
2024-03-07 03:20:00,1,0,9,2,5,17
2024-03-07 03:30:00,1,0,7,5,5,18
2024-03-07 03:40:00,0,0,7,8,4,19
2024-03-07 03:50:00,0,0,6,7,4,17
2024-03-07 04:00:00,1,0,8,10,4,23
2024-03-07 04:10:00,0,0,6,11,0,17
2024-03-07 04:20:00,0,0,8,5,5,18
2024-03-07 04:30:00,0,0,11,10,8,29
2024-03-07 04:40:00,0,0,17,15,7,39
2024-03-07 04:50:00,0,0,20,18,9,47
2024-03-07 05:00:00,0,0,20,24,6,50
2024-03-07 05:10:00,0,0,19,36,11,66
2024-03-07 05:20:00,0,0,25,56,11,92
2024-03-07 05:30:00,2,0,52,51,18,123
2024-03-07 05:40:00,1,0,42,61,13,117
2024-03-07 05:50:00,3,0,61,59,16,139
2024-03-07 06:00:00,1,0,47,52,17,117
2024-03-07 06:10:00,1,0,70,67,21,159
2024-03-07 06:20:00,3,0,89,83,27,202
2024-03-07 06:30:00,1,0,73,83,17,174
2024-03-07 06:40:00,1,0,106,110,28,245
2024-03-07 06:50:00,1,0,117,114,25,257
2024-03-07 07:00:00,4,0,115,75,27,221
2024-03-07 07:10:00,2,0,103,139,27,271
2024-03-07 07:20:00,1,0,124,135,27,287
2024-03-07 07:30:00,2,1,132,150,17,302
2024-03-07 07:40:00,7,0,141,150,20,318
2024-03-07 07:50:00,2,0,141,156,22,321
2024-03-07 08:00:00,5,0,149,142,30,326
2024-03-07 08:10:00,5,0,124,136,40,305
2024-03-07 08:20:00,6,0,109,133,21,269
2024-03-07 08:30:00,3,0,121,125,21,270
2024-03-07 08:40:00,3,0,138,101,28,270
2024-03-07 08:50:00,4,2,137,110,18,271
2024-03-07 09:00:00,2,0,126,113,25,266
2024-03-07 09:10:00,6,3,117,94,26,246
2024-03-07 09:20:00,5,1,109,118,25,258
2024-03-07 09:30:00,3,0,118,112,24,257
2024-03-07 09:40:00,5,0,120,136,24,285
2024-03-07 09:50:00,5,0,112,103,20,240
2024-03-07 10:00:00,2,1,135,114,20,272
2024-03-07 10:10:00,5,0,134,103,24,266
2024-03-07 10:20:00,2,0,116,107,37,262
2024-03-07 10:30:00,3,1,103,105,21,233
2024-03-07 10:40:00,3,0,86,101,24,214
2024-03-07 10:50:00,1,0,114,123,25,263
2024-03-07 11:00:00,3,0,110,117,23,253
2024-03-07 11:10:00,2,0,115,122,37,276
2024-03-07 11:20:00,0,0,115,115,30,260
2024-03-07 11:30:00,5,1,127,106,21,260
2024-03-07 11:40:00,3,0,123,125,26,277
2024-03-07 11:50:00,5,0,128,105,21,259
2024-03-07 12:00:00,5,2,124,117,24,272
2024-03-07 12:10:00,0,0,135,128,21,284
2024-03-07 12:20:00,5,0,126,118,33,282
2024-03-07 12:30:00,7,0,127,95,32,261
2024-03-07 12:40:00,1,0,107,114,22,244
2024-03-07 12:50:00,6,1,114,114,26,261
2024-03-07 13:00:00,5,1,110,106,21,243
2024-03-07 13:10:00,4,0,133,103,29,269
2024-03-07 13:20:00,3,0,142,117,24,286
2024-03-07 13:30:00,4,0,79,90,15,188
2024-03-07 13:40:00,7,0,147,126,25,305
2024-03-07 13:50:00,3,1,120,123,18,265
2024-03-07 14:00:00,5,0,143,115,18,281
2024-03-07 14:10:00,2,2,135,140,18,297
2024-03-07 14:20:00,5,1,150,106,18,280
2024-03-07 14:30:00,3,2,136,124,16,281
2024-03-07 14:40:00,2,2,138,114,18,274
2024-03-07 14:50:00,3,0,156,117,20,296
2024-03-07 15:00:00,3,1,135,122,15,276
2024-03-07 15:10:00,8,1,156,129,21,315
2024-03-07 15:20:00,2,1,131,129,23,286
2024-03-07 15:30:00,3,1,157,158,23,342
2024-03-07 15:40:00,5,0,136,124,25,290
2024-03-07 15:50:00,3,0,157,141,16,317
2024-03-07 16:00:00,6,2,148,134,12,302
2024-03-07 16:10:00,3,0,173,149,13,338
2024-03-07 16:20:00,6,3,148,168,12,337
2024-03-07 16:30:00,7,0,164,147,16,334
2024-03-07 16:40:00,12,3,151,129,10,305
2024-03-07 16:50:00,5,2,157,157,9,330
2024-03-07 17:00:00,8,0,170,110,11,299
2024-03-07 17:10:00,8,2,166,141,12,329
2024-03-07 17:20:00,7,0,163,147,12,329
2024-03-07 17:30:00,3,0,165,144,20,332
2024-03-07 17:40:00,7,0,150,152,14,323
2024-03-07 17:50:00,2,1,162,145,15,325
2024-03-07 18:00:00,1,1,146,153,34,335
2024-03-07 18:10:00,1,0,122,159,20,302
2024-03-07 18:20:00,2,0,138,155,21,316
2024-03-07 18:30:00,3,1,120,112,28,264
2024-03-07 18:40:00,7,1,125,126,22,281
2024-03-07 18:50:00,6,0,130,95,22,253
2024-03-07 19:00:00,3,1,121,104,16,245
2024-03-07 19:10:00,1,1,76,86,21,185
2024-03-07 19:20:00,3,0,85,91,28,207
2024-03-07 19:30:00,0,0,76,100,24,200
2024-03-07 19:40:00,3,0,63,68,26,160
2024-03-07 19:50:00,0,0,0,89,25,114
2024-03-07 20:00:00,3,0,24,74,25,126
2024-03-07 20:10:00,1,0,26,74,18,119
2024-03-07 20:20:00,3,0,89,53,35,180
2024-03-07 20:30:00,1,0,56,70,17,144
2024-03-07 20:40:00,1,0,57,44,18,120
2024-03-07 20:50:00,2,0,64,56,28,150
2024-03-07 21:00:00,2,1,60,50,23,136
2024-03-07 21:10:00,6,1,68,44,31,150
2024-03-07 21:20:00,3,1,63,49,31,147
2024-03-07 21:30:00,4,0,54,56,17,131
2024-03-07 21:40:00,3,0,38,39,22,102
2024-03-07 21:50:00,0,0,45,43,13,101
2024-03-07 22:00:00,0,0,52,41,24,117
2024-03-07 22:10:00,7,0,54,37,15,113
2024-03-07 22:20:00,2,0,39,43,14,98
2024-03-07 22:30:00,0,0,39,30,17,86
2024-03-07 22:40:00,0,0,32,18,16,66
2024-03-07 22:50:00,0,0,37,32,14,83
2024-03-07 23:00:00,3,1,31,24,13,72
2024-03-07 23:10:00,0,0,30,13,12,55
2024-03-07 23:20:00,0,0,12,20,8,40
2024-03-07 23:30:00,0,0,16,16,10,42
2024-03-07 23:40:00,0,0,10,13,4,27
2024-03-07 23:50:00,1,0,12,17,5,35
2024-03-08 00:00:00,1,1,17,11,4,34
2024-03-08 00:10:00,1,0,12,15,8,36
2024-03-08 00:20:00,1,0,8,4,2,15
2024-03-08 00:30:00,0,0,9,1,7,17
2024-03-08 00:40:00,0,0,11,5,7,23
2024-03-08 00:50:00,0,0,9,9,5,23
2024-03-08 01:00:00,0,0,10,11,7,28
2024-03-08 01:10:00,0,0,7,9,5,21
2024-03-08 01:20:00,0,0,4,3,1,8
2024-03-08 01:30:00,0,0,6,5,5,16
2024-03-08 01:40:00,1,0,8,4,3,16
2024-03-08 01:50:00,0,0,7,5,1,13
2024-03-08 02:00:00,0,0,6,3,4,13
2024-03-08 02:10:00,0,0,2,6,2,10
2024-03-08 02:20:00,0,0,10,4,9,23
2024-03-08 02:30:00,0,0,7,3,5,15
2024-03-08 02:40:00,0,0,6,3,3,12
2024-03-08 02:50:00,0,0,5,1,4,10
2024-03-08 03:00:00,0,0,7,4,4,15
2024-03-08 03:10:00,0,0,2,2,1,5
2024-03-08 03:20:00,0,0,5,7,5,17
2024-03-08 03:30:00,0,0,9,7,7,23
2024-03-08 03:40:00,1,1,6,5,6,19
2024-03-08 03:50:00,0,0,5,8,2,15
2024-03-08 04:00:00,0,0,6,4,2,12
2024-03-08 04:10:00,0,0,7,9,3,19
2024-03-08 04:20:00,0,0,5,4,4,13
2024-03-08 04:30:00,0,0,9,8,7,24
2024-03-08 04:40:00,0,0,10,17,4,31
2024-03-08 04:50:00,0,0,13,15,5,33
2024-03-08 05:00:00,0,0,16,24,6,46
2024-03-08 05:10:00,1,0,21,24,9,55
2024-03-08 05:20:00,0,0,26,55,13,94
2024-03-08 05:30:00,1,0,32,39,16,88
2024-03-08 05:40:00,0,0,51,66,17,134
2024-03-08 05:50:00,2,0,47,59,18,126
2024-03-08 06:00:00,2,0,54,54,17,127
2024-03-08 06:10:00,2,0,63,80,23,168
2024-03-08 06:20:00,1,0,74,81,18,174
2024-03-08 06:30:00,2,0,76,78,16,172
2024-03-08 06:40:00,3,0,112,99,30,244
2024-03-08 06:50:00,4,0,122,101,24,251
2024-03-08 07:00:00,3,0,87,94,18,202
2024-03-08 07:10:00,1,0,113,125,22,261
2024-03-08 07:20:00,2,0,124,124,21,271
2024-03-08 07:30:00,1,0,125,142,24,292
2024-03-08 07:40:00,2,0,134,117,12,265
2024-03-08 07:50:00,0,0,149,157,25,331
2024-03-08 08:00:00,2,0,148,95,43,288
2024-03-08 08:10:00,1,0,133,133,38,305
2024-03-08 08:20:00,1,0,130,104,25,260
2024-03-08 08:30:00,3,0,105,105,34,247
2024-03-08 08:40:00,0,1,104,124,26,255
2024-03-08 08:50:00,0,1,130,99,26,256
2024-03-08 09:00:00,1,0,129,104,25,259
2024-03-08 09:10:00,4,1,106,106,26,243
2024-03-08 09:20:00,1,0,107,103,24,235
2024-03-08 09:30:00,7,0,118,125,28,278
2024-03-08 09:40:00,2,1,109,120,27,259
2024-03-08 09:50:00,4,1,124,91,29,249
2024-03-08 10:00:00,2,0,125,108,33,268
2024-03-08 10:10:00,4,0,129,104,25,262
2024-03-08 10:20:00,3,0,123,101,21,248
2024-03-08 10:30:00,5,0,130,101,10,246
2024-03-08 10:40:00,1,0,123,128,12,264
2024-03-08 10:50:00,1,1,120,111,16,249
2024-03-08 11:00:00,1,0,126,88,24,239
2024-03-08 11:10:00,5,0,139,118,15,277
2024-03-08 11:20:00,5,0,147,130,18,300
2024-03-08 11:30:00,4,0,119,124,15,262
2024-03-08 11:40:00,6,0,134,121,16,277
2024-03-08 11:50:00,3,0,132,149,23,307
2024-03-08 12:00:00,6,0,128,128,17,279
2024-03-08 12:10:00,3,0,146,128,27,304
2024-03-08 12:20:00,4,0,142,148,20,314
2024-03-08 12:30:00,2,1,134,136,12,285
2024-03-08 12:40:00,2,0,144,114,21,281
2024-03-08 12:50:00,8,1,130,146,18,303
2024-03-08 13:00:00,3,1,138,124,21,287
2024-03-08 13:10:00,2,1,155,136,18,312
2024-03-08 13:20:00,4,0,157,137,15,313
2024-03-08 13:30:00,2,0,164,123,26,315
2024-03-08 13:40:00,6,0,155,134,14,309
2024-03-08 13:50:00,4,0,172,130,14,320
2024-03-08 14:00:00,7,0,168,119,13,307
2024-03-08 14:10:00,4,0,155,77,16,252
2024-03-08 14:20:00,3,0,145,156,15,319
2024-03-08 14:30:00,3,1,161,166,24,355
2024-03-08 14:40:00,8,1,157,144,19,329
2024-03-08 14:50:00,3,1,139,136,19,298
2024-03-08 15:00:00,3,0,123,123,11,260
2024-03-08 15:10:00,4,2,156,142,19,323
2024-03-08 15:20:00,1,1,153,156,18,329
2024-03-08 15:30:00,4,2,173,157,7,343
2024-03-08 15:40:00,6,1,156,141,5,309
2024-03-08 15:50:00,6,0,155,119,9,289
2024-03-08 16:00:00,5,0,137,170,18,330
2024-03-08 16:10:00,6,0,150,153,21,330
2024-03-08 16:20:00,9,0,161,131,21,322
2024-03-08 16:30:00,13,0,153,149,14,329
2024-03-08 16:40:00,8,1,158,154,18,339
2024-03-08 16:50:00,1,0,138,147,11,297
2024-03-08 17:00:00,9,3,140,134,14,300
2024-03-08 17:10:00,4,0,134,132,10,280
2024-03-08 17:20:00,6,0,0,151,83,240
2024-03-08 17:30:00,5,0,0,139,153,297
2024-03-08 17:40:00,2,0,19,135,127,283
2024-03-08 17:50:00,5,0,117,138,110,370
2024-03-08 18:00:00,5,0,125,133,105,368
2024-03-08 18:10:00,5,0,155,133,20,313
2024-03-08 18:20:00,3,0,131,125,28,287
2024-03-08 18:30:00,0,1,121,115,26,263
2024-03-08 18:40:00,1,0,123,134,30,288
2024-03-08 18:50:00,0,0,124,124,34,282
2024-03-08 19:00:00,2,0,101,104,26,233
2024-03-08 19:10:00,4,0,93,98,20,215
2024-03-08 19:20:00,5,0,78,96,20,199
2024-03-08 19:30:00,2,1,103,95,29,230
2024-03-08 19:40:00,2,0,72,84,18,176
2024-03-08 19:50:00,2,0,71,70,14,157
2024-03-08 20:00:00,1,1,66,69,23,160
2024-03-08 20:10:00,1,0,71,65,28,165
2024-03-08 20:20:00,0,0,78,82,34,194
2024-03-08 20:30:00,0,0,68,54,26,148
2024-03-08 20:40:00,1,0,62,66,17,146
2024-03-08 20:50:00,1,0,48,64,18,131
2024-03-08 21:00:00,2,0,59,45,22,128
2024-03-08 21:10:00,0,1,52,66,20,139
2024-03-08 21:20:00,4,0,61,36,20,121
2024-03-08 21:30:00,3,1,55,48,15,122
2024-03-08 21:40:00,5,0,49,43,22,119
2024-03-08 21:50:00,4,0,48,42,17,111
2024-03-08 22:00:00,2,0,38,47,12,99
2024-03-08 22:10:00,2,0,57,48,23,130
2024-03-08 22:20:00,1,0,50,28,21,100
2024-03-08 22:30:00,0,0,46,35,16,97
2024-03-08 22:40:00,1,0,49,52,20,122
2024-03-08 22:50:00,1,0,54,37,18,110
2024-03-08 23:00:00,0,1,36,29,12,78
2024-03-08 23:10:00,0,0,36,32,9,77
2024-03-08 23:20:00,0,0,31,32,14,77
2024-03-08 23:30:00,1,0,27,17,10,55
2024-03-08 23:40:00,0,0,30,21,13,64
2024-03-08 23:50:00,0,0,22,19,9,50
2024-03-09 00:00:00,0,0,28,22,16,66
2024-03-09 00:10:00,0,0,21,10,11,42
2024-03-09 00:20:00,0,0,26,12,15,53
2024-03-09 00:30:00,2,0,18,19,10,49
2024-03-09 00:40:00,1,0,22,18,7,48
2024-03-09 00:50:00,0,1,17,16,5,39
2024-03-09 01:00:00,0,0,12,6,8,26
2024-03-09 01:10:00,1,0,16,8,9,34
2024-03-09 01:20:00,0,0,12,12,7,31
2024-03-09 01:30:00,0,0,9,7,9,25
2024-03-09 01:40:00,1,0,12,11,5,29
2024-03-09 01:50:00,0,0,13,12,4,29
2024-03-09 02:00:00,1,0,16,6,8,31
2024-03-09 02:10:00,0,0,9,6,5,20
2024-03-09 02:20:00,0,0,10,9,3,22
2024-03-09 02:30:00,1,0,10,10,8,29
2024-03-09 02:40:00,0,0,4,3,1,8
2024-03-09 02:50:00,0,0,7,4,6,17
2024-03-09 03:00:00,0,0,9,6,2,17
2024-03-09 03:10:00,1,0,11,11,6,29
2024-03-09 03:20:00,0,0,11,7,9,27
2024-03-09 03:30:00,1,0,10,2,6,19
2024-03-09 03:40:00,0,0,9,7,6,22
2024-03-09 03:50:00,0,0,6,5,2,13
2024-03-09 04:00:00,0,0,9,9,6,24
2024-03-09 04:10:00,0,0,5,6,2,13
2024-03-09 04:20:00,0,0,7,4,3,14
2024-03-09 04:30:00,0,0,7,6,6,19
2024-03-09 04:40:00,0,0,8,8,3,19
2024-03-09 04:50:00,0,0,7,10,4,21
2024-03-09 05:00:00,0,0,18,12,9,39
2024-03-09 05:10:00,0,0,22,14,8,44
2024-03-09 05:20:00,0,0,16,11,8,35
2024-03-09 05:30:00,0,0,16,16,6,38
2024-03-09 05:40:00,0,0,23,15,8,46
2024-03-09 05:50:00,0,0,17,18,6,41
2024-03-09 06:00:00,0,1,20,16,11,48
2024-03-09 06:10:00,0,0,23,24,11,58
2024-03-09 06:20:00,0,0,24,17,15,56
2024-03-09 06:30:00,1,0,27,19,15,62
2024-03-09 06:40:00,0,0,31,12,15,58
2024-03-09 06:50:00,1,0,28,20,10,59
2024-03-09 07:00:00,0,1,31,16,20,68
2024-03-09 07:10:00,0,0,40,38,13,91
2024-03-09 07:20:00,1,0,39,35,10,85
2024-03-09 07:30:00,2,0,42,29,15,88
2024-03-09 07:40:00,0,0,53,43,26,122
2024-03-09 07:50:00,5,0,69,31,25,130
2024-03-09 08:00:00,1,0,62,40,21,124
2024-03-09 08:10:00,1,1,58,62,20,142
2024-03-09 08:20:00,0,0,63,49,22,134
2024-03-09 08:30:00,3,1,79,77,27,187
2024-03-09 08:40:00,3,0,74,69,13,159
2024-03-09 08:50:00,2,1,101,70,24,198
2024-03-09 09:00:00,1,1,101,71,25,199
2024-03-09 09:10:00,4,0,94,91,21,210
2024-03-09 09:20:00,3,0,103,89,28,223
2024-03-09 09:30:00,7,0,90,113,16,226
2024-03-09 09:40:00,4,0,105,99,22,230
2024-03-09 09:50:00,3,0,107,106,28,244
2024-03-09 10:00:00,4,1,109,114,22,250
2024-03-09 10:10:00,3,0,113,92,23,231
2024-03-09 10:20:00,2,0,120,100,28,250
2024-03-09 10:30:00,2,2,125,110,19,258
2024-03-09 10:40:00,3,0,113,141,19,276
2024-03-09 10:50:00,0,0,128,117,26,271
2024-03-09 11:00:00,0,0,119,122,19,260
2024-03-09 11:10:00,5,0,130,116,16,267
2024-03-09 11:20:00,3,0,129,109,9,250
2024-03-09 11:30:00,2,0,134,123,14,273
2024-03-09 11:40:00,2,0,150,131,15,298
2024-03-09 11:50:00,2,0,136,126,25,289
2024-03-09 12:00:00,1,0,139,111,22,273
2024-03-09 12:10:00,2,0,137,129,19,287
2024-03-09 12:20:00,2,1,127,132,17,279
2024-03-09 12:30:00,4,0,145,141,22,312
2024-03-09 12:40:00,4,1,118,140,31,294
2024-03-09 12:50:00,5,0,131,128,26,290
2024-03-09 13:00:00,5,0,116,132,27,280
2024-03-09 13:10:00,0,0,137,143,15,295
2024-03-09 13:20:00,1,1,157,145,25,329
2024-03-09 13:30:00,8,0,141,130,17,296
2024-03-09 13:40:00,4,0,157,130,11,302
2024-03-09 13:50:00,3,4,124,143,24,298
2024-03-09 14:00:00,2,1,144,122,18,287
2024-03-09 14:10:00,3,0,148,137,14,302
2024-03-09 14:20:00,6,0,122,135,12,275
2024-03-09 14:30:00,1,1,133,138,18,291
2024-03-09 14:40:00,2,0,118,149,17,286
2024-03-09 14:50:00,2,1,139,123,10,275
2024-03-09 15:00:00,1,0,123,120,22,266
2024-03-09 15:10:00,2,1,118,123,16,260
2024-03-09 15:20:00,1,0,120,134,22,277
2024-03-09 15:30:00,0,1,109,121,18,249
2024-03-09 15:40:00,1,0,118,119,25,263
2024-03-09 15:50:00,5,1,107,117,11,241
2024-03-09 16:00:00,1,0,120,113,15,249
2024-03-09 16:10:00,2,1,97,109,23,232
2024-03-09 16:20:00,2,1,113,116,21,253
2024-03-09 16:30:00,2,1,105,135,13,256
2024-03-09 16:40:00,1,0,122,112,29,264
2024-03-09 16:50:00,4,1,118,125,19,267
2024-03-09 17:00:00,1,0,102,111,23,237
2024-03-09 17:10:00,1,0,132,100,31,264
2024-03-09 17:20:00,3,0,128,122,20,273
2024-03-09 17:30:00,5,0,127,124,24,280
2024-03-09 17:40:00,7,0,115,137,15,274
2024-03-09 17:50:00,2,0,108,115,35,260
2024-03-09 18:00:00,1,0,112,115,34,262
2024-03-09 18:10:00,1,1,112,92,26,232
2024-03-09 18:20:00,3,0,103,114,19,239
2024-03-09 18:30:00,0,1,88,93,26,208
2024-03-09 18:40:00,5,1,111,101,31,249
2024-03-09 18:50:00,0,0,98,119,26,243
2024-03-09 19:00:00,0,0,84,85,31,200
2024-03-09 19:10:00,0,1,88,100,26,215
2024-03-09 19:20:00,1,0,90,90,24,205
2024-03-09 19:30:00,2,0,70,99,25,196
2024-03-09 19:40:00,6,0,67,84,19,176
2024-03-09 19:50:00,3,0,73,78,23,177
2024-03-09 20:00:00,0,0,56,68,16,140
2024-03-09 20:10:00,0,0,55,86,19,160
2024-03-09 20:20:00,1,0,57,58,26,142
2024-03-09 20:30:00,1,1,54,66,16,138
2024-03-09 20:40:00,1,2,56,57,21,137
2024-03-09 20:50:00,0,0,42,48,17,107
2024-03-09 21:00:00,1,0,38,54,13,106
2024-03-09 21:10:00,0,0,63,44,26,133
2024-03-09 21:20:00,1,0,46,43,22,112
2024-03-09 21:30:00,0,0,41,40,27,108
2024-03-09 21:40:00,0,0,33,40,11,84
2024-03-09 21:50:00,0,0,29,49,8,86
2024-03-09 22:00:00,0,0,38,39,20,97
2024-03-09 22:10:00,0,0,54,40,25,119
2024-03-09 22:20:00,0,1,37,43,17,98
2024-03-09 22:30:00,0,3,48,31,22,104
2024-03-09 22:40:00,0,0,40,28,17,85
2024-03-09 22:50:00,1,0,43,41,22,107
2024-03-09 23:00:00,1,0,28,21,12,62
2024-03-09 23:10:00,0,0,31,24,8,63
2024-03-09 23:20:00,0,0,44,21,22,87
2024-03-09 23:30:00,0,0,34,18,13,65
2024-03-09 23:40:00,2,0,25,27,11,65
2024-03-09 23:50:00,1,0,28,15,16,60
2024-03-10 00:00:00,0,0,31,25,16,72
2024-03-10 00:10:00,0,0,24,20,9,53
2024-03-10 00:20:00,0,0,30,19,17,66
2024-03-10 00:30:00,0,0,23,17,7,47
2024-03-10 00:40:00,0,0,20,27,13,60
2024-03-10 00:50:00,0,0,25,13,6,44
2024-03-10 01:00:00,0,0,29,17,13,59
2024-03-10 01:10:00,0,0,23,10,8,41
2024-03-10 01:20:00,1,0,14,17,6,38
2024-03-10 01:30:00,0,0,19,17,7,43
2024-03-10 01:40:00,0,0,13,15,6,34
2024-03-10 01:50:00,0,0,19,12,10,41
2024-03-10 02:00:00,0,0,11,12,5,28
2024-03-10 02:10:00,0,0,11,6,7,24
2024-03-10 02:20:00,0,0,10,5,5,20
2024-03-10 02:30:00,0,0,11,6,5,22
2024-03-10 02:40:00,0,0,20,10,14,44
2024-03-10 02:50:00,0,0,10,8,5,23
2024-03-10 03:00:00,0,0,9,7,2,18
2024-03-10 03:10:00,0,0,11,6,7,24
2024-03-10 03:20:00,1,0,14,5,12,32
2024-03-10 03:30:00,0,0,8,10,4,22
2024-03-10 03:40:00,0,0,9,8,4,21
2024-03-10 03:50:00,0,0,15,9,6,30
2024-03-10 04:00:00,1,0,8,9,6,24
2024-03-10 04:10:00,0,0,7,7,5,19
2024-03-10 04:20:00,0,0,6,7,3,16
2024-03-10 04:30:00,1,1,6,5,4,17
2024-03-10 04:40:00,0,0,2,12,1,15
2024-03-10 04:50:00,0,0,5,4,2,11
2024-03-10 05:00:00,0,0,12,8,8,28
2024-03-10 05:10:00,0,0,9,11,5,25
2024-03-10 05:20:00,0,0,7,11,1,19
2024-03-10 05:30:00,1,0,13,8,8,30
2024-03-10 05:40:00,0,0,16,13,12,41
2024-03-10 05:50:00,0,0,9,19,4,32
2024-03-10 06:00:00,1,0,12,5,6,24
2024-03-10 06:10:00,0,0,7,5,4,16
2024-03-10 06:20:00,1,0,7,8,4,20
2024-03-10 06:30:00,0,0,6,10,5,21
2024-03-10 06:40:00,0,0,14,9,5,28
2024-03-10 06:50:00,0,0,13,7,9,29
2024-03-10 07:00:00,0,0,10,10,6,26
2024-03-10 07:10:00,3,0,14,15,6,38
2024-03-10 07:20:00,0,0,14,15,6,35
2024-03-10 07:30:00,0,0,12,7,6,25
2024-03-10 07:40:00,1,0,21,8,8,38
2024-03-10 07:50:00,2,0,12,8,5,27
2024-03-10 08:00:00,2,0,13,8,7,30
2024-03-10 08:10:00,1,0,23,16,9,49
2024-03-10 08:20:00,1,0,21,14,7,43
2024-03-10 08:30:00,2,0,23,16,7,48
2024-03-10 08:40:00,0,0,35,30,15,80
2024-03-10 08:50:00,0,1,24,30,8,63
2024-03-10 09:00:00,2,0,23,24,6,55
2024-03-10 09:10:00,0,0,37,28,20,85
2024-03-10 09:20:00,5,0,46,40,12,103
2024-03-10 09:30:00,1,0,38,53,10,102
2024-03-10 09:40:00,2,0,57,66,17,142
2024-03-10 09:50:00,2,0,52,53,15,122
2024-03-10 10:00:00,2,0,51,39,23,115
2024-03-10 10:10:00,0,0,51,54,15,120
2024-03-10 10:20:00,0,0,67,62,16,145
2024-03-10 10:30:00,0,0,57,51,15,123
2024-03-10 10:40:00,0,0,69,69,21,159
2024-03-10 10:50:00,0,0,61,52,10,123
2024-03-10 11:00:00,0,0,68,64,20,152
2024-03-10 11:10:00,1,0,87,59,18,165
2024-03-10 11:20:00,0,0,66,61,13,140
2024-03-10 11:30:00,2,0,70,78,15,165
2024-03-10 11:40:00,6,0,76,62,23,167
2024-03-10 11:50:00,1,0,88,52,24,165
2024-03-10 12:00:00,3,0,75,72,24,174
2024-03-10 12:10:00,1,0,64,73,22,160
2024-03-10 12:20:00,2,0,87,64,19,172
2024-03-10 12:30:00,1,0,42,84,14,141
2024-03-10 12:40:00,2,0,77,66,20,165
2024-03-10 12:50:00,0,1,88,74,29,192
2024-03-10 13:00:00,2,1,83,71,21,178
2024-03-10 13:10:00,1,0,95,70,22,188
2024-03-10 13:20:00,1,1,75,76,21,174
2024-03-10 13:30:00,2,0,86,79,17,184
2024-03-10 13:40:00,3,0,89,68,21,181
2024-03-10 13:50:00,0,0,80,111,20,211
2024-03-10 14:00:00,0,0,96,120,24,240
2024-03-10 14:10:00,1,1,84,89,23,198
2024-03-10 14:20:00,3,2,88,103,22,218
2024-03-10 14:30:00,4,1,91,102,21,219
2024-03-10 14:40:00,5,0,94,90,18,207
2024-03-10 14:50:00,2,0,84,86,19,191
2024-03-10 15:00:00,1,0,106,104,26,237
2024-03-10 15:10:00,0,1,100,96,22,219
2024-03-10 15:20:00,1,0,75,79,25,180
2024-03-10 15:30:00,1,3,90,69,28,191
2024-03-10 15:40:00,3,0,86,91,17,197
2024-03-10 15:50:00,2,0,89,66,29,186
2024-03-10 16:00:00,2,0,85,72,18,177
2024-03-10 16:10:00,1,0,81,69,23,174
2024-03-10 16:20:00,2,0,91,84,21,198
2024-03-10 16:30:00,0,0,79,74,25,178
2024-03-10 16:40:00,1,0,90,81,26,198
2024-03-10 16:50:00,2,0,73,74,17,166
2024-03-10 17:00:00,0,0,82,83,22,187
2024-03-10 17:10:00,2,1,71,90,14,178
2024-03-10 17:20:00,0,3,86,77,18,184
2024-03-10 17:30:00,0,1,77,75,23,176
2024-03-10 17:40:00,1,0,90,92,23,206
2024-03-10 17:50:00,4,0,84,80,20,188
2024-03-10 18:00:00,3,0,76,82,28,189
2024-03-10 18:10:00,1,0,91,72,22,186
2024-03-10 18:20:00,5,1,90,121,14,231
2024-03-10 18:30:00,14,3,64,100,13,194
2024-03-10 18:40:00,3,1,74,109,18,205
2024-03-10 18:50:00,0,0,63,109,20,192
2024-03-10 19:00:00,0,1,84,108,26,219
2024-03-10 19:10:00,3,1,64,66,23,157
2024-03-10 19:20:00,4,0,62,68,13,147
2024-03-10 19:30:00,2,1,56,77,30,166
2024-03-10 19:40:00,0,0,65,66,25,156
2024-03-10 19:50:00,0,0,52,51,22,125
2024-03-10 20:00:00,1,0,39,58,15,113
2024-03-10 20:10:00,0,0,44,51,17,112
2024-03-10 20:20:00,0,0,43,45,19,107
2024-03-10 20:30:00,0,0,50,41,22,113
2024-03-10 20:40:00,0,0,56,39,18,113
2024-03-10 20:50:00,0,0,39,26,16,81
2024-03-10 21:00:00,1,0,27,58,22,108
2024-03-10 21:10:00,1,0,45,37,16,99
2024-03-10 21:20:00,0,0,43,26,28,97
2024-03-10 21:30:00,0,0,50,35,21,106
2024-03-10 21:40:00,3,0,22,27,6,58
2024-03-10 21:50:00,0,0,31,19,15,65
2024-03-10 22:00:00,0,0,31,20,12,63
2024-03-10 22:10:00,1,0,26,19,8,54
2024-03-10 22:20:00,0,0,15,17,10,42
2024-03-10 22:30:00,0,0,16,13,7,36
2024-03-10 22:40:00,1,0,23,13,9,46
2024-03-10 22:50:00,0,0,16,13,10,39
2024-03-10 23:00:00,0,0,9,16,6,31
2024-03-10 23:10:00,0,0,19,11,8,38
2024-03-10 23:20:00,1,0,13,10,6,30
2024-03-10 23:30:00,0,0,13,8,8,29
2024-03-10 23:40:00,1,1,14,13,4,33
2024-03-10 23:50:00,1,0,15,10,5,31
2024-03-11 00:00:00,0,0,8,4,4,16
2024-03-11 00:10:00,0,0,9,4,4,17
2024-03-11 00:20:00,0,0,10,9,5,24
2024-03-11 00:30:00,0,0,9,3,4,16
2024-03-11 00:40:00,0,0,11,5,4,20
2024-03-11 00:50:00,0,0,8,13,3,24
2024-03-11 01:00:00,0,0,6,5,2,13
2024-03-11 01:10:00,0,0,6,4,3,13
2024-03-11 01:20:00,0,0,9,4,6,19
2024-03-11 01:30:00,0,0,6,4,2,12
2024-03-11 01:40:00,0,0,3,1,2,6
2024-03-11 01:50:00,0,0,4,0,2,6
2024-03-11 02:00:00,0,0,5,2,3,10
2024-03-11 02:10:00,0,0,2,2,0,4
2024-03-11 02:20:00,0,0,2,0,2,4
2024-03-11 02:30:00,0,0,13,3,9,25
2024-03-11 02:40:00,0,0,2,5,1,8
2024-03-11 02:50:00,0,0,8,5,5,18
2024-03-11 03:00:00,0,0,2,0,2,4
2024-03-11 03:10:00,0,0,4,2,2,8
2024-03-11 03:20:00,1,0,3,2,1,7
2024-03-11 03:30:00,0,0,5,2,3,10
2024-03-11 03:40:00,0,1,8,4,6,19
2024-03-11 03:50:00,0,0,8,4,4,16
2024-03-11 04:00:00,0,0,4,6,1,11
2024-03-11 04:10:00,0,0,4,9,1,14
2024-03-11 04:20:00,0,0,6,8,5,19
2024-03-11 04:30:00,0,0,13,11,5,29
2024-03-11 04:40:00,1,0,9,14,1,25
2024-03-11 04:50:00,0,0,17,20,9,46
2024-03-11 05:00:00,0,0,20,27,7,54
2024-03-11 05:10:00,0,0,18,25,7,50
2024-03-11 05:20:00,0,0,29,43,17,89
2024-03-11 05:30:00,0,0,43,57,19,119
2024-03-11 05:40:00,0,0,69,67,24,160
2024-03-11 05:50:00,2,0,51,72,16,141
2024-03-11 06:00:00,2,0,47,48,21,118
2024-03-11 06:10:00,1,0,67,74,19,161
2024-03-11 06:20:00,5,0,88,70,16,179
2024-03-11 06:30:00,1,1,91,101,25,219
2024-03-11 06:40:00,1,0,111,91,25,228
2024-03-11 06:50:00,0,0,129,92,34,255
2024-03-11 07:00:00,4,0,94,109,13,220
2024-03-11 07:10:00,2,0,129,149,20,300
2024-03-11 07:20:00,3,0,111,148,5,267
2024-03-11 07:30:00,4,0,96,176,20,296
2024-03-11 07:40:00,4,1,141,165,12,323
2024-03-11 07:50:00,1,0,157,145,16,319
2024-03-11 08:00:00,4,0,138,133,21,296
2024-03-11 08:10:00,1,0,102,127,20,250
2024-03-11 08:20:00,4,0,119,136,22,281
2024-03-11 08:30:00,4,1,123,98,22,248
2024-03-11 08:40:00,2,0,105,114,13,234
2024-03-11 08:50:00,1,0,107,119,15,242
2024-03-11 09:00:00,2,0,128,101,29,260
2024-03-11 09:10:00,3,0,115,92,28,238
2024-03-11 09:20:00,3,0,113,102,21,239
2024-03-11 09:30:00,6,2,97,113,23,241
2024-03-11 09:40:00,4,2,127,113,24,270
2024-03-11 09:50:00,2,1,123,106,24,256
2024-03-11 10:00:00,3,0,116,91,16,226
2024-03-11 10:10:00,5,1,113,97,21,237
2024-03-11 10:20:00,2,0,110,98,17,227
2024-03-11 10:30:00,3,1,115,91,15,225
2024-03-11 10:40:00,4,0,108,104,20,236
2024-03-11 10:50:00,3,0,103,111,24,241
2024-03-11 11:00:00,3,1,116,126,15,261
2024-03-11 11:10:00,3,0,115,107,17,242
2024-03-11 11:20:00,1,0,116,98,19,234
2024-03-11 11:30:00,1,0,99,96,19,215
2024-03-11 11:40:00,2,0,52,104,24,182
2024-03-11 11:50:00,4,1,85,107,18,215
2024-03-11 12:00:00,4,0,88,88,24,204
2024-03-11 12:10:00,8,1,10,106,19,144
2024-03-11 12:20:00,3,0,0,127,20,150
2024-03-11 12:30:00,1,0,83,91,25,200
2024-03-11 12:40:00,3,0,97,101,25,226
2024-03-11 12:50:00,7,0,110,108,27,252
2024-03-11 13:00:00,11,0,106,109,26,252
2024-03-11 13:10:00,4,1,70,119,24,218
2024-03-11 13:20:00,2,2,105,104,20,233
2024-03-11 13:30:00,1,1,110,113,23,248
2024-03-11 13:40:00,2,0,118,112,28,260
2024-03-11 13:50:00,3,1,61,121,21,207
2024-03-11 14:00:00,3,0,123,109,29,264
2024-03-11 14:10:00,3,0,126,122,24,275
2024-03-11 14:20:00,1,1,147,112,26,287
2024-03-11 14:30:00,3,1,140,119,29,292
2024-03-11 14:40:00,5,0,120,127,23,275
2024-03-11 14:50:00,6,1,129,124,14,274
2024-03-11 15:00:00,7,0,135,120,17,279
2024-03-11 15:10:00,4,0,122,146,19,291
2024-03-11 15:20:00,4,1,127,124,14,270
2024-03-11 15:30:00,2,0,154,130,17,303
2024-03-11 15:40:00,7,0,139,114,9,269
2024-03-11 15:50:00,2,1,159,146,13,321
2024-03-11 16:00:00,6,0,105,134,22,267
2024-03-11 16:10:00,7,0,0,134,14,155
2024-03-11 16:20:00,4,1,0,119,15,139
2024-03-11 16:30:00,15,1,86,144,16,262
2024-03-11 16:40:00,11,1,22,125,22,181
2024-03-11 16:50:00,4,1,98,105,19,227
2024-03-11 17:00:00,11,2,150,123,3,289
2024-03-11 17:10:00,10,3,134,139,13,299
2024-03-11 17:20:00,6,2,107,124,12,251
2024-03-11 17:30:00,7,2,133,161,14,317
2024-03-11 17:40:00,5,0,129,129,13,276
2024-03-11 17:50:00,8,0,125,127,22,282
2024-03-11 18:00:00,4,0,121,117,19,261
2024-03-11 18:10:00,5,0,25,127,17,174
2024-03-11 18:20:00,2,0,84,124,21,231
2024-03-11 18:30:00,3,0,124,103,21,251
2024-03-11 18:40:00,5,1,108,88,23,225
2024-03-11 18:50:00,7,0,110,103,28,248
2024-03-11 19:00:00,0,1,82,85,28,196
2024-03-11 19:10:00,4,0,78,83,25,190
2024-03-11 19:20:00,3,1,85,70,27,186
2024-03-11 19:30:00,3,0,62,86,19,170
2024-03-11 19:40:00,4,0,74,83,16,177
2024-03-11 19:50:00,1,0,72,57,26,156
2024-03-11 20:00:00,2,0,59,68,21,150
2024-03-11 20:10:00,2,1,49,58,13,123
2024-03-11 20:20:00,1,0,45,58,21,125
2024-03-11 20:30:00,2,0,51,43,28,124
2024-03-11 20:40:00,2,0,49,37,13,101
2024-03-11 20:50:00,0,0,43,42,18,103
2024-03-11 21:00:00,0,0,38,40,15,93
2024-03-11 21:10:00,0,0,50,35,17,102
2024-03-11 21:20:00,0,0,54,51,18,123
2024-03-11 21:30:00,1,0,41,34,20,96
2024-03-11 21:40:00,3,0,40,37,19,99
2024-03-11 21:50:00,1,0,43,41,12,97
2024-03-11 22:00:00,1,0,38,33,22,94
2024-03-11 22:10:00,1,0,48,31,18,98
2024-03-11 22:20:00,0,0,45,20,13,78
2024-03-11 22:30:00,2,0,31,20,10,63
2024-03-11 22:40:00,0,0,33,28,13,74
2024-03-11 22:50:00,0,0,27,14,15,56
2024-03-11 23:00:00,0,0,19,16,9,44
2024-03-11 23:10:00,0,0,20,11,9,40
2024-03-11 23:20:00,0,0,16,12,10,38
2024-03-11 23:30:00,0,0,11,4,5,20
2024-03-11 23:40:00,1,1,15,9,4,30
2024-03-11 23:50:00,0,0,7,9,2,18
2024-03-12 00:00:00,0,0,9,6,6,21
2024-03-12 00:10:00,0,0,8,2,2,12
2024-03-12 00:20:00,0,0,3,1,2,6
2024-03-12 00:30:00,0,0,4,2,2,8
2024-03-12 00:40:00,0,0,10,4,3,17
2024-03-12 00:50:00,0,0,7,4,6,17
2024-03-12 01:00:00,1,0,7,3,5,16
2024-03-12 01:10:00,0,0,6,4,3,13
2024-03-12 01:20:00,0,0,5,3,3,11
2024-03-12 01:30:00,0,0,5,2,4,11
2024-03-12 01:40:00,0,0,8,4,3,15
2024-03-12 01:50:00,0,0,9,4,5,18
2024-03-12 02:00:00,0,0,4,5,2,11
2024-03-12 02:10:00,0,0,1,1,1,3
2024-03-12 02:20:00,0,0,7,2,3,12
2024-03-12 02:30:00,0,0,3,2,3,8
2024-03-12 02:40:00,0,0,8,7,2,17
2024-03-12 02:50:00,0,0,7,5,4,16
2024-03-12 03:00:00,0,0,5,6,4,15
2024-03-12 03:10:00,0,0,7,5,7,19
2024-03-12 03:20:00,0,0,6,1,4,11
2024-03-12 03:30:00,1,0,9,6,6,22
2024-03-12 03:40:00,1,1,5,3,3,13
2024-03-12 03:50:00,0,0,7,5,1,13
2024-03-12 04:00:00,0,0,7,8,3,18
2024-03-12 04:10:00,0,0,8,9,4,21
2024-03-12 04:20:00,0,0,10,11,6,27
2024-03-12 04:30:00,0,0,10,9,5,24
2024-03-12 04:40:00,0,0,12,11,2,25
2024-03-12 04:50:00,0,0,11,20,5,36
2024-03-12 05:00:00,0,0,19,26,4,49
2024-03-12 05:10:00,0,0,20,29,3,52
2024-03-12 05:20:00,0,0,17,48,10,75
2024-03-12 05:30:00,1,0,44,50,15,110
2024-03-12 05:40:00,0,0,54,49,20,123
2024-03-12 05:50:00,0,0,36,49,11,96
2024-03-12 06:00:00,2,0,53,69,16,140
2024-03-12 06:10:00,4,1,61,57,21,144
2024-03-12 06:20:00,3,0,72,72,17,164
2024-03-12 06:30:00,1,0,86,98,15,200
2024-03-12 06:40:00,1,1,107,95,23,227
2024-03-12 06:50:00,3,0,108,118,17,246
2024-03-12 07:00:00,6,1,92,121,18,238
2024-03-12 07:10:00,2,0,97,139,17,255
2024-03-12 07:20:00,3,0,92,132,22,249
2024-03-12 07:30:00,1,0,89,164,18,272
2024-03-12 07:40:00,4,1,94,168,12,279
2024-03-12 07:50:00,1,0,127,113,27,268
2024-03-12 08:00:00,1,0,112,152,23,288
2024-03-12 08:10:00,4,0,94,164,28,290
2024-03-12 08:20:00,2,0,63,123,23,211
2024-03-12 08:30:00,1,0,91,116,24,232
2024-03-12 08:40:00,2,0,89,129,25,245
2024-03-12 08:50:00,1,1,118,118,30,268
2024-03-12 09:00:00,6,0,47,96,15,164
2024-03-12 09:10:00,9,0,105,109,27,250
2024-03-12 09:20:00,4,1,118,105,25,253
2024-03-12 09:30:00,4,1,105,98,42,250
2024-03-12 09:40:00,8,2,88,104,37,239
2024-03-12 09:50:00,4,0,103,121,16,244
2024-03-12 10:00:00,5,0,102,87,19,213
2024-03-12 10:10:00,7,0,87,111,19,224
2024-03-12 10:20:00,2,0,97,97,27,223
2024-03-12 10:30:00,1,0,119,93,29,242
2024-03-12 10:40:00,1,0,79,103,22,205
2024-03-12 10:50:00,5,0,100,102,17,224
2024-03-12 11:00:00,7,2,96,101,18,224
2024-03-12 11:10:00,1,0,101,111,14,227
2024-03-12 11:20:00,2,0,101,89,20,212
2024-03-12 11:30:00,1,0,86,100,18,205
2024-03-12 11:40:00,3,0,104,103,23,233
2024-03-12 11:50:00,5,1,117,121,15,259
2024-03-12 12:00:00,2,2,113,100,24,241
2024-03-12 12:10:00,4,1,118,101,14,238
2024-03-12 12:20:00,4,0,115,108,29,256
2024-03-12 12:30:00,2,0,3,90,26,121
2024-03-12 12:40:00,4,0,26,110,19,159
2024-03-12 12:50:00,6,0,93,106,26,231
2024-03-12 13:00:00,3,0,88,102,25,218
2024-03-12 13:10:00,7,0,120,115,13,255
2024-03-12 13:20:00,4,0,109,121,20,254
2024-03-12 13:30:00,5,1,110,113,20,249
2024-03-12 13:40:00,5,1,126,110,19,261
2024-03-12 13:50:00,5,0,109,128,22,264
2024-03-12 14:00:00,2,1,116,104,19,242
2024-03-12 14:10:00,5,1,124,117,27,274
2024-03-12 14:20:00,4,0,122,114,21,261
2024-03-12 14:30:00,5,0,130,102,22,259
2024-03-12 14:40:00,4,2,139,109,26,280
2024-03-12 14:50:00,2,2,117,117,18,256
2024-03-12 15:00:00,6,0,105,148,26,285
2024-03-12 15:10:00,2,0,0,137,31,170
2024-03-12 15:20:00,2,1,126,148,15,292
2024-03-12 15:30:00,4,2,90,157,21,274
2024-03-12 15:40:00,2,0,119,162,7,290
2024-03-12 15:50:00,7,0,129,141,17,294
2024-03-12 16:00:00,4,1,134,139,25,303
2024-03-12 16:10:00,9,0,119,138,20,286
2024-03-12 16:20:00,4,0,149,126,18,297
2024-03-12 16:30:00,2,0,157,146,12,317
2024-03-12 16:40:00,10,0,148,135,6,299
2024-03-12 16:50:00,8,3,144,135,18,308
2024-03-12 17:00:00,7,1,150,137,25,320
2024-03-12 17:10:00,8,2,119,148,16,293
2024-03-12 17:20:00,10,1,128,135,14,288
2024-03-12 17:30:00,4,0,148,131,22,305
2024-03-12 17:40:00,7,0,123,104,27,261
2024-03-12 17:50:00,4,0,128,152,24,308
2024-03-12 18:00:00,0,0,146,117,27,290
2024-03-12 18:10:00,3,1,107,142,22,275
2024-03-12 18:20:00,3,0,122,117,25,267
2024-03-12 18:30:00,4,0,119,100,18,241
2024-03-12 18:40:00,4,1,118,118,28,269
2024-03-12 18:50:00,1,0,129,73,33,236
2024-03-12 19:00:00,2,0,85,74,20,181
2024-03-12 19:10:00,2,0,85,95,29,211
2024-03-12 19:20:00,5,0,70,77,15,167
2024-03-12 19:30:00,5,0,68,75,14,162
2024-03-12 19:40:00,3,0,74,68,26,171
2024-03-12 19:50:00,0,0,75,65,34,174
2024-03-12 20:00:00,2,0,59,70,20,151
2024-03-12 20:10:00,1,0,54,58,18,131
2024-03-12 20:20:00,0,0,56,61,23,140
2024-03-12 20:30:00,6,1,58,41,9,115
2024-03-12 20:40:00,3,0,35,55,7,100
2024-03-12 20:50:00,1,0,50,53,33,137
2024-03-12 21:00:00,1,0,53,65,20,139
2024-03-12 21:10:00,10,1,56,45,21,133
2024-03-12 21:20:00,4,0,36,48,18,106
2024-03-12 21:30:00,1,0,43,48,18,110
2024-03-12 21:40:00,3,0,37,39,14,93
2024-03-12 21:50:00,0,0,39,38,18,95
2024-03-12 22:00:00,1,0,31,38,17,87
2024-03-12 22:10:00,0,0,37,26,15,78
2024-03-12 22:20:00,1,0,41,21,14,77
2024-03-12 22:30:00,4,0,26,26,13,69
2024-03-12 22:40:00,0,0,31,28,16,75
2024-03-12 22:50:00,0,0,14,21,6,41
2024-03-12 23:00:00,0,0,22,24,10,56
2024-03-12 23:10:00,1,0,21,12,6,40
2024-03-12 23:20:00,0,0,14,7,9,30
2024-03-12 23:30:00,0,0,13,11,7,31
2024-03-12 23:40:00,0,0,15,8,8,31
2024-03-12 23:50:00,0,0,11,5,6,22
2024-03-13 00:00:00,0,0,13,8,8,29
2024-03-13 00:10:00,0,0,11,8,6,25
2024-03-13 00:20:00,0,0,8,7,4,19
2024-03-13 00:30:00,0,0,5,4,1,10
2024-03-13 00:40:00,0,0,3,6,0,9
2024-03-13 00:50:00,0,0,13,5,7,25
2024-03-13 01:00:00,0,0,7,6,3,16
2024-03-13 01:10:00,0,0,5,2,2,9
2024-03-13 01:20:00,0,1,8,2,4,15
2024-03-13 01:30:00,1,1,8,7,4,21
2024-03-13 01:40:00,0,0,4,2,0,6
2024-03-13 01:50:00,0,0,5,2,1,8
2024-03-13 02:00:00,0,0,6,4,3,13
2024-03-13 02:10:00,0,0,6,3,3,12
2024-03-13 02:20:00,1,0,8,4,6,19
2024-03-13 02:30:00,0,0,8,3,6,17
2024-03-13 02:40:00,0,0,5,2,4,11
2024-03-13 02:50:00,0,0,6,6,4,16
2024-03-13 03:00:00,0,0,4,2,2,8
2024-03-13 03:10:00,0,0,5,3,4,12
2024-03-13 03:20:00,1,0,6,3,3,13
2024-03-13 03:30:00,0,0,3,7,3,13
2024-03-13 03:40:00,0,0,8,9,0,17
2024-03-13 03:50:00,0,0,10,6,4,20
2024-03-13 04:00:00,0,0,6,6,6,18
2024-03-13 04:10:00,0,0,6,10,3,19
2024-03-13 04:20:00,0,0,1,7,1,9
2024-03-13 04:30:00,0,0,18,11,7,36
2024-03-13 04:40:00,0,1,13,10,5,29
2024-03-13 04:50:00,0,0,9,15,4,28
2024-03-13 05:00:00,1,0,16,27,8,52
2024-03-13 05:10:00,0,0,20,26,6,52
2024-03-13 05:20:00,0,0,20,29,8,57
2024-03-13 05:30:00,1,0,41,62,14,118
2024-03-13 05:40:00,0,0,56,56,20,132
2024-03-13 05:50:00,2,0,39,63,19,123
2024-03-13 06:00:00,0,0,48,45,14,107
2024-03-13 06:10:00,2,0,63,72,15,152
2024-03-13 06:20:00,2,1,67,88,14,172
2024-03-13 06:30:00,0,1,74,94,20,189
2024-03-13 06:40:00,2,0,80,99,16,197
2024-03-13 06:50:00,2,2,102,113,29,248
2024-03-13 07:00:00,2,0,87,116,19,224
2024-03-13 07:10:00,2,0,102,141,22,267
2024-03-13 07:20:00,2,0,108,134,12,256
2024-03-13 07:30:00,2,1,82,165,11,261
2024-03-13 07:40:00,1,2,106,187,24,320
2024-03-13 07:50:00,1,1,108,139,19,268
2024-03-13 08:00:00,1,1,95,146,18,261
2024-03-13 08:10:00,5,0,98,130,30,263
2024-03-13 08:20:00,1,0,96,114,19,230
2024-03-13 08:30:00,1,3,82,100,25,211
2024-03-13 08:40:00,2,2,122,121,22,269
2024-03-13 08:50:00,4,1,90,94,10,199
2024-03-13 09:00:00,4,1,110,100,27,242
2024-03-13 09:10:00,3,1,100,89,26,219
2024-03-13 09:20:00,2,0,80,100,19,201
2024-03-13 09:30:00,3,0,100,96,22,221
2024-03-13 09:40:00,9,1,93,112,15,230
2024-03-13 09:50:00,2,1,87,89,15,194
2024-03-13 10:00:00,2,0,101,96,18,217
2024-03-13 10:10:00,0,0,103,83,15,201
2024-03-13 10:20:00,4,0,90,107,18,219
2024-03-13 10:30:00,1,1,92,97,21,212
2024-03-13 10:40:00,2,2,96,107,14,221
2024-03-13 10:50:00,3,1,89,96,22,211
2024-03-13 11:00:00,1,1,86,109,20,217
2024-03-13 11:10:00,1,2,90,96,23,212
2024-03-13 11:20:00,2,0,103,78,30,213
2024-03-13 11:30:00,1,2,106,105,23,237
2024-03-13 11:40:00,3,3,111,114,24,255
2024-03-13 11:50:00,2,2,121,116,19,260
2024-03-13 12:00:00,3,1,97,102,14,217
2024-03-13 12:10:00,3,0,107,101,25,236
2024-03-13 12:20:00,6,1,59,112,15,193
2024-03-13 12:30:00,3,2,0,111,12,128
2024-03-13 12:40:00,5,2,1,114,21,143
2024-03-13 12:50:00,2,0,103,115,18,238
2024-03-13 13:00:00,2,1,105,107,26,241
2024-03-13 13:10:00,3,0,112,97,19,231
2024-03-13 13:20:00,2,0,115,81,24,222
2024-03-13 13:30:00,11,1,116,107,22,257
2024-03-13 13:40:00,4,2,118,104,26,254
2024-03-13 13:50:00,6,7,125,125,14,277
2024-03-13 14:00:00,4,0,132,114,28,278
2024-03-13 14:10:00,5,2,129,122,12,270
2024-03-13 14:20:00,2,3,122,118,29,274
2024-03-13 14:30:00,3,2,140,116,26,287
2024-03-13 14:40:00,7,2,118,118,16,261
2024-03-13 14:50:00,8,0,127,144,16,295
2024-03-13 15:00:00,5,1,124,107,21,258
2024-03-13 15:10:00,3,1,117,114,22,257
2024-03-13 15:20:00,4,0,129,133,14,280
2024-03-13 15:30:00,7,1,139,147,14,308
2024-03-13 15:40:00,3,1,114,157,16,291
2024-03-13 15:50:00,8,0,133,137,22,300
2024-03-13 16:00:00,5,1,127,150,23,306
2024-03-13 16:10:00,1,0,110,141,23,275
2024-03-13 16:20:00,4,0,134,135,18,291
2024-03-13 16:30:00,11,1,152,139,18,321
2024-03-13 16:40:00,6,2,151,155,11,325
2024-03-13 16:50:00,8,0,114,144,15,281
2024-03-13 17:00:00,14,1,130,144,20,309
2024-03-13 17:10:00,11,0,132,149,13,305
2024-03-13 17:20:00,5,0,126,159,23,313
2024-03-13 17:30:00,5,1,134,133,15,288
2024-03-13 17:40:00,9,1,132,137,19,298
2024-03-13 17:50:00,4,0,147,140,27,318
2024-03-13 18:00:00,1,1,135,131,21,289
2024-03-13 18:10:00,7,0,109,138,23,277
2024-03-13 18:20:00,5,0,102,130,9,246
2024-03-13 18:30:00,3,0,106,84,18,211
2024-03-13 18:40:00,2,2,101,110,12,227
2024-03-13 18:50:00,3,0,94,100,24,221
2024-03-13 19:00:00,4,0,104,74,29,211
2024-03-13 19:10:00,4,0,88,112,20,224
2024-03-13 19:20:00,1,0,94,85,26,206
2024-03-13 19:30:00,1,0,85,79,17,182
2024-03-13 19:40:00,1,0,68,64,17,150
2024-03-13 19:50:00,1,0,71,74,23,169
2024-03-13 20:00:00,2,0,74,65,24,165
2024-03-13 20:10:00,3,0,68,78,25,174
2024-03-13 20:20:00,0,0,60,48,23,131
2024-03-13 20:30:00,0,0,58,58,23,139
2024-03-13 20:40:00,1,0,47,34,25,107
2024-03-13 20:50:00,1,0,39,52,16,108
2024-03-13 21:00:00,6,0,45,33,22,106
2024-03-13 21:10:00,8,0,41,63,13,125
2024-03-13 21:20:00,2,0,58,58,18,136
2024-03-13 21:30:00,0,0,51,40,17,108
2024-03-13 21:40:00,2,0,37,42,13,94
2024-03-13 21:50:00,1,0,43,44,15,103
2024-03-13 22:00:00,0,0,38,38,18,94
2024-03-13 22:10:00,3,0,42,38,18,101
2024-03-13 22:20:00,1,0,32,25,21,79
2024-03-13 22:30:00,1,0,31,29,9,70
2024-03-13 22:40:00,0,0,33,18,18,69
2024-03-13 22:50:00,0,0,35,30,15,80
2024-03-13 23:00:00,0,1,26,20,16,63
2024-03-13 23:10:00,0,0,16,23,4,43
2024-03-13 23:20:00,1,0,24,13,11,49
2024-03-13 23:30:00,2,0,22,10,6,40
2024-03-13 23:40:00,0,0,23,12,6,41
2024-03-13 23:50:00,2,0,17,16,11,46
2024-03-14 00:00:00,3,0,11,14,3,31
2024-03-14 00:10:00,1,0,13,10,5,29
2024-03-14 00:20:00,0,0,13,5,5,23
2024-03-14 00:30:00,0,0,7,4,3,14
2024-03-14 00:40:00,1,0,12,10,6,29
2024-03-14 00:50:00,0,0,3,5,3,11
2024-03-14 01:00:00,0,0,7,4,3,14
2024-03-14 01:10:00,0,0,3,2,2,7
2024-03-14 01:20:00,0,0,6,2,4,12
2024-03-14 01:30:00,0,0,5,5,2,12
2024-03-14 01:40:00,0,0,5,4,2,11
2024-03-14 01:50:00,0,0,3,1,2,6
2024-03-14 02:00:00,0,0,6,2,3,11
2024-03-14 02:10:00,0,0,5,3,4,12
2024-03-14 02:20:00,0,0,7,7,5,19
2024-03-14 02:30:00,0,0,15,5,6,26
2024-03-14 02:40:00,1,0,6,5,3,15
2024-03-14 02:50:00,0,0,4,2,3,9
2024-03-14 03:00:00,0,0,7,1,5,13
2024-03-14 03:10:00,0,0,4,0,4,8
2024-03-14 03:20:00,0,0,6,2,2,10
2024-03-14 03:30:00,1,0,6,1,5,13
2024-03-14 03:40:00,0,1,7,9,5,22
2024-03-14 03:50:00,0,0,10,7,7,24
2024-03-14 04:00:00,0,0,7,6,1,14
2024-03-14 04:10:00,0,0,7,9,3,19
2024-03-14 04:20:00,0,0,11,12,2,25
2024-03-14 04:30:00,0,0,14,10,10,34
2024-03-14 04:40:00,0,0,10,12,2,24
2024-03-14 04:50:00,0,0,14,21,6,41
2024-03-14 05:00:00,0,0,17,23,7,47
2024-03-14 05:10:00,2,2,18,33,9,64
2024-03-14 05:20:00,1,0,28,50,15,94
2024-03-14 05:30:00,1,0,38,62,14,115
2024-03-14 05:40:00,1,0,50,54,17,122
2024-03-14 05:50:00,3,0,38,56,12,109
2024-03-14 06:00:00,3,0,54,49,13,119
2024-03-14 06:10:00,0,0,64,64,18,146
2024-03-14 06:20:00,5,0,73,69,18,165
2024-03-14 06:30:00,0,0,75,112,16,203
2024-03-14 06:40:00,2,0,88,96,18,204
2024-03-14 06:50:00,2,0,87,95,20,204
2024-03-14 07:00:00,3,0,82,100,19,204
2024-03-14 07:10:00,5,0,92,135,18,250
2024-03-14 07:20:00,0,1,112,146,20,279
2024-03-14 07:30:00,2,0,97,169,17,285
2024-03-14 07:40:00,3,1,111,181,17,313
2024-03-14 07:50:00,5,0,117,148,27,297
2024-03-14 08:00:00,7,1,123,140,18,289
2024-03-14 08:10:00,3,1,112,149,22,287
2024-03-14 08:20:00,2,0,114,133,27,276
2024-03-14 08:30:00,1,1,124,125,31,282
2024-03-14 08:40:00,1,2,107,131,16,257
2024-03-14 08:50:00,5,0,116,117,25,263
2024-03-14 09:00:00,2,2,130,99,24,257
2024-03-14 09:10:00,1,1,95,116,27,240
2024-03-14 09:20:00,6,2,120,119,27,274
2024-03-14 09:30:00,5,0,113,111,27,256
2024-03-14 09:40:00,6,1,114,123,32,276
2024-03-14 09:50:00,3,0,116,104,31,254
2024-03-14 10:00:00,1,0,110,108,15,234
2024-03-14 10:10:00,4,1,105,101,17,228
2024-03-14 10:20:00,3,0,123,124,21,271
2024-03-14 10:30:00,2,0,118,103,21,244
2024-03-14 10:40:00,2,0,110,115,27,254
2024-03-14 10:50:00,3,0,102,127,21,253
2024-03-14 11:00:00,3,0,122,110,24,259
2024-03-14 11:10:00,3,2,113,107,29,254
2024-03-14 11:20:00,2,1,113,111,29,256
2024-03-14 11:30:00,2,0,125,108,21,256
2024-03-14 11:40:00,3,0,117,143,14,277
2024-03-14 11:50:00,7,0,107,123,14,251
2024-03-14 12:00:00,7,0,121,103,16,247
2024-03-14 12:10:00,1,2,112,125,14,254
2024-03-14 12:20:00,4,1,124,130,20,279
2024-03-14 12:30:00,2,2,120,125,22,271
2024-03-14 12:40:00,3,0,103,104,22,232
2024-03-14 12:50:00,1,0,122,126,16,265
2024-03-14 13:00:00,4,0,101,122,17,244
2024-03-14 13:10:00,6,0,122,120,17,265
2024-03-14 13:20:00,8,0,150,118,20,296
2024-03-14 13:30:00,4,0,125,117,26,272
2024-03-14 13:40:00,4,0,136,116,13,269
2024-03-14 13:50:00,0,2,128,125,24,279
2024-03-14 14:00:00,5,1,142,109,21,278
2024-03-14 14:10:00,7,2,96,130,12,247
2024-03-14 14:20:00,3,0,109,141,19,272
2024-03-14 14:30:00,2,1,123,137,25,288
2024-03-14 14:40:00,4,1,127,125,25,282
2024-03-14 14:50:00,1,0,158,144,12,315
2024-03-14 15:00:00,5,0,106,130,15,256
2024-03-14 15:10:00,1,1,139,125,16,282
2024-03-14 15:20:00,4,2,135,153,13,307
2024-03-14 15:30:00,10,3,143,153,15,324
2024-03-14 15:40:00,10,2,146,139,9,306
2024-03-14 15:50:00,2,0,135,148,11,296
2024-03-14 16:00:00,13,1,150,130,10,304
2024-03-14 16:10:00,4,0,132,143,11,290
2024-03-14 16:20:00,4,0,155,119,5,283
2024-03-14 16:30:00,10,0,142,142,13,307
2024-03-14 16:40:00,7,0,46,147,8,208
2024-03-14 16:50:00,7,0,67,147,15,236
2024-03-14 17:00:00,8,0,151,151,9,319
2024-03-14 17:10:00,6,2,129,162,11,310
2024-03-14 17:20:00,6,0,121,146,15,288
2024-03-14 17:30:00,6,0,140,142,19,307
2024-03-14 17:40:00,4,0,144,147,18,313
2024-03-14 17:50:00,4,0,130,123,25,282
2024-03-14 18:00:00,2,0,145,137,15,299
2024-03-14 18:10:00,6,1,143,124,22,296
2024-03-14 18:20:00,3,1,106,128,21,259
2024-03-14 18:30:00,4,0,131,131,21,287
2024-03-14 18:40:00,3,2,91,114,19,229
2024-03-14 18:50:00,3,1,112,101,31,248
2024-03-14 19:00:00,2,0,58,87,32,179
2024-03-14 19:10:00,2,0,93,76,27,198
2024-03-14 19:20:00,6,0,81,79,22,188
2024-03-14 19:30:00,1,0,63,88,23,175
2024-03-14 19:40:00,2,0,74,88,26,190
2024-03-14 19:50:00,3,1,63,83,32,182
2024-03-14 20:00:00,0,0,57,75,17,149
2024-03-14 20:10:00,2,0,48,65,16,131
2024-03-14 20:20:00,1,1,66,45,22,135
2024-03-14 20:30:00,1,0,59,59,15,134
2024-03-14 20:40:00,2,1,57,66,21,147
2024-03-14 20:50:00,3,0,67,63,29,162
2024-03-14 21:00:00,2,0,45,42,15,104
2024-03-14 21:10:00,2,0,38,43,13,96
2024-03-14 21:20:00,1,0,51,61,21,134
2024-03-14 21:30:00,1,0,57,46,20,124
2024-03-14 21:40:00,1,0,63,47,21,132
2024-03-14 21:50:00,0,0,46,57,19,122
2024-03-14 22:00:00,0,0,44,43,17,104
2024-03-14 22:10:00,0,0,46,39,15,100
2024-03-14 22:20:00,3,0,32,33,15,83
2024-03-14 22:30:00,3,0,33,28,15,79
2024-03-14 22:40:00,3,0,34,22,12,71
2024-03-14 22:50:00,0,0,30,17,12,59
2024-03-14 23:00:00,0,1,20,23,8,52
2024-03-14 23:10:00,1,0,22,14,10,47
2024-03-14 23:20:00,0,0,11,17,1,29
2024-03-14 23:30:00,0,0,19,12,8,39
2024-03-14 23:40:00,0,0,14,12,5,31
2024-03-14 23:50:00,1,0,9,11,5,26
2024-03-15 00:00:00,0,0,10,12,4,26
2024-03-15 00:10:00,1,0,8,5,3,17
2024-03-15 00:20:00,1,0,14,7,8,30
2024-03-15 00:30:00,0,0,9,9,4,22
2024-03-15 00:40:00,0,0,12,12,5,29
2024-03-15 00:50:00,1,0,9,7,7,24
2024-03-15 01:00:00,0,0,9,5,4,18
2024-03-15 01:10:00,0,0,4,4,3,11
2024-03-15 01:20:00,0,0,3,2,2,7
2024-03-15 01:30:00,0,0,7,6,6,19
2024-03-15 01:40:00,0,0,4,2,2,8
2024-03-15 01:50:00,0,0,6,3,1,10
2024-03-15 02:00:00,0,0,8,2,6,16
2024-03-15 02:10:00,0,0,5,2,3,10
2024-03-15 02:20:00,0,0,5,5,3,13
2024-03-15 02:30:00,0,0,10,4,10,24
2024-03-15 02:40:00,0,0,10,2,5,17
2024-03-15 02:50:00,0,0,6,4,4,14
2024-03-15 03:00:00,0,0,3,5,3,11
2024-03-15 03:10:00,0,0,3,2,3,8
2024-03-15 03:20:00,0,0,5,7,1,13
2024-03-15 03:30:00,1,0,10,6,4,21
2024-03-15 03:40:00,0,0,3,6,1,10
2024-03-15 03:50:00,0,0,12,10,7,29
2024-03-15 04:00:00,0,1,3,3,2,9
2024-03-15 04:10:00,0,0,9,9,3,21
2024-03-15 04:20:00,0,0,10,10,4,24
2024-03-15 04:30:00,0,0,9,12,4,25
2024-03-15 04:40:00,0,0,10,9,3,22
2024-03-15 04:50:00,0,0,18,25,6,49
2024-03-15 05:00:00,0,0,17,23,9,49
2024-03-15 05:10:00,1,0,20,23,9,53
2024-03-15 05:20:00,0,0,27,41,13,81
2024-03-15 05:30:00,0,0,39,45,22,106
2024-03-15 05:40:00,0,3,38,51,13,105
2024-03-15 05:50:00,0,0,52,61,18,131
2024-03-15 06:00:00,1,0,52,53,13,119
2024-03-15 06:10:00,1,0,60,75,20,156
2024-03-15 06:20:00,4,0,64,65,23,156
2024-03-15 06:30:00,1,0,63,90,19,173
2024-03-15 06:40:00,2,0,84,99,28,213
2024-03-15 06:50:00,4,1,95,92,26,218
2024-03-15 07:00:00,0,0,87,92,21,200
2024-03-15 07:10:00,0,1,104,111,31,247
2024-03-15 07:20:00,3,0,85,147,13,248
2024-03-15 07:30:00,0,0,100,132,22,254
2024-03-15 07:40:00,3,0,112,155,27,297
2024-03-15 07:50:00,1,0,139,108,37,285
2024-03-15 08:00:00,3,0,97,112,36,248
2024-03-15 08:10:00,5,0,101,124,21,251
2024-03-15 08:20:00,0,3,94,108,32,237
2024-03-15 08:30:00,4,1,92,87,33,217
2024-03-15 08:40:00,4,1,106,109,48,268
2024-03-15 08:50:00,2,1,98,105,32,238
2024-03-15 09:00:00,3,3,103,97,14,220
2024-03-15 09:10:00,3,1,114,108,18,244
2024-03-15 09:20:00,5,0,109,130,14,258
2024-03-15 09:30:00,1,0,113,98,25,237
2024-03-15 09:40:00,4,1,122,117,25,269
2024-03-15 09:50:00,9,0,106,110,21,246
2024-03-15 10:00:00,4,0,128,91,22,245
2024-03-15 10:10:00,3,1,136,131,28,299
2024-03-15 10:20:00,3,0,105,110,20,238
2024-03-15 10:30:00,3,0,114,106,24,247
2024-03-15 10:40:00,0,0,112,115,24,251
2024-03-15 10:50:00,1,1,112,127,19,260
2024-03-15 11:00:00,3,2,111,128,19,263
2024-03-15 11:10:00,2,0,115,123,16,256
2024-03-15 11:20:00,2,1,105,115,22,245
2024-03-15 11:30:00,1,2,97,127,24,251
2024-03-15 11:40:00,0,0,108,117,19,244
2024-03-15 11:50:00,4,2,113,136,23,278
2024-03-15 12:00:00,4,1,133,123,12,273
2024-03-15 12:10:00,6,0,137,119,16,278
2024-03-15 12:20:00,7,2,119,134,22,284
2024-03-15 12:30:00,3,1,126,150,21,301
2024-03-15 12:40:00,6,1,138,125,13,283
2024-03-15 12:50:00,1,0,143,129,25,298
2024-03-15 13:00:00,4,0,145,106,25,280
2024-03-15 13:10:00,3,0,125,141,14,283
2024-03-15 13:20:00,4,0,158,129,19,310
2024-03-15 13:30:00,2,0,153,119,23,297
2024-03-15 13:40:00,2,0,161,136,15,314
2024-03-15 13:50:00,8,0,143,153,15,319
2024-03-15 14:00:00,10,0,142,131,22,305
2024-03-15 14:10:00,5,1,110,133,11,260
2024-03-15 14:20:00,5,2,150,144,14,315
2024-03-15 14:30:00,8,1,135,123,10,277
2024-03-15 14:40:00,5,3,111,140,9,268
2024-03-15 14:50:00,4,0,133,129,14,280
2024-03-15 15:00:00,4,0,138,146,15,303
2024-03-15 15:10:00,4,0,142,153,11,310
2024-03-15 15:20:00,9,1,140,130,20,300
2024-03-15 15:30:00,5,2,158,140,16,321
2024-03-15 15:40:00,3,0,146,140,16,305
2024-03-15 15:50:00,7,0,153,139,12,311
2024-03-15 16:00:00,2,0,143,135,18,298
2024-03-15 16:10:00,5,0,140,153,18,316
2024-03-15 16:20:00,3,0,138,126,21,288
2024-03-15 16:30:00,7,0,129,151,13,300
2024-03-15 16:40:00,4,0,161,130,15,310
2024-03-15 16:50:00,4,0,146,145,24,319
2024-03-15 17:00:00,9,0,127,111,14,261
2024-03-15 17:10:00,9,1,133,161,18,322
2024-03-15 17:20:00,3,1,145,128,17,294
2024-03-15 17:30:00,5,0,143,148,11,307
2024-03-15 17:40:00,2,0,144,148,27,321
2024-03-15 17:50:00,8,1,134,148,19,310
2024-03-15 18:00:00,5,1,130,123,19,278
2024-03-15 18:10:00,5,2,107,148,15,277
2024-03-15 18:20:00,5,1,131,136,11,284
2024-03-15 18:30:00,2,1,119,140,22,284
2024-03-15 18:40:00,1,3,110,151,13,278
2024-03-15 18:50:00,3,0,92,96,25,216
2024-03-15 19:00:00,1,0,89,117,20,227
2024-03-15 19:10:00,4,1,95,105,28,233
2024-03-15 19:20:00,5,1,69,96,16,187
2024-03-15 19:30:00,3,0,86,83,25,197
2024-03-15 19:40:00,2,0,80,81,25,188
2024-03-15 19:50:00,1,0,67,73,30,171
2024-03-15 20:00:00,2,0,65,78,18,163
2024-03-15 20:10:00,2,0,60,64,17,143
2024-03-15 20:20:00,1,1,57,64,19,142
2024-03-15 20:30:00,0,0,47,54,16,117
2024-03-15 20:40:00,2,0,63,53,17,135
2024-03-15 20:50:00,0,1,41,54,15,111
2024-03-15 21:00:00,1,1,53,47,22,124
2024-03-15 21:10:00,1,0,49,55,18,123
2024-03-15 21:20:00,2,1,61,55,17,136
2024-03-15 21:30:00,2,1,54,45,14,116
2024-03-15 21:40:00,1,0,47,63,18,129
2024-03-15 21:50:00,2,0,56,51,19,128
2024-03-15 22:00:00,0,0,50,42,19,111
2024-03-15 22:10:00,1,0,61,35,27,124
2024-03-15 22:20:00,4,0,49,40,18,111
2024-03-15 22:30:00,3,0,49,38,18,108
2024-03-15 22:40:00,2,0,49,36,18,105
2024-03-15 22:50:00,0,0,39,29,17,85
2024-03-15 23:00:00,0,1,39,26,23,89
2024-03-15 23:10:00,0,0,33,39,10,82
2024-03-15 23:20:00,2,0,31,24,10,67
2024-03-15 23:30:00,2,0,30,25,12,69
2024-03-15 23:40:00,5,0,30,19,11,65
2024-03-15 23:50:00,1,0,22,23,8,54
2024-03-16 00:00:00,0,0,18,15,9,42
2024-03-16 00:10:00,0,0,28,15,15,58
2024-03-16 00:20:00,1,0,16,12,8,37
2024-03-16 00:30:00,0,0,21,15,8,44
2024-03-16 00:40:00,2,0,16,19,8,45
2024-03-16 00:50:00,0,0,15,11,5,31
2024-03-16 01:00:00,1,0,24,6,7,38
2024-03-16 01:10:00,0,0,21,18,9,48
2024-03-16 01:20:00,0,0,17,14,5,36
2024-03-16 01:30:00,1,0,13,5,7,26
2024-03-16 01:40:00,0,0,12,5,6,23
2024-03-16 01:50:00,0,0,11,7,5,23
2024-03-16 02:00:00,1,0,12,6,5,24
2024-03-16 02:10:00,0,0,12,2,8,22
2024-03-16 02:20:00,0,0,10,6,6,22
2024-03-16 02:30:00,0,0,15,10,8,33
2024-03-16 02:40:00,0,0,7,5,2,14
2024-03-16 02:50:00,0,0,5,3,5,13
2024-03-16 03:00:00,0,0,6,7,2,15
2024-03-16 03:10:00,1,0,9,10,4,24
2024-03-16 03:20:00,0,0,9,4,6,19
2024-03-16 03:30:00,1,0,10,8,3,22
2024-03-16 03:40:00,0,0,10,6,9,25
2024-03-16 03:50:00,0,0,10,8,7,25
2024-03-16 04:00:00,0,0,5,7,1,13
2024-03-16 04:10:00,0,0,7,9,4,20
2024-03-16 04:20:00,0,0,8,13,7,28
2024-03-16 04:30:00,1,0,9,10,4,24
2024-03-16 04:40:00,1,0,8,5,5,19
2024-03-16 04:50:00,0,0,13,7,6,26
2024-03-16 05:00:00,0,0,13,16,5,34
2024-03-16 05:10:00,0,0,20,22,11,53
2024-03-16 05:20:00,0,0,9,13,2,24
2024-03-16 05:30:00,0,0,21,16,8,45
2024-03-16 05:40:00,1,0,18,18,11,48
2024-03-16 05:50:00,1,0,17,15,10,43
2024-03-16 06:00:00,1,0,18,13,10,42
2024-03-16 06:10:00,1,0,20,21,6,48
2024-03-16 06:20:00,2,0,17,16,11,46
2024-03-16 06:30:00,3,0,22,27,8,60
2024-03-16 06:40:00,0,0,29,14,15,58
2024-03-16 06:50:00,0,0,37,24,15,76
2024-03-16 07:00:00,2,0,32,17,16,67
2024-03-16 07:10:00,1,0,29,30,13,73
2024-03-16 07:20:00,1,0,36,33,11,81
2024-03-16 07:30:00,5,0,43,44,14,106
2024-03-16 07:40:00,5,0,54,39,15,113
2024-03-16 07:50:00,0,0,54,36,22,112
2024-03-16 08:00:00,1,0,46,47,21,115
2024-03-16 08:10:00,2,0,59,53,13,127
2024-03-16 08:20:00,2,0,61,68,25,156
2024-03-16 08:30:00,2,0,55,58,19,134
2024-03-16 08:40:00,2,0,63,67,11,143
2024-03-16 08:50:00,0,0,80,71,16,167
2024-03-16 09:00:00,2,0,71,84,18,175
2024-03-16 09:10:00,2,0,84,88,24,198
2024-03-16 09:20:00,2,0,82,96,19,199
2024-03-16 09:30:00,4,1,80,95,16,196
2024-03-16 09:40:00,4,0,113,95,28,240
2024-03-16 09:50:00,5,0,123,113,24,265
2024-03-16 10:00:00,1,0,91,85,14,191
2024-03-16 10:10:00,2,0,112,101,21,236
2024-03-16 10:20:00,3,0,110,111,61,285
2024-03-16 10:30:00,1,0,83,111,28,223
2024-03-16 10:40:00,1,0,0,108,24,133
2024-03-16 10:50:00,1,0,76,109,24,210
2024-03-16 11:00:00,1,0,54,119,24,198
2024-03-16 11:10:00,1,1,2,115,14,133
2024-03-16 11:20:00,0,0,63,126,14,203
2024-03-16 11:30:00,5,0,115,95,18,233
2024-03-16 11:40:00,4,1,137,114,21,277
2024-03-16 11:50:00,3,0,101,148,16,268
2024-03-16 12:00:00,2,1,135,135,17,290
2024-03-16 12:10:00,3,0,113,125,14,255
2024-03-16 12:20:00,1,0,116,147,14,278
2024-03-16 12:30:00,3,1,130,120,25,279
2024-03-16 12:40:00,2,0,119,128,17,266
2024-03-16 12:50:00,3,0,130,150,29,312
2024-03-16 13:00:00,7,1,127,152,12,299
2024-03-16 13:10:00,1,0,134,125,18,278
2024-03-16 13:20:00,2,0,104,152,17,275
2024-03-16 13:30:00,4,2,115,131,35,287
2024-03-16 13:40:00,4,1,129,145,26,305
2024-03-16 13:50:00,1,0,114,145,17,277
2024-03-16 14:00:00,2,0,105,166,19,292
2024-03-16 14:10:00,2,0,137,136,21,296
2024-03-16 14:20:00,3,2,139,150,27,321
2024-03-16 14:30:00,1,1,122,119,29,272
2024-03-16 14:40:00,3,1,123,131,29,287
2024-03-16 14:50:00,0,0,114,109,22,245
2024-03-16 15:00:00,1,0,103,124,28,256
2024-03-16 15:10:00,0,0,112,119,27,258
2024-03-16 15:20:00,0,0,112,104,23,239
2024-03-16 15:30:00,2,0,126,83,21,232
2024-03-16 15:40:00,2,0,124,108,15,249
2024-03-16 15:50:00,3,0,97,120,17,237
2024-03-16 16:00:00,0,1,125,105,25,256
2024-03-16 16:10:00,3,0,100,93,16,212
2024-03-16 16:20:00,3,1,105,109,22,240
2024-03-16 16:30:00,0,1,102,119,31,253
2024-03-16 16:40:00,6,0,87,95,13,201
2024-03-16 16:50:00,1,1,101,105,20,228
2024-03-16 17:00:00,2,1,87,98,21,209
2024-03-16 17:10:00,2,0,88,90,20,200
2024-03-16 17:20:00,1,1,106,108,18,234
2024-03-16 17:30:00,2,0,112,98,28,240
2024-03-16 17:40:00,2,0,124,136,26,288
2024-03-16 17:50:00,1,1,117,116,29,264
2024-03-16 18:00:00,2,0,123,100,31,256
2024-03-16 18:10:00,1,2,122,106,32,263
2024-03-16 18:20:00,3,0,132,103,34,272
2024-03-16 18:30:00,2,0,99,110,27,238
2024-03-16 18:40:00,5,2,101,103,28,239
2024-03-16 18:50:00,1,2,85,90,11,189
2024-03-16 19:00:00,1,1,76,76,25,179
2024-03-16 19:10:00,0,1,78,91,27,197
2024-03-16 19:20:00,2,0,79,76,23,180
2024-03-16 19:30:00,3,0,75,76,29,183
2024-03-16 19:40:00,1,0,67,71,26,165
2024-03-16 19:50:00,0,0,74,74,20,168
2024-03-16 20:00:00,1,1,68,61,26,157
2024-03-16 20:10:00,0,0,71,75,19,165
2024-03-16 20:20:00,7,1,72,53,26,159
2024-03-16 20:30:00,1,0,54,47,16,118
2024-03-16 20:40:00,1,0,59,48,27,135
2024-03-16 20:50:00,0,0,49,44,19,112
2024-03-16 21:00:00,1,0,50,54,16,121
2024-03-16 21:10:00,0,0,57,60,24,141
2024-03-16 21:20:00,1,0,57,57,21,136
2024-03-16 21:30:00,0,0,44,51,16,111
2024-03-16 21:40:00,0,0,50,64,14,128
2024-03-16 21:50:00,0,0,55,50,16,121
2024-03-16 22:00:00,0,0,41,40,16,97
2024-03-16 22:10:00,0,0,43,44,24,111
2024-03-16 22:20:00,1,0,43,35,16,95
2024-03-16 22:30:00,0,0,34,27,16,77
2024-03-16 22:40:00,0,0,37,28,20,85
2024-03-16 22:50:00,0,0,40,35,19,94
2024-03-16 23:00:00,0,1,21,32,16,70
2024-03-16 23:10:00,0,0,19,33,8,60
2024-03-16 23:20:00,0,0,26,33,13,72
2024-03-16 23:30:00,0,0,26,24,12,62
2024-03-16 23:40:00,0,0,19,28,6,53
2024-03-16 23:50:00,0,0,31,27,19,77
2024-03-17 00:00:00,0,0,29,25,10,64
2024-03-17 00:10:00,0,0,15,28,6,49
2024-03-17 00:20:00,1,0,23,11,8,43
2024-03-17 00:30:00,0,0,25,23,10,58
2024-03-17 00:40:00,0,0,20,11,9,40
2024-03-17 00:50:00,1,0,22,22,7,52
2024-03-17 01:00:00,0,0,18,13,4,35
2024-03-17 01:10:00,1,0,14,13,8,36
2024-03-17 01:20:00,0,0,15,13,8,36
2024-03-17 01:30:00,0,0,13,15,6,34
2024-03-17 01:40:00,0,0,21,11,7,39
2024-03-17 01:50:00,0,0,5,14,2,21
2024-03-17 02:00:00,0,0,8,9,4,21
2024-03-17 02:10:00,0,0,13,13,6,32
2024-03-17 02:20:00,0,0,16,10,9,35
2024-03-17 02:30:00,1,0,5,5,4,15
2024-03-17 02:40:00,0,0,13,7,5,25
2024-03-17 02:50:00,0,0,12,9,11,32
2024-03-17 03:00:00,0,0,9,6,5,20
2024-03-17 03:10:00,0,0,6,11,7,24
2024-03-17 03:20:00,1,0,21,4,7,33
2024-03-17 03:30:00,0,0,8,11,4,23
2024-03-17 03:40:00,0,0,7,2,4,13
2024-03-17 03:50:00,1,2,10,5,4,22
2024-03-17 04:00:00,0,0,15,4,3,22
2024-03-17 04:10:00,0,0,9,4,2,15
2024-03-17 04:20:00,1,0,10,4,4,19
2024-03-17 04:30:00,0,0,7,4,6,17
2024-03-17 04:40:00,1,0,10,8,2,21
2024-03-17 04:50:00,0,0,5,4,3,12
2024-03-17 05:00:00,0,0,9,12,6,27
2024-03-17 05:10:00,0,0,12,12,7,31
2024-03-17 05:20:00,0,0,8,7,4,19
2024-03-17 05:30:00,1,0,13,10,8,32
2024-03-17 05:40:00,0,0,10,12,5,27
2024-03-17 05:50:00,1,0,13,8,7,29
2024-03-17 06:00:00,1,0,12,12,7,32
2024-03-17 06:10:00,2,0,10,10,6,28
2024-03-17 06:20:00,0,0,13,16,6,35
2024-03-17 06:30:00,1,0,11,8,6,26
2024-03-17 06:40:00,0,0,14,9,6,29
2024-03-17 06:50:00,0,0,9,6,3,18
2024-03-17 07:00:00,0,0,12,9,6,27
2024-03-17 07:10:00,1,0,11,8,5,25
2024-03-17 07:20:00,1,0,11,6,8,26
2024-03-17 07:30:00,0,0,8,10,8,26
2024-03-17 07:40:00,0,0,13,9,5,27
2024-03-17 07:50:00,0,0,16,13,7,36
2024-03-17 08:00:00,3,0,14,16,6,39
2024-03-17 08:10:00,0,0,26,20,5,51
2024-03-17 08:20:00,0,0,15,15,5,35
2024-03-17 08:30:00,1,0,23,43,9,76
2024-03-17 08:40:00,2,0,24,22,7,55
2024-03-17 08:50:00,0,1,28,25,9,63
2024-03-17 09:00:00,1,0,33,28,13,75
2024-03-17 09:10:00,0,0,46,41,11,98
2024-03-17 09:20:00,1,0,47,51,22,121
2024-03-17 09:30:00,5,0,54,35,18,112
2024-03-17 09:40:00,3,3,46,63,13,128
2024-03-17 09:50:00,2,0,47,63,15,127
2024-03-17 10:00:00,1,0,55,54,15,125
2024-03-17 10:10:00,0,0,39,54,18,111
2024-03-17 10:20:00,2,0,37,46,16,101
2024-03-17 10:30:00,0,0,49,57,13,119
2024-03-17 10:40:00,0,1,61,60,22,144
2024-03-17 10:50:00,1,0,62,57,23,143
2024-03-17 11:00:00,1,0,50,64,19,134
2024-03-17 11:10:00,2,0,69,69,23,163
2024-03-17 11:20:00,0,0,55,51,26,132
2024-03-17 11:30:00,2,0,44,76,22,144
2024-03-17 11:40:00,0,1,56,69,21,147
2024-03-17 11:50:00,0,0,57,74,15,146
2024-03-17 12:00:00,4,0,61,59,13,137
2024-03-17 12:10:00,3,0,73,83,14,173
2024-03-17 12:20:00,1,0,59,75,11,146
2024-03-17 12:30:00,4,1,62,84,19,170
2024-03-17 12:40:00,2,0,17,94,17,130
2024-03-17 12:50:00,0,0,49,83,25,157
2024-03-17 13:00:00,3,0,76,65,18,162
2024-03-17 13:10:00,1,0,46,90,27,164
2024-03-17 13:20:00,1,0,89,78,17,185
2024-03-17 13:30:00,1,0,51,74,15,141
2024-03-17 13:40:00,4,0,74,74,16,168
2024-03-17 13:50:00,0,1,63,113,18,195
2024-03-17 14:00:00,2,1,86,96,32,217
2024-03-17 14:10:00,2,0,61,81,19,163
2024-03-17 14:20:00,0,0,73,79,14,166
2024-03-17 14:30:00,2,0,68,98,15,183
2024-03-17 14:40:00,3,0,77,89,24,193
2024-03-17 14:50:00,4,0,77,91,19,191
2024-03-17 15:00:00,2,0,62,76,20,160
2024-03-17 15:10:00,7,0,73,73,16,169
2024-03-17 15:20:00,7,0,69,84,15,175
2024-03-17 15:30:00,3,0,30,77,17,127
2024-03-17 15:40:00,1,0,77,76,24,178
2024-03-17 15:50:00,1,0,79,81,14,175
2024-03-17 16:00:00,0,1,89,79,13,182
2024-03-17 16:10:00,3,0,65,98,16,182
2024-03-17 16:20:00,1,1,66,73,13,154
2024-03-17 16:30:00,0,0,82,89,29,200
2024-03-17 16:40:00,1,0,85,60,20,166
2024-03-17 16:50:00,1,3,75,77,14,170
2024-03-17 17:00:00,3,2,95,60,20,180
2024-03-17 17:10:00,2,0,72,86,15,175
2024-03-17 17:20:00,2,1,77,108,17,205
2024-03-17 17:30:00,4,1,90,95,13,203
2024-03-17 17:40:00,1,0,74,84,17,176
2024-03-17 17:50:00,3,1,87,96,28,215
2024-03-17 18:00:00,2,0,75,83,29,189
2024-03-17 18:10:00,2,0,83,77,25,187
2024-03-17 18:20:00,4,1,86,80,23,194
2024-03-17 18:30:00,4,1,68,79,20,172
2024-03-17 18:40:00,2,1,73,69,25,170
2024-03-17 18:50:00,1,1,60,61,16,139
2024-03-17 19:00:00,1,0,61,66,19,147
2024-03-17 19:10:00,2,1,52,45,12,112
2024-03-17 19:20:00,3,0,39,44,11,97
2024-03-17 19:30:00,1,0,57,59,17,134
2024-03-17 19:40:00,0,0,50,69,9,128
2024-03-17 19:50:00,3,0,50,51,17,121
2024-03-17 20:00:00,1,0,49,43,10,103
2024-03-17 20:10:00,2,0,52,57,17,128
2024-03-17 20:20:00,1,1,43,48,17,110
2024-03-17 20:30:00,0,0,56,36,32,124
2024-03-17 20:40:00,3,0,50,40,16,109
2024-03-17 20:50:00,1,0,39,41,17,98
2024-03-17 21:00:00,2,1,28,38,12,81
2024-03-17 21:10:00,1,0,39,44,19,103
2024-03-17 21:20:00,1,0,35,37,15,88
2024-03-17 21:30:00,0,0,31,31,12,74
2024-03-17 21:40:00,1,0,34,39,17,91
2024-03-17 21:50:00,1,0,26,32,9,68
2024-03-17 22:00:00,1,0,35,19,19,74
2024-03-17 22:10:00,1,0,20,21,11,53
2024-03-17 22:20:00,1,0,33,22,14,70
2024-03-17 22:30:00,0,0,27,33,12,72
2024-03-17 22:40:00,0,0,31,15,15,61
2024-03-17 22:50:00,0,0,22,14,7,43
2024-03-17 23:00:00,0,0,16,17,7,40
2024-03-17 23:10:00,0,0,16,9,6,31
2024-03-17 23:20:00,0,0,16,15,7,38
2024-03-17 23:30:00,0,0,15,11,9,35
2024-03-17 23:40:00,0,0,12,7,6,25
2024-03-17 23:50:00,1,0,11,7,4,23
2024-03-18 00:00:00,0,0,14,7,4,25
2024-03-18 00:10:00,0,0,6,11,2,19
2024-03-18 00:20:00,0,0,5,3,3,11
2024-03-18 00:30:00,0,0,5,4,3,12
2024-03-18 00:40:00,3,0,8,4,6,21
2024-03-18 00:50:00,0,0,4,7,3,14
2024-03-18 01:00:00,0,0,7,4,4,15
2024-03-18 01:10:00,0,0,5,5,3,13
2024-03-18 01:20:00,0,0,5,3,5,13
2024-03-18 01:30:00,0,0,12,2,7,21
2024-03-18 01:40:00,0,0,6,6,5,17
2024-03-18 01:50:00,0,0,8,4,4,16
2024-03-18 02:00:00,0,0,5,3,2,10
2024-03-18 02:10:00,1,0,3,6,3,13
2024-03-18 02:20:00,1,0,3,3,2,9
2024-03-18 02:30:00,0,0,7,2,5,14
2024-03-18 02:40:00,0,0,2,3,1,6
2024-03-18 02:50:00,0,0,5,2,4,11
2024-03-18 03:00:00,0,0,6,3,4,13
2024-03-18 03:10:00,0,0,9,6,6,21
2024-03-18 03:20:00,1,0,6,3,3,13
2024-03-18 03:30:00,1,0,5,4,1,11
2024-03-18 03:40:00,0,0,5,3,5,13
2024-03-18 03:50:00,0,0,5,7,3,15
2024-03-18 04:00:00,0,0,6,6,4,16
2024-03-18 04:10:00,0,0,8,11,3,22
2024-03-18 04:20:00,0,0,11,6,5,22
2024-03-18 04:30:00,0,0,8,13,3,24
2024-03-18 04:40:00,0,0,13,12,5,30
2024-03-18 04:50:00,0,1,16,17,5,39
2024-03-18 05:00:00,0,0,22,34,9,65
2024-03-18 05:10:00,1,0,27,21,12,61
2024-03-18 05:20:00,1,0,33,50,10,94
2024-03-18 05:30:00,2,0,41,61,12,116
2024-03-18 05:40:00,0,0,12,64,15,91
2024-03-18 05:50:00,0,0,36,65,12,113
2024-03-18 06:00:00,1,0,49,53,8,111
2024-03-18 06:10:00,1,0,72,73,17,163
2024-03-18 06:20:00,4,0,74,98,13,189
2024-03-18 06:30:00,0,0,94,82,20,196
2024-03-18 06:40:00,0,1,101,105,23,230
2024-03-18 06:50:00,2,0,105,91,23,221
2024-03-18 07:00:00,3,0,88,97,20,208
2024-03-18 07:10:00,3,0,111,156,27,297
2024-03-18 07:20:00,5,0,123,154,19,301
2024-03-18 07:30:00,4,2,97,146,16,265
2024-03-18 07:40:00,2,0,128,180,14,324
2024-03-18 07:50:00,3,2,142,134,19,300
2024-03-18 08:00:00,2,1,128,130,22,283
2024-03-18 08:10:00,5,0,99,137,22,263
2024-03-18 08:20:00,6,0,111,123,19,259
2024-03-18 08:30:00,4,0,82,112,16,214
2024-03-18 08:40:00,1,0,113,125,17,256
2024-03-18 08:50:00,2,0,123,129,27,281
2024-03-18 09:00:00,2,1,101,110,29,243
2024-03-18 09:10:00,1,1,105,105,21,233
2024-03-18 09:20:00,6,1,104,110,21,242
2024-03-18 09:30:00,4,2,95,103,25,229
2024-03-18 09:40:00,10,1,115,112,27,265
2024-03-18 09:50:00,4,0,106,89,19,218
2024-03-18 10:00:00,3,1,107,100,33,244
2024-03-18 10:10:00,4,0,117,102,13,236
2024-03-18 10:20:00,4,0,109,106,16,235
2024-03-18 10:30:00,3,1,103,104,16,227
2024-03-18 10:40:00,5,0,99,103,22,229
2024-03-18 10:50:00,1,1,115,108,26,251
2024-03-18 11:00:00,2,0,113,98,20,233
2024-03-18 11:10:00,2,2,101,103,17,225
2024-03-18 11:20:00,3,0,108,92,17,220
2024-03-18 11:30:00,1,0,86,104,23,214
2024-03-18 11:40:00,0,0,138,113,26,277
2024-03-18 11:50:00,1,0,109,100,23,233
2024-03-18 12:00:00,5,0,106,118,18,247
2024-03-18 12:10:00,5,3,117,105,20,250
2024-03-18 12:20:00,7,0,131,109,30,277
2024-03-18 12:30:00,2,0,121,135,17,275
2024-03-18 12:40:00,4,1,118,91,22,236
2024-03-18 12:50:00,2,0,112,124,22,260
2024-03-18 13:00:00,5,0,109,124,22,260
2024-03-18 13:10:00,4,2,128,111,23,268
2024-03-18 13:20:00,5,1,123,125,20,274
2024-03-18 13:30:00,5,2,134,130,20,291
2024-03-18 13:40:00,5,1,115,124,20,265
2024-03-18 13:50:00,3,0,101,124,15,243
2024-03-18 14:00:00,7,0,130,136,6,279
2024-03-18 14:10:00,4,0,124,121,19,268
2024-03-18 14:20:00,4,0,144,117,17,282
2024-03-18 14:30:00,1,0,129,147,18,295
2024-03-18 14:40:00,5,1,144,107,25,282
2024-03-18 14:50:00,2,2,148,124,14,290
2024-03-18 15:00:00,5,0,151,136,13,305
2024-03-18 15:10:00,1,0,136,114,19,270
2024-03-18 15:20:00,4,3,141,146,14,308
2024-03-18 15:30:00,3,0,153,165,16,337
2024-03-18 15:40:00,5,0,146,150,13,314
2024-03-18 15:50:00,6,1,154,138,14,313
2024-03-18 16:00:00,9,0,142,135,20,306
2024-03-18 16:10:00,8,0,157,144,9,318
2024-03-18 16:20:00,5,1,151,157,10,324
2024-03-18 16:30:00,10,1,148,155,12,326
2024-03-18 16:40:00,8,1,148,145,15,317
2024-03-18 16:50:00,4,1,130,162,26,323
2024-03-18 17:00:00,7,2,144,155,10,318
2024-03-18 17:10:00,5,0,148,147,22,322
2024-03-18 17:20:00,12,1,145,150,12,320
2024-03-18 17:30:00,7,2,145,122,13,289
2024-03-18 17:40:00,11,3,136,138,6,294
2024-03-18 17:50:00,7,0,152,134,25,318
2024-03-18 18:00:00,4,1,121,128,14,268
2024-03-18 18:10:00,4,1,141,128,21,295
2024-03-18 18:20:00,3,1,121,108,15,248
2024-03-18 18:30:00,0,1,137,96,26,260
2024-03-18 18:40:00,4,1,90,111,12,218
2024-03-18 18:50:00,2,0,88,108,25,223
2024-03-18 19:00:00,5,0,73,76,18,172
2024-03-18 19:10:00,10,0,83,88,19,200
2024-03-18 19:20:00,3,1,70,80,11,165
2024-03-18 19:30:00,0,0,91,67,20,178
2024-03-18 19:40:00,0,0,70,72,24,166
2024-03-18 19:50:00,1,0,63,71,21,156
2024-03-18 20:00:00,1,0,76,68,23,168
2024-03-18 20:10:00,2,0,51,55,14,122
2024-03-18 20:20:00,0,0,65,58,18,141
2024-03-18 20:30:00,1,0,58,45,20,124
2024-03-18 20:40:00,2,0,60,66,20,148
2024-03-18 20:50:00,0,1,51,43,21,116
2024-03-18 21:00:00,2,0,60,42,26,130
2024-03-18 21:10:00,0,0,60,38,20,118
2024-03-18 21:20:00,2,0,45,45,15,107
2024-03-18 21:30:00,0,0,45,47,24,116
2024-03-18 21:40:00,0,0,48,28,25,101
2024-03-18 21:50:00,0,0,36,43,17,96
2024-03-18 22:00:00,0,1,39,35,15,90
2024-03-18 22:10:00,0,0,39,27,14,80
2024-03-18 22:20:00,1,0,40,21,8,70
2024-03-18 22:30:00,0,0,43,23,16,82
2024-03-18 22:40:00,1,0,34,23,17,75
2024-03-18 22:50:00,0,0,16,14,9,39
2024-03-18 23:00:00,0,0,20,21,5,46
2024-03-18 23:10:00,0,0,9,12,2,23
2024-03-18 23:20:00,0,0,23,18,7,48
2024-03-18 23:30:00,0,0,20,11,9,40
2024-03-18 23:40:00,0,0,13,9,6,28
2024-03-18 23:50:00,1,1,11,11,3,27
2024-03-19 00:00:00,0,0,9,6,5,20
2024-03-19 00:10:00,0,0,11,5,5,21
2024-03-19 00:20:00,0,0,9,6,4,19
2024-03-19 00:30:00,0,0,7,6,3,16
2024-03-19 00:40:00,1,0,10,3,4,18
2024-03-19 00:50:00,0,0,12,8,5,25
2024-03-19 01:00:00,0,0,10,7,1,18
2024-03-19 01:10:00,0,0,4,5,3,12
2024-03-19 01:20:00,0,0,4,3,3,10
2024-03-19 01:30:00,1,0,11,3,4,19
2024-03-19 01:40:00,0,0,5,2,1,8
2024-03-19 01:50:00,1,0,3,2,1,7
2024-03-19 02:00:00,0,0,8,6,2,16
2024-03-19 02:10:00,0,0,7,3,3,13
2024-03-19 02:20:00,0,0,8,4,2,14
2024-03-19 02:30:00,0,0,7,2,5,14
2024-03-19 02:40:00,0,0,2,5,1,8
2024-03-19 02:50:00,0,0,11,7,8,26
2024-03-19 03:00:00,1,0,6,2,4,13
2024-03-19 03:10:00,0,0,4,2,3,9
2024-03-19 03:20:00,0,0,9,5,5,19
2024-03-19 03:30:00,1,0,8,5,3,17
2024-03-19 03:40:00,0,0,9,4,6,19
2024-03-19 03:50:00,0,1,7,3,6,17
2024-03-19 04:00:00,0,0,3,7,0,10
2024-03-19 04:10:00,0,0,13,10,4,27
2024-03-19 04:20:00,0,0,13,6,7,26
2024-03-19 04:30:00,1,0,14,9,3,27
2024-03-19 04:40:00,0,0,16,15,7,38
2024-03-19 04:50:00,0,0,16,11,9,36
2024-03-19 05:00:00,0,0,23,32,11,66
2024-03-19 05:10:00,1,1,19,39,12,72
2024-03-19 05:20:00,1,0,24,37,11,73
2024-03-19 05:30:00,0,0,54,54,20,128
2024-03-19 05:40:00,0,0,50,63,21,134
2024-03-19 05:50:00,0,0,43,55,19,117
2024-03-19 06:00:00,3,0,45,62,16,126
2024-03-19 06:10:00,1,0,67,78,17,163
2024-03-19 06:20:00,3,0,83,63,20,169
2024-03-19 06:30:00,2,0,106,86,31,225
2024-03-19 06:40:00,1,0,100,103,19,223
2024-03-19 06:50:00,1,0,86,92,17,196
2024-03-19 07:00:00,2,0,100,110,20,232
2024-03-19 07:10:00,7,0,113,146,27,293
2024-03-19 07:20:00,3,1,124,153,19,300
2024-03-19 07:30:00,1,0,133,193,29,356
2024-03-19 07:40:00,8,0,139,160,18,325
2024-03-19 07:50:00,1,0,181,151,12,345
2024-03-19 08:00:00,3,0,153,129,21,306
2024-03-19 08:10:00,2,0,145,162,19,328
2024-03-19 08:20:00,5,0,42,124,22,193
2024-03-19 08:30:00,2,0,36,109,27,174
2024-03-19 08:40:00,4,0,69,122,18,213
2024-03-19 08:50:00,2,1,81,118,26,228
2024-03-19 09:00:00,4,0,65,89,27,185
2024-03-19 09:10:00,5,0,99,117,18,239
2024-03-19 09:20:00,3,1,110,95,27,236
2024-03-19 09:30:00,3,0,104,111,24,242
2024-03-19 09:40:00,6,1,107,121,25,260
2024-03-19 09:50:00,4,1,122,112,19,258
2024-03-19 10:00:00,5,2,125,98,27,257
2024-03-19 10:10:00,1,1,107,102,26,237
2024-03-19 10:20:00,3,1,86,112,11,213
2024-03-19 10:30:00,6,3,113,87,24,233
2024-03-19 10:40:00,1,0,114,118,18,251
2024-03-19 10:50:00,3,0,108,119,17,247
2024-03-19 11:00:00,1,1,96,95,20,213
2024-03-19 11:10:00,1,0,76,97,26,200
2024-03-19 11:20:00,3,0,81,106,21,211
2024-03-19 11:30:00,0,1,112,105,21,239
2024-03-19 11:40:00,2,0,115,92,18,227
2024-03-19 11:50:00,3,1,108,95,27,234
2024-03-19 12:00:00,2,1,109,116,31,259
2024-03-19 12:10:00,2,0,85,89,33,209
2024-03-19 12:20:00,4,0,17,115,30,166
2024-03-19 12:30:00,3,0,100,104,23,230
2024-03-19 12:40:00,3,4,104,132,10,253
2024-03-19 12:50:00,4,0,135,107,16,262
2024-03-19 13:00:00,7,0,100,123,12,242
2024-03-19 13:10:00,1,0,110,104,22,237
2024-03-19 13:20:00,0,0,117,107,13,237
2024-03-19 13:30:00,3,1,114,109,23,250
2024-03-19 13:40:00,3,0,115,107,14,239
2024-03-19 13:50:00,1,0,133,105,20,259
2024-03-19 14:00:00,3,0,118,104,23,248
2024-03-19 14:10:00,4,1,123,98,17,243
2024-03-19 14:20:00,7,1,145,126,23,302
2024-03-19 14:30:00,6,0,119,132,29,286
2024-03-19 14:40:00,3,0,132,135,13,283
2024-03-19 14:50:00,4,3,132,131,22,292
2024-03-19 15:00:00,5,1,146,130,18,300
2024-03-19 15:10:00,4,1,141,145,15,306
2024-03-19 15:20:00,4,2,130,119,9,264
2024-03-19 15:30:00,5,0,138,171,15,329
2024-03-19 15:40:00,10,0,147,148,7,312
2024-03-19 15:50:00,4,1,168,139,8,320
2024-03-19 16:00:00,4,2,150,152,18,326
2024-03-19 16:10:00,7,0,140,135,10,292
2024-03-19 16:20:00,9,0,159,141,13,322
2024-03-19 16:30:00,9,0,154,143,19,325
2024-03-19 16:40:00,19,0,137,132,5,293
2024-03-19 16:50:00,5,0,171,152,13,341
2024-03-19 17:00:00,7,0,140,160,19,326
2024-03-19 17:10:00,8,1,149,151,10,319
2024-03-19 17:20:00,8,0,131,128,16,283
2024-03-19 17:30:00,2,1,137,126,26,292
2024-03-19 17:40:00,4,0,153,116,26,299
2024-03-19 17:50:00,6,0,132,125,32,295
2024-03-19 18:00:00,4,1,118,124,23,270
2024-03-19 18:10:00,4,1,124,122,31,282
2024-03-19 18:20:00,2,1,131,112,23,269
2024-03-19 18:30:00,2,0,128,108,25,263
2024-03-19 18:40:00,4,0,112,107,21,244
2024-03-19 18:50:00,2,0,137,113,19,271
2024-03-19 19:00:00,5,1,107,87,23,223
2024-03-19 19:10:00,3,0,41,83,18,145
2024-03-19 19:20:00,1,1,83,84,28,197
2024-03-19 19:30:00,3,0,80,79,19,181
2024-03-19 19:40:00,3,0,85,77,29,194
2024-03-19 19:50:00,9,1,60,72,19,161
2024-03-19 20:00:00,3,0,69,75,18,165
2024-03-19 20:10:00,2,0,62,63,28,155
2024-03-19 20:20:00,2,0,51,51,21,125
2024-03-19 20:30:00,2,0,52,44,22,120
2024-03-19 20:40:00,1,0,59,38,17,115
2024-03-19 20:50:00,2,0,51,51,22,126
2024-03-19 21:00:00,0,1,49,55,23,128
2024-03-19 21:10:00,1,0,63,51,17,132
2024-03-19 21:20:00,1,0,51,58,20,130
2024-03-19 21:30:00,0,0,43,47,16,106
2024-03-19 21:40:00,2,1,32,37,8,80
2024-03-19 21:50:00,2,0,44,46,21,113
2024-03-19 22:00:00,0,0,32,35,15,82
2024-03-19 22:10:00,0,0,40,31,17,88
2024-03-19 22:20:00,0,0,33,37,12,82
2024-03-19 22:30:00,0,0,37,22,13,72
2024-03-19 22:40:00,2,0,35,24,18,79
2024-03-19 22:50:00,0,0,25,23,9,57
2024-03-19 23:00:00,0,0,20,19,7,46
2024-03-19 23:10:00,1,0,21,23,5,50
2024-03-19 23:20:00,0,0,18,14,12,44
2024-03-19 23:30:00,0,0,24,9,5,38
2024-03-19 23:40:00,1,0,25,12,9,47
2024-03-19 23:50:00,1,0,18,9,3,31
2024-03-20 00:00:00,2,0,11,7,5,25
2024-03-20 00:10:00,1,0,30,11,6,48
2024-03-20 00:20:00,2,0,16,4,5,27
2024-03-20 00:30:00,0,0,5,6,3,14
2024-03-20 00:40:00,0,0,0,2,6,8
2024-03-20 00:50:00,1,0,0,7,5,13
2024-03-20 01:00:00,0,0,3,5,0,8
2024-03-20 01:10:00,0,0,9,2,1,12
2024-03-20 01:20:00,0,0,4,6,1,11
2024-03-20 01:30:00,0,0,2,3,1,6
2024-03-20 01:40:00,0,0,4,3,3,10
2024-03-20 01:50:00,0,0,3,1,3,7
2024-03-20 02:00:00,0,0,5,3,2,10
2024-03-20 02:10:00,0,0,14,2,5,21
2024-03-20 02:20:00,0,0,11,5,5,21
2024-03-20 02:30:00,0,0,9,5,4,18
2024-03-20 02:40:00,0,0,2,3,0,5
2024-03-20 02:50:00,0,0,7,4,6,17
2024-03-20 03:00:00,0,0,8,2,4,14
2024-03-20 03:10:00,0,0,5,3,2,10
2024-03-20 03:20:00,0,0,8,4,6,18
2024-03-20 03:30:00,0,0,5,4,2,11
2024-03-20 03:40:00,1,0,3,3,2,9
2024-03-20 03:50:00,0,0,11,8,6,25
2024-03-20 04:00:00,0,0,7,11,2,20
2024-03-20 04:10:00,0,0,11,7,6,24
2024-03-20 04:20:00,0,0,6,8,2,16
2024-03-20 04:30:00,0,0,13,14,8,35
2024-03-20 04:40:00,0,0,20,13,6,39
2024-03-20 04:50:00,1,0,14,18,4,37
2024-03-20 05:00:00,0,0,17,24,7,48
2024-03-20 05:10:00,0,0,25,32,12,69
2024-03-20 05:20:00,0,0,25,44,9,78
2024-03-20 05:30:00,1,0,36,61,12,110
2024-03-20 05:40:00,0,0,53,59,26,138
2024-03-20 05:50:00,0,0,52,63,17,132
2024-03-20 06:00:00,3,0,54,67,13,137
2024-03-20 06:10:00,1,0,76,72,12,161
2024-03-20 06:20:00,2,0,72,82,12,168
2024-03-20 06:30:00,2,0,88,97,23,210
2024-03-20 06:40:00,3,0,99,89,26,217
2024-03-20 06:50:00,0,0,107,93,35,235
2024-03-20 07:00:00,0,0,118,97,21,236
2024-03-20 07:10:00,2,0,61,134,24,221
2024-03-20 07:20:00,2,0,88,156,19,265
2024-03-20 07:30:00,3,0,68,153,24,248
2024-03-20 07:40:00,6,0,146,166,24,342
2024-03-20 07:50:00,1,0,136,167,31,335
2024-03-20 08:00:00,4,0,121,120,30,275
2024-03-20 08:10:00,3,0,98,149,20,270
2024-03-20 08:20:00,0,0,116,105,32,253
2024-03-20 08:30:00,3,1,115,112,20,251
2024-03-20 08:40:00,0,0,102,112,17,231
2024-03-20 08:50:00,1,1,122,123,37,284
2024-03-20 09:00:00,1,0,101,100,34,236
2024-03-20 09:10:00,2,1,77,106,17,203
2024-03-20 09:20:00,3,0,64,102,25,194
2024-03-20 09:30:00,6,0,91,94,23,214
2024-03-20 09:40:00,5,0,107,113,20,245
2024-03-20 09:50:00,7,1,123,111,27,269
2024-03-20 10:00:00,1,1,116,106,27,251
2024-03-20 10:10:00,2,0,111,96,18,227
2024-03-20 10:20:00,2,1,109,94,16,222
2024-03-20 10:30:00,3,0,119,95,21,238
2024-03-20 10:40:00,3,0,94,121,20,238
2024-03-20 10:50:00,2,0,110,110,25,247
2024-03-20 11:00:00,2,1,107,80,22,212
2024-03-20 11:10:00,5,0,118,98,23,244
2024-03-20 11:20:00,3,1,108,118,15,245
2024-03-20 11:30:00,3,1,104,103,19,230
2024-03-20 11:40:00,0,0,123,121,25,269
2024-03-20 11:50:00,4,0,82,120,34,240
2024-03-20 12:00:00,3,0,100,120,20,243
2024-03-20 12:10:00,5,2,70,123,27,227
2024-03-20 12:20:00,3,0,81,124,29,237
2024-03-20 12:30:00,1,0,107,94,13,215
2024-03-20 12:40:00,2,1,101,115,19,238
2024-03-20 12:50:00,1,0,136,108,27,272
2024-03-20 13:00:00,1,0,121,115,26,263
2024-03-20 13:10:00,4,2,117,109,23,255
2024-03-20 13:20:00,2,0,102,140,15,259
2024-03-20 13:30:00,5,0,0,116,26,147
2024-03-20 13:40:00,3,0,0,113,28,144
2024-03-20 13:50:00,6,0,72,103,19,200
2024-03-20 14:00:00,5,1,131,124,20,281
2024-03-20 14:10:00,4,1,134,119,17,275
2024-03-20 14:20:00,3,0,140,119,19,281
2024-03-20 14:30:00,3,2,118,123,15,261
2024-03-20 14:40:00,2,0,143,101,19,265
2024-03-20 14:50:00,3,0,121,136,16,276
2024-03-20 15:00:00,3,3,159,127,16,308
2024-03-20 15:10:00,8,0,148,136,24,316
2024-03-20 15:20:00,3,0,132,135,8,278
2024-03-20 15:30:00,10,1,159,142,9,321
2024-03-20 15:40:00,8,0,147,141,7,303
2024-03-20 15:50:00,3,1,158,150,21,333
2024-03-20 16:00:00,5,0,156,141,9,311
2024-03-20 16:10:00,10,0,150,154,9,323
2024-03-20 16:20:00,5,1,167,141,9,323
2024-03-20 16:30:00,2,0,165,151,7,325
2024-03-20 16:40:00,10,0,152,136,9,307
2024-03-20 16:50:00,9,0,146,149,17,321
2024-03-20 17:00:00,6,0,147,133,10,296
2024-03-20 17:10:00,8,0,132,141,23,304
2024-03-20 17:20:00,12,1,151,156,12,332
2024-03-20 17:30:00,4,0,161,167,17,349
2024-03-20 17:40:00,5,2,139,142,17,305
2024-03-20 17:50:00,3,0,118,133,18,272
2024-03-20 18:00:00,6,0,84,116,16,222
2024-03-20 18:10:00,5,2,32,132,15,186
2024-03-20 18:20:00,6,1,136,114,22,279
2024-03-20 18:30:00,7,1,121,101,28,258
2024-03-20 18:40:00,8,1,107,90,20,226
2024-03-20 18:50:00,3,0,90,100,13,206
2024-03-20 19:00:00,0,1,78,81,33,193
2024-03-20 19:10:00,4,2,90,93,25,214
2024-03-20 19:20:00,2,0,109,88,42,241
2024-03-20 19:30:00,2,1,102,101,35,241
2024-03-20 19:40:00,2,0,92,83,22,199
2024-03-20 19:50:00,2,1,63,69,23,158
2024-03-20 20:00:00,0,0,60,70,22,152
2024-03-20 20:10:00,1,1,63,65,20,150
2024-03-20 20:20:00,1,0,61,44,20,126
2024-03-20 20:30:00,0,0,50,71,17,138
2024-03-20 20:40:00,2,0,50,38,15,105
2024-03-20 20:50:00,0,0,49,58,14,121
2024-03-20 21:00:00,0,0,40,51,18,109
2024-03-20 21:10:00,4,0,55,48,23,130
2024-03-20 21:20:00,0,0,50,44,21,115
2024-03-20 21:30:00,0,0,54,43,27,124
2024-03-20 21:40:00,1,0,54,37,22,114
2024-03-20 21:50:00,1,0,40,52,16,109
2024-03-20 22:00:00,3,0,30,33,17,83
2024-03-20 22:10:00,5,1,48,42,10,106
2024-03-20 22:20:00,2,0,35,26,16,79
2024-03-20 22:30:00,2,0,40,26,13,81
2024-03-20 22:40:00,0,0,33,21,15,69
2024-03-20 22:50:00,2,0,32,27,14,75
2024-03-20 23:00:00,2,0,21,24,12,59
2024-03-20 23:10:00,0,0,30,20,12,62
2024-03-20 23:20:00,0,0,26,16,15,57
2024-03-20 23:30:00,0,0,18,11,10,39
2024-03-20 23:40:00,1,1,21,5,10,38
2024-03-20 23:50:00,0,0,18,10,10,38
2024-03-21 00:00:00,0,0,19,6,8,33
2024-03-21 00:10:00,0,0,15,10,7,32
2024-03-21 00:20:00,0,0,9,8,6,23
2024-03-21 00:30:00,0,0,14,5,7,26
2024-03-21 00:40:00,2,0,3,8,1,14
2024-03-21 00:50:00,0,0,2,3,1,6
2024-03-21 01:00:00,0,0,10,2,5,17
2024-03-21 01:10:00,0,0,4,3,2,9
2024-03-21 01:20:00,0,0,6,6,3,15
2024-03-21 01:30:00,0,0,8,6,2,16
2024-03-21 01:40:00,0,0,5,2,6,13
2024-03-21 01:50:00,0,0,5,6,4,15
2024-03-21 02:00:00,0,0,4,3,3,10
2024-03-21 02:10:00,0,0,6,3,2,11
2024-03-21 02:20:00,0,0,8,5,2,15
2024-03-21 02:30:00,0,0,9,7,8,24
2024-03-21 02:40:00,0,0,10,5,3,18
2024-03-21 02:50:00,0,0,10,3,4,17
2024-03-21 03:00:00,0,0,9,5,7,21
2024-03-21 03:10:00,0,0,6,4,5,15
2024-03-21 03:20:00,1,0,4,1,4,10
2024-03-21 03:30:00,1,0,6,2,3,12
2024-03-21 03:40:00,0,0,5,3,1,9
2024-03-21 03:50:00,1,0,7,7,1,16
2024-03-21 04:00:00,0,0,7,6,1,14
2024-03-21 04:10:00,1,1,15,11,6,34
2024-03-21 04:20:00,1,0,8,10,4,23
2024-03-21 04:30:00,1,0,6,10,6,23
2024-03-21 04:40:00,0,0,18,7,9,34
2024-03-21 04:50:00,0,0,12,22,7,41
2024-03-21 05:00:00,1,0,15,22,10,48
2024-03-21 05:10:00,2,1,27,36,16,82
2024-03-21 05:20:00,0,0,33,53,17,103
2024-03-21 05:30:00,0,0,44,51,13,108
2024-03-21 05:40:00,0,0,59,56,14,129
2024-03-21 05:50:00,1,0,44,62,16,123
2024-03-21 06:00:00,1,0,59,57,22,139
2024-03-21 06:10:00,2,0,65,65,16,148
2024-03-21 06:20:00,2,0,80,76,12,170
2024-03-21 06:30:00,3,0,65,105,24,197
2024-03-21 06:40:00,1,0,90,92,22,205
2024-03-21 06:50:00,1,0,107,94,23,225
2024-03-21 07:00:00,0,0,99,102,28,229
2024-03-21 07:10:00,3,1,107,151,26,288
2024-03-21 07:20:00,4,0,110,160,19,293
2024-03-21 07:30:00,2,0,89,154,19,264
2024-03-21 07:40:00,1,0,102,191,30,324
2024-03-21 07:50:00,2,0,111,131,22,266
2024-03-21 08:00:00,5,2,105,133,23,268
2024-03-21 08:10:00,1,0,111,142,24,278
2024-03-21 08:20:00,1,0,97,124,18,240
2024-03-21 08:30:00,2,0,108,94,24,228
2024-03-21 08:40:00,5,1,117,106,29,258
2024-03-21 08:50:00,2,1,111,105,30,249
2024-03-21 09:00:00,3,4,132,92,22,253
2024-03-21 09:10:00,2,0,79,136,32,249
2024-03-21 09:20:00,4,1,91,131,18,245
2024-03-21 09:30:00,3,1,80,98,23,205
2024-03-21 09:40:00,7,0,113,123,22,265
2024-03-21 09:50:00,3,1,124,120,23,271
2024-03-21 10:00:00,3,0,117,95,26,241
2024-03-21 10:10:00,1,0,70,94,26,191
2024-03-21 10:20:00,2,0,53,107,16,178
2024-03-21 10:30:00,2,2,126,100,22,252
2024-03-21 10:40:00,0,0,110,110,17,237
2024-03-21 10:50:00,1,0,126,104,28,259
2024-03-21 11:00:00,3,0,131,97,22,253
2024-03-21 11:10:00,5,1,104,126,20,256
2024-03-21 11:20:00,0,1,114,116,22,253
2024-03-21 11:30:00,2,1,77,120,25,225
2024-03-21 11:40:00,3,0,105,117,21,246
2024-03-21 11:50:00,4,1,124,110,22,261
2024-03-21 12:00:00,6,2,113,123,21,265
2024-03-21 12:10:00,4,1,118,133,24,280
2024-03-21 12:20:00,2,0,111,130,18,261
2024-03-21 12:30:00,3,2,130,126,18,279
2024-03-21 12:40:00,2,0,128,118,29,277
2024-03-21 12:50:00,2,1,112,106,18,239
2024-03-21 13:00:00,6,0,126,113,24,269
2024-03-21 13:10:00,4,0,118,109,25,256
2024-03-21 13:20:00,7,0,128,104,15,254
2024-03-21 13:30:00,1,0,77,133,24,235
2024-03-21 13:40:00,4,0,130,114,16,264
2024-03-21 13:50:00,3,0,99,121,28,251
2024-03-21 14:00:00,3,0,124,88,25,240
2024-03-21 14:10:00,6,0,61,107,18,192
2024-03-21 14:20:00,1,1,122,140,17,281
2024-03-21 14:30:00,8,0,148,147,18,321
2024-03-21 14:40:00,5,0,146,155,11,317
2024-03-21 14:50:00,4,2,135,140,22,303
2024-03-21 15:00:00,4,0,138,143,12,297
2024-03-21 15:10:00,5,0,160,143,16,324
2024-03-21 15:20:00,4,1,138,147,19,309
2024-03-21 15:30:00,7,1,152,167,8,335
2024-03-21 15:40:00,7,1,151,138,13,310
2024-03-21 15:50:00,5,0,156,135,16,312
2024-03-21 16:00:00,3,0,131,132,16,282
2024-03-21 16:10:00,9,1,169,153,11,343
2024-03-21 16:20:00,8,0,168,139,11,326
2024-03-21 16:30:00,6,0,163,143,14,326
2024-03-21 16:40:00,11,3,149,138,5,306
2024-03-21 16:50:00,8,0,153,153,5,319
2024-03-21 17:00:00,9,1,98,137,16,261
2024-03-21 17:10:00,6,0,117,149,5,277
2024-03-21 17:20:00,1,0,170,153,14,338
2024-03-21 17:30:00,4,0,153,141,21,319
2024-03-21 17:40:00,7,4,145,158,15,329
2024-03-21 17:50:00,4,0,154,125,25,308
2024-03-21 18:00:00,5,0,151,143,12,311
2024-03-21 18:10:00,2,1,138,159,17,317
2024-03-21 18:20:00,5,1,143,156,22,327
2024-03-21 18:30:00,6,2,133,130,24,295
2024-03-21 18:40:00,2,0,103,121,13,239
2024-03-21 18:50:00,3,0,92,97,31,223
2024-03-21 19:00:00,5,1,96,83,22,207
2024-03-21 19:10:00,1,0,103,83,18,205
2024-03-21 19:20:00,5,0,86,104,30,225
2024-03-21 19:30:00,3,0,71,66,19,159
2024-03-21 19:40:00,4,0,67,83,18,172
2024-03-21 19:50:00,1,1,69,81,27,179
2024-03-21 20:00:00,2,0,66,65,18,151
2024-03-21 20:10:00,2,0,65,61,15,143
2024-03-21 20:20:00,1,0,58,70,21,150
2024-03-21 20:30:00,3,0,50,60,18,131
2024-03-21 20:40:00,3,0,50,52,20,125
2024-03-21 20:50:00,2,0,59,43,20,124
2024-03-21 21:00:00,0,0,61,54,25,140
2024-03-21 21:10:00,2,1,52,60,21,136
2024-03-21 21:20:00,1,0,63,62,23,149
2024-03-21 21:30:00,0,0,52,49,19,120
2024-03-21 21:40:00,0,0,43,51,12,106
2024-03-21 21:50:00,3,0,51,58,19,131
2024-03-21 22:00:00,1,0,53,31,22,107
2024-03-21 22:10:00,3,0,61,31,21,116
2024-03-21 22:20:00,7,0,40,36,18,101
2024-03-21 22:30:00,1,1,33,35,11,81
2024-03-21 22:40:00,5,1,33,22,12,73
2024-03-21 22:50:00,0,0,45,22,18,85
2024-03-21 23:00:00,1,0,26,28,12,67
2024-03-21 23:10:00,4,0,22,15,13,54
2024-03-21 23:20:00,0,0,21,18,9,48
2024-03-21 23:30:00,0,0,15,13,11,39
2024-03-21 23:40:00,0,0,14,8,7,29
2024-03-21 23:50:00,2,0,20,11,11,44
2024-03-22 00:00:00,0,0,12,8,7,27
2024-03-22 00:10:00,0,0,20,9,10,39
2024-03-22 00:20:00,0,0,12,6,5,23
2024-03-22 00:30:00,0,0,10,3,4,17
2024-03-22 00:40:00,0,0,7,7,4,18
2024-03-22 00:50:00,0,0,11,8,5,24
2024-03-22 01:00:00,0,0,8,9,2,19
2024-03-22 01:10:00,0,0,8,5,4,17
2024-03-22 01:20:00,0,0,4,6,3,13
2024-03-22 01:30:00,0,0,5,3,3,11
2024-03-22 01:40:00,0,0,13,3,7,23
2024-03-22 01:50:00,1,0,9,7,4,21
2024-03-22 02:00:00,0,0,10,0,7,17
2024-03-22 02:10:00,0,0,3,3,3,9
2024-03-22 02:20:00,0,0,12,8,8,28
2024-03-22 02:30:00,1,0,7,4,4,16
2024-03-22 02:40:00,0,0,2,5,2,9
2024-03-22 02:50:00,0,0,5,4,4,13
2024-03-22 03:00:00,0,0,3,0,3,6
2024-03-22 03:10:00,0,0,7,3,6,16
2024-03-22 03:20:00,1,0,6,2,3,12
2024-03-22 03:30:00,1,0,6,10,2,19
2024-03-22 03:40:00,0,0,5,3,3,11
2024-03-22 03:50:00,0,0,6,4,1,11
2024-03-22 04:00:00,0,0,5,12,2,19
2024-03-22 04:10:00,0,0,9,10,2,21
2024-03-22 04:20:00,0,0,8,12,1,21
2024-03-22 04:30:00,0,1,7,8,4,20
2024-03-22 04:40:00,0,0,12,12,6,30
2024-03-22 04:50:00,0,0,15,17,6,38
2024-03-22 05:00:00,0,0,12,22,8,42
2024-03-22 05:10:00,0,0,20,27,9,56
2024-03-22 05:20:00,1,0,30,43,17,91
2024-03-22 05:30:00,2,0,42,45,15,104
2024-03-22 05:40:00,0,0,47,67,16,130
2024-03-22 05:50:00,2,0,46,56,17,121
2024-03-22 06:00:00,2,0,43,58,11,114
2024-03-22 06:10:00,0,0,77,57,21,155
2024-03-22 06:20:00,2,0,72,74,18,166
2024-03-22 06:30:00,3,0,74,95,20,192
2024-03-22 06:40:00,1,0,121,90,24,236
2024-03-22 06:50:00,1,0,104,82,27,214
2024-03-22 07:00:00,1,0,83,90,26,200
2024-03-22 07:10:00,0,0,111,140,14,265
2024-03-22 07:20:00,2,0,108,124,23,257
2024-03-22 07:30:00,1,0,120,143,40,304
2024-03-22 07:40:00,3,0,137,125,24,289
2024-03-22 07:50:00,1,0,174,124,41,340
2024-03-22 08:00:00,3,0,114,96,17,230
2024-03-22 08:10:00,3,0,102,124,24,253
2024-03-22 08:20:00,5,0,105,113,26,249
2024-03-22 08:30:00,2,0,102,93,18,215
2024-03-22 08:40:00,3,1,117,130,26,277
2024-03-22 08:50:00,0,0,114,121,24,259
2024-03-22 09:00:00,2,0,121,100,16,239
2024-03-22 09:10:00,4,0,101,99,27,231
2024-03-22 09:20:00,4,1,118,99,26,248
2024-03-22 09:30:00,6,0,122,123,22,273
2024-03-22 09:40:00,7,0,125,132,29,293
2024-03-22 09:50:00,2,0,125,122,34,283
2024-03-22 10:00:00,1,0,122,140,19,282
2024-03-22 10:10:00,0,0,119,138,22,279
2024-03-22 10:20:00,4,0,120,156,24,304
2024-03-22 10:30:00,1,0,136,137,25,299
2024-03-22 10:40:00,3,0,127,145,20,295
2024-03-22 10:50:00,5,0,105,132,16,258
2024-03-22 11:00:00,3,1,130,117,21,272
2024-03-22 11:10:00,4,0,145,119,24,292
2024-03-22 11:20:00,3,0,153,146,17,319
2024-03-22 11:30:00,6,0,115,129,26,276
2024-03-22 11:40:00,2,0,142,139,25,308
2024-03-22 11:50:00,3,1,53,163,27,247
2024-03-22 12:00:00,9,1,117,130,26,283
2024-03-22 12:10:00,2,0,143,170,34,349
2024-03-22 12:20:00,1,0,110,159,22,292
2024-03-22 12:30:00,3,0,74,147,30,254
2024-03-22 12:40:00,5,0,124,140,21,290
2024-03-22 12:50:00,4,0,119,165,20,308
2024-03-22 13:00:00,3,0,106,145,26,280
2024-03-22 13:10:00,7,1,68,138,16,230
2024-03-22 13:20:00,7,1,157,145,11,321
2024-03-22 13:30:00,7,2,153,137,25,324
2024-03-22 13:40:00,4,1,75,111,17,208
2024-03-22 13:50:00,4,0,129,139,21,293
2024-03-22 14:00:00,1,0,148,123,17,289
2024-03-22 14:10:00,9,1,148,148,7,313
2024-03-22 14:20:00,4,0,82,141,13,240
2024-03-22 14:30:00,2,0,122,165,30,319
2024-03-22 14:40:00,5,1,144,140,14,304
2024-03-22 14:50:00,3,0,171,165,18,357
2024-03-22 15:00:00,1,0,134,156,16,307
2024-03-22 15:10:00,2,0,158,157,25,342
2024-03-22 15:20:00,7,1,148,172,23,351
2024-03-22 15:30:00,5,0,169,138,15,327
2024-03-22 15:40:00,2,0,158,141,15,316
2024-03-22 15:50:00,5,0,143,158,20,326
2024-03-22 16:00:00,2,1,166,133,21,323
2024-03-22 16:10:00,9,0,141,122,18,290
2024-03-22 16:20:00,6,0,162,137,26,331
2024-03-22 16:30:00,10,1,137,133,17,298
2024-03-22 16:40:00,8,0,125,127,12,272
2024-03-22 16:50:00,4,0,128,145,15,292
2024-03-22 17:00:00,9,0,137,127,18,291
2024-03-22 17:10:00,3,1,151,125,15,295
2024-03-22 17:20:00,1,1,135,155,27,319
2024-03-22 17:30:00,8,0,150,114,26,298
2024-03-22 17:40:00,10,1,144,135,18,308
2024-03-22 17:50:00,5,0,119,136,14,274
2024-03-22 18:00:00,3,1,125,139,30,298
2024-03-22 18:10:00,4,1,128,124,28,285
2024-03-22 18:20:00,3,0,116,114,28,261
2024-03-22 18:30:00,1,1,79,66,13,160
2024-03-22 18:40:00,1,0,38,49,6,94
2024-03-22 18:50:00,1,0,42,54,9,106
2024-03-22 19:00:00,0,0,86,103,21,210
2024-03-22 19:10:00,0,0,71,99,28,198
2024-03-22 19:20:00,3,0,86,69,19,177
2024-03-22 19:30:00,7,0,75,86,20,188
2024-03-22 19:40:00,17,2,80,66,22,187
2024-03-22 19:50:00,7,0,87,78,25,197
2024-03-22 20:00:00,4,0,81,63,33,181
2024-03-22 20:10:00,3,0,70,63,17,153
2024-03-22 20:20:00,8,0,64,49,16,137
2024-03-22 20:30:00,2,1,57,69,21,150
2024-03-22 20:40:00,1,1,65,54,28,149
2024-03-22 20:50:00,0,0,54,65,20,139
2024-03-22 21:00:00,2,0,62,53,29,146
2024-03-22 21:10:00,6,2,52,61,17,138
2024-03-22 21:20:00,0,1,60,52,33,146
2024-03-22 21:30:00,0,0,48,54,20,122
2024-03-22 21:40:00,0,1,47,41,14,103
2024-03-22 21:50:00,2,0,39,61,13,115
2024-03-22 22:00:00,0,0,33,57,22,112
2024-03-22 22:10:00,3,0,63,33,15,114
2024-03-22 22:20:00,5,0,38,35,21,99
2024-03-22 22:30:00,1,0,48,44,17,110
2024-03-22 22:40:00,1,1,46,27,25,100
2024-03-22 22:50:00,4,1,46,45,18,114
2024-03-22 23:00:00,0,0,43,32,18,93
2024-03-22 23:10:00,0,0,35,41,11,87
2024-03-22 23:20:00,1,0,36,31,15,83
2024-03-22 23:30:00,0,0,31,19,12,62
2024-03-22 23:40:00,1,0,21,27,11,60
2024-03-22 23:50:00,0,0,16,17,8,41
2024-03-23 00:00:00,1,0,34,14,16,65
2024-03-23 00:10:00,0,0,21,23,6,50
2024-03-23 00:20:00,1,0,19,15,10,45
2024-03-23 00:30:00,1,0,20,19,8,48
2024-03-23 00:40:00,1,0,22,12,10,45
2024-03-23 00:50:00,0,0,13,8,10,31
2024-03-23 01:00:00,0,0,22,16,12,50
2024-03-23 01:10:00,0,0,16,13,8,37
2024-03-23 01:20:00,0,0,15,10,7,32
2024-03-23 01:30:00,0,0,15,12,4,31
2024-03-23 01:40:00,1,0,12,5,7,25
2024-03-23 01:50:00,0,0,13,4,11,28
2024-03-23 02:00:00,0,0,11,8,6,25
2024-03-23 02:10:00,0,0,10,8,4,22
2024-03-23 02:20:00,0,0,9,10,6,25
2024-03-23 02:30:00,0,0,13,6,8,27
2024-03-23 02:40:00,1,0,27,13,8,49
2024-03-23 02:50:00,0,0,17,9,6,32
2024-03-23 03:00:00,0,0,10,9,5,24
2024-03-23 03:10:00,0,0,5,11,3,19
2024-03-23 03:20:00,0,0,18,3,6,27
2024-03-23 03:30:00,0,0,15,4,5,24
2024-03-23 03:40:00,0,0,8,9,4,21
2024-03-23 03:50:00,1,0,12,4,8,25
2024-03-23 04:00:00,0,0,6,7,3,16
2024-03-23 04:10:00,0,0,4,2,2,8
2024-03-23 04:20:00,0,0,10,4,4,18
2024-03-23 04:30:00,0,0,5,9,2,16
2024-03-23 04:40:00,0,0,6,7,1,14
2024-03-23 04:50:00,0,0,9,15,7,31
2024-03-23 05:00:00,0,0,20,13,11,44
2024-03-23 05:10:00,0,0,15,19,7,41
2024-03-23 05:20:00,0,0,19,17,11,47
2024-03-23 05:30:00,0,0,24,16,10,50
2024-03-23 05:40:00,1,0,15,23,9,48
2024-03-23 05:50:00,0,0,19,21,11,51
2024-03-23 06:00:00,4,0,13,14,8,39
2024-03-23 06:10:00,1,0,27,20,13,61
2024-03-23 06:20:00,2,0,32,20,11,65
2024-03-23 06:30:00,1,0,23,32,7,63
2024-03-23 06:40:00,1,0,12,15,10,38
2024-03-23 06:50:00,2,0,2,23,16,43
2024-03-23 07:00:00,1,0,35,22,16,74
2024-03-23 07:10:00,2,0,30,24,10,66
2024-03-23 07:20:00,0,0,34,38,12,84
2024-03-23 07:30:00,0,0,38,25,23,86
2024-03-23 07:40:00,0,0,56,36,23,115
2024-03-23 07:50:00,3,0,52,37,15,107
2024-03-23 08:00:00,1,0,57,49,21,128
2024-03-23 08:10:00,1,0,58,50,23,132
2024-03-23 08:20:00,1,0,54,53,17,125
2024-03-23 08:30:00,1,0,72,52,20,145
2024-03-23 08:40:00,5,0,82,57,14,158
2024-03-23 08:50:00,3,0,69,73,25,170
2024-03-23 09:00:00,2,0,67,82,12,163
2024-03-23 09:10:00,2,0,83,77,16,178
2024-03-23 09:20:00,4,1,53,80,16,154
2024-03-23 09:30:00,6,0,75,106,14,201
2024-03-23 09:40:00,6,0,83,104,25,218
2024-03-23 09:50:00,4,0,130,108,19,261
2024-03-23 10:00:00,2,0,47,88,17,154
2024-03-23 10:10:00,2,0,91,106,28,227
2024-03-23 10:20:00,1,2,83,92,21,199
2024-03-23 10:30:00,0,0,107,122,26,255
2024-03-23 10:40:00,2,0,94,119,21,236
2024-03-23 10:50:00,3,0,94,108,21,226
2024-03-23 11:00:00,2,0,109,100,25,236
2024-03-23 11:10:00,3,0,98,101,21,223
2024-03-23 11:20:00,2,0,122,97,16,237
2024-03-23 11:30:00,1,0,71,110,18,200
2024-03-23 11:40:00,1,0,124,128,18,271
2024-03-23 11:50:00,1,0,121,143,23,288
2024-03-23 12:00:00,1,0,99,147,15,262
2024-03-23 12:10:00,4,0,110,117,20,251
2024-03-23 12:20:00,3,0,114,128,27,272
2024-03-23 12:30:00,2,0,119,138,15,274
2024-03-23 12:40:00,4,0,113,123,19,259
2024-03-23 12:50:00,3,0,114,118,18,253
2024-03-23 13:00:00,3,0,107,128,15,253
2024-03-23 13:10:00,1,0,97,119,24,241
2024-03-23 13:20:00,1,1,125,118,23,268
2024-03-23 13:30:00,2,0,73,113,13,201
2024-03-23 13:40:00,1,2,76,116,39,234
2024-03-23 13:50:00,2,1,74,144,21,242
2024-03-23 14:00:00,4,0,142,131,16,293
2024-03-23 14:10:00,2,0,119,125,17,263
2024-03-23 14:20:00,5,0,150,135,17,307
2024-03-23 14:30:00,0,0,88,123,15,226
2024-03-23 14:40:00,4,2,37,135,13,191
2024-03-23 14:50:00,1,0,119,112,19,251
2024-03-23 15:00:00,2,0,99,112,14,227
2024-03-23 15:10:00,0,0,112,115,27,254
2024-03-23 15:20:00,5,1,111,112,26,255
2024-03-23 15:30:00,1,0,124,101,25,251
2024-03-23 15:40:00,1,0,113,107,24,245
2024-03-23 15:50:00,0,0,95,113,19,227
2024-03-23 16:00:00,1,0,109,117,25,252
2024-03-23 16:10:00,2,3,109,99,22,235
2024-03-23 16:20:00,7,0,104,129,12,252
2024-03-23 16:30:00,2,0,101,103,19,225
2024-03-23 16:40:00,1,0,125,103,36,265
2024-03-23 16:50:00,1,1,96,130,25,253
2024-03-23 17:00:00,1,0,115,113,15,244
2024-03-23 17:10:00,1,0,104,99,21,225
2024-03-23 17:20:00,2,0,104,107,22,235
2024-03-23 17:30:00,6,1,105,124,13,249
2024-03-23 17:40:00,7,1,74,114,20,216
2024-03-23 17:50:00,2,1,97,98,14,212
2024-03-23 18:00:00,3,0,97,113,25,238
2024-03-23 18:10:00,2,0,92,117,23,234
2024-03-23 18:20:00,1,0,45,99,32,177
2024-03-23 18:30:00,1,0,57,109,23,190
2024-03-23 18:40:00,7,0,6,96,22,131
2024-03-23 18:50:00,1,0,55,64,22,142
2024-03-23 19:00:00,3,0,64,73,24,164
2024-03-23 19:10:00,2,0,55,67,20,144
2024-03-23 19:20:00,2,0,68,83,20,173
2024-03-23 19:30:00,1,0,76,76,22,175
2024-03-23 19:40:00,1,0,57,76,12,146
2024-03-23 19:50:00,0,0,51,71,14,136
2024-03-23 20:00:00,1,0,52,75,21,149
2024-03-23 20:10:00,0,1,73,70,22,166
2024-03-23 20:20:00,1,0,52,59,20,132
2024-03-23 20:30:00,0,0,61,56,27,144
2024-03-23 20:40:00,1,0,48,57,18,124
2024-03-23 20:50:00,0,0,44,36,15,95
2024-03-23 21:00:00,0,0,56,51,23,130
2024-03-23 21:10:00,0,0,50,36,20,106
2024-03-23 21:20:00,1,0,54,50,19,124
2024-03-23 21:30:00,0,0,45,43,15,103
2024-03-23 21:40:00,0,0,49,55,17,121
2024-03-23 21:50:00,4,0,36,51,15,106
2024-03-23 22:00:00,2,0,32,38,12,84
2024-03-23 22:10:00,1,0,43,34,14,92
2024-03-23 22:20:00,1,0,50,29,15,95
2024-03-23 22:30:00,0,0,46,35,17,98
2024-03-23 22:40:00,1,0,36,22,12,71
2024-03-23 22:50:00,2,0,37,17,7,63
2024-03-23 23:00:00,0,0,28,24,14,66
2024-03-23 23:10:00,0,0,36,28,13,77
2024-03-23 23:20:00,0,0,26,26,11,63
2024-03-23 23:30:00,0,0,16,12,14,42
2024-03-23 23:40:00,0,1,57,15,14,87
2024-03-23 23:50:00,1,1,32,21,12,67
2024-03-24 00:00:00,0,0,44,27,21,92
2024-03-24 00:10:00,2,1,24,20,9,56
2024-03-24 00:20:00,0,0,28,20,8,56
2024-03-24 00:30:00,0,0,21,19,5,45
2024-03-24 00:40:00,0,0,23,11,11,45
2024-03-24 00:50:00,0,0,11,14,3,28
2024-03-24 01:00:00,0,0,23,9,7,39
2024-03-24 01:10:00,0,0,17,16,6,39
2024-03-24 01:20:00,1,0,23,17,5,46
2024-03-24 01:30:00,1,0,15,14,3,33
2024-03-24 01:40:00,0,0,15,10,8,33
2024-03-24 01:50:00,0,0,16,6,8,30
2024-03-24 02:00:00,0,0,17,8,3,28
2024-03-24 02:10:00,0,0,6,12,3,21
2024-03-24 02:20:00,0,0,16,9,6,31
2024-03-24 02:30:00,1,0,16,11,10,38
2024-03-24 02:40:00,0,0,11,7,5,23
2024-03-24 02:50:00,0,0,7,8,9,24
2024-03-24 03:00:00,0,0,9,5,2,16
2024-03-24 03:10:00,0,0,10,5,6,21
2024-03-24 03:20:00,0,0,12,11,5,28
2024-03-24 03:30:00,1,0,4,4,2,11
2024-03-24 03:40:00,0,0,6,5,2,13
2024-03-24 03:50:00,0,1,8,2,5,16
2024-03-24 04:00:00,1,0,8,3,6,18
2024-03-24 04:10:00,0,0,6,3,2,11
2024-03-24 04:20:00,0,1,3,3,1,8
2024-03-24 04:30:00,0,1,2,3,1,7
2024-03-24 04:40:00,1,0,6,5,2,14
2024-03-24 04:50:00,0,0,9,11,2,22
2024-03-24 05:00:00,0,0,7,9,2,18
2024-03-24 05:10:00,0,0,11,10,3,24
2024-03-24 05:20:00,0,0,13,9,8,30
2024-03-24 05:30:00,0,0,14,8,5,27
2024-03-24 05:40:00,0,0,4,7,1,12
2024-03-24 05:50:00,0,0,17,13,5,35
2024-03-24 06:00:00,0,0,9,9,4,22
2024-03-24 06:10:00,1,0,14,14,5,34
2024-03-24 06:20:00,1,0,3,10,0,14
2024-03-24 06:30:00,0,0,14,4,8,26
2024-03-24 06:40:00,0,0,12,7,7,26
2024-03-24 06:50:00,0,0,10,9,5,24
2024-03-24 07:00:00,0,0,9,11,5,25
2024-03-24 07:10:00,1,0,13,13,5,32
2024-03-24 07:20:00,0,0,13,11,7,31
2024-03-24 07:30:00,3,0,7,7,4,21
2024-03-24 07:40:00,0,0,17,12,3,32
2024-03-24 07:50:00,0,0,14,19,6,39
2024-03-24 08:00:00,3,0,20,8,7,38
2024-03-24 08:10:00,2,0,20,10,2,34
2024-03-24 08:20:00,2,1,21,10,15,49
2024-03-24 08:30:00,0,0,15,16,6,37
2024-03-24 08:40:00,1,0,18,30,8,57
2024-03-24 08:50:00,1,1,24,26,7,59
2024-03-24 09:00:00,2,0,27,22,10,61
2024-03-24 09:10:00,0,0,29,25,11,65
2024-03-24 09:20:00,1,0,26,35,18,80
2024-03-24 09:30:00,1,0,23,44,9,77
2024-03-24 09:40:00,4,0,47,65,14,130
2024-03-24 09:50:00,5,1,42,38,16,102
2024-03-24 10:00:00,1,0,45,31,8,85
2024-03-24 10:10:00,2,0,41,40,17,100
2024-03-24 10:20:00,0,0,45,43,12,100
2024-03-24 10:30:00,0,0,64,59,23,146
2024-03-24 10:40:00,1,0,65,54,21,141
2024-03-24 10:50:00,0,0,66,64,13,143
2024-03-24 11:00:00,3,0,60,50,9,122
2024-03-24 11:10:00,0,0,51,46,12,109
2024-03-24 11:20:00,0,0,44,53,11,108
2024-03-24 11:30:00,1,1,67,60,16,145
2024-03-24 11:40:00,1,0,72,67,19,159
2024-03-24 11:50:00,2,0,68,57,16,143
2024-03-24 12:00:00,3,0,72,53,17,145
2024-03-24 12:10:00,4,0,69,65,23,161
2024-03-24 12:20:00,5,0,79,59,12,155
2024-03-24 12:30:00,3,0,77,68,21,169
2024-03-24 12:40:00,0,0,83,77,25,185
2024-03-24 12:50:00,0,0,69,84,22,175
2024-03-24 13:00:00,1,0,82,63,10,156
2024-03-24 13:10:00,0,0,86,58,20,164
2024-03-24 13:20:00,0,0,84,62,15,161
2024-03-24 13:30:00,1,1,88,54,17,161
2024-03-24 13:40:00,1,0,84,71,18,174
2024-03-24 13:50:00,2,0,88,70,15,175
2024-03-24 14:00:00,5,0,78,69,21,173
2024-03-24 14:10:00,2,0,64,72,14,152
2024-03-24 14:20:00,1,0,80,100,19,200
2024-03-24 14:30:00,0,1,76,93,17,187
2024-03-24 14:40:00,2,1,92,96,12,203
2024-03-24 14:50:00,0,0,81,114,10,205
2024-03-24 15:00:00,1,0,74,74,17,166
2024-03-24 15:10:00,2,0,77,71,26,176
2024-03-24 15:20:00,0,1,56,73,18,148
2024-03-24 15:30:00,1,2,68,84,10,165
2024-03-24 15:40:00,0,0,84,92,18,194
2024-03-24 15:50:00,0,0,59,76,17,152
2024-03-24 16:00:00,0,2,73,84,19,178
2024-03-24 16:10:00,3,0,66,71,21,161
2024-03-24 16:20:00,1,0,60,63,17,141
2024-03-24 16:30:00,1,0,54,83,11,149
2024-03-24 16:40:00,2,1,80,96,17,196
2024-03-24 16:50:00,1,1,67,102,13,184
2024-03-24 17:00:00,1,1,72,86,28,188
2024-03-24 17:10:00,4,0,67,82,12,165
2024-03-24 17:20:00,2,1,60,93,17,173
2024-03-24 17:30:00,4,0,80,104,30,218
2024-03-24 17:40:00,4,2,73,88,24,191
2024-03-24 17:50:00,2,0,68,68,20,158
2024-03-24 18:00:00,0,0,60,84,19,163
2024-03-24 18:10:00,2,0,71,85,22,180
2024-03-24 18:20:00,2,0,50,65,21,138
2024-03-24 18:30:00,2,1,61,46,25,135
2024-03-24 18:40:00,1,1,70,61,25,158
2024-03-24 18:50:00,2,0,57,85,14,158
2024-03-24 19:00:00,1,0,69,85,24,179
2024-03-24 19:10:00,1,0,53,63,17,134
2024-03-24 19:20:00,0,0,47,65,17,129
2024-03-24 19:30:00,2,1,52,55,12,122
2024-03-24 19:40:00,5,4,60,57,18,144
2024-03-24 19:50:00,4,0,45,49,13,111
2024-03-24 20:00:00,0,1,55,44,24,124
2024-03-24 20:10:00,1,1,48,35,13,98
2024-03-24 20:20:00,1,0,53,45,20,119
2024-03-24 20:30:00,4,0,53,40,13,110
2024-03-24 20:40:00,3,0,44,33,12,92
2024-03-24 20:50:00,0,0,38,41,12,91
2024-03-24 21:00:00,0,0,44,35,14,93
2024-03-24 21:10:00,1,1,38,36,18,94
2024-03-24 21:20:00,3,1,44,31,20,99
2024-03-24 21:30:00,4,0,27,38,14,83
2024-03-24 21:40:00,1,0,30,22,14,67
2024-03-24 21:50:00,0,0,37,32,10,79
2024-03-24 22:00:00,0,0,35,38,13,86
2024-03-24 22:10:00,0,0,34,30,11,75
2024-03-24 22:20:00,0,0,34,18,13,65
2024-03-24 22:30:00,0,1,29,20,13,63
2024-03-24 22:40:00,1,0,16,18,8,43
2024-03-24 22:50:00,0,0,17,12,5,34
2024-03-24 23:00:00,0,0,13,17,4,34
2024-03-24 23:10:00,0,0,25,18,9,52
2024-03-24 23:20:00,1,1,14,22,8,46
2024-03-24 23:30:00,1,0,18,21,5,45
2024-03-24 23:40:00,1,0,16,13,5,35
2024-03-24 23:50:00,0,0,12,11,4,27
2024-03-25 00:00:00,0,0,13,9,9,31
2024-03-25 00:10:00,0,0,11,10,3,24
2024-03-25 00:20:00,1,0,11,4,6,22
2024-03-25 00:30:00,0,0,8,3,4,15
2024-03-25 00:40:00,1,0,12,3,4,20
2024-03-25 00:50:00,0,0,10,6,3,19
2024-03-25 01:00:00,0,0,4,6,2,12
2024-03-25 01:10:00,0,1,8,2,4,15
2024-03-25 01:20:00,0,0,4,4,1,9
2024-03-25 01:30:00,0,0,3,2,3,8
2024-03-25 01:40:00,1,0,7,2,2,12
2024-03-25 01:50:00,0,0,7,3,3,13
2024-03-25 02:00:00,0,0,5,1,4,10
2024-03-25 02:10:00,0,0,5,4,4,13
2024-03-25 02:20:00,0,0,1,2,0,3
2024-03-25 02:30:00,0,0,8,4,4,16
2024-03-25 02:40:00,0,0,9,4,7,20
2024-03-25 02:50:00,0,0,10,7,6,23
2024-03-25 03:00:00,0,0,6,5,2,13
2024-03-25 03:10:00,0,0,4,2,4,10
2024-03-25 03:20:00,0,0,7,1,4,12
2024-03-25 03:30:00,1,0,4,2,1,8
2024-03-25 03:40:00,0,0,7,4,4,15
2024-03-25 03:50:00,0,0,5,8,1,14
2024-03-25 04:00:00,0,0,6,4,3,13
2024-03-25 04:10:00,0,0,6,7,2,15
2024-03-25 04:20:00,0,1,16,14,8,39
2024-03-25 04:30:00,0,0,8,15,5,28
2024-03-25 04:40:00,0,0,9,10,2,21
2024-03-25 04:50:00,0,0,13,18,4,35
2024-03-25 05:00:00,0,0,20,29,9,58
2024-03-25 05:10:00,1,0,24,23,8,56
2024-03-25 05:20:00,1,0,31,32,12,76
2024-03-25 05:30:00,2,0,36,51,10,99
2024-03-25 05:40:00,0,0,49,47,23,119
2024-03-25 05:50:00,3,0,33,58,6,100
2024-03-25 06:00:00,1,0,52,61,26,140
2024-03-25 06:10:00,3,0,54,60,18,135
2024-03-25 06:20:00,2,0,79,80,20,181
2024-03-25 06:30:00,0,0,83,86,20,189
2024-03-25 06:40:00,0,0,105,86,27,218
2024-03-25 06:50:00,0,0,86,86,22,194
2024-03-25 07:00:00,4,0,91,77,27,199
2024-03-25 07:10:00,1,0,102,108,28,239
2024-03-25 07:20:00,1,0,149,121,19,290
2024-03-25 07:30:00,2,0,112,142,28,284
2024-03-25 07:40:00,3,0,150,121,25,299
2024-03-25 07:50:00,3,0,149,107,25,284
2024-03-25 08:00:00,1,0,121,98,14,234
2024-03-25 08:10:00,2,0,104,126,16,248
2024-03-25 08:20:00,5,0,120,130,18,273
2024-03-25 08:30:00,3,0,115,101,30,249
2024-03-25 08:40:00,5,1,136,110,30,282
2024-03-25 08:50:00,1,1,128,126,24,280
2024-03-25 09:00:00,1,0,114,90,17,222
2024-03-25 09:10:00,3,1,93,101,21,219
2024-03-25 09:20:00,4,0,99,97,28,228
2024-03-25 09:30:00,6,0,109,126,14,255
2024-03-25 09:40:00,4,0,126,134,28,292
2024-03-25 09:50:00,3,1,133,123,29,289
2024-03-25 10:00:00,5,0,115,135,19,274
2024-03-25 10:10:00,7,0,108,106,22,243
2024-03-25 10:20:00,3,0,123,112,15,253
2024-03-25 10:30:00,3,0,126,114,17,260
2024-03-25 10:40:00,2,0,125,124,18,269
2024-03-25 10:50:00,0,0,116,107,28,251
2024-03-25 11:00:00,2,1,116,105,21,245
2024-03-25 11:10:00,1,0,111,125,28,265
2024-03-25 11:20:00,1,0,108,95,23,227
2024-03-25 11:30:00,0,1,131,125,19,276
2024-03-25 11:40:00,4,0,122,103,21,250
2024-03-25 11:50:00,7,0,121,125,26,279
2024-03-25 12:00:00,1,1,113,112,22,249
2024-03-25 12:10:00,6,1,136,104,14,261
2024-03-25 12:20:00,4,1,122,126,17,270
2024-03-25 12:30:00,4,1,126,121,26,278
2024-03-25 12:40:00,2,2,109,114,33,260
2024-03-25 12:50:00,2,1,100,118,22,243
2024-03-25 13:00:00,3,0,102,102,25,232
2024-03-25 13:10:00,4,0,114,118,24,260
2024-03-25 13:20:00,7,0,112,116,26,261
2024-03-25 13:30:00,3,2,112,120,25,262
2024-03-25 13:40:00,4,0,114,110,22,250
2024-03-25 13:50:00,4,1,117,109,12,243
2024-03-25 14:00:00,2,2,126,134,12,276
2024-03-25 14:10:00,3,1,124,92,20,240
2024-03-25 14:20:00,2,1,133,148,21,305
2024-03-25 14:30:00,2,0,130,113,16,261
2024-03-25 14:40:00,2,5,128,121,12,268
2024-03-25 14:50:00,4,2,129,111,24,270
2024-03-25 15:00:00,5,4,99,119,7,234
2024-03-25 15:10:00,3,0,151,131,15,300
2024-03-25 15:20:00,4,1,110,128,14,257
2024-03-25 15:30:00,5,1,103,152,13,274
2024-03-25 15:40:00,6,0,121,123,13,263
2024-03-25 15:50:00,3,1,145,163,10,322
2024-03-25 16:00:00,4,0,141,142,14,301
2024-03-25 16:10:00,9,2,144,143,14,312
2024-03-25 16:20:00,7,1,135,150,16,309
2024-03-25 16:30:00,10,1,61,146,8,226
2024-03-25 16:40:00,8,3,141,143,13,308
2024-03-25 16:50:00,12,0,161,116,4,293
2024-03-25 17:00:00,10,2,150,138,17,317
2024-03-25 17:10:00,5,0,139,150,21,315
2024-03-25 17:20:00,6,2,153,151,13,325
2024-03-25 17:30:00,5,1,166,134,18,324
2024-03-25 17:40:00,9,1,139,120,29,298
2024-03-25 17:50:00,5,0,141,133,25,304
2024-03-25 18:00:00,7,0,132,115,22,276
2024-03-25 18:10:00,5,0,136,140,35,316
2024-03-25 18:20:00,6,0,103,125,21,255
2024-03-25 18:30:00,2,1,109,112,35,259
2024-03-25 18:40:00,3,0,105,118,20,246
2024-03-25 18:50:00,1,1,91,93,29,215
2024-03-25 19:00:00,2,1,97,103,18,221
2024-03-25 19:10:00,2,0,89,98,21,210
2024-03-25 19:20:00,2,0,60,98,25,185
2024-03-25 19:30:00,3,0,80,72,15,170
2024-03-25 19:40:00,1,0,73,67,22,163
2024-03-25 19:50:00,0,1,58,83,22,164
2024-03-25 20:00:00,2,1,58,74,18,153
2024-03-25 20:10:00,4,0,56,69,30,159
2024-03-25 20:20:00,1,0,48,53,19,121
2024-03-25 20:30:00,0,1,61,60,22,144
2024-03-25 20:40:00,1,0,64,55,31,151
2024-03-25 20:50:00,2,0,47,40,16,105
2024-03-25 21:00:00,0,0,40,40,13,93
2024-03-25 21:10:00,0,0,53,34,22,109
2024-03-25 21:20:00,1,0,47,48,15,111
2024-03-25 21:30:00,1,0,33,37,17,88
2024-03-25 21:40:00,2,0,39,23,21,85
2024-03-25 21:50:00,1,0,33,41,7,82
2024-03-25 22:00:00,0,0,40,32,9,81
2024-03-25 22:10:00,1,0,45,27,19,92
2024-03-25 22:20:00,0,0,37,19,15,71
2024-03-25 22:30:00,0,0,34,22,18,74
2024-03-25 22:40:00,0,0,33,17,12,62
2024-03-25 22:50:00,0,0,32,26,11,69
2024-03-25 23:00:00,2,1,33,14,16,66
2024-03-25 23:10:00,0,1,26,20,8,55
2024-03-25 23:20:00,0,1,28,22,7,58
2024-03-25 23:30:00,0,0,17,10,8,35
2024-03-25 23:40:00,1,0,15,17,3,36
2024-03-25 23:50:00,1,0,17,18,8,44
2024-03-26 00:00:00,0,0,12,7,7,26
2024-03-26 00:10:00,0,0,7,9,1,17
2024-03-26 00:20:00,0,0,14,8,8,30
2024-03-26 00:30:00,0,0,11,5,4,20
2024-03-26 00:40:00,0,0,11,7,4,22
2024-03-26 00:50:00,0,0,12,5,4,21
2024-03-26 01:00:00,0,0,7,5,4,16
2024-03-26 01:10:00,0,0,5,3,5,13
2024-03-26 01:20:00,0,0,7,2,7,16
2024-03-26 01:30:00,0,0,3,6,1,10
2024-03-26 01:40:00,0,0,6,3,4,13
2024-03-26 01:50:00,0,0,8,4,5,17
2024-03-26 02:00:00,0,0,9,5,5,19
2024-03-26 02:10:00,0,0,3,1,2,6
2024-03-26 02:20:00,0,0,5,5,1,11
2024-03-26 02:30:00,0,0,10,6,7,23
2024-03-26 02:40:00,0,0,8,5,3,16
2024-03-26 02:50:00,0,0,8,4,4,16
2024-03-26 03:00:00,0,0,11,6,5,22
2024-03-26 03:10:00,0,0,7,5,3,15
2024-03-26 03:20:00,0,0,6,1,5,12
2024-03-26 03:30:00,1,0,7,3,5,16
2024-03-26 03:40:00,0,0,4,1,3,8
2024-03-26 03:50:00,0,0,5,7,2,14
2024-03-26 04:00:00,0,0,8,6,5,19
2024-03-26 04:10:00,0,0,8,11,1,20
2024-03-26 04:20:00,0,0,13,6,6,25
2024-03-26 04:30:00,0,0,7,10,3,20
2024-03-26 04:40:00,0,0,15,20,7,42
2024-03-26 04:50:00,0,0,12,19,5,36
2024-03-26 05:00:00,0,0,17,21,6,44
2024-03-26 05:10:00,1,0,25,27,14,67
2024-03-26 05:20:00,0,0,34,40,13,87
2024-03-26 05:30:00,0,0,40,46,14,100
2024-03-26 05:40:00,0,0,41,57,9,107
2024-03-26 05:50:00,3,0,45,48,15,111
2024-03-26 06:00:00,5,0,55,66,16,142
2024-03-26 06:10:00,5,0,66,77,20,168
2024-03-26 06:20:00,5,0,78,77,14,174
2024-03-26 06:30:00,1,0,88,88,27,204
2024-03-26 06:40:00,0,0,97,95,19,211
2024-03-26 06:50:00,2,0,91,86,20,199
2024-03-26 07:00:00,1,0,95,92,26,214
2024-03-26 07:10:00,2,0,100,93,26,221
2024-03-26 07:20:00,0,0,101,120,26,247
2024-03-26 07:30:00,5,0,92,119,12,228
2024-03-26 07:40:00,1,0,113,129,23,266
2024-03-26 07:50:00,1,0,136,100,32,269
2024-03-26 08:00:00,5,0,86,135,22,248
2024-03-26 08:10:00,2,0,105,130,26,263
2024-03-26 08:20:00,2,0,105,104,28,239
2024-03-26 08:30:00,2,1,107,102,21,233
2024-03-26 08:40:00,3,0,126,131,24,284
2024-03-26 08:50:00,2,0,111,105,22,240
2024-03-26 09:00:00,3,3,100,103,30,239
2024-03-26 09:10:00,6,1,101,101,17,226
2024-03-26 09:20:00,3,0,111,102,25,241
2024-03-26 09:30:00,11,0,105,83,19,218
2024-03-26 09:40:00,3,1,134,122,29,289
2024-03-26 09:50:00,4,1,111,108,23,247
2024-03-26 10:00:00,1,0,123,108,33,265
2024-03-26 10:10:00,2,0,119,135,22,278
2024-03-26 10:20:00,3,1,112,110,20,246
2024-03-26 10:30:00,4,0,129,98,22,253
2024-03-26 10:40:00,2,1,99,107,23,232
2024-03-26 10:50:00,2,1,108,100,18,229
2024-03-26 11:00:00,2,1,103,126,22,254
2024-03-26 11:10:00,1,0,105,124,19,249
2024-03-26 11:20:00,1,0,129,110,18,258
2024-03-26 11:30:00,1,0,127,129,23,280
2024-03-26 11:40:00,0,0,134,109,21,264
2024-03-26 11:50:00,1,0,138,98,17,254
2024-03-26 12:00:00,3,0,109,100,20,232
2024-03-26 12:10:00,2,1,117,118,23,261
2024-03-26 12:20:00,4,1,92,97,10,204
2024-03-26 12:30:00,1,0,131,100,35,267
2024-03-26 12:40:00,3,0,129,100,25,257
2024-03-26 12:50:00,0,1,109,113,25,248
2024-03-26 13:00:00,1,1,114,111,18,245
2024-03-26 13:10:00,4,1,118,111,24,258
2024-03-26 13:20:00,5,0,121,129,20,275
2024-03-26 13:30:00,1,1,103,86,43,234
2024-03-26 13:40:00,7,1,119,111,24,262
2024-03-26 13:50:00,3,2,122,113,18,258
2024-03-26 14:00:00,2,1,134,141,17,295
2024-03-26 14:10:00,3,3,143,117,17,283
2024-03-26 14:20:00,4,1,119,122,19,265
2024-03-26 14:30:00,2,0,109,125,19,255
2024-03-26 14:40:00,4,2,138,126,17,287
2024-03-26 14:50:00,5,1,138,132,18,294
2024-03-26 15:00:00,4,0,132,132,23,291
2024-03-26 15:10:00,4,1,109,118,20,252
2024-03-26 15:20:00,2,0,155,129,12,298
2024-03-26 15:30:00,3,0,128,157,19,307
2024-03-26 15:40:00,14,0,147,165,10,336
2024-03-26 15:50:00,4,0,144,153,10,311
2024-03-26 16:00:00,4,0,149,163,14,330
2024-03-26 16:10:00,6,0,126,140,6,278
2024-03-26 16:20:00,8,0,155,152,9,324
2024-03-26 16:30:00,5,0,138,129,16,288
2024-03-26 16:40:00,12,0,143,137,12,304
2024-03-26 16:50:00,9,1,160,153,26,349
2024-03-26 17:00:00,11,1,165,150,22,349
2024-03-26 17:10:00,8,2,105,124,20,259
2024-03-26 17:20:00,10,0,128,154,13,305
2024-03-26 17:30:00,7,2,127,140,20,296
2024-03-26 17:40:00,8,0,139,139,30,316
2024-03-26 17:50:00,4,0,138,95,28,265
2024-03-26 18:00:00,5,0,132,152,22,311
2024-03-26 18:10:00,7,0,119,113,31,270
2024-03-26 18:20:00,1,3,116,133,24,277
2024-03-26 18:30:00,4,0,146,119,14,283
2024-03-26 18:40:00,2,1,107,119,19,248
2024-03-26 18:50:00,3,1,109,87,31,231
2024-03-26 19:00:00,1,0,61,88,20,170
2024-03-26 19:10:00,5,0,63,85,23,176
2024-03-26 19:20:00,0,1,82,76,28,187
2024-03-26 19:30:00,4,0,84,86,22,196
2024-03-26 19:40:00,3,0,64,74,26,167
2024-03-26 19:50:00,1,1,66,62,25,155
2024-03-26 20:00:00,0,0,55,66,22,143
2024-03-26 20:10:00,0,0,68,50,24,142
2024-03-26 20:20:00,2,0,64,44,26,136
2024-03-26 20:30:00,0,0,47,69,19,135
2024-03-26 20:40:00,2,1,70,51,27,151
2024-03-26 20:50:00,3,0,50,47,19,119
2024-03-26 21:00:00,1,0,46,58,23,128
2024-03-26 21:10:00,1,0,36,48,16,101
2024-03-26 21:20:00,1,0,41,33,17,92
2024-03-26 21:30:00,0,0,45,38,17,100
2024-03-26 21:40:00,0,0,38,48,15,101
2024-03-26 21:50:00,2,0,33,48,9,92
2024-03-26 22:00:00,0,0,38,33,15,86
2024-03-26 22:10:00,5,0,37,25,16,83
2024-03-26 22:20:00,2,0,35,24,12,73
2024-03-26 22:30:00,1,0,23,16,12,52
2024-03-26 22:40:00,1,1,31,26,8,67
2024-03-26 22:50:00,0,0,37,19,20,76
2024-03-26 23:00:00,0,0,21,20,7,48
2024-03-26 23:10:00,0,0,20,14,3,37
2024-03-26 23:20:00,1,0,20,20,10,51
2024-03-26 23:30:00,0,0,15,13,6,34
2024-03-26 23:40:00,4,0,21,12,8,45
2024-03-26 23:50:00,0,0,28,14,7,49
2024-03-27 00:00:00,0,0,20,9,7,36
2024-03-27 00:10:00,0,0,14,8,2,24
2024-03-27 00:20:00,0,0,10,5,6,21
2024-03-27 00:30:00,0,0,15,5,8,28
2024-03-27 00:40:00,1,0,0,5,3,9
2024-03-27 00:50:00,0,0,0,4,6,10
2024-03-27 01:00:00,0,0,3,4,4,11
2024-03-27 01:10:00,0,0,10,6,3,19
2024-03-27 01:20:00,0,0,7,2,5,14
2024-03-27 01:30:00,0,0,7,7,5,19
2024-03-27 01:40:00,0,0,7,5,4,16
2024-03-27 01:50:00,0,0,8,3,1,12
2024-03-27 02:00:00,0,0,6,6,5,17
2024-03-27 02:10:00,0,0,4,1,4,9
2024-03-27 02:20:00,1,0,5,1,2,9
2024-03-27 02:30:00,0,0,3,3,4,10
2024-03-27 02:40:00,0,0,4,4,0,8
2024-03-27 02:50:00,1,0,4,3,3,11
2024-03-27 03:00:00,0,0,9,6,5,20
2024-03-27 03:10:00,0,0,8,4,5,17
2024-03-27 03:20:00,0,0,7,2,5,14
2024-03-27 03:30:00,1,0,5,4,4,14
2024-03-27 03:40:00,0,0,9,7,3,19
2024-03-27 03:50:00,0,0,7,4,2,13
2024-03-27 04:00:00,0,0,6,3,5,14
2024-03-27 04:10:00,0,0,5,12,3,20
2024-03-27 04:20:00,0,0,10,8,4,22
2024-03-27 04:30:00,0,0,13,5,10,28
2024-03-27 04:40:00,0,0,11,11,3,25
2024-03-27 04:50:00,1,0,21,16,10,48
2024-03-27 05:00:00,1,0,19,22,5,47
2024-03-27 05:10:00,0,0,17,31,9,57
2024-03-27 05:20:00,0,0,31,35,15,81
2024-03-27 05:30:00,1,0,40,57,10,108
2024-03-27 05:40:00,0,0,49,63,15,127
2024-03-27 05:50:00,0,0,40,59,17,116
2024-03-27 06:00:00,3,0,51,62,16,132
2024-03-27 06:10:00,0,0,63,70,26,159
2024-03-27 06:20:00,2,0,81,83,19,185
2024-03-27 06:30:00,3,0,77,87,26,193
2024-03-27 06:40:00,4,1,88,84,11,188
2024-03-27 06:50:00,1,0,101,83,24,209
2024-03-27 07:00:00,1,0,93,82,29,205
2024-03-27 07:10:00,2,1,60,85,16,164
2024-03-27 07:20:00,3,0,93,98,18,212
2024-03-27 07:30:00,2,0,101,133,24,260
2024-03-27 07:40:00,3,0,111,135,21,270
2024-03-27 07:50:00,5,1,104,108,20,238
2024-03-27 08:00:00,1,0,89,116,19,225
2024-03-27 08:10:00,2,0,92,125,13,232
2024-03-27 08:20:00,2,1,104,114,20,241
2024-03-27 08:30:00,3,2,102,99,18,224
2024-03-27 08:40:00,3,0,112,109,25,249
2024-03-27 08:50:00,3,0,116,97,29,245
2024-03-27 09:00:00,3,1,119,100,28,251
2024-03-27 09:10:00,3,1,98,107,22,231
2024-03-27 09:20:00,4,0,120,118,27,269
2024-03-27 09:30:00,9,0,110,127,24,270
2024-03-27 09:40:00,4,0,124,99,19,246
2024-03-27 09:50:00,3,0,124,89,19,235
2024-03-27 10:00:00,1,1,117,111,20,250
2024-03-27 10:10:00,2,0,125,119,24,270
2024-03-27 10:20:00,3,0,107,106,29,245
2024-03-27 10:30:00,4,1,121,116,24,266
2024-03-27 10:40:00,5,0,103,89,33,230
2024-03-27 10:50:00,1,1,115,125,23,265
2024-03-27 11:00:00,3,0,111,98,18,230
2024-03-27 11:10:00,3,1,117,122,17,260
2024-03-27 11:20:00,1,0,135,114,31,281
2024-03-27 11:30:00,6,0,121,119,29,275
2024-03-27 11:40:00,1,0,137,108,22,268
2024-03-27 11:50:00,1,1,141,133,20,296
2024-03-27 12:00:00,7,0,127,120,18,272
2024-03-27 12:10:00,3,0,93,128,20,244
2024-03-27 12:20:00,2,0,119,127,26,274
2024-03-27 12:30:00,2,1,124,108,28,263
2024-03-27 12:40:00,5,0,110,126,17,258
2024-03-27 12:50:00,1,1,137,126,27,292
2024-03-27 13:00:00,3,0,132,127,18,280
2024-03-27 13:10:00,1,0,127,102,16,246
2024-03-27 13:20:00,3,1,122,105,18,249
2024-03-27 13:30:00,2,2,104,125,22,255
2024-03-27 13:40:00,2,1,129,118,11,261
2024-03-27 13:50:00,0,1,132,120,36,289
2024-03-27 14:00:00,5,1,128,109,16,259
2024-03-27 14:10:00,4,1,146,153,20,324
2024-03-27 14:20:00,2,3,129,96,22,252
2024-03-27 14:30:00,1,1,130,135,26,293
2024-03-27 14:40:00,6,2,126,104,16,254
2024-03-27 14:50:00,5,2,147,133,17,304
2024-03-27 15:00:00,4,0,144,137,20,305
2024-03-27 15:10:00,3,0,129,115,22,269
2024-03-27 15:20:00,4,0,139,131,13,287
2024-03-27 15:30:00,7,0,138,147,18,310
2024-03-27 15:40:00,6,2,142,145,20,315
2024-03-27 15:50:00,3,0,127,153,26,309
2024-03-27 16:00:00,7,0,158,134,14,313
2024-03-27 16:10:00,12,0,134,122,19,287
2024-03-27 16:20:00,9,0,164,149,8,330
2024-03-27 16:30:00,4,0,155,147,8,314
2024-03-27 16:40:00,7,0,140,144,21,312
2024-03-27 16:50:00,4,1,158,116,20,299
2024-03-27 17:00:00,7,1,144,144,11,307
2024-03-27 17:10:00,7,0,147,143,8,305
2024-03-27 17:20:00,6,1,145,153,18,323
2024-03-27 17:30:00,4,1,170,152,20,347
2024-03-27 17:40:00,6,4,144,133,13,300
2024-03-27 17:50:00,7,0,121,158,12,298
2024-03-27 18:00:00,5,1,120,137,11,274
2024-03-27 18:10:00,3,0,116,137,20,276
2024-03-27 18:20:00,1,0,123,131,14,269
2024-03-27 18:30:00,4,0,103,108,20,235
2024-03-27 18:40:00,7,0,126,113,27,273
2024-03-27 18:50:00,2,0,103,118,27,250
2024-03-27 19:00:00,1,0,85,89,27,202
2024-03-27 19:10:00,6,0,86,81,21,194
2024-03-27 19:20:00,1,2,73,94,23,193
2024-03-27 19:30:00,4,0,75,84,23,186
2024-03-27 19:40:00,2,0,60,87,17,166
2024-03-27 19:50:00,1,0,63,92,15,171
2024-03-27 20:00:00,5,0,31,70,26,132
2024-03-27 20:10:00,12,0,70,77,23,182
2024-03-27 20:20:00,0,0,75,70,19,164
2024-03-27 20:30:00,1,0,45,56,18,120
2024-03-27 20:40:00,1,0,52,50,23,126
2024-03-27 20:50:00,0,0,49,66,21,136
2024-03-27 21:00:00,1,0,40,54,12,107
2024-03-27 21:10:00,0,0,57,46,15,118
2024-03-27 21:20:00,3,0,63,46,22,134
2024-03-27 21:30:00,0,0,62,53,20,135
2024-03-27 21:40:00,3,0,34,47,14,98
2024-03-27 21:50:00,0,0,43,52,13,108
2024-03-27 22:00:00,3,0,45,37,24,109
2024-03-27 22:10:00,0,0,43,34,20,97
2024-03-27 22:20:00,3,0,34,29,13,79
2024-03-27 22:30:00,0,0,40,36,10,86
2024-03-27 22:40:00,0,0,41,21,17,79
2024-03-27 22:50:00,3,0,35,19,13,70
2024-03-27 23:00:00,0,1,37,19,12,69
2024-03-27 23:10:00,1,0,19,21,2,43
2024-03-27 23:20:00,1,0,21,17,11,50
2024-03-27 23:30:00,0,0,23,13,10,46
2024-03-27 23:40:00,2,0,18,13,10,43
2024-03-27 23:50:00,0,0,18,12,8,38
2024-03-28 00:00:00,1,0,13,9,4,27
2024-03-28 00:10:00,0,0,11,6,4,21
2024-03-28 00:20:00,0,0,13,11,6,30
2024-03-28 00:30:00,1,0,9,7,6,23
2024-03-28 00:40:00,0,0,8,8,6,22
2024-03-28 00:50:00,0,0,8,5,3,16
2024-03-28 01:00:00,0,0,13,12,2,27
2024-03-28 01:10:00,0,0,5,2,3,10
2024-03-28 01:20:00,0,0,6,5,1,12
2024-03-28 01:30:00,0,0,7,3,6,16
2024-03-28 01:40:00,0,0,11,4,6,21
2024-03-28 01:50:00,0,0,9,6,4,19
2024-03-28 02:00:00,0,0,5,4,3,12
2024-03-28 02:10:00,0,0,9,4,8,21
2024-03-28 02:20:00,0,0,4,7,3,14
2024-03-28 02:30:00,0,0,9,4,7,20
2024-03-28 02:40:00,0,0,4,7,2,13
2024-03-28 02:50:00,0,0,8,7,1,16
2024-03-28 03:00:00,0,0,6,3,4,13
2024-03-28 03:10:00,0,1,6,5,5,17
2024-03-28 03:20:00,0,0,10,4,6,20
2024-03-28 03:30:00,1,0,2,1,1,5
2024-03-28 03:40:00,0,0,5,7,2,14
2024-03-28 03:50:00,0,0,3,4,3,10
2024-03-28 04:00:00,0,0,8,7,3,18
2024-03-28 04:10:00,0,0,10,8,0,18
2024-03-28 04:20:00,0,0,11,5,5,21
2024-03-28 04:30:00,0,0,12,12,5,29
2024-03-28 04:40:00,0,0,15,10,6,31
2024-03-28 04:50:00,0,0,20,21,12,53
2024-03-28 05:00:00,0,0,20,27,7,54
2024-03-28 05:10:00,0,1,16,32,8,57
2024-03-28 05:20:00,0,0,37,33,15,85
2024-03-28 05:30:00,1,1,45,55,10,112
2024-03-28 05:40:00,0,0,50,50,13,113
2024-03-28 05:50:00,2,0,55,72,16,145
2024-03-28 06:00:00,2,0,50,58,17,127
2024-03-28 06:10:00,3,0,54,63,13,133
2024-03-28 06:20:00,3,0,68,81,15,167
2024-03-28 06:30:00,1,1,71,66,17,156
2024-03-28 06:40:00,1,1,98,66,28,194
2024-03-28 06:50:00,0,0,92,72,30,194
2024-03-28 07:00:00,1,0,107,86,24,218
2024-03-28 07:10:00,4,0,98,124,22,248
2024-03-28 07:20:00,1,2,111,109,21,244
2024-03-28 07:30:00,0,0,106,105,17,228
2024-03-28 07:40:00,3,0,87,127,19,236
2024-03-28 07:50:00,1,0,120,108,29,258
2024-03-28 08:00:00,3,0,110,101,23,237
2024-03-28 08:10:00,5,0,79,145,20,249
2024-03-28 08:20:00,3,0,141,111,14,269
2024-03-28 08:30:00,5,0,114,111,7,237
2024-03-28 08:40:00,3,0,124,113,17,257
2024-03-28 08:50:00,4,2,127,103,18,254
2024-03-28 09:00:00,2,0,122,86,18,228
2024-03-28 09:10:00,3,0,122,116,25,266
2024-03-28 09:20:00,1,2,130,130,20,283
2024-03-28 09:30:00,2,0,119,120,12,253
2024-03-28 09:40:00,10,0,125,130,11,276
2024-03-28 09:50:00,3,0,78,113,18,212
2024-03-28 10:00:00,0,0,105,112,21,238
2024-03-28 10:10:00,4,2,134,141,16,297
2024-03-28 10:20:00,3,0,141,129,12,285
2024-03-28 10:30:00,1,0,127,136,18,282
2024-03-28 10:40:00,3,0,125,109,14,251
2024-03-28 10:50:00,2,0,151,129,15,297
2024-03-28 11:00:00,1,1,145,128,17,292
2024-03-28 11:10:00,1,0,131,120,26,278
2024-03-28 11:20:00,2,1,133,109,31,276
2024-03-28 11:30:00,2,0,134,126,18,280
2024-03-28 11:40:00,4,0,122,149,14,289
2024-03-28 11:50:00,2,0,140,123,16,281
2024-03-28 12:00:00,4,0,135,137,15,291
2024-03-28 12:10:00,4,0,139,158,9,310
2024-03-28 12:20:00,4,0,117,141,19,281
2024-03-28 12:30:00,2,0,126,139,19,286
2024-03-28 12:40:00,2,0,110,128,19,259
2024-03-28 12:50:00,2,1,26,124,23,176
2024-03-28 13:00:00,1,2,124,122,23,272
2024-03-28 13:10:00,1,1,145,123,18,288
2024-03-28 13:20:00,5,0,127,124,22,278
2024-03-28 13:30:00,8,0,133,116,22,279
2024-03-28 13:40:00,1,2,131,135,21,290
2024-03-28 13:50:00,6,2,123,137,8,276
2024-03-28 14:00:00,8,1,139,123,4,275
2024-03-28 14:10:00,2,2,139,140,8,291
2024-03-28 14:20:00,4,2,128,124,15,273
2024-03-28 14:30:00,1,2,4,146,19,172
2024-03-28 14:40:00,4,2,63,146,22,237
2024-03-28 14:50:00,6,2,144,165,22,339
2024-03-28 15:00:00,3,0,146,129,10,288
2024-03-28 15:10:00,3,0,34,119,12,168
2024-03-28 15:20:00,2,0,91,158,9,260
2024-03-28 15:30:00,4,0,115,152,18,289
2024-03-28 15:40:00,6,0,130,159,9,304
2024-03-28 15:50:00,4,1,71,145,11,232
2024-03-28 16:00:00,5,1,159,149,13,327
2024-03-28 16:10:00,5,1,88,137,7,238
2024-03-28 16:20:00,3,1,117,153,12,286
2024-03-28 16:30:00,5,0,133,122,11,271
2024-03-28 16:40:00,8,2,111,125,10,256
2024-03-28 16:50:00,4,1,142,150,8,305
2024-03-28 17:00:00,8,2,160,141,18,329
2024-03-28 17:10:00,4,0,129,142,9,284
2024-03-28 17:20:00,3,2,171,149,10,335
2024-03-28 17:30:00,10,1,153,136,4,304
2024-03-28 17:40:00,5,3,149,146,11,314
2024-03-28 17:50:00,4,1,147,127,14,293
2024-03-28 18:00:00,4,2,158,130,22,316
2024-03-28 18:10:00,7,0,125,139,25,296
2024-03-28 18:20:00,3,0,127,139,17,286
2024-03-28 18:30:00,4,0,120,136,22,282
2024-03-28 18:40:00,3,1,18,125,26,173
2024-03-28 18:50:00,4,2,73,125,22,226
2024-03-28 19:00:00,1,2,78,102,18,201
2024-03-28 19:10:00,3,1,112,106,19,241
2024-03-28 19:20:00,1,1,77,105,26,210
2024-03-28 19:30:00,4,0,98,96,19,217
2024-03-28 19:40:00,1,0,88,93,21,203
2024-03-28 19:50:00,2,0,74,130,25,231
2024-03-28 20:00:00,1,1,78,108,22,210
2024-03-28 20:10:00,4,1,78,103,19,205
2024-03-28 20:20:00,1,1,82,89,20,193
2024-03-28 20:30:00,2,0,68,74,17,161
2024-03-28 20:40:00,0,0,72,59,24,155
2024-03-28 20:50:00,1,0,60,71,25,157
2024-03-28 21:00:00,0,0,63,43,19,125
2024-03-28 21:10:00,0,0,55,61,18,134
2024-03-28 21:20:00,0,1,70,63,22,156
2024-03-28 21:30:00,0,0,67,47,25,139
2024-03-28 21:40:00,2,0,56,45,19,122
2024-03-28 21:50:00,0,0,54,64,17,135
2024-03-28 22:00:00,0,0,53,45,24,122
2024-03-28 22:10:00,0,0,53,31,27,111
2024-03-28 22:20:00,0,0,55,38,23,116
2024-03-28 22:30:00,0,0,45,33,16,94
2024-03-28 22:40:00,1,1,46,23,14,85
2024-03-28 22:50:00,0,0,42,29,22,93
2024-03-28 23:00:00,0,1,43,26,15,85
2024-03-28 23:10:00,0,0,32,33,14,79
2024-03-28 23:20:00,0,0,33,19,17,69
2024-03-28 23:30:00,4,0,23,29,5,61
2024-03-28 23:40:00,0,0,18,23,3,44
2024-03-28 23:50:00,1,0,24,12,9,46
2024-03-29 00:00:00,0,1,23,13,10,47
2024-03-29 00:10:00,0,0,15,9,8,32
2024-03-29 00:20:00,0,0,20,9,10,39
2024-03-29 00:30:00,0,0,15,12,7,34
2024-03-29 00:40:00,0,0,17,9,10,36
2024-03-29 00:50:00,0,0,12,12,8,32
2024-03-29 01:00:00,0,0,13,11,7,31
2024-03-29 01:10:00,1,0,15,14,5,35
2024-03-29 01:20:00,0,0,12,9,6,27
2024-03-29 01:30:00,0,0,17,9,8,34
2024-03-29 01:40:00,0,0,14,9,6,29
2024-03-29 01:50:00,0,0,10,8,4,22
2024-03-29 02:00:00,0,0,10,10,5,25
2024-03-29 02:10:00,1,0,13,5,7,26
2024-03-29 02:20:00,0,1,12,7,4,24
2024-03-29 02:30:00,0,0,6,7,5,18
2024-03-29 02:40:00,1,0,12,4,9,26
2024-03-29 02:50:00,0,0,6,5,3,14
2024-03-29 03:00:00,0,0,4,3,3,10
2024-03-29 03:10:00,0,0,10,2,7,19
2024-03-29 03:20:00,0,0,4,4,3,11
2024-03-29 03:30:00,1,0,7,4,4,16
2024-03-29 03:40:00,0,0,6,10,2,18
2024-03-29 03:50:00,0,0,8,2,5,15
2024-03-29 04:00:00,0,0,9,8,4,21
2024-03-29 04:10:00,0,0,6,5,3,14
2024-03-29 04:20:00,0,0,4,8,1,13
2024-03-29 04:30:00,0,0,7,5,5,17
2024-03-29 04:40:00,0,0,2,5,0,7
2024-03-29 04:50:00,1,0,7,9,2,19
2024-03-29 05:00:00,0,0,5,10,2,17
2024-03-29 05:10:00,0,0,15,10,4,29
2024-03-29 05:20:00,0,0,10,14,6,30
2024-03-29 05:30:00,1,0,16,17,5,39
2024-03-29 05:40:00,0,0,8,10,2,20
2024-03-29 05:50:00,0,0,11,14,6,31
2024-03-29 06:00:00,1,0,8,8,1,18
2024-03-29 06:10:00,1,0,18,15,10,44
2024-03-29 06:20:00,0,0,9,13,7,29
2024-03-29 06:30:00,1,0,8,9,5,23
2024-03-29 06:40:00,2,0,22,14,9,47
2024-03-29 06:50:00,0,0,19,9,8,36
2024-03-29 07:00:00,0,0,10,14,4,28
2024-03-29 07:10:00,0,0,15,17,5,37
2024-03-29 07:20:00,0,0,12,8,5,25
2024-03-29 07:30:00,0,0,9,14,2,25
2024-03-29 07:40:00,0,0,14,6,6,26
2024-03-29 07:50:00,0,0,14,12,9,35
2024-03-29 08:00:00,0,0,15,12,8,35
2024-03-29 08:10:00,0,0,19,19,8,46
2024-03-29 08:20:00,1,0,7,11,4,23
2024-03-29 08:30:00,0,0,21,16,4,41
2024-03-29 08:40:00,0,2,35,23,11,71
2024-03-29 08:50:00,0,0,32,25,6,63
2024-03-29 09:00:00,0,0,16,26,4,46
2024-03-29 09:10:00,1,0,15,25,5,46
2024-03-29 09:20:00,2,0,16,36,5,59
2024-03-29 09:30:00,1,0,27,50,8,86
2024-03-29 09:40:00,3,0,33,43,10,89
2024-03-29 09:50:00,4,1,43,33,13,94
2024-03-29 10:00:00,0,0,40,33,9,82
2024-03-29 10:10:00,1,1,33,43,12,90
2024-03-29 10:20:00,0,0,37,30,11,78
2024-03-29 10:30:00,1,0,33,34,11,79
2024-03-29 10:40:00,1,0,38,42,7,88
2024-03-29 10:50:00,0,0,43,30,16,89
2024-03-29 11:00:00,1,0,44,56,15,116
2024-03-29 11:10:00,1,1,37,43,13,95
2024-03-29 11:20:00,1,0,41,54,8,104
2024-03-29 11:30:00,1,0,54,39,14,108
2024-03-29 11:40:00,2,0,60,51,12,125
2024-03-29 11:50:00,1,0,51,71,18,141
2024-03-29 12:00:00,2,1,70,49,28,150
2024-03-29 12:10:00,1,0,60,62,11,134
2024-03-29 12:20:00,0,0,68,73,19,160
2024-03-29 12:30:00,3,0,68,53,18,142
2024-03-29 12:40:00,0,0,63,52,17,132
2024-03-29 12:50:00,1,0,76,57,19,153
2024-03-29 13:00:00,0,0,102,72,23,197
2024-03-29 13:10:00,1,0,71,71,13,156
2024-03-29 13:20:00,1,1,74,87,18,181
2024-03-29 13:30:00,0,0,66,73,24,163
2024-03-29 13:40:00,2,0,54,79,12,147
2024-03-29 13:50:00,1,0,75,69,17,162
2024-03-29 14:00:00,1,0,64,86,16,167
2024-03-29 14:10:00,2,1,69,79,10,161
2024-03-29 14:20:00,0,1,66,66,23,156
2024-03-29 14:30:00,0,0,52,72,16,140
2024-03-29 14:40:00,0,0,64,78,14,156
2024-03-29 14:50:00,0,0,69,67,19,155
2024-03-29 15:00:00,0,0,54,59,12,125
2024-03-29 15:10:00,1,0,52,57,14,124
2024-03-29 15:20:00,0,0,61,52,22,135
2024-03-29 15:30:00,2,1,49,46,16,114
2024-03-29 15:40:00,3,0,45,51,13,112
2024-03-29 15:50:00,0,1,73,47,25,146
2024-03-29 16:00:00,2,0,52,65,15,134
2024-03-29 16:10:00,2,0,58,44,21,125
2024-03-29 16:20:00,4,1,55,64,9,133
2024-03-29 16:30:00,2,0,74,72,23,171
2024-03-29 16:40:00,2,0,60,57,16,135
2024-03-29 16:50:00,2,0,51,51,17,121
2024-03-29 17:00:00,2,0,48,54,13,117
2024-03-29 17:10:00,1,0,47,55,15,118
2024-03-29 17:20:00,1,1,44,76,15,137
2024-03-29 17:30:00,1,0,64,61,26,152
2024-03-29 17:40:00,2,0,87,55,31,175
2024-03-29 17:50:00,0,0,48,57,21,126
2024-03-29 18:00:00,1,0,66,76,19,162
2024-03-29 18:10:00,0,0,58,78,17,153
2024-03-29 18:20:00,1,0,58,53,16,128
2024-03-29 18:30:00,1,0,56,73,21,151
2024-03-29 18:40:00,1,1,63,56,26,147
2024-03-29 18:50:00,0,1,62,52,17,132
2024-03-29 19:00:00,0,0,52,54,21,127
2024-03-29 19:10:00,7,0,59,49,15,130
2024-03-29 19:20:00,2,0,43,44,22,111
2024-03-29 19:30:00,4,0,47,35,14,100
2024-03-29 19:40:00,2,1,56,49,19,127
2024-03-29 19:50:00,1,0,44,42,9,96
2024-03-29 20:00:00,1,1,32,39,16,89
2024-03-29 20:10:00,1,0,56,38,15,110
2024-03-29 20:20:00,0,0,36,41,12,89
2024-03-29 20:30:00,1,0,40,33,19,93
2024-03-29 20:40:00,1,1,48,32,22,104
2024-03-29 20:50:00,1,0,44,31,18,94
2024-03-29 21:00:00,0,0,35,38,16,89
2024-03-29 21:10:00,0,0,31,40,9,80
2024-03-29 21:20:00,2,0,34,29,18,83
2024-03-29 21:30:00,0,0,57,47,20,124
2024-03-29 21:40:00,3,0,38,43,13,97
2024-03-29 21:50:00,0,0,41,30,21,92
2024-03-29 22:00:00,0,0,31,36,12,79
2024-03-29 22:10:00,1,0,37,24,12,74
2024-03-29 22:20:00,4,0,33,22,18,77
2024-03-29 22:30:00,1,0,27,32,19,79
2024-03-29 22:40:00,0,0,29,18,14,61
2024-03-29 22:50:00,0,0,24,26,13,63
2024-03-29 23:00:00,1,1,31,25,16,74
2024-03-29 23:10:00,1,0,23,22,7,53
2024-03-29 23:20:00,0,0,24,18,12,54
2024-03-29 23:30:00,0,0,23,21,13,57
2024-03-29 23:40:00,0,0,23,17,5,45
2024-03-29 23:50:00,1,0,10,19,3,33
2024-03-30 00:00:00,0,0,11,17,7,35
2024-03-30 00:10:00,1,0,20,13,6,40
2024-03-30 00:20:00,0,0,11,18,8,37
2024-03-30 00:30:00,0,0,18,11,8,37
2024-03-30 00:40:00,1,0,17,14,5,37
2024-03-30 00:50:00,0,0,11,14,3,28
2024-03-30 01:00:00,0,0,22,7,12,41
2024-03-30 01:10:00,0,0,10,14,4,28
2024-03-30 01:20:00,0,0,14,11,9,34
2024-03-30 01:30:00,0,0,12,4,7,23
2024-03-30 01:40:00,0,0,11,7,3,21
2024-03-30 01:50:00,1,0,8,8,4,21
2024-03-30 02:00:00,0,0,9,9,6,24
2024-03-30 02:10:00,0,0,7,4,3,14
2024-03-30 02:20:00,0,0,7,5,3,15
2024-03-30 02:30:00,0,0,9,5,4,18
2024-03-30 02:40:00,0,0,14,6,8,28
2024-03-30 02:50:00,0,0,8,6,6,20
2024-03-30 03:00:00,1,0,3,2,1,7
2024-03-30 03:10:00,0,0,7,6,3,16
2024-03-30 03:20:00,0,0,9,5,5,19
2024-03-30 03:30:00,1,0,9,5,4,19
2024-03-30 03:40:00,0,0,8,6,2,16
2024-03-30 03:50:00,0,0,12,8,6,26
2024-03-30 04:00:00,0,0,5,4,2,11
2024-03-30 04:10:00,0,0,3,2,1,6
2024-03-30 04:20:00,0,1,8,8,4,21
2024-03-30 04:30:00,0,0,12,7,7,26
2024-03-30 04:40:00,0,0,12,12,7,31
2024-03-30 04:50:00,1,0,14,9,5,29
2024-03-30 05:00:00,0,0,11,24,3,38
2024-03-30 05:10:00,0,0,20,11,13,44
2024-03-30 05:20:00,1,0,15,12,5,33
2024-03-30 05:30:00,0,0,17,12,6,35
2024-03-30 05:40:00,0,0,20,28,5,53
2024-03-30 05:50:00,0,0,20,16,8,44
2024-03-30 06:00:00,3,0,18,12,9,42
2024-03-30 06:10:00,2,0,14,19,5,40
2024-03-30 06:20:00,1,0,17,14,8,40
2024-03-30 06:30:00,1,0,23,16,14,54
2024-03-30 06:40:00,0,0,31,19,13,63
2024-03-30 06:50:00,1,0,44,17,13,75
2024-03-30 07:00:00,2,0,36,11,15,64
2024-03-30 07:10:00,0,0,51,29,22,102
2024-03-30 07:20:00,0,0,39,27,14,80
2024-03-30 07:30:00,0,0,41,34,19,94
2024-03-30 07:40:00,1,0,64,41,13,119
2024-03-30 07:50:00,1,0,66,44,15,126
2024-03-30 08:00:00,2,0,55,47,16,120
2024-03-30 08:10:00,0,0,80,50,21,151
2024-03-30 08:20:00,0,1,54,51,15,121
2024-03-30 08:30:00,0,0,63,61,18,142
2024-03-30 08:40:00,0,0,93,73,13,179
2024-03-30 08:50:00,0,0,97,64,29,190
2024-03-30 09:00:00,2,0,86,80,21,189
2024-03-30 09:10:00,1,0,93,89,26,209
2024-03-30 09:20:00,0,0,90,98,21,209
2024-03-30 09:30:00,1,0,87,113,20,221
2024-03-30 09:40:00,6,1,110,123,28,268
2024-03-30 09:50:00,2,0,115,115,21,253
2024-03-30 10:00:00,0,0,103,102,15,220
2024-03-30 10:10:00,1,0,118,124,36,279
2024-03-30 10:20:00,3,0,133,126,23,285
2024-03-30 10:30:00,3,1,138,120,28,290
2024-03-30 10:40:00,1,0,145,140,10,296
2024-03-30 10:50:00,0,0,141,110,21,272
2024-03-30 11:00:00,3,0,117,125,15,260
2024-03-30 11:10:00,1,0,122,148,23,294
2024-03-30 11:20:00,0,1,130,145,25,301
2024-03-30 11:30:00,1,1,126,112,20,260
2024-03-30 11:40:00,2,1,139,140,20,302
2024-03-30 11:50:00,1,0,107,133,18,259
2024-03-30 12:00:00,1,1,107,136,11,256
2024-03-30 12:10:00,1,0,139,124,20,284
2024-03-30 12:20:00,5,0,107,141,14,267
2024-03-30 12:30:00,1,1,116,115,19,252
2024-03-30 12:40:00,0,0,131,133,30,294
2024-03-30 12:50:00,4,0,130,136,18,288
2024-03-30 13:00:00,3,0,121,121,30,275
2024-03-30 13:10:00,2,0,111,124,24,261
2024-03-30 13:20:00,2,1,102,117,14,236
2024-03-30 13:30:00,0,0,109,125,25,259
2024-03-30 13:40:00,0,1,137,115,16,269
2024-03-30 13:50:00,0,0,125,114,29,268
2024-03-30 14:00:00,0,1,117,129,20,267
2024-03-30 14:10:00,3,1,128,113,17,262
2024-03-30 14:20:00,3,0,121,123,21,268
2024-03-30 14:30:00,0,0,115,99,19,233
2024-03-30 14:40:00,1,0,100,107,26,234
2024-03-30 14:50:00,0,0,95,94,26,215
2024-03-30 15:00:00,2,2,84,103,22,213
2024-03-30 15:10:00,1,1,118,117,18,255
2024-03-30 15:20:00,0,0,94,112,24,230
2024-03-30 15:30:00,0,0,112,101,19,232
2024-03-30 15:40:00,2,0,109,94,28,233
2024-03-30 15:50:00,0,4,119,99,23,245
2024-03-30 16:00:00,2,1,112,106,18,239
2024-03-30 16:10:00,1,1,119,102,23,246
2024-03-30 16:20:00,3,0,117,71,23,214
2024-03-30 16:30:00,2,1,95,98,14,210
2024-03-30 16:40:00,5,2,103,106,17,233
2024-03-30 16:50:00,1,1,89,107,16,214
2024-03-30 17:00:00,5,1,100,94,21,221
2024-03-30 17:10:00,2,1,108,100,26,237
2024-03-30 17:20:00,1,0,94,97,16,208
2024-03-30 17:30:00,4,0,107,107,30,248
2024-03-30 17:40:00,1,0,98,95,24,218
2024-03-30 17:50:00,2,1,93,92,30,218
2024-03-30 18:00:00,1,0,90,85,26,202
2024-03-30 18:10:00,0,0,92,106,23,221
2024-03-30 18:20:00,2,0,92,88,25,207
2024-03-30 18:30:00,5,1,91,81,21,199
2024-03-30 18:40:00,0,0,74,82,21,177
2024-03-30 18:50:00,0,0,74,100,25,199
2024-03-30 19:00:00,2,1,88,88,22,201
2024-03-30 19:10:00,3,0,67,74,23,167
2024-03-30 19:20:00,4,0,67,90,21,182
2024-03-30 19:30:00,0,0,73,67,19,159
2024-03-30 19:40:00,1,0,76,70,24,171
2024-03-30 19:50:00,1,0,62,65,15,143
2024-03-30 20:00:00,0,1,62,60,18,141
2024-03-30 20:10:00,0,0,67,64,34,165
2024-03-30 20:20:00,1,0,60,64,14,139
2024-03-30 20:30:00,0,1,63,82,23,169
2024-03-30 20:40:00,2,1,61,59,25,148
2024-03-30 20:50:00,1,1,37,46,16,101
2024-03-30 21:00:00,0,0,40,52,14,106
2024-03-30 21:10:00,1,0,50,42,19,112
2024-03-30 21:20:00,0,0,54,37,33,124
2024-03-30 21:30:00,1,1,51,41,19,113
2024-03-30 21:40:00,0,0,30,51,13,94
2024-03-30 21:50:00,1,0,42,47,16,106
2024-03-30 22:00:00,0,0,38,47,17,102
2024-03-30 22:10:00,0,0,42,31,19,92
2024-03-30 22:20:00,0,0,42,32,20,94
2024-03-30 22:30:00,0,0,33,22,16,71
2024-03-30 22:40:00,1,1,28,22,13,65
2024-03-30 22:50:00,1,0,35,26,16,78
2024-03-30 23:00:00,0,2,35,36,16,89
2024-03-30 23:10:00,1,0,46,28,15,90
2024-03-30 23:20:00,1,2,30,24,11,68
2024-03-30 23:30:00,0,1,21,23,6,51
2024-03-30 23:40:00,1,0,32,19,15,67
2024-03-30 23:50:00,1,1,31,24,9,66
2024-03-31 00:00:00,1,0,25,19,12,57
2024-03-31 00:10:00,0,0,12,9,5,26
2024-03-31 00:20:00,0,1,18,13,9,41
2024-03-31 00:30:00,0,2,16,10,8,36
2024-03-31 00:40:00,2,0,22,15,11,50
2024-03-31 00:50:00,0,1,22,17,15,55
2024-03-31 01:00:00,0,0,17,17,4,38
2024-03-31 01:10:00,0,1,16,13,5,35
2024-03-31 01:20:00,0,3,12,8,5,28
2024-03-31 01:30:00,0,0,12,6,4,22
2024-03-31 01:40:00,0,0,7,9,2,18
2024-03-31 01:50:00,0,0,11,6,5,22
2024-03-31 02:00:00,0,0,0,0,0,0
2024-03-31 02:10:00,0,0,0,0,0,0
2024-03-31 02:20:00,0,0,0,0,0,0
2024-03-31 02:30:00,0,0,0,0,0,0
2024-03-31 02:40:00,0,0,0,0,0,0
2024-03-31 02:50:00,0,0,0,0,0,0
2024-03-31 03:00:00,1,0,15,6,12,34
2024-03-31 03:10:00,2,0,11,13,2,28
2024-03-31 03:20:00,0,0,17,6,6,29
2024-03-31 03:30:00,0,0,14,2,10,26
2024-03-31 03:40:00,1,1,16,11,7,36
2024-03-31 03:50:00,0,0,10,8,3,21
2024-03-31 04:00:00,0,0,16,12,9,37
2024-03-31 04:10:00,0,0,18,7,12,37
2024-03-31 04:20:00,0,0,10,5,7,22
2024-03-31 04:30:00,0,0,8,8,4,20
2024-03-31 04:40:00,0,0,11,9,4,24
2024-03-31 04:50:00,0,0,9,11,2,22
2024-03-31 05:00:00,0,0,9,12,5,26
2024-03-31 05:10:00,0,0,12,7,7,26
2024-03-31 05:20:00,0,0,17,12,3,32
2024-03-31 05:30:00,0,2,16,8,8,34
2024-03-31 05:40:00,0,0,10,10,3,23
2024-03-31 05:50:00,0,0,14,14,5,33
2024-03-31 06:00:00,1,0,11,12,10,34
2024-03-31 06:10:00,1,1,13,10,10,35
2024-03-31 06:20:00,0,0,8,7,4,19
2024-03-31 06:30:00,0,0,6,5,5,16
2024-03-31 06:40:00,0,0,17,7,10,34
2024-03-31 06:50:00,1,0,16,7,5,29
2024-03-31 07:00:00,0,0,8,8,5,21
2024-03-31 07:10:00,1,0,5,7,3,16
2024-03-31 07:20:00,2,0,10,4,6,22
2024-03-31 07:30:00,3,0,9,7,3,22
2024-03-31 07:40:00,1,0,7,11,5,24
2024-03-31 07:50:00,0,0,12,12,5,29
2024-03-31 08:00:00,2,0,10,5,4,21
2024-03-31 08:10:00,0,0,7,8,2,17
2024-03-31 08:20:00,0,0,9,11,3,23
2024-03-31 08:30:00,1,0,16,14,8,39
2024-03-31 08:40:00,0,0,24,14,8,46
2024-03-31 08:50:00,0,0,15,23,11,49
2024-03-31 09:00:00,0,0,26,25,10,61
2024-03-31 09:10:00,0,0,22,21,12,55
2024-03-31 09:20:00,1,0,29,37,10,77
2024-03-31 09:30:00,0,0,33,40,16,89
2024-03-31 09:40:00,4,0,27,43,10,84
2024-03-31 09:50:00,3,0,35,34,16,88
2024-03-31 10:00:00,0,0,49,46,23,118
2024-03-31 10:10:00,3,1,44,36,13,97
2024-03-31 10:20:00,2,0,37,38,11,88
2024-03-31 10:30:00,0,1,35,50,10,96
2024-03-31 10:40:00,4,0,51,53,16,124
2024-03-31 10:50:00,1,0,66,39,16,122
2024-03-31 11:00:00,1,0,52,45,20,118
2024-03-31 11:10:00,1,0,54,58,17,130
2024-03-31 11:20:00,2,0,66,49,12,129
2024-03-31 11:30:00,2,0,64,68,19,153
2024-03-31 11:40:00,1,0,60,68,26,155
2024-03-31 11:50:00,0,0,74,52,23,149
2024-03-31 12:00:00,3,0,68,59,17,147
2024-03-31 12:10:00,0,0,56,68,22,146
2024-03-31 12:20:00,0,0,53,73,10,136
2024-03-31 12:30:00,3,1,64,62,12,142
2024-03-31 12:40:00,0,0,76,56,29,161
2024-03-31 12:50:00,0,0,69,73,23,165
2024-03-31 13:00:00,1,0,66,57,25,149
2024-03-31 13:10:00,1,0,63,61,22,147
2024-03-31 13:20:00,2,0,68,58,24,152
2024-03-31 13:30:00,5,1,73,72,16,167
2024-03-31 13:40:00,3,0,78,72,22,175
2024-03-31 13:50:00,0,0,50,71,15,136
2024-03-31 14:00:00,0,1,81,63,27,172
2024-03-31 14:10:00,1,0,69,56,18,144
2024-03-31 14:20:00,1,0,69,61,12,143
2024-03-31 14:30:00,1,0,66,76,13,156
2024-03-31 14:40:00,1,0,88,74,23,186
2024-03-31 14:50:00,0,0,77,73,22,172
2024-03-31 15:00:00,0,0,86,74,36,196
2024-03-31 15:10:00,2,1,76,65,21,165
2024-03-31 15:20:00,3,0,66,55,17,141
2024-03-31 15:30:00,0,0,57,55,12,124
2024-03-31 15:40:00,1,0,54,69,14,138
2024-03-31 15:50:00,2,0,63,45,19,129
2024-03-31 16:00:00,2,0,71,61,17,151
2024-03-31 16:10:00,0,0,61,87,16,164
2024-03-31 16:20:00,1,1,51,74,15,142
2024-03-31 16:30:00,1,0,48,64,17,130
2024-03-31 16:40:00,2,0,81,76,22,181
2024-03-31 16:50:00,2,0,56,77,16,151
2024-03-31 17:00:00,0,0,60,64,11,135
2024-03-31 17:10:00,1,0,67,84,16,168
2024-03-31 17:20:00,2,1,64,85,14,166
2024-03-31 17:30:00,2,0,62,75,15,154
2024-03-31 17:40:00,1,0,77,69,15,162
2024-03-31 17:50:00,0,0,81,72,19,172
2024-03-31 18:00:00,0,0,61,81,12,154
2024-03-31 18:10:00,0,0,66,59,23,148
2024-03-31 18:20:00,5,0,55,63,11,134
2024-03-31 18:30:00,4,0,59,61,14,138
2024-03-31 18:40:00,2,1,63,66,26,158
2024-03-31 18:50:00,0,1,62,40,27,130
2024-03-31 19:00:00,0,0,71,74,12,157
2024-03-31 19:10:00,2,0,72,58,27,159
2024-03-31 19:20:00,0,0,57,56,19,132
2024-03-31 19:30:00,0,1,57,61,18,137
2024-03-31 19:40:00,0,0,63,64,15,142
2024-03-31 19:50:00,2,0,64,58,17,141
2024-03-31 20:00:00,3,0,46,52,20,121
2024-03-31 20:10:00,1,0,39,41,5,86
2024-03-31 20:20:00,0,0,47,37,17,101
2024-03-31 20:30:00,0,1,41,37,7,86
2024-03-31 20:40:00,0,1,34,49,10,94
2024-03-31 20:50:00,0,1,37,37,13,88
2024-03-31 21:00:00,0,0,52,39,22,113
2024-03-31 21:10:00,0,0,40,51,14,105
2024-03-31 21:20:00,1,0,42,29,16,88
2024-03-31 21:30:00,1,0,41,37,20,99
2024-03-31 21:40:00,0,0,50,23,21,94
2024-03-31 21:50:00,0,0,34,45,16,95
2024-03-31 22:00:00,0,0,26,28,11,65
2024-03-31 22:10:00,1,0,30,24,18,73
2024-03-31 22:20:00,0,0,37,27,18,82
2024-03-31 22:30:00,0,0,27,35,8,70
2024-03-31 22:40:00,1,0,23,37,10,71
2024-03-31 22:50:00,2,0,30,20,13,65
2024-03-31 23:00:00,0,0,27,21,14,62
2024-03-31 23:10:00,0,0,37,22,14,73
2024-03-31 23:20:00,0,1,29,13,10,53
2024-03-31 23:30:00,1,0,28,25,6,60
2024-03-31 23:40:00,0,0,15,14,6,35
2024-03-31 23:50:00,0,0,19,17,10,46
2024-04-01 00:00:00,0,0,20,20,5,45
2024-04-01 00:10:00,0,0,12,12,5,29
2024-04-01 00:20:00,1,0,11,12,6,30
2024-04-01 00:30:00,0,0,11,14,7,32
2024-04-01 00:40:00,1,0,21,18,6,46
2024-04-01 00:50:00,0,0,15,8,4,27
2024-04-01 01:00:00,1,0,12,9,4,26
2024-04-01 01:10:00,0,0,12,8,2,22
2024-04-01 01:20:00,1,0,9,11,5,26
2024-04-01 01:30:00,0,0,12,9,4,25
2024-04-01 01:40:00,0,0,13,11,7,31
2024-04-01 01:50:00,0,0,10,5,4,19
2024-04-01 02:00:00,0,0,14,17,4,35
2024-04-01 02:10:00,0,0,12,8,8,28
2024-04-01 02:20:00,0,0,10,8,5,23
2024-04-01 02:30:00,0,0,3,8,0,11
2024-04-01 02:40:00,0,0,8,5,4,17
2024-04-01 02:50:00,0,0,15,4,4,23
2024-04-01 03:00:00,0,0,8,8,4,20
2024-04-01 03:10:00,0,0,5,1,4,10
2024-04-01 03:20:00,0,0,8,4,6,18
2024-04-01 03:30:00,0,0,4,3,3,10
2024-04-01 03:40:00,0,0,6,3,4,13
2024-04-01 03:50:00,0,0,6,4,2,12
2024-04-01 04:00:00,0,0,5,7,3,15
2024-04-01 04:10:00,0,0,2,3,3,8
2024-04-01 04:20:00,0,0,4,5,0,9
2024-04-01 04:30:00,0,0,6,6,4,16
2024-04-01 04:40:00,0,0,6,5,4,15
2024-04-01 04:50:00,0,0,5,5,3,13
2024-04-01 05:00:00,0,0,7,9,4,20
2024-04-01 05:10:00,0,0,9,16,1,26
2024-04-01 05:20:00,0,0,13,13,8,34
2024-04-01 05:30:00,0,0,9,15,6,30
2024-04-01 05:40:00,0,0,16,13,7,36
2024-04-01 05:50:00,2,0,12,8,7,29
2024-04-01 06:00:00,1,0,8,9,3,21
2024-04-01 06:10:00,1,0,8,5,7,21
2024-04-01 06:20:00,0,0,10,9,8,27
2024-04-01 06:30:00,0,0,11,7,6,24
2024-04-01 06:40:00,0,0,13,9,6,28
2024-04-01 06:50:00,0,0,10,7,7,24
2024-04-01 07:00:00,0,0,7,6,4,17
2024-04-01 07:10:00,1,0,6,6,1,14
2024-04-01 07:20:00,0,0,8,5,3,16
2024-04-01 07:30:00,0,0,4,9,1,14
2024-04-01 07:40:00,0,0,13,13,6,32
2024-04-01 07:50:00,1,0,10,10,3,24
2024-04-01 08:00:00,0,0,5,6,1,12
2024-04-01 08:10:00,0,0,8,8,4,20
2024-04-01 08:20:00,1,0,10,11,3,25
2024-04-01 08:30:00,0,0,15,18,6,39
2024-04-01 08:40:00,1,0,17,13,2,33
2024-04-01 08:50:00,1,0,14,19,8,42
2024-04-01 09:00:00,1,0,13,15,4,33
2024-04-01 09:10:00,0,2,17,21,4,44
2024-04-01 09:20:00,2,1,22,27,10,62
2024-04-01 09:30:00,0,0,19,23,10,52
2024-04-01 09:40:00,7,0,27,26,6,66
2024-04-01 09:50:00,0,0,16,22,5,43
2024-04-01 10:00:00,0,0,29,25,9,63
2024-04-01 10:10:00,0,0,34,26,10,70
2024-04-01 10:20:00,1,1,29,33,9,73
2024-04-01 10:30:00,0,0,31,29,7,67
2024-04-01 10:40:00,0,0,37,23,9,69
2024-04-01 10:50:00,2,0,46,45,14,107
2024-04-01 11:00:00,0,0,48,41,14,103
2024-04-01 11:10:00,0,0,42,53,11,106
2024-04-01 11:20:00,0,0,38,52,13,103
2024-04-01 11:30:00,2,0,53,55,12,122
2024-04-01 11:40:00,1,0,57,59,12,129
2024-04-01 11:50:00,1,0,54,70,13,138
2024-04-01 12:00:00,0,0,60,52,12,124
2024-04-01 12:10:00,3,0,58,69,15,145
2024-04-01 12:20:00,2,0,52,46,16,116
2024-04-01 12:30:00,1,0,53,47,17,118
2024-04-01 12:40:00,2,0,52,71,11,136
2024-04-01 12:50:00,1,0,53,53,15,122
2024-04-01 13:00:00,3,0,67,58,15,143
2024-04-01 13:10:00,4,0,59,63,11,137
2024-04-01 13:20:00,2,0,51,57,18,128
2024-04-01 13:30:00,0,0,54,49,10,113
2024-04-01 13:40:00,0,0,50,73,12,135
2024-04-01 13:50:00,0,0,69,67,15,151
2024-04-01 14:00:00,0,1,86,66,16,169
2024-04-01 14:10:00,0,0,88,63,18,169
2024-04-01 14:20:00,4,1,74,61,19,159
2024-04-01 14:30:00,0,0,56,79,17,152
2024-04-01 14:40:00,2,0,66,64,16,148
2024-04-01 14:50:00,1,0,71,72,25,169
2024-04-01 15:00:00,3,3,63,74,16,159
2024-04-01 15:10:00,1,0,63,80,13,157
2024-04-01 15:20:00,2,0,65,62,9,138
2024-04-01 15:30:00,2,2,68,48,12,132
2024-04-01 15:40:00,2,1,69,68,13,153
2024-04-01 15:50:00,3,0,68,60,17,148
2024-04-01 16:00:00,2,0,55,57,9,123
2024-04-01 16:10:00,1,0,69,71,26,167
2024-04-01 16:20:00,2,0,70,70,20,162
2024-04-01 16:30:00,0,0,73,75,21,169
2024-04-01 16:40:00,1,1,72,62,17,153
2024-04-01 16:50:00,1,0,72,82,14,169
2024-04-01 17:00:00,2,0,69,60,12,143
2024-04-01 17:10:00,0,1,76,72,20,169
2024-04-01 17:20:00,1,1,79,79,20,180
2024-04-01 17:30:00,1,2,62,66,22,153
2024-04-01 17:40:00,2,0,72,78,25,177
2024-04-01 17:50:00,4,0,70,75,14,163
2024-04-01 18:00:00,3,0,49,75,13,140
2024-04-01 18:10:00,3,0,71,78,21,173
2024-04-01 18:20:00,1,0,46,74,12,133
2024-04-01 18:30:00,0,0,62,57,12,131
2024-04-01 18:40:00,2,0,58,58,21,139
2024-04-01 18:50:00,3,0,68,58,19,148
2024-04-01 19:00:00,0,0,58,71,11,140
2024-04-01 19:10:00,2,0,66,76,21,165
2024-04-01 19:20:00,2,0,71,65,13,151
2024-04-01 19:30:00,0,0,61,72,12,145
2024-04-01 19:40:00,1,0,47,56,15,119
2024-04-01 19:50:00,1,0,63,73,22,159
2024-04-01 20:00:00,3,0,52,58,11,124
2024-04-01 20:10:00,1,0,48,47,19,115
2024-04-01 20:20:00,4,0,40,40,10,94
2024-04-01 20:30:00,1,0,44,40,13,98
2024-04-01 20:40:00,1,1,37,33,8,80
2024-04-01 20:50:00,0,0,46,37,21,104
2024-04-01 21:00:00,1,0,42,48,10,101
2024-04-01 21:10:00,0,0,43,29,20,92
2024-04-01 21:20:00,3,0,38,35,13,89
2024-04-01 21:30:00,0,0,50,35,15,100
2024-04-01 21:40:00,0,0,47,28,21,96
2024-04-01 21:50:00,0,0,29,32,11,72
2024-04-01 22:00:00,0,0,35,30,18,83
2024-04-01 22:10:00,1,0,37,27,17,82
2024-04-01 22:20:00,0,0,39,29,12,80
2024-04-01 22:30:00,1,0,23,24,12,60
2024-04-01 22:40:00,2,0,27,20,12,61
2024-04-01 22:50:00,0,0,30,26,14,70
2024-04-01 23:00:00,1,0,23,16,11,51
2024-04-01 23:10:00,0,0,26,16,11,53
2024-04-01 23:20:00,1,0,25,20,10,56
2024-04-01 23:30:00,1,0,18,15,4,38
2024-04-01 23:40:00,1,0,26,20,7,54
2024-04-01 23:50:00,1,0,20,18,7,46
2024-04-02 00:00:00,0,0,15,15,7,37
2024-04-02 00:10:00,0,0,14,5,6,25
2024-04-02 00:20:00,0,0,14,8,5,27
2024-04-02 00:30:00,1,0,17,9,8,35
2024-04-02 00:40:00,0,0,12,9,3,24
2024-04-02 00:50:00,0,0,12,7,8,27
2024-04-02 01:00:00,1,0,9,6,8,24
2024-04-02 01:10:00,1,0,10,11,3,25
2024-04-02 01:20:00,0,0,12,5,6,23
2024-04-02 01:30:00,0,0,4,3,2,9
2024-04-02 01:40:00,1,0,10,5,4,20
2024-04-02 01:50:00,0,0,5,0,3,8
2024-04-02 02:00:00,0,0,11,5,3,19
2024-04-02 02:10:00,0,0,4,6,4,14
2024-04-02 02:20:00,0,0,6,5,3,14
2024-04-02 02:30:00,0,0,9,8,3,20
2024-04-02 02:40:00,0,0,6,5,5,16
2024-04-02 02:50:00,0,0,6,4,3,13
2024-04-02 03:00:00,1,0,6,4,3,14
2024-04-02 03:10:00,0,0,7,3,5,15
2024-04-02 03:20:00,0,0,7,4,3,14
2024-04-02 03:30:00,1,0,5,4,2,12
2024-04-02 03:40:00,1,1,7,2,5,16
2024-04-02 03:50:00,2,0,8,5,3,18
2024-04-02 04:00:00,0,0,10,8,5,23
2024-04-02 04:10:00,0,0,6,7,2,15
2024-04-02 04:20:00,0,0,13,7,9,29
2024-04-02 04:30:00,0,0,14,8,8,30
2024-04-02 04:40:00,0,0,17,15,3,35
2024-04-02 04:50:00,0,0,20,21,10,51
2024-04-02 05:00:00,0,0,26,26,11,63
2024-04-02 05:10:00,1,2,24,28,5,60
2024-04-02 05:20:00,1,0,30,38,14,83
2024-04-02 05:30:00,0,0,44,58,13,115
2024-04-02 05:40:00,1,0,55,58,18,132
2024-04-02 05:50:00,1,0,40,55,13,109
2024-04-02 06:00:00,2,0,43,48,15,108
2024-04-02 06:10:00,0,0,68,57,18,143
2024-04-02 06:20:00,3,0,67,67,16,153
2024-04-02 06:30:00,1,0,67,88,17,173
2024-04-02 06:40:00,3,0,91,79,18,191
2024-04-02 06:50:00,0,0,90,79,21,190
2024-04-02 07:00:00,5,1,95,90,27,218
2024-04-02 07:10:00,1,0,75,110,20,206
2024-04-02 07:20:00,1,0,125,96,25,247
2024-04-02 07:30:00,3,0,96,121,21,241
2024-04-02 07:40:00,1,0,97,108,16,222
2024-04-02 07:50:00,0,0,127,112,23,262
2024-04-02 08:00:00,3,1,93,89,17,203
2024-04-02 08:10:00,5,1,94,98,16,214
2024-04-02 08:20:00,5,0,105,109,16,235
2024-04-02 08:30:00,1,1,113,115,25,255
2024-04-02 08:40:00,1,1,82,113,17,214
2024-04-02 08:50:00,0,0,109,90,29,228
2024-04-02 09:00:00,2,1,109,93,15,220
2024-04-02 09:10:00,2,1,83,101,22,209
2024-04-02 09:20:00,2,0,96,102,15,215
2024-04-02 09:30:00,3,0,95,86,29,213
2024-04-02 09:40:00,7,1,90,97,14,209
2024-04-02 09:50:00,3,0,107,97,27,234
2024-04-02 10:00:00,2,1,130,77,25,235
2024-04-02 10:10:00,3,0,110,87,23,223
2024-04-02 10:20:00,4,0,118,127,28,277
2024-04-02 10:30:00,3,0,100,116,25,244
2024-04-02 10:40:00,3,0,109,121,16,249
2024-04-02 10:50:00,5,0,115,114,24,258
2024-04-02 11:00:00,2,0,111,105,20,238
2024-04-02 11:10:00,2,0,107,108,20,237
2024-04-02 11:20:00,4,1,130,81,24,240
2024-04-02 11:30:00,4,3,123,128,20,278
2024-04-02 11:40:00,2,3,107,93,14,219
2024-04-02 11:50:00,2,0,106,101,15,224
2024-04-02 12:00:00,3,0,123,118,22,266
2024-04-02 12:10:00,5,0,96,107,19,227
2024-04-02 12:20:00,4,0,123,110,37,274
2024-04-02 12:30:00,3,0,109,118,26,256
2024-04-02 12:40:00,3,1,117,106,21,248
2024-04-02 12:50:00,0,0,115,116,18,249
2024-04-02 13:00:00,4,0,123,99,20,246
2024-04-02 13:10:00,2,0,125,90,19,236
2024-04-02 13:20:00,8,2,135,136,15,296
2024-04-02 13:30:00,4,0,132,105,21,262
2024-04-02 13:40:00,2,2,117,96,13,230
2024-04-02 13:50:00,4,0,121,130,21,276
2024-04-02 14:00:00,3,0,110,99,23,235
2024-04-02 14:10:00,4,0,125,122,11,262
2024-04-02 14:20:00,5,2,107,130,15,259
2024-04-02 14:30:00,2,0,136,121,31,290
2024-04-02 14:40:00,3,1,134,108,11,257
2024-04-02 14:50:00,5,1,152,145,9,312
2024-04-02 15:00:00,5,0,135,124,17,281
2024-04-02 15:10:00,6,0,129,128,13,276
2024-04-02 15:20:00,3,0,123,134,17,277
2024-04-02 15:30:00,5,0,127,126,20,278
2024-04-02 15:40:00,6,0,145,139,5,295
2024-04-02 15:50:00,2,0,146,155,5,308
2024-04-02 16:00:00,4,0,137,128,18,287
2024-04-02 16:10:00,9,2,155,147,10,323
2024-04-02 16:20:00,10,0,149,157,18,334
2024-04-02 16:30:00,10,0,161,145,9,325
2024-04-02 16:40:00,4,0,160,135,12,311
2024-04-02 16:50:00,7,0,139,122,16,284
2024-04-02 17:00:00,9,0,136,130,17,292
2024-04-02 17:10:00,9,0,132,136,12,289
2024-04-02 17:20:00,3,1,151,142,7,304
2024-04-02 17:30:00,4,0,132,133,16,285
2024-04-02 17:40:00,5,0,131,133,11,280
2024-04-02 17:50:00,1,0,132,109,25,267
2024-04-02 18:00:00,4,0,124,105,25,258
2024-04-02 18:10:00,6,2,104,117,28,257
2024-04-02 18:20:00,2,0,124,119,21,266
2024-04-02 18:30:00,1,0,124,107,23,255
2024-04-02 18:40:00,6,0,110,107,21,244
2024-04-02 18:50:00,2,0,89,117,28,236
2024-04-02 19:00:00,5,0,92,85,19,201
2024-04-02 19:10:00,2,0,85,99,35,221
2024-04-02 19:20:00,1,0,86,74,29,190
2024-04-02 19:30:00,6,1,72,98,21,198
2024-04-02 19:40:00,0,0,82,67,21,170
2024-04-02 19:50:00,2,1,70,59,16,148
2024-04-02 20:00:00,0,0,59,66,21,146
2024-04-02 20:10:00,0,1,59,68,17,145
2024-04-02 20:20:00,3,0,61,59,15,138
2024-04-02 20:30:00,0,0,46,49,20,115
2024-04-02 20:40:00,1,1,46,59,14,121
2024-04-02 20:50:00,1,0,45,56,18,120
2024-04-02 21:00:00,0,0,59,49,18,126
2024-04-02 21:10:00,0,0,37,47,14,98
2024-04-02 21:20:00,0,0,57,52,23,132
2024-04-02 21:30:00,0,0,37,39,9,85
2024-04-02 21:40:00,2,0,46,35,23,106
2024-04-02 21:50:00,0,0,40,47,15,102
2024-04-02 22:00:00,1,0,23,26,11,61
2024-04-02 22:10:00,2,0,38,29,8,77
2024-04-02 22:20:00,2,0,45,22,15,84
2024-04-02 22:30:00,1,0,32,30,13,76
2024-04-02 22:40:00,2,2,23,23,9,59
2024-04-02 22:50:00,0,0,29,28,12,69
2024-04-02 23:00:00,0,0,29,19,10,58
2024-04-02 23:10:00,1,0,33,17,13,64
2024-04-02 23:20:00,1,0,19,18,11,49
2024-04-02 23:30:00,0,0,14,20,6,40
2024-04-02 23:40:00,0,0,24,19,11,54
2024-04-02 23:50:00,0,0,11,10,6,27
2024-04-03 00:00:00,1,0,15,9,5,30
2024-04-03 00:10:00,0,0,14,10,5,29
2024-04-03 00:20:00,0,0,13,11,5,29
2024-04-03 00:30:00,1,0,6,4,4,15
2024-04-03 00:40:00,0,0,16,4,5,25
2024-04-03 00:50:00,0,0,7,4,4,15
2024-04-03 01:00:00,0,1,8,8,2,19
2024-04-03 01:10:00,0,0,11,7,7,25
2024-04-03 01:20:00,0,0,10,4,5,19
2024-04-03 01:30:00,0,0,11,6,5,22
2024-04-03 01:40:00,0,0,4,6,3,13
2024-04-03 01:50:00,0,0,9,7,5,21
2024-04-03 02:00:00,0,0,5,5,4,14
2024-04-03 02:10:00,0,0,6,3,4,13
2024-04-03 02:20:00,1,0,11,5,8,25
2024-04-03 02:30:00,1,0,7,7,3,18
2024-04-03 02:40:00,0,0,7,4,4,15
2024-04-03 02:50:00,0,0,6,6,3,15
2024-04-03 03:00:00,0,0,7,6,3,16
2024-04-03 03:10:00,0,0,8,4,4,16
2024-04-03 03:20:00,0,0,8,3,4,15
2024-04-03 03:30:00,1,0,5,1,3,10
2024-04-03 03:40:00,1,0,9,6,1,17
2024-04-03 03:50:00,0,0,4,6,3,13
2024-04-03 04:00:00,0,0,9,5,5,19
2024-04-03 04:10:00,1,0,9,8,4,22
2024-04-03 04:20:00,0,0,9,9,3,21
2024-04-03 04:30:00,0,0,15,12,7,34
2024-04-03 04:40:00,0,0,14,13,3,30
2024-04-03 04:50:00,0,0,16,16,9,41
2024-04-03 05:00:00,0,0,22,31,8,61
2024-04-03 05:10:00,0,0,20,29,11,60
2024-04-03 05:20:00,0,0,32,37,12,81
2024-04-03 05:30:00,1,0,43,61,13,118
2024-04-03 05:40:00,1,0,45,61,22,129
2024-04-03 05:50:00,0,0,37,55,9,101
2024-04-03 06:00:00,2,0,42,56,15,115
2024-04-03 06:10:00,4,0,57,61,12,134
2024-04-03 06:20:00,1,0,79,68,20,168
2024-04-03 06:30:00,2,0,70,95,15,182
2024-04-03 06:40:00,2,0,103,92,19,216
2024-04-03 06:50:00,1,0,85,66,19,171
2024-04-03 07:00:00,0,0,87,79,25,191
2024-04-03 07:10:00,2,0,94,116,22,234
2024-04-03 07:20:00,2,0,84,90,25,201
2024-04-03 07:30:00,4,0,85,98,18,205
2024-04-03 07:40:00,3,0,94,121,11,229
2024-04-03 07:50:00,1,0,131,98,22,252
2024-04-03 08:00:00,3,3,103,104,21,234
2024-04-03 08:10:00,1,0,88,102,23,214
2024-04-03 08:20:00,4,0,93,116,12,225
2024-04-03 08:30:00,4,2,85,95,14,200
2024-04-03 08:40:00,1,0,89,89,18,197
2024-04-03 08:50:00,1,0,98,98,27,224
2024-04-03 09:00:00,3,0,96,81,24,204
2024-04-03 09:10:00,4,0,105,108,16,233
2024-04-03 09:20:00,6,0,95,90,20,211
2024-04-03 09:30:00,4,0,82,103,19,208
2024-04-03 09:40:00,8,0,105,107,8,228
2024-04-03 09:50:00,3,0,105,97,13,218
2024-04-03 10:00:00,1,0,112,96,20,229
2024-04-03 10:10:00,1,0,94,83,20,198
2024-04-03 10:20:00,2,0,109,101,21,233
2024-04-03 10:30:00,3,1,100,99,19,222
2024-04-03 10:40:00,1,0,94,103,18,216
2024-04-03 10:50:00,1,0,106,85,25,217
2024-04-03 11:00:00,2,0,120,107,20,249
2024-04-03 11:10:00,1,2,114,82,35,234
2024-04-03 11:20:00,2,0,95,91,16,204
2024-04-03 11:30:00,5,0,102,99,19,225
2024-04-03 11:40:00,4,0,103,111,20,238
2024-04-03 11:50:00,3,4,109,115,26,257
2024-04-03 12:00:00,0,0,107,102,25,234
2024-04-03 12:10:00,4,0,107,68,10,189
2024-04-03 12:20:00,5,0,141,133,21,300
2024-04-03 12:30:00,3,0,107,127,14,251
2024-04-03 12:40:00,1,0,99,86,18,204
2024-04-03 12:50:00,1,0,120,103,22,246
2024-04-03 13:00:00,2,0,103,107,17,229
2024-04-03 13:10:00,3,0,131,82,14,230
2024-04-03 13:20:00,4,0,125,119,17,265
2024-04-03 13:30:00,3,0,110,103,17,233
2024-04-03 13:40:00,0,0,113,106,21,240
2024-04-03 13:50:00,1,0,108,119,24,252
2024-04-03 14:00:00,2,0,106,113,25,246
2024-04-03 14:10:00,6,2,116,111,17,252
2024-04-03 14:20:00,5,1,112,121,13,252
2024-04-03 14:30:00,3,0,119,114,30,266
2024-04-03 14:40:00,4,0,117,124,10,255
2024-04-03 14:50:00,3,2,99,136,11,251
2024-04-03 15:00:00,2,2,114,133,10,261
2024-04-03 15:10:00,1,1,139,117,12,270
2024-04-03 15:20:00,2,0,133,129,22,286
2024-04-03 15:30:00,5,1,137,140,11,294
2024-04-03 15:40:00,4,2,134,152,23,315
2024-04-03 15:50:00,7,1,143,120,14,285
2024-04-03 16:00:00,3,0,140,125,20,288
2024-04-03 16:10:00,8,0,136,116,13,273
2024-04-03 16:20:00,8,0,135,144,15,302
2024-04-03 16:30:00,11,0,149,119,15,294
2024-04-03 16:40:00,9,0,152,132,11,304
2024-04-03 16:50:00,4,0,149,124,12,289
2024-04-03 17:00:00,3,0,131,143,14,291
2024-04-03 17:10:00,6,0,120,149,12,287
2024-04-03 17:20:00,6,0,134,144,10,294
2024-04-03 17:30:00,4,0,121,163,18,306
2024-04-03 17:40:00,9,0,105,131,14,259
2024-04-03 17:50:00,8,1,111,130,18,268
2024-04-03 18:00:00,12,3,124,101,14,254
2024-04-03 18:10:00,6,1,112,111,13,243
2024-04-03 18:20:00,5,1,106,122,17,251
2024-04-03 18:30:00,1,1,108,97,27,234
2024-04-03 18:40:00,1,0,91,104,22,218
2024-04-03 18:50:00,3,1,97,89,13,203
2024-04-03 19:00:00,2,0,83,81,18,184
2024-04-03 19:10:00,4,0,76,86,10,176
2024-04-03 19:20:00,5,0,74,72,21,172
2024-04-03 19:30:00,0,0,87,69,16,172
2024-04-03 19:40:00,1,1,89,67,12,170
2024-04-03 19:50:00,1,1,75,65,21,163
2024-04-03 20:00:00,1,1,60,66,17,145
2024-04-03 20:10:00,1,0,41,57,12,111
2024-04-03 20:20:00,0,2,60,50,22,134
2024-04-03 20:30:00,1,0,62,48,16,127
2024-04-03 20:40:00,1,0,49,37,19,106
2024-04-03 20:50:00,1,0,53,54,20,128
2024-04-03 21:00:00,0,0,59,54,24,137
2024-04-03 21:10:00,2,0,59,40,24,125
2024-04-03 21:20:00,0,0,61,45,13,119
2024-04-03 21:30:00,1,0,54,42,17,114
2024-04-03 21:40:00,2,0,44,38,18,102
2024-04-03 21:50:00,1,0,43,48,14,106
2024-04-03 22:00:00,1,0,42,32,22,97
2024-04-03 22:10:00,2,0,42,45,22,111
2024-04-03 22:20:00,2,0,39,32,13,86
2024-04-03 22:30:00,1,0,35,27,11,74
2024-04-03 22:40:00,2,0,22,37,8,69
2024-04-03 22:50:00,0,0,34,28,10,72
2024-04-03 23:00:00,0,2,33,31,12,78
2024-04-03 23:10:00,5,0,39,28,17,89
2024-04-03 23:20:00,0,0,24,15,16,55
2024-04-03 23:30:00,0,0,17,15,7,39
2024-04-03 23:40:00,0,0,17,11,8,36
2024-04-03 23:50:00,0,0,21,12,12,45
2024-04-04 00:00:00,0,0,21,9,14,44
2024-04-04 00:10:00,0,0,21,17,7,45
2024-04-04 00:20:00,0,0,25,10,9,44
2024-04-04 00:30:00,0,0,10,10,6,26
2024-04-04 00:40:00,1,0,11,10,7,29
2024-04-04 00:50:00,1,0,6,8,3,18
2024-04-04 01:00:00,0,0,5,7,2,14
2024-04-04 01:10:00,0,0,4,4,3,11
2024-04-04 01:20:00,0,0,5,7,2,14
2024-04-04 01:30:00,0,0,9,3,3,15
2024-04-04 01:40:00,0,0,11,6,4,21
2024-04-04 01:50:00,0,0,7,0,2,9
2024-04-04 02:00:00,0,0,8,3,3,14
2024-04-04 02:10:00,0,0,8,4,5,17
2024-04-04 02:20:00,0,0,5,4,4,13
2024-04-04 02:30:00,0,0,12,6,6,24
2024-04-04 02:40:00,0,0,6,0,2,8
2024-04-04 02:50:00,0,0,5,2,4,11
2024-04-04 03:00:00,0,0,13,8,6,27
2024-04-04 03:10:00,0,0,8,2,6,16
2024-04-04 03:20:00,0,0,8,4,6,18
2024-04-04 03:30:00,1,0,8,4,3,16
2024-04-04 03:40:00,0,0,9,4,4,17
2024-04-04 03:50:00,0,0,8,7,3,18
2024-04-04 04:00:00,0,0,8,5,3,16
2024-04-04 04:10:00,0,0,9,12,5,26
2024-04-04 04:20:00,0,0,6,6,4,16
2024-04-04 04:30:00,0,0,13,12,6,31
2024-04-04 04:40:00,0,0,12,12,4,28
2024-04-04 04:50:00,0,0,16,14,7,37
2024-04-04 05:00:00,0,0,23,29,7,59
2024-04-04 05:10:00,0,2,20,40,8,70
2024-04-04 05:20:00,0,0,34,41,10,85
2024-04-04 05:30:00,0,1,42,55,15,113
2024-04-04 05:40:00,1,0,52,54,12,119
2024-04-04 05:50:00,0,0,45,41,7,93
2024-04-04 06:00:00,2,0,37,50,11,100
2024-04-04 06:10:00,2,0,62,64,18,146
2024-04-04 06:20:00,4,0,69,61,17,151
2024-04-04 06:30:00,2,0,71,87,25,185
2024-04-04 06:40:00,0,0,87,84,13,184
2024-04-04 06:50:00,1,0,104,71,21,197
2024-04-04 07:00:00,0,0,83,95,12,190
2024-04-04 07:10:00,2,0,82,100,27,211
2024-04-04 07:20:00,1,0,100,91,23,215
2024-04-04 07:30:00,4,0,93,99,13,209
2024-04-04 07:40:00,2,0,116,128,16,262
2024-04-04 07:50:00,1,2,114,83,15,215
2024-04-04 08:00:00,4,1,105,99,16,225
2024-04-04 08:10:00,2,1,97,131,16,247
2024-04-04 08:20:00,2,0,96,117,15,230
2024-04-04 08:30:00,2,0,113,96,14,225
2024-04-04 08:40:00,4,1,100,98,17,220
2024-04-04 08:50:00,3,0,109,98,18,228
2024-04-04 09:00:00,5,0,113,88,21,227
2024-04-04 09:10:00,2,1,102,113,22,240
2024-04-04 09:20:00,2,0,75,93,18,188
2024-04-04 09:30:00,4,1,112,93,22,232
2024-04-04 09:40:00,6,0,95,119,16,236
2024-04-04 09:50:00,5,0,107,114,17,243
2024-04-04 10:00:00,2,1,108,97,24,232
2024-04-04 10:10:00,0,2,110,101,21,234
2024-04-04 10:20:00,1,3,94,116,23,237
2024-04-04 10:30:00,2,0,117,81,22,222
2024-04-04 10:40:00,1,0,115,84,12,212
2024-04-04 10:50:00,1,1,107,99,12,220
2024-04-04 11:00:00,4,0,113,88,13,218
2024-04-04 11:10:00,1,1,98,109,28,237
2024-04-04 11:20:00,3,0,111,109,14,237
2024-04-04 11:30:00,3,1,104,96,21,225
2024-04-04 11:40:00,1,0,118,102,19,240
2024-04-04 11:50:00,3,2,109,128,13,255
2024-04-04 12:00:00,6,1,102,113,25,247
2024-04-04 12:10:00,2,0,110,89,26,227
2024-04-04 12:20:00,4,0,104,134,11,253
2024-04-04 12:30:00,4,0,105,124,13,246
2024-04-04 12:40:00,4,0,107,118,19,248
2024-04-04 12:50:00,3,0,112,103,24,242
2024-04-04 13:00:00,4,0,103,114,16,237
2024-04-04 13:10:00,3,2,105,106,10,226
2024-04-04 13:20:00,2,4,123,99,12,240
2024-04-04 13:30:00,4,0,118,101,19,242
2024-04-04 13:40:00,1,1,117,98,16,233
2024-04-04 13:50:00,3,2,116,101,15,237
2024-04-04 14:00:00,1,0,114,106,26,247
2024-04-04 14:10:00,2,0,104,99,20,225
2024-04-04 14:20:00,4,0,125,107,14,250
2024-04-04 14:30:00,4,0,120,131,26,281
2024-04-04 14:40:00,4,2,131,104,19,260
2024-04-04 14:50:00,5,0,147,133,9,294
2024-04-04 15:00:00,5,1,132,135,29,302
2024-04-04 15:10:00,2,0,148,115,13,278
2024-04-04 15:20:00,1,0,127,133,17,278
2024-04-04 15:30:00,8,0,132,146,18,304
2024-04-04 15:40:00,6,0,123,152,7,288
2024-04-04 15:50:00,6,1,139,168,17,331
2024-04-04 16:00:00,9,0,149,122,19,299
2024-04-04 16:10:00,5,0,146,124,29,304
2024-04-04 16:20:00,6,1,151,156,10,324
2024-04-04 16:30:00,8,0,158,144,7,317
2024-04-04 16:40:00,7,0,151,135,19,312
2024-04-04 16:50:00,8,0,160,124,30,322
2024-04-04 17:00:00,6,0,143,134,23,306
2024-04-04 17:10:00,8,0,133,136,13,290
2024-04-04 17:20:00,8,0,112,160,15,295
2024-04-04 17:30:00,4,0,123,123,6,256
2024-04-04 17:40:00,5,1,113,122,13,254
2024-04-04 17:50:00,9,1,114,129,21,274
2024-04-04 18:00:00,4,0,126,123,15,268
2024-04-04 18:10:00,3,1,114,113,22,253
2024-04-04 18:20:00,6,0,121,107,25,259
2024-04-04 18:30:00,6,0,103,104,16,229
2024-04-04 18:40:00,1,2,110,113,14,240
2024-04-04 18:50:00,0,0,91,103,22,216
2024-04-04 19:00:00,1,1,111,71,17,201
2024-04-04 19:10:00,4,2,82,107,15,210
2024-04-04 19:20:00,2,0,87,89,31,209
2024-04-04 19:30:00,3,1,69,82,19,174
2024-04-04 19:40:00,6,0,83,75,17,181
2024-04-04 19:50:00,0,1,84,74,23,182
2024-04-04 20:00:00,1,0,81,69,17,168
2024-04-04 20:10:00,2,0,59,63,12,136
2024-04-04 20:20:00,1,0,50,50,19,120
2024-04-04 20:30:00,1,1,74,58,19,153
2024-04-04 20:40:00,3,0,44,44,15,106
2024-04-04 20:50:00,0,0,55,48,23,126
2024-04-04 21:00:00,0,0,49,62,22,133
2024-04-04 21:10:00,0,0,55,43,21,119
2024-04-04 21:20:00,1,0,37,50,14,102
2024-04-04 21:30:00,0,0,62,41,33,136
2024-04-04 21:40:00,4,0,49,51,21,125
2024-04-04 21:50:00,4,0,27,38,7,76
2024-04-04 22:00:00,0,0,51,40,24,115
2024-04-04 22:10:00,0,0,50,41,17,108
2024-04-04 22:20:00,1,0,36,40,16,93
2024-04-04 22:30:00,5,0,40,33,17,95
2024-04-04 22:40:00,4,0,30,40,7,81
2024-04-04 22:50:00,1,1,40,27,19,88
2024-04-04 23:00:00,0,1,29,31,11,72
2024-04-04 23:10:00,3,0,32,21,13,69
2024-04-04 23:20:00,4,1,26,22,12,65
2024-04-04 23:30:00,0,0,23,18,7,48
2024-04-04 23:40:00,0,0,20,15,8,43
2024-04-04 23:50:00,0,0,19,17,9,45
2024-04-05 00:00:00,1,0,14,11,7,33
2024-04-05 00:10:00,0,0,17,10,10,37
2024-04-05 00:20:00,0,0,18,11,9,38
2024-04-05 00:30:00,0,0,16,15,5,36
2024-04-05 00:40:00,2,0,17,11,7,37
2024-04-05 00:50:00,0,0,12,10,3,25
2024-04-05 01:00:00,0,0,14,10,6,30
2024-04-05 01:10:00,0,0,7,3,3,13
2024-04-05 01:20:00,0,0,13,3,6,22
2024-04-05 01:30:00,0,0,10,5,6,21
2024-04-05 01:40:00,0,0,7,4,4,15
2024-04-05 01:50:00,0,0,7,2,4,13
2024-04-05 02:00:00,0,0,1,0,0,1
