datetime,D11Z,D12Z,D21Z,D41Z,D42Z,Total
2024-03-01 01:00:00,0,1,0,10,3,14
2024-03-01 01:10:00,0,0,0,6,5,11
2024-03-01 01:20:00,0,2,0,8,5,15
2024-03-01 01:30:00,0,0,0,7,2,9
2024-03-01 01:40:00,2,4,0,7,3,16
2024-03-01 01:50:00,0,2,0,4,2,8
2024-03-01 02:00:00,0,0,0,0,2,2
2024-03-01 02:10:00,0,1,0,8,3,12
2024-03-01 02:20:00,0,0,0,8,2,10
2024-03-01 02:30:00,0,0,0,3,2,5
2024-03-01 02:40:00,0,1,0,4,2,7
2024-03-01 02:50:00,0,0,0,4,4,8
2024-03-01 03:00:00,0,1,0,8,2,11
2024-03-01 03:10:00,0,0,0,2,1,3
2024-03-01 03:20:00,0,0,0,6,5,11
2024-03-01 03:30:00,0,0,0,5,2,7
2024-03-01 03:40:00,0,1,0,6,6,13
2024-03-01 03:50:00,1,1,0,3,2,7
2024-03-01 04:00:00,0,0,0,5,1,6
2024-03-01 04:10:00,0,0,0,8,2,10
2024-03-01 04:20:00,1,0,0,9,2,12
2024-03-01 04:30:00,0,0,0,5,3,8
2024-03-01 04:40:00,0,2,0,13,3,18
2024-03-01 04:50:00,0,0,0,10,4,14
2024-03-01 05:00:00,0,4,0,6,1,11
2024-03-01 05:10:00,0,1,0,11,6,18
2024-03-01 05:20:00,0,3,0,21,5,29
2024-03-01 05:30:00,0,1,0,29,14,44
2024-03-01 05:40:00,2,1,0,38,4,45
2024-03-01 05:50:00,1,2,0,32,10,45
2024-03-01 06:00:00,0,6,0,35,11,52
2024-03-01 06:10:00,0,1,0,36,11,48
2024-03-01 06:20:00,0,4,0,51,5,60
2024-03-01 06:30:00,2,3,0,52,9,66
2024-03-01 06:40:00,3,6,0,45,15,69
2024-03-01 06:50:00,0,5,0,68,11,84
2024-03-01 07:00:00,3,5,0,66,10,84
2024-03-01 07:10:00,7,10,0,78,11,106
2024-03-01 07:20:00,3,9,0,86,6,104
2024-03-01 07:30:00,7,13,0,80,19,119
2024-03-01 07:40:00,12,9,0,100,14,135
2024-03-01 07:50:00,12,15,0,86,16,129
2024-03-01 08:00:00,4,8,0,91,21,124
2024-03-01 08:10:00,4,9,0,88,10,111
2024-03-01 08:20:00,2,6,0,70,15,93
2024-03-01 08:30:00,5,9,0,91,8,113
2024-03-01 08:40:00,5,10,0,109,18,142
2024-03-01 08:50:00,3,10,0,94,8,115
2024-03-01 09:00:00,5,8,0,77,16,106
2024-03-01 09:10:00,5,6,0,77,10,98
2024-03-01 09:20:00,5,8,0,77,14,104
2024-03-01 09:30:00,5,7,0,88,10,110
2024-03-01 09:40:00,3,7,0,77,9,96
2024-03-01 09:50:00,7,12,0,73,10,102
2024-03-01 10:00:00,6,9,0,70,9,94
2024-03-01 10:10:00,16,14,0,77,12,119
2024-03-01 10:20:00,5,13,0,66,10,94
2024-03-01 10:30:00,5,14,0,75,19,113
2024-03-01 10:40:00,5,14,0,93,13,125
2024-03-01 10:50:00,9,18,0,88,14,129
2024-03-01 11:00:00,8,7,0,82,11,108
2024-03-01 11:10:00,7,7,0,57,15,86
2024-03-01 11:20:00,7,12,0,82,20,121
2024-03-01 11:30:00,11,14,0,82,14,121
2024-03-01 11:40:00,12,13,0,72,19,116
2024-03-01 11:50:00,19,20,0,71,11,121
2024-03-01 12:00:00,5,15,0,73,18,111
2024-03-01 12:10:00,9,9,0,79,18,115
2024-03-01 12:20:00,13,18,0,93,20,144
2024-03-01 12:30:00,12,17,0,74,12,115
2024-03-01 12:40:00,10,23,0,87,12,132
2024-03-01 12:50:00,14,16,0,97,9,136
2024-03-01 13:00:00,11,19,0,69,12,111
2024-03-01 13:10:00,9,18,0,80,13,120
2024-03-01 13:20:00,10,18,0,75,16,119
2024-03-01 13:30:00,4,12,0,87,15,118
2024-03-01 13:40:00,8,21,0,83,17,129
2024-03-01 13:50:00,7,16,0,81,17,121
2024-03-01 14:00:00,7,13,0,81,8,109
2024-03-01 14:10:00,12,16,0,94,13,135
2024-03-01 14:20:00,10,22,0,84,7,123
2024-03-01 14:30:00,11,14,0,80,15,120
2024-03-01 14:40:00,4,24,0,107,11,146
2024-03-01 14:50:00,11,18,0,78,11,118
2024-03-01 15:00:00,7,9,0,86,18,120
2024-03-01 15:10:00,7,20,0,87,10,124
2024-03-01 15:20:00,8,19,0,85,13,125
2024-03-01 15:30:00,10,17,0,101,11,139
2024-03-01 15:40:00,11,10,0,100,12,133
2024-03-01 15:50:00,9,15,0,90,9,123
2024-03-01 16:00:00,11,12,0,84,15,122
2024-03-01 16:10:00,9,26,0,88,17,140
2024-03-01 16:20:00,8,11,0,81,13,113
2024-03-01 16:30:00,11,14,0,90,13,128
2024-03-01 16:40:00,3,14,0,74,10,101
2024-03-01 16:50:00,4,20,0,90,11,125
2024-03-01 17:00:00,9,20,0,88,17,134
2024-03-01 17:10:00,10,21,0,90,19,140
2024-03-01 17:20:00,10,18,0,96,9,133
2024-03-01 17:30:00,5,12,0,88,16,121
2024-03-01 17:40:00,7,8,0,89,13,117
2024-03-01 17:50:00,4,20,0,92,17,133
2024-03-01 18:00:00,6,12,0,81,18,117
2024-03-01 18:10:00,11,16,0,82,32,141
2024-03-01 18:20:00,9,21,0,91,23,144
2024-03-01 18:30:00,6,11,0,96,18,131
2024-03-01 18:40:00,8,13,0,99,13,133
2024-03-01 18:50:00,2,20,0,100,11,133
2024-03-01 19:00:00,6,14,0,97,14,131
2024-03-01 19:10:00,7,15,0,82,15,119
2024-03-01 19:20:00,1,13,0,63,6,83
2024-03-01 19:30:00,5,12,0,67,11,95
2024-03-01 19:40:00,4,12,0,77,12,105
2024-03-01 19:50:00,2,10,0,68,8,88
2024-03-01 20:00:00,3,6,0,61,12,82
2024-03-01 20:10:00,3,10,0,74,3,90
2024-03-01 20:20:00,5,6,0,61,9,81
2024-03-01 20:30:00,4,7,0,51,9,71
2024-03-01 20:40:00,18,20,0,55,13,106
2024-03-01 20:50:00,10,11,0,50,7,78
2024-03-01 21:00:00,8,5,0,39,7,59
2024-03-01 21:10:00,6,7,0,40,5,58
2024-03-01 21:20:00,6,9,0,47,12,74
2024-03-01 21:30:00,2,8,0,49,10,69
2024-03-01 21:40:00,3,8,0,35,13,59
2024-03-01 21:50:00,6,14,0,39,8,67
2024-03-01 22:00:00,1,4,0,37,7,49
2024-03-01 22:10:00,2,5,0,38,6,51
2024-03-01 22:20:00,2,7,0,28,8,45
2024-03-01 22:30:00,1,3,0,37,9,50
2024-03-01 22:40:00,1,3,0,38,14,56
2024-03-01 22:50:00,1,3,0,37,10,51
2024-03-01 23:00:00,2,8,0,31,5,46
2024-03-01 23:10:00,1,4,0,38,5,48
2024-03-01 23:20:00,1,5,0,28,7,41
2024-03-01 23:30:00,0,4,0,21,9,34
2024-03-01 23:40:00,2,10,0,16,9,37
2024-03-01 23:50:00,0,6,0,28,11,45
2024-03-02 00:00:00,3,3,0,22,12,40
2024-03-02 00:10:00,1,2,0,21,10,34
2024-03-02 00:20:00,0,0,0,24,6,30
2024-03-02 00:30:00,1,2,0,19,7,29
2024-03-02 00:40:00,2,3,0,16,13,34
2024-03-02 00:50:00,0,1,0,8,2,11
2024-03-02 01:00:00,1,1,0,19,7,28
2024-03-02 01:10:00,1,3,0,17,7,28
2024-03-02 01:20:00,1,3,0,11,5,20
2024-03-02 01:30:00,1,4,0,10,4,19
2024-03-02 01:40:00,0,1,0,10,5,16
2024-03-02 01:50:00,0,0,0,9,2,11
2024-03-02 02:00:00,0,6,0,15,6,27
2024-03-02 02:10:00,2,2,0,9,3,16
2024-03-02 02:20:00,0,3,0,12,4,19
2024-03-02 02:30:00,0,1,0,8,7,16
2024-03-02 02:40:00,1,3,0,7,1,12
2024-03-02 02:50:00,1,2,0,8,2,13
2024-03-02 03:00:00,0,1,0,8,4,13
2024-03-02 03:10:00,0,2,0,7,4,13
2024-03-02 03:20:00,0,1,0,7,6,14
2024-03-02 03:30:00,0,3,0,8,7,18
2024-03-02 03:40:00,0,0,0,9,3,12
2024-03-02 03:50:00,0,0,0,9,5,14
2024-03-02 04:00:00,0,0,0,13,3,16
2024-03-02 04:10:00,0,0,0,12,3,15
2024-03-02 04:20:00,0,0,0,8,5,13
2024-03-02 04:30:00,0,1,0,10,3,14
2024-03-02 04:40:00,0,2,0,9,3,14
2024-03-02 04:50:00,0,0,0,8,6,14
2024-03-02 05:00:00,0,0,0,6,0,6
2024-03-02 05:10:00,0,2,0,11,2,15
2024-03-02 05:20:00,1,0,0,13,3,17
2024-03-02 05:30:00,0,2,0,14,5,21
2024-03-02 05:40:00,0,3,0,19,4,26
2024-03-02 05:50:00,0,2,0,13,6,21
2024-03-02 06:00:00,1,1,0,8,2,12
2024-03-02 06:10:00,0,0,0,15,6,21
2024-03-02 06:20:00,0,1,0,14,4,19
2024-03-02 06:30:00,0,2,0,13,5,20
2024-03-02 06:40:00,1,1,0,18,7,27
2024-03-02 06:50:00,0,2,0,13,7,22
2024-03-02 07:00:00,1,2,0,14,4,21
2024-03-02 07:10:00,0,4,0,17,8,29
2024-03-02 07:20:00,3,2,0,20,5,30
2024-03-02 07:30:00,1,3,0,27,4,35
2024-03-02 07:40:00,0,7,0,26,8,41
2024-03-02 07:50:00,3,6,0,31,10,50
2024-03-02 08:00:00,5,2,0,23,5,35
2024-03-02 08:10:00,1,3,0,26,2,32
2024-03-02 08:20:00,1,3,0,37,14,55
2024-03-02 08:30:00,3,8,0,37,3,51
2024-03-02 08:40:00,6,6,0,29,4,45
2024-03-02 08:50:00,1,13,0,41,17,72
2024-03-02 09:00:00,4,10,0,50,13,77
2024-03-02 09:10:00,4,8,0,48,10,70
2024-03-02 09:20:00,3,10,0,46,8,67
2024-03-02 09:30:00,2,11,0,60,8,81
2024-03-02 09:40:00,6,12,0,68,6,92
2024-03-02 09:50:00,8,12,0,75,9,104
2024-03-02 10:00:00,5,8,0,54,14,81
2024-03-02 10:10:00,10,13,0,65,10,98
2024-03-02 10:20:00,7,15,0,74,12,108
2024-03-02 10:30:00,9,8,0,79,9,105
2024-03-02 10:40:00,10,13,0,69,13,105
2024-03-02 10:50:00,7,14,0,101,15,137
2024-03-02 11:00:00,9,22,0,87,14,132
2024-03-02 11:10:00,4,18,0,82,13,117
2024-03-02 11:20:00,8,11,0,80,9,108
2024-03-02 11:30:00,11,16,0,73,17,117
2024-03-02 11:40:00,9,9,0,99,15,132
2024-03-02 11:50:00,12,28,0,75,18,133
2024-03-02 12:00:00,12,18,0,84,15,129
2024-03-02 12:10:00,13,23,0,89,8,133
2024-03-02 12:20:00,9,8,0,75,14,106
2024-03-02 12:30:00,9,25,0,90,10,134
2024-03-02 12:40:00,10,22,0,89,9,130
2024-03-02 12:50:00,15,27,0,99,15,156
2024-03-02 13:00:00,9,28,0,87,14,138
2024-03-02 13:10:00,10,15,0,107,14,146
2024-03-02 13:20:00,11,19,0,95,6,131
2024-03-02 13:30:00,11,20,0,112,10,153
2024-03-02 13:40:00,9,17,0,114,15,155
2024-03-02 13:50:00,11,23,0,91,13,138
2024-03-02 14:00:00,14,24,0,112,8,158
2024-03-02 14:10:00,6,22,0,88,11,127
2024-03-02 14:20:00,10,17,0,103,11,141
2024-03-02 14:30:00,11,18,0,89,14,132
2024-03-02 14:40:00,8,18,0,98,10,134
2024-03-02 14:50:00,10,10,0,103,9,132
2024-03-02 15:00:00,5,9,0,91,7,112
2024-03-02 15:10:00,5,17,0,98,18,138
2024-03-02 15:20:00,9,9,0,97,10,125
2024-03-02 15:30:00,10,8,0,100,9,127
2024-03-02 15:40:00,8,14,0,102,14,138
2024-03-02 15:50:00,15,13,0,73,16,117
2024-03-02 16:00:00,7,7,0,98,7,119
2024-03-02 16:10:00,7,19,0,78,13,117
2024-03-02 16:20:00,8,11,0,88,6,113
2024-03-02 16:30:00,9,11,0,87,8,115
2024-03-02 16:40:00,2,14,0,85,10,111
2024-03-02 16:50:00,10,23,0,87,7,127
2024-03-02 17:00:00,7,14,0,74,14,109
2024-03-02 17:10:00,8,11,0,92,9,120
2024-03-02 17:20:00,6,11,0,91,11,119
2024-03-02 17:30:00,5,13,0,92,10,120
2024-03-02 17:40:00,7,14,0,83,11,115
2024-03-02 17:50:00,7,14,0,84,8,113
2024-03-02 18:00:00,7,13,0,89,10,119
2024-03-02 18:10:00,11,12,0,95,6,124
2024-03-02 18:20:00,5,20,0,89,2,116
2024-03-02 18:30:00,6,19,0,77,14,116
2024-03-02 18:40:00,7,14,0,78,12,111
2024-03-02 18:50:00,3,14,0,76,9,102
2024-03-02 19:00:00,2,11,0,85,11,109
2024-03-02 19:10:00,4,11,0,89,11,115
2024-03-02 19:20:00,5,10,0,77,12,104
2024-03-02 19:30:00,2,14,0,66,13,95
2024-03-02 19:40:00,1,9,0,58,15,83
2024-03-02 19:50:00,6,13,0,65,10,94
2024-03-02 20:00:00,5,11,0,64,7,87
2024-03-02 20:10:00,2,5,0,64,11,82
2024-03-02 20:20:00,3,9,0,54,9,75
2024-03-02 20:30:00,2,5,0,50,14,71
2024-03-02 20:40:00,1,10,0,46,13,70
2024-03-02 20:50:00,2,5,0,49,2,58
2024-03-02 21:00:00,6,8,0,41,9,64
2024-03-02 21:10:00,2,6,0,43,6,57
2024-03-02 21:20:00,3,9,0,42,13,67
2024-03-02 21:30:00,3,7,0,44,12,66
2024-03-02 21:40:00,3,7,0,40,8,58
2024-03-02 21:50:00,2,7,0,46,9,64
2024-03-02 22:00:00,3,5,0,34,7,49
2024-03-02 22:10:00,1,5,0,42,8,56
2024-03-02 22:20:00,1,4,0,39,10,54
2024-03-02 22:30:00,1,3,0,44,9,57
2024-03-02 22:40:00,1,1,0,36,4,42
2024-03-02 22:50:00,0,5,0,35,9,49
2024-03-02 23:00:00,2,5,0,38,7,52
2024-03-02 23:10:00,1,2,0,28,6,37
2024-03-02 23:20:00,1,4,0,29,7,41
2024-03-02 23:30:00,0,3,0,20,8,31
2024-03-02 23:40:00,3,3,0,29,4,39
2024-03-02 23:50:00,2,5,0,27,10,44
2024-03-03 00:00:00,4,2,0,26,9,41
2024-03-03 00:10:00,3,2,0,30,6,41
2024-03-03 00:20:00,0,1,0,13,10,24
2024-03-03 00:30:00,1,3,0,18,4,26
2024-03-03 00:40:00,0,6,0,22,5,33
2024-03-03 00:50:00,0,5,0,22,10,37
2024-03-03 01:00:00,1,3,0,18,9,31
2024-03-03 01:10:00,0,5,0,21,4,30
2024-03-03 01:20:00,0,3,0,18,11,32
2024-03-03 01:30:00,1,1,0,15,8,25
2024-03-03 01:40:00,3,1,0,14,6,24
2024-03-03 01:50:00,1,0,0,13,5,19
2024-03-03 02:00:00,2,1,0,18,7,28
2024-03-03 02:10:00,0,3,0,17,3,23
2024-03-03 02:20:00,0,1,0,19,6,26
2024-03-03 02:30:00,2,4,0,10,4,20
2024-03-03 02:40:00,1,1,0,7,2,11
2024-03-03 02:50:00,0,0,0,8,1,9
2024-03-03 03:00:00,0,0,0,9,3,12
2024-03-03 03:10:00,0,0,0,10,3,13
2024-03-03 03:20:00,1,3,0,11,2,17
2024-03-03 03:30:00,0,1,0,11,4,16
2024-03-03 03:40:00,2,2,0,8,8,20
2024-03-03 03:50:00,0,0,0,7,3,10
2024-03-03 04:00:00,0,0,0,10,6,16
2024-03-03 04:10:00,3,2,0,7,2,14
2024-03-03 04:20:00,1,2,0,5,9,17
2024-03-03 04:30:00,1,1,0,8,5,15
2024-03-03 04:40:00,1,1,0,8,8,18
2024-03-03 04:50:00,0,2,0,9,5,16
2024-03-03 05:00:00,0,1,0,7,4,12
2024-03-03 05:10:00,0,0,0,12,7,19
2024-03-03 05:20:00,0,0,0,9,5,14
2024-03-03 05:30:00,0,1,0,17,5,23
2024-03-03 05:40:00,0,2,0,17,4,23
2024-03-03 05:50:00,0,1,0,9,5,15
2024-03-03 06:00:00,0,1,0,10,8,19
2024-03-03 06:10:00,0,1,0,8,4,13
2024-03-03 06:20:00,0,0,0,5,2,7
2024-03-03 06:30:00,0,1,0,6,2,9
2024-03-03 06:40:00,0,0,0,4,3,7
2024-03-03 06:50:00,0,1,0,6,1,8
2024-03-03 07:00:00,0,0,0,9,7,16
2024-03-03 07:10:00,1,2,0,3,1,7
2024-03-03 07:20:00,0,0,0,5,3,8
2024-03-03 07:30:00,0,1,0,8,3,12
2024-03-03 07:40:00,1,0,0,13,2,16
2024-03-03 07:50:00,0,1,0,6,4,11
2024-03-03 08:00:00,0,1,0,10,3,14
2024-03-03 08:10:00,0,1,0,8,3,12
2024-03-03 08:20:00,0,0,0,13,7,20
2024-03-03 08:30:00,2,1,0,19,5,27
2024-03-03 08:40:00,1,2,0,12,3,18
2024-03-03 08:50:00,0,4,0,18,6,28
2024-03-03 09:00:00,1,2,0,19,9,31
2024-03-03 09:10:00,0,3,0,29,15,47
2024-03-03 09:20:00,3,7,0,38,25,73
2024-03-03 09:30:00,2,7,0,43,27,79
2024-03-03 09:40:00,3,11,0,48,25,87
2024-03-03 09:50:00,1,5,0,38,12,56
2024-03-03 10:00:00,1,5,0,38,5,49
2024-03-03 10:10:00,3,1,0,31,7,42
2024-03-03 10:20:00,1,2,0,34,11,48
2024-03-03 10:30:00,0,4,0,37,6,47
2024-03-03 10:40:00,3,5,0,53,4,65
2024-03-03 10:50:00,5,2,0,43,13,63
2024-03-03 11:00:00,1,5,0,34,3,43
2024-03-03 11:10:00,1,5,0,30,10,46
2024-03-03 11:20:00,3,8,0,26,6,43
2024-03-03 11:30:00,4,10,0,51,8,73
2024-03-03 11:40:00,3,6,0,41,7,57
2024-03-03 11:50:00,3,3,0,43,8,57
2024-03-03 12:00:00,13,14,0,57,5,89
2024-03-03 12:10:00,25,16,0,53,6,100
2024-03-03 12:20:00,15,12,0,59,11,97
2024-03-03 12:30:00,12,10,0,56,5,83
2024-03-03 12:40:00,4,7,0,54,4,69
2024-03-03 12:50:00,4,4,0,52,12,72
2024-03-03 13:00:00,3,10,0,54,14,81
2024-03-03 13:10:00,2,4,0,58,10,74
2024-03-03 13:20:00,4,4,0,61,10,79
2024-03-03 13:30:00,4,4,0,69,11,88
2024-03-03 13:40:00,8,7,0,52,7,74
2024-03-03 13:50:00,3,4,0,43,11,61
2024-03-03 14:00:00,2,5,0,52,10,69
2024-03-03 14:10:00,6,6,0,54,13,79
2024-03-03 14:20:00,0,4,0,54,11,69
2024-03-03 14:30:00,3,7,0,54,7,71
2024-03-03 14:40:00,2,4,0,61,8,75
2024-03-03 14:50:00,1,5,0,77,11,94
2024-03-03 15:00:00,6,8,0,75,18,107
2024-03-03 15:10:00,5,8,0,59,12,84
2024-03-03 15:20:00,4,5,0,63,10,82
2024-03-03 15:30:00,0,4,0,62,7,73
2024-03-03 15:40:00,1,4,0,65,10,80
2024-03-03 15:50:00,3,7,0,53,11,74
2024-03-03 16:00:00,2,7,0,57,5,71
2024-03-03 16:10:00,1,3,0,62,19,85
2024-03-03 16:20:00,0,6,0,84,20,110
2024-03-03 16:30:00,7,13,0,64,26,110
2024-03-03 16:40:00,3,9,0,55,18,85
2024-03-03 16:50:00,5,7,0,58,17,87
2024-03-03 17:00:00,2,4,0,60,4,70
2024-03-03 17:10:00,1,4,0,71,5,81
2024-03-03 17:20:00,4,8,0,49,10,71
2024-03-03 17:30:00,1,7,0,68,6,82
2024-03-03 17:40:00,3,5,0,58,5,71
2024-03-03 17:50:00,3,4,0,53,10,70
2024-03-03 18:00:00,1,5,0,61,7,74
2024-03-03 18:10:00,3,8,0,54,8,73
2024-03-03 18:20:00,6,8,0,48,11,73
2024-03-03 18:30:00,20,17,0,62,11,110
2024-03-03 18:40:00,13,11,0,81,7,112
2024-03-03 18:50:00,7,7,0,56,3,73
2024-03-03 19:00:00,8,7,0,46,5,66
2024-03-03 19:10:00,4,8,0,55,10,77
2024-03-03 19:20:00,6,10,0,42,15,73
2024-03-03 19:30:00,2,3,0,52,9,66
2024-03-03 19:40:00,4,5,0,50,8,67
2024-03-03 19:50:00,3,6,0,50,7,66
2024-03-03 20:00:00,2,3,0,37,10,52
2024-03-03 20:10:00,2,4,0,42,8,56
2024-03-03 20:20:00,5,6,0,39,14,64
2024-03-03 20:30:00,2,5,0,29,9,45
2024-03-03 20:40:00,4,6,0,35,6,51
2024-03-03 20:50:00,1,6,0,30,6,43
2024-03-03 21:00:00,2,6,0,36,4,48
2024-03-03 21:10:00,1,3,0,27,5,36
2024-03-03 21:20:00,2,6,0,34,10,52
2024-03-03 21:30:00,3,10,0,31,5,49
2024-03-03 21:40:00,2,2,0,27,9,40
2024-03-03 21:50:00,1,2,0,30,7,40
2024-03-03 22:00:00,5,3,0,29,6,43
2024-03-03 22:10:00,1,2,0,23,7,33
2024-03-03 22:20:00,1,2,0,24,11,38
2024-03-03 22:30:00,1,3,0,26,4,34
2024-03-03 22:40:00,1,5,0,12,6,24
2024-03-03 22:50:00,1,3,0,22,13,39
2024-03-03 23:00:00,2,3,0,21,5,31
2024-03-03 23:10:00,0,7,0,12,3,22
2024-03-03 23:20:00,0,4,0,19,7,30
2024-03-03 23:30:00,1,0,0,12,2,15
2024-03-03 23:40:00,2,3,0,12,3,20
2024-03-03 23:50:00,0,0,0,9,11,20
2024-03-04 00:00:00,0,1,0,7,4,12
2024-03-04 00:10:00,1,1,0,10,2,14
2024-03-04 00:20:00,0,0,0,9,1,10
2024-03-04 00:30:00,0,1,0,8,5,14
2024-03-04 00:40:00,0,0,0,5,0,5
2024-03-04 00:50:00,0,1,0,9,5,15
2024-03-04 01:00:00,0,2,0,5,5,12
2024-03-04 01:10:00,3,1,0,7,4,15
2024-03-04 01:20:00,0,0,0,1,4,5
2024-03-04 01:30:00,0,0,0,2,3,5
2024-03-04 01:40:00,1,2,0,1,2,6
2024-03-04 01:50:00,0,3,0,3,4,10
2024-03-04 02:00:00,0,0,0,4,1,5
2024-03-04 02:10:00,0,0,0,2,0,2
2024-03-04 02:20:00,0,0,0,4,0,4
2024-03-04 02:30:00,0,1,0,7,2,10
2024-03-04 02:40:00,0,0,0,1,3,4
2024-03-04 02:50:00,0,0,0,2,3,5
2024-03-04 03:00:00,0,0,0,4,0,4
2024-03-04 03:10:00,0,0,0,3,2,5
2024-03-04 03:20:00,0,0,0,2,1,3
2024-03-04 03:30:00,0,1,0,3,4,8
2024-03-04 03:40:00,0,2,0,4,2,8
2024-03-04 03:50:00,0,0,0,4,0,4
2024-03-04 04:00:00,0,0,0,5,0,5
2024-03-04 04:10:00,0,0,0,9,4,13
2024-03-04 04:20:00,0,1,0,10,2,13
2024-03-04 04:30:00,0,0,0,3,1,4
2024-03-04 04:40:00,0,2,0,9,6,17
2024-03-04 04:50:00,0,0,0,3,6,9
2024-03-04 05:00:00,0,0,0,8,4,12
2024-03-04 05:10:00,0,2,0,12,6,20
2024-03-04 05:20:00,0,0,0,19,3,22
2024-03-04 05:30:00,2,1,0,33,12,48
2024-03-04 05:40:00,0,2,0,44,9,55
2024-03-04 05:50:00,1,4,0,38,9,52
2024-03-04 06:00:00,0,4,0,33,11,48
2024-03-04 06:10:00,0,2,0,42,8,52
2024-03-04 06:20:00,2,4,0,44,19,69
2024-03-04 06:30:00,2,2,0,62,11,77
2024-03-04 06:40:00,3,4,0,59,7,73
2024-03-04 06:50:00,1,6,0,59,9,75
2024-03-04 07:00:00,4,8,0,81,10,103
2024-03-04 07:10:00,3,10,0,84,12,109
2024-03-04 07:20:00,2,7,0,100,6,115
2024-03-04 07:30:00,4,10,0,96,13,123
2024-03-04 07:40:00,3,4,0,111,15,133
2024-03-04 07:50:00,6,10,0,85,17,118
2024-03-04 08:00:00,10,7,0,79,13,109
2024-03-04 08:10:00,3,13,0,87,16,119
2024-03-04 08:20:00,6,11,0,82,13,112
2024-03-04 08:30:00,9,13,0,94,13,129
2024-03-04 08:40:00,9,10,0,88,19,126
2024-03-04 08:50:00,11,12,0,99,15,137
2024-03-04 09:00:00,7,8,0,76,19,110
2024-03-04 09:10:00,8,6,0,90,16,120
2024-03-04 09:20:00,2,10,0,82,9,103
2024-03-04 09:30:00,5,9,0,75,15,104
2024-03-04 09:40:00,7,11,0,88,18,124
2024-03-04 09:50:00,4,9,0,71,12,96
2024-03-04 10:00:00,11,6,0,68,15,100
2024-03-04 10:10:00,6,15,0,64,12,97
2024-03-04 10:20:00,5,9,0,73,12,99
2024-03-04 10:30:00,5,16,0,73,13,107
2024-03-04 10:40:00,6,9,0,91,14,120
2024-03-04 10:50:00,4,10,0,49,11,74
2024-03-04 11:00:00,4,13,0,62,8,87
2024-03-04 11:10:00,9,13,0,72,12,106
2024-03-04 11:20:00,6,12,0,62,11,91
2024-03-04 11:30:00,5,13,0,65,16,99
2024-03-04 11:40:00,6,19,0,72,11,108
2024-03-04 11:50:00,8,13,0,69,17,107
2024-03-04 12:00:00,3,15,0,67,18,103
2024-03-04 12:10:00,7,19,0,72,16,114
2024-03-04 12:20:00,13,24,0,90,15,142
2024-03-04 12:30:00,13,25,0,86,10,134
2024-03-04 12:40:00,6,19,0,70,13,108
2024-03-04 12:50:00,5,20,0,82,17,124
2024-03-04 13:00:00,7,13,0,67,16,103
2024-03-04 13:10:00,4,14,0,86,19,123
2024-03-04 13:20:00,3,10,0,76,9,98
2024-03-04 13:30:00,8,16,0,81,11,116
2024-03-04 13:40:00,5,10,0,80,17,112
2024-03-04 13:50:00,7,17,0,78,23,125
2024-03-04 14:00:00,3,7,0,70,15,95
2024-03-04 14:10:00,5,8,0,77,9,99
2024-03-04 14:20:00,4,8,0,89,12,113
2024-03-04 14:30:00,11,10,0,76,10,107
2024-03-04 14:40:00,7,17,0,75,16,115
2024-03-04 14:50:00,8,18,0,88,12,126
2024-03-04 15:00:00,13,15,0,96,13,137
2024-03-04 15:10:00,10,21,0,79,14,124
2024-03-04 15:20:00,5,12,0,92,20,129
2024-03-04 15:30:00,6,14,0,84,8,112
2024-03-04 15:40:00,10,12,0,89,15,126
2024-03-04 15:50:00,6,17,0,85,10,118
2024-03-04 16:00:00,5,13,0,90,17,125
2024-03-04 16:10:00,12,18,0,98,14,142
2024-03-04 16:20:00,6,16,0,86,12,120
2024-03-04 16:30:00,9,9,0,93,17,128
2024-03-04 16:40:00,12,11,0,105,12,140
2024-03-04 16:50:00,10,14,0,85,15,124
2024-03-04 17:00:00,7,23,0,105,16,151
2024-03-04 17:10:00,12,19,0,98,15,144
2024-03-04 17:20:00,10,13,0,99,21,143
2024-03-04 17:30:00,6,18,0,105,21,150
2024-03-04 17:40:00,8,13,0,96,14,131
2024-03-04 17:50:00,4,17,0,89,16,126
2024-03-04 18:00:00,9,14,0,80,15,118
2024-03-04 18:10:00,5,9,0,82,11,107
2024-03-04 18:20:00,4,12,0,85,15,116
2024-03-04 18:30:00,3,14,0,88,13,118
2024-03-04 18:40:00,5,13,0,79,15,112
2024-03-04 18:50:00,9,11,0,71,12,103
2024-03-04 19:00:00,10,12,0,59,13,94
2024-03-04 19:10:00,5,18,0,71,8,102
2024-03-04 19:20:00,7,9,0,64,14,94
2024-03-04 19:30:00,2,9,0,48,8,67
2024-03-04 19:40:00,2,6,0,45,11,64
2024-03-04 19:50:00,2,12,0,49,5,68
2024-03-04 20:00:00,7,6,0,46,5,64
2024-03-04 20:10:00,5,12,0,49,8,74
2024-03-04 20:20:00,2,7,0,47,11,67
2024-03-04 20:30:00,1,8,0,50,9,68
2024-03-04 20:40:00,4,5,0,32,16,57
2024-03-04 20:50:00,0,6,0,31,4,41
2024-03-04 21:00:00,1,5,0,30,8,44
2024-03-04 21:10:00,3,12,0,33,7,55
2024-03-04 21:20:00,4,4,0,31,10,49
2024-03-04 21:30:00,1,5,0,46,7,59
2024-03-04 21:40:00,2,7,0,28,9,46
2024-03-04 21:50:00,1,4,0,27,5,37
2024-03-04 22:00:00,0,2,0,18,8,28
2024-03-04 22:10:00,0,2,0,27,6,35
2024-03-04 22:20:00,1,3,0,27,12,43
2024-03-04 22:30:00,1,4,0,25,7,37
2024-03-04 22:40:00,1,0,0,21,5,27
2024-03-04 22:50:00,1,3,0,17,7,28
2024-03-04 23:00:00,0,2,0,16,8,26
2024-03-04 23:10:00,1,3,0,25,4,33
2024-03-04 23:20:00,0,1,0,12,8,21
2024-03-04 23:30:00,0,1,0,16,4,21
2024-03-04 23:40:00,1,1,0,10,1,13
2024-03-04 23:50:00,2,2,0,13,8,25
2024-03-05 00:00:00,1,0,0,9,6,16
2024-03-05 00:10:00,1,2,0,8,4,15
2024-03-05 00:20:00,0,1,0,3,3,7
2024-03-05 00:30:00,0,3,0,7,2,12
2024-03-05 00:40:00,1,3,0,7,2,13
2024-03-05 00:50:00,0,1,0,5,5,11
2024-03-05 01:00:00,0,0,0,3,3,6
2024-03-05 01:10:00,0,1,0,3,6,10
2024-03-05 01:20:00,1,0,0,8,0,9
2024-03-05 01:30:00,0,1,0,3,3,7
2024-03-05 01:40:00,0,0,0,2,1,3
2024-03-05 01:50:00,0,0,0,2,2,4
2024-03-05 02:00:00,1,1,0,1,0,3
2024-03-05 02:10:00,0,0,0,3,1,4
2024-03-05 02:20:00,0,0,0,3,2,5
2024-03-05 02:30:00,0,1,0,5,6,12
2024-03-05 02:40:00,0,0,0,2,3,5
2024-03-05 02:50:00,0,0,0,3,1,4
2024-03-05 03:00:00,0,0,0,1,0,1
2024-03-05 03:10:00,0,0,0,5,2,7
2024-03-05 03:20:00,0,0,0,1,1,2
2024-03-05 03:30:00,0,0,0,5,5,10
2024-03-05 03:40:00,0,1,0,4,2,7
2024-03-05 03:50:00,0,0,0,2,0,2
2024-03-05 04:00:00,0,0,0,4,0,4
2024-03-05 04:10:00,0,0,0,5,2,7
2024-03-05 04:20:00,0,0,0,8,3,11
2024-03-05 04:30:00,0,0,0,7,4,11
2024-03-05 04:40:00,1,1,0,6,4,12
2024-03-05 04:50:00,0,2,0,10,3,15
2024-03-05 05:00:00,1,1,0,12,3,17
2024-03-05 05:10:00,1,3,0,8,6,18
2024-03-05 05:20:00,0,1,0,20,6,27
2024-03-05 05:30:00,0,1,0,25,7,33
2024-03-05 05:40:00,2,3,0,22,7,34
2024-03-05 05:50:00,1,6,0,30,11,48
2024-03-05 06:00:00,0,1,0,32,10,43
2024-03-05 06:10:00,0,5,0,49,10,64
2024-03-05 06:20:00,2,4,0,49,3,58
2024-03-05 06:30:00,1,4,0,54,9,68
2024-03-05 06:40:00,4,3,0,68,7,82
2024-03-05 06:50:00,1,7,0,68,11,87
2024-03-05 07:00:00,4,7,0,80,12,103
2024-03-05 07:10:00,4,9,0,93,15,121
2024-03-05 07:20:00,2,14,0,92,8,116
2024-03-05 07:30:00,2,10,0,91,11,114
2024-03-05 07:40:00,8,11,0,97,13,129
2024-03-05 07:50:00,4,8,0,88,11,111
2024-03-05 08:00:00,8,8,0,91,15,122
2024-03-05 08:10:00,2,8,0,101,11,122
2024-03-05 08:20:00,3,7,0,101,16,127
2024-03-05 08:30:00,5,7,0,95,11,118
2024-03-05 08:40:00,7,12,0,87,14,120
2024-03-05 08:50:00,5,7,0,94,18,124
2024-03-05 09:00:00,7,6,0,90,17,120
2024-03-05 09:10:00,8,13,0,90,8,119
2024-03-05 09:20:00,8,3,0,74,13,98
2024-03-05 09:30:00,6,12,0,77,17,112
2024-03-05 09:40:00,5,13,0,76,10,104
2024-03-05 09:50:00,3,7,0,74,12,96
2024-03-05 10:00:00,6,11,0,58,13,88
2024-03-05 10:10:00,4,10,0,80,11,105
2024-03-05 10:20:00,6,9,0,74,14,103
2024-03-05 10:30:00,9,8,0,60,9,86
2024-03-05 10:40:00,6,12,0,88,14,120
2024-03-05 10:50:00,4,5,0,73,17,99
2024-03-05 11:00:00,8,12,0,64,12,96
2024-03-05 11:10:00,2,10,0,84,17,113
2024-03-05 11:20:00,6,14,0,58,14,92
2024-03-05 11:30:00,7,15,0,69,12,103
2024-03-05 11:40:00,4,11,0,71,18,104
2024-03-05 11:50:00,6,15,0,77,12,110
2024-03-05 12:00:00,8,12,0,75,12,107
2024-03-05 12:10:00,6,14,0,85,17,122
2024-03-05 12:20:00,5,20,0,74,14,113
2024-03-05 12:30:00,3,12,0,76,10,101
2024-03-05 12:40:00,4,12,0,72,16,104
2024-03-05 12:50:00,7,17,0,80,10,114
2024-03-05 13:00:00,10,13,0,79,13,115
2024-03-05 13:10:00,5,13,0,68,13,99
2024-03-05 13:20:00,7,13,0,82,18,120
2024-03-05 13:30:00,4,4,0,82,11,101
2024-03-05 13:40:00,5,13,0,87,13,118
2024-03-05 13:50:00,8,9,0,83,14,114
2024-03-05 14:00:00,7,10,0,75,20,112
2024-03-05 14:10:00,2,15,0,83,9,109
2024-03-05 14:20:00,7,7,0,74,9,97
2024-03-05 14:30:00,7,12,0,78,10,107
2024-03-05 14:40:00,1,8,0,89,13,111
2024-03-05 14:50:00,5,13,0,87,16,121
2024-03-05 15:00:00,2,5,0,101,7,115
2024-03-05 15:10:00,7,9,0,75,14,105
2024-03-05 15:20:00,6,11,0,76,11,104
2024-03-05 15:30:00,8,9,0,92,15,124
2024-03-05 15:40:00,5,16,0,102,15,138
2024-03-05 15:50:00,6,13,0,85,6,110
2024-03-05 16:00:00,9,7,0,93,14,123
2024-03-05 16:10:00,10,14,0,103,14,141
2024-03-05 16:20:00,9,14,0,87,7,117
2024-03-05 16:30:00,7,9,0,102,14,132
2024-03-05 16:40:00,10,18,0,101,13,142
2024-03-05 16:50:00,8,18,0,73,8,107
2024-03-05 17:00:00,4,17,0,96,14,131
2024-03-05 17:10:00,9,18,0,89,18,134
2024-03-05 17:20:00,8,13,0,111,5,137
2024-03-05 17:30:00,4,7,0,87,18,116
2024-03-05 17:40:00,9,15,0,100,10,134
2024-03-05 17:50:00,4,11,0,84,9,108
2024-03-05 18:00:00,4,12,0,103,10,129
2024-03-05 18:10:00,6,17,0,100,13,136
2024-03-05 18:20:00,8,19,0,93,10,130
2024-03-05 18:30:00,9,13,0,93,11,126
2024-03-05 18:40:00,6,13,0,75,18,112
2024-03-05 18:50:00,6,18,0,76,20,120
2024-03-05 19:00:00,2,13,0,78,15,108
2024-03-05 19:10:00,6,5,0,73,21,105
2024-03-05 19:20:00,2,10,0,62,10,84
2024-03-05 19:30:00,5,8,0,47,9,69
2024-03-05 19:40:00,5,11,0,69,14,99
2024-03-05 19:50:00,3,8,0,41,9,61
2024-03-05 20:00:00,2,13,0,51,11,77
2024-03-05 20:10:00,3,9,0,44,7,63
2024-03-05 20:20:00,4,10,0,47,7,68
2024-03-05 20:30:00,2,12,0,38,4,56
2024-03-05 20:40:00,1,5,0,34,8,48
2024-03-05 20:50:00,4,7,0,33,12,56
2024-03-05 21:00:00,4,7,0,44,12,67
2024-03-05 21:10:00,4,1,0,32,7,44
2024-03-05 21:20:00,4,7,0,30,7,48
2024-03-05 21:30:00,5,5,0,35,3,48
2024-03-05 21:40:00,2,4,0,34,6,46
2024-03-05 21:50:00,5,6,0,37,7,55
2024-03-05 22:00:00,3,4,0,18,9,34
2024-03-05 22:10:00,1,1,0,22,5,29
2024-03-05 22:20:00,1,5,0,27,6,39
2024-03-05 22:30:00,2,4,0,24,8,38
2024-03-05 22:40:00,0,3,0,28,9,40
2024-03-05 22:50:00,0,4,0,16,8,28
2024-03-05 23:00:00,1,7,0,15,5,28
2024-03-05 23:10:00,0,3,0,15,10,28
2024-03-05 23:20:00,1,1,0,15,4,21
2024-03-05 23:30:00,2,2,0,15,6,25
2024-03-05 23:40:00,0,1,0,9,2,12
2024-03-05 23:50:00,0,2,0,9,6,17
2024-03-06 00:00:00,2,4,0,12,2,20
2024-03-06 00:10:00,0,2,0,12,4,18
2024-03-06 00:20:00,1,0,0,5,3,9
2024-03-06 00:30:00,0,2,0,12,3,17
2024-03-06 00:40:00,0,2,0,9,3,14
2024-03-06 00:50:00,0,0,0,3,2,5
2024-03-06 01:00:00,0,0,0,14,5,19
2024-03-06 01:10:00,0,0,0,6,9,15
2024-03-06 01:20:00,0,0,0,5,1,6
2024-03-06 01:30:00,1,0,0,0,3,4
2024-03-06 01:40:00,0,2,0,5,2,9
2024-03-06 01:50:00,0,0,0,4,2,6
2024-03-06 02:00:00,0,4,0,6,2,12
2024-03-06 02:10:00,0,1,0,3,1,5
2024-03-06 02:20:00,0,0,0,9,3,12
2024-03-06 02:30:00,0,0,0,2,1,3
2024-03-06 02:40:00,0,0,0,4,1,5
2024-03-06 02:50:00,0,0,0,3,3,6
2024-03-06 03:00:00,1,2,0,4,0,7
2024-03-06 03:10:00,0,1,0,3,0,4
2024-03-06 03:20:00,0,0,0,5,0,5
2024-03-06 03:30:00,0,1,0,8,2,11
2024-03-06 03:40:00,1,0,0,2,2,5
2024-03-06 03:50:00,0,0,0,6,1,7
2024-03-06 04:00:00,0,0,0,2,2,4
2024-03-06 04:10:00,0,0,0,3,0,3
2024-03-06 04:20:00,0,0,0,2,8,10
2024-03-06 04:30:00,0,2,0,11,5,18
2024-03-06 04:40:00,0,3,0,8,5,16
2024-03-06 04:50:00,1,0,0,5,5,11
2024-03-06 05:00:00,0,1,0,9,4,14
2024-03-06 05:10:00,0,0,0,9,3,12
2024-03-06 05:20:00,1,5,0,19,4,29
2024-03-06 05:30:00,2,2,0,26,6,36
2024-03-06 05:40:00,0,0,0,28,7,35
2024-03-06 05:50:00,1,3,0,43,9,56
2024-03-06 06:00:00,1,2,0,28,10,41
2024-03-06 06:10:00,1,3,0,39,6,49
2024-03-06 06:20:00,0,2,0,38,9,49
2024-03-06 06:30:00,2,2,0,56,12,72
2024-03-06 06:40:00,2,6,0,64,13,85
2024-03-06 06:50:00,5,6,0,85,9,105
2024-03-06 07:00:00,3,8,0,74,14,99
2024-03-06 07:10:00,3,6,0,92,8,109
2024-03-06 07:20:00,7,9,0,104,14,134
2024-03-06 07:30:00,5,5,0,89,13,112
2024-03-06 07:40:00,7,14,0,113,21,155
2024-03-06 07:50:00,9,13,0,93,23,138
2024-03-06 08:00:00,4,13,0,98,10,125
2024-03-06 08:10:00,0,11,0,91,11,113
2024-03-06 08:20:00,4,13,0,103,16,136
2024-03-06 08:30:00,5,15,0,90,16,126
2024-03-06 08:40:00,3,7,0,106,11,127
2024-03-06 08:50:00,7,8,0,77,13,105
2024-03-06 09:00:00,6,8,0,92,11,117
2024-03-06 09:10:00,5,6,0,83,17,111
2024-03-06 09:20:00,3,6,0,103,11,123
2024-03-06 09:30:00,5,6,0,85,11,107
2024-03-06 09:40:00,4,9,0,99,10,122
2024-03-06 09:50:00,5,6,0,96,9,116
2024-03-06 10:00:00,2,11,0,61,10,84
2024-03-06 10:10:00,6,13,0,65,10,94
2024-03-06 10:20:00,8,12,0,70,13,103
2024-03-06 10:30:00,2,6,0,59,15,82
2024-03-06 10:40:00,6,12,0,85,18,121
2024-03-06 10:50:00,5,15,0,58,17,95
2024-03-06 11:00:00,3,14,0,64,14,95
2024-03-06 11:10:00,9,10,0,91,14,124
2024-03-06 11:20:00,4,12,0,73,11,100
2024-03-06 11:30:00,7,8,0,69,10,94
2024-03-06 11:40:00,6,9,0,74,9,98
2024-03-06 11:50:00,2,14,0,79,8,103
2024-03-06 12:00:00,2,13,0,80,13,108
2024-03-06 12:10:00,11,16,0,77,13,117
2024-03-06 12:20:00,5,10,0,71,13,99
2024-03-06 12:30:00,8,18,0,72,15,113
2024-03-06 12:40:00,6,12,0,75,10,103
2024-03-06 12:50:00,6,22,0,69,11,108
2024-03-06 13:00:00,6,16,0,56,18,96
2024-03-06 13:10:00,10,10,0,64,12,96
2024-03-06 13:20:00,8,15,0,78,12,113
2024-03-06 13:30:00,8,10,0,79,16,113
2024-03-06 13:40:00,13,12,0,76,15,116
2024-03-06 13:50:00,5,14,0,83,14,116
2024-03-06 14:00:00,3,10,0,73,5,91
2024-03-06 14:10:00,4,6,0,72,15,97
2024-03-06 14:20:00,7,12,0,73,12,104
2024-03-06 14:30:00,8,11,0,85,11,115
2024-03-06 14:40:00,6,15,0,87,15,123
2024-03-06 14:50:00,10,11,0,96,14,131
2024-03-06 15:00:00,6,8,0,79,13,106
2024-03-06 15:10:00,10,18,0,79,10,117
2024-03-06 15:20:00,10,13,0,71,9,103
2024-03-06 15:30:00,10,5,0,77,7,99
2024-03-06 15:40:00,10,9,0,89,14,122
2024-03-06 15:50:00,8,13,0,108,10,139
2024-03-06 16:00:00,8,16,0,90,21,135
2024-03-06 16:10:00,9,17,0,103,11,140
2024-03-06 16:20:00,9,16,0,71,11,107
2024-03-06 16:30:00,4,8,0,98,19,129
2024-03-06 16:40:00,14,16,0,106,17,153
2024-03-06 16:50:00,17,19,0,94,11,141
2024-03-06 17:00:00,14,19,0,75,9,117
2024-03-06 17:10:00,8,12,0,108,12,140
2024-03-06 17:20:00,10,13,0,93,10,126
2024-03-06 17:30:00,5,15,0,101,14,135
2024-03-06 17:40:00,4,11,0,89,17,121
2024-03-06 17:50:00,9,16,0,104,16,145
2024-03-06 18:00:00,11,9,0,99,13,132
2024-03-06 18:10:00,4,18,0,81,13,116
2024-03-06 18:20:00,8,10,0,89,10,117
2024-03-06 18:30:00,5,11,0,88,11,115
2024-03-06 18:40:00,7,13,0,97,12,129
2024-03-06 18:50:00,13,14,0,92,15,134
2024-03-06 19:00:00,6,12,0,63,11,92
2024-03-06 19:10:00,2,15,0,81,7,105
2024-03-06 19:20:00,2,15,0,63,9,89
2024-03-06 19:30:00,2,14,0,54,16,86
2024-03-06 19:40:00,7,11,0,57,14,89
2024-03-06 19:50:00,5,9,0,52,7,73
2024-03-06 20:00:00,1,13,0,57,12,83
2024-03-06 20:10:00,2,5,0,44,11,62
2024-03-06 20:20:00,2,8,0,42,7,59
2024-03-06 20:30:00,1,7,0,39,8,55
2024-03-06 20:40:00,3,4,0,34,15,56
2024-03-06 20:50:00,2,8,0,36,10,56
2024-03-06 21:00:00,7,8,0,36,9,60
2024-03-06 21:10:00,2,10,0,31,12,55
2024-03-06 21:20:00,3,11,0,22,8,44
2024-03-06 21:30:00,2,4,0,35,8,49
2024-03-06 21:40:00,3,6,0,26,5,40
2024-03-06 21:50:00,3,4,0,32,4,43
2024-03-06 22:00:00,0,2,0,26,4,32
2024-03-06 22:10:00,1,4,0,22,7,34
2024-03-06 22:20:00,2,8,0,28,5,43
2024-03-06 22:30:00,2,2,0,23,4,31
2024-03-06 22:40:00,0,2,0,28,7,37
2024-03-06 22:50:00,2,1,0,22,9,34
2024-03-06 23:00:00,3,3,0,14,6,26
2024-03-06 23:10:00,0,2,0,20,4,26
2024-03-06 23:20:00,2,2,0,10,4,18
2024-03-06 23:30:00,0,2,0,16,9,27
2024-03-06 23:40:00,0,2,0,13,2,17
2024-03-06 23:50:00,0,0,0,11,6,17
2024-03-07 00:00:00,0,1,0,16,4,21
2024-03-07 00:10:00,0,0,0,14,3,17
2024-03-07 00:20:00,0,3,0,7,3,13
2024-03-07 00:30:00,0,1,0,15,5,21
2024-03-07 00:40:00,0,0,0,8,0,8
2024-03-07 00:50:00,1,0,0,6,2,9
2024-03-07 01:00:00,1,0,0,11,9,21
2024-03-07 01:10:00,2,1,0,4,3,10
2024-03-07 01:20:00,0,0,0,8,4,12
2024-03-07 01:30:00,0,0,0,5,8,13
2024-03-07 01:40:00,0,0,0,7,4,11
2024-03-07 01:50:00,0,1,0,6,3,10
2024-03-07 02:00:00,0,1,0,3,3,7
2024-03-07 02:10:00,0,0,0,4,4,8
2024-03-07 02:20:00,0,1,0,8,2,11
2024-03-07 02:30:00,0,1,0,3,1,5
2024-03-07 02:40:00,0,0,0,3,2,5
2024-03-07 02:50:00,0,1,0,2,2,5
2024-03-07 03:00:00,0,0,0,2,2,4
2024-03-07 03:10:00,0,0,0,6,1,7
2024-03-07 03:20:00,0,0,0,4,4,8
2024-03-07 03:30:00,0,0,0,6,4,10
2024-03-07 03:40:00,0,0,0,3,2,5
2024-03-07 03:50:00,1,1,0,3,2,7
2024-03-07 04:00:00,0,0,0,3,2,5
2024-03-07 04:10:00,2,2,0,7,1,12
2024-03-07 04:20:00,0,0,0,10,1,11
2024-03-07 04:30:00,0,1,0,6,3,10
2024-03-07 04:40:00,1,2,0,11,11,25
2024-03-07 04:50:00,0,0,0,6,5,11
2024-03-07 05:00:00,0,1,0,13,4,18
2024-03-07 05:10:00,0,2,0,10,5,17
2024-03-07 05:20:00,0,4,0,15,4,23
2024-03-07 05:30:00,0,3,0,20,12,35
2024-03-07 05:40:00,3,4,0,23,8,38
2024-03-07 05:50:00,0,2,0,43,9,54
2024-03-07 06:00:00,2,1,0,35,9,47
2024-03-07 06:10:00,1,2,0,41,8,52
2024-03-07 06:20:00,0,2,0,57,12,71
2024-03-07 06:30:00,0,2,0,59,11,72
2024-03-07 06:40:00,1,5,0,72,9,87
2024-03-07 06:50:00,4,2,0,61,13,80
2024-03-07 07:00:00,4,11,0,84,15,114
2024-03-07 07:10:00,9,11,0,110,12,142
2024-03-07 07:20:00,1,10,0,114,12,137
2024-03-07 07:30:00,4,8,0,106,15,133
2024-03-07 07:40:00,5,9,0,129,18,161
2024-03-07 07:50:00,9,11,0,101,13,134
2024-03-07 08:00:00,7,11,0,102,11,131
2024-03-07 08:10:00,5,10,0,96,14,125
2024-03-07 08:20:00,3,11,0,113,11,138
2024-03-07 08:30:00,7,8,0,105,8,128
2024-03-07 08:40:00,2,7,0,106,11,126
2024-03-07 08:50:00,6,11,0,87,18,122
2024-03-07 09:00:00,8,9,0,69,11,97
2024-03-07 09:10:00,5,10,0,94,16,125
2024-03-07 09:20:00,7,8,0,92,16,123
2024-03-07 09:30:00,5,3,0,89,17,114
2024-03-07 09:40:00,10,11,0,61,15,97
2024-03-07 09:50:00,5,7,0,71,15,98
2024-03-07 10:00:00,6,10,0,79,11,106
2024-03-07 10:10:00,5,11,0,65,11,92
2024-03-07 10:20:00,5,14,0,88,15,122
2024-03-07 10:30:00,9,13,0,64,14,100
2024-03-07 10:40:00,6,15,0,68,16,105
2024-03-07 10:50:00,9,4,0,66,9,88
2024-03-07 11:00:00,6,11,0,63,13,93
2024-03-07 11:10:00,6,9,0,75,16,106
2024-03-07 11:20:00,10,8,0,85,9,112
2024-03-07 11:30:00,6,13,0,64,16,99
2024-03-07 11:40:00,7,17,0,76,9,109
2024-03-07 11:50:00,3,13,0,71,5,92
2024-03-07 12:00:00,5,12,0,72,8,97
2024-03-07 12:10:00,6,13,0,73,15,107
2024-03-07 12:20:00,7,11,0,93,10,121
2024-03-07 12:30:00,9,14,0,100,15,138
2024-03-07 12:40:00,8,7,0,85,15,115
2024-03-07 12:50:00,9,13,0,66,9,97
2024-03-07 13:00:00,15,14,0,81,19,129
2024-03-07 13:10:00,13,10,0,85,19,127
2024-03-07 13:20:00,3,16,0,65,9,93
2024-03-07 13:30:00,9,20,0,89,14,132
2024-03-07 13:40:00,5,10,0,101,12,128
2024-03-07 13:50:00,7,18,0,84,14,123
2024-03-07 14:00:00,7,15,0,72,13,107
2024-03-07 14:10:00,5,16,0,66,14,101
2024-03-07 14:20:00,4,9,0,81,7,101
2024-03-07 14:30:00,9,12,0,91,17,129
2024-03-07 14:40:00,10,19,0,89,12,130
2024-03-07 14:50:00,10,14,0,73,17,114
2024-03-07 15:00:00,8,11,0,96,17,132
2024-03-07 15:10:00,10,22,0,83,14,129
2024-03-07 15:20:00,13,19,0,84,11,127
2024-03-07 15:30:00,6,10,0,82,12,110
2024-03-07 15:40:00,10,9,0,97,12,128
2024-03-07 15:50:00,8,13,0,93,20,134
2024-03-07 16:00:00,9,20,0,72,12,113
2024-03-07 16:10:00,14,18,0,111,15,158
2024-03-07 16:20:00,11,18,0,83,19,131
2024-03-07 16:30:00,23,10,0,82,10,125
2024-03-07 16:40:00,16,18,0,98,8,140
2024-03-07 16:50:00,5,18,0,103,5,131
2024-03-07 17:00:00,5,23,0,96,14,138
2024-03-07 17:10:00,9,11,0,102,13,135
2024-03-07 17:20:00,5,14,0,91,11,121
2024-03-07 17:30:00,11,10,0,106,12,139
2024-03-07 17:40:00,14,19,0,92,16,141
2024-03-07 17:50:00,6,13,0,79,9,107
2024-03-07 18:00:00,3,15,0,112,18,148
2024-03-07 18:10:00,12,14,0,88,16,130
2024-03-07 18:20:00,8,15,0,114,15,152
2024-03-07 18:30:00,8,16,0,92,15,131
2024-03-07 18:40:00,7,14,0,88,20,129
2024-03-07 18:50:00,7,11,0,98,20,136
2024-03-07 19:00:00,6,14,0,65,10,95
2024-03-07 19:10:00,4,8,0,59,12,83
2024-03-07 19:20:00,8,13,0,78,6,105
2024-03-07 19:30:00,3,9,0,64,13,89
2024-03-07 19:40:00,5,9,0,55,8,77
2024-03-07 19:50:00,5,11,0,46,6,68
2024-03-07 20:00:00,1,6,0,58,7,72
2024-03-07 20:10:00,4,5,0,47,12,68
2024-03-07 20:20:00,0,2,0,59,14,75
2024-03-07 20:30:00,5,9,0,45,7,66
2024-03-07 20:40:00,0,6,0,38,16,60
2024-03-07 20:50:00,3,11,0,42,13,69
2024-03-07 21:00:00,7,10,0,43,16,76
2024-03-07 21:10:00,2,8,0,35,5,50
2024-03-07 21:20:00,3,8,0,29,14,54
2024-03-07 21:30:00,0,4,0,29,6,39
2024-03-07 21:40:00,6,11,0,32,6,55
2024-03-07 21:50:00,2,6,0,30,7,45
2024-03-07 22:00:00,3,4,0,29,4,40
2024-03-07 22:10:00,2,9,0,25,14,50
2024-03-07 22:20:00,1,5,0,33,6,45
2024-03-07 22:30:00,1,5,0,31,8,45
2024-03-07 22:40:00,1,2,0,35,1,39
2024-03-07 22:50:00,0,3,0,33,6,42
2024-03-07 23:00:00,3,5,0,22,3,33
2024-03-07 23:10:00,3,5,0,19,5,32
2024-03-07 23:20:00,1,3,0,17,10,31
2024-03-07 23:30:00,0,2,0,23,6,31
2024-03-07 23:40:00,2,2,0,19,6,29
2024-03-07 23:50:00,0,2,0,10,7,19
2024-03-08 00:00:00,0,1,0,15,6,22
2024-03-08 00:10:00,1,0,0,12,5,18
2024-03-08 00:20:00,0,2,0,7,3,12
2024-03-08 00:30:00,0,4,0,13,2,19
2024-03-08 00:40:00,0,0,0,14,4,18
2024-03-08 00:50:00,0,1,0,9,1,11
2024-03-08 01:00:00,0,2,0,5,3,10
2024-03-08 01:10:00,0,3,0,8,5,16
2024-03-08 01:20:00,0,1,0,7,1,9
2024-03-08 01:30:00,1,1,0,7,5,14
2024-03-08 01:40:00,0,0,0,8,1,9
2024-03-08 01:50:00,2,3,0,5,2,12
2024-03-08 02:00:00,0,0,0,5,2,7
2024-03-08 02:10:00,0,1,0,5,2,8
2024-03-08 02:20:00,0,0,0,4,2,6
2024-03-08 02:30:00,0,0,0,5,2,7
2024-03-08 02:40:00,0,0,0,5,4,9
2024-03-08 02:50:00,1,1,0,3,2,7
2024-03-08 03:00:00,0,0,0,6,3,9
2024-03-08 03:10:00,1,2,0,3,1,7
2024-03-08 03:20:00,0,0,0,4,2,6
2024-03-08 03:30:00,0,0,0,3,1,4
2024-03-08 03:40:00,0,1,0,2,3,6
2024-03-08 03:50:00,0,0,0,2,1,3
2024-03-08 04:00:00,1,0,0,5,3,9
2024-03-08 04:10:00,0,0,0,6,4,10
2024-03-08 04:20:00,0,0,0,8,0,8
2024-03-08 04:30:00,0,0,0,8,4,12
2024-03-08 04:40:00,1,1,0,10,4,16
2024-03-08 04:50:00,0,1,0,3,6,10
2024-03-08 05:00:00,0,3,0,8,3,14
2024-03-08 05:10:00,0,0,0,11,8,19
2024-03-08 05:20:00,0,5,0,19,6,30
2024-03-08 05:30:00,2,2,0,21,6,31
2024-03-08 05:40:00,1,2,0,39,9,51
2024-03-08 05:50:00,0,5,0,39,8,52
2024-03-08 06:00:00,0,3,0,30,10,43
2024-03-08 06:10:00,0,1,0,43,8,52
2024-03-08 06:20:00,0,0,0,47,6,53
2024-03-08 06:30:00,1,1,0,69,16,87
2024-03-08 06:40:00,2,4,0,56,7,69
2024-03-08 06:50:00,2,1,0,64,9,76
2024-03-08 07:00:00,2,6,0,76,14,98
2024-03-08 07:10:00,7,5,0,74,16,102
2024-03-08 07:20:00,6,10,0,90,14,120
2024-03-08 07:30:00,5,8,0,109,13,135
2024-03-08 07:40:00,6,7,0,108,26,147
2024-03-08 07:50:00,15,7,0,79,20,121
2024-03-08 08:00:00,2,9,0,79,17,107
2024-03-08 08:10:00,8,17,0,85,17,127
2024-03-08 08:20:00,2,11,0,91,12,116
2024-03-08 08:30:00,8,13,0,93,11,125
2024-03-08 08:40:00,6,8,0,95,13,122
2024-03-08 08:50:00,11,7,0,77,17,112
2024-03-08 09:00:00,7,9,0,72,15,103
2024-03-08 09:10:00,9,13,0,86,14,122
2024-03-08 09:20:00,5,10,0,79,10,104
2024-03-08 09:30:00,9,19,0,75,16,119
2024-03-08 09:40:00,10,10,0,99,16,135
2024-03-08 09:50:00,5,6,0,76,14,101
2024-03-08 10:00:00,2,7,0,64,14,87
2024-03-08 10:10:00,4,11,0,72,13,100
2024-03-08 10:20:00,6,12,0,88,11,117
2024-03-08 10:30:00,8,10,0,71,21,110
2024-03-08 10:40:00,1,12,0,78,12,103
2024-03-08 10:50:00,5,12,0,69,16,102
2024-03-08 11:00:00,6,11,0,67,16,100
2024-03-08 11:10:00,5,16,0,84,11,116
2024-03-08 11:20:00,8,14,0,72,12,106
2024-03-08 11:30:00,18,16,0,66,16,116
2024-03-08 11:40:00,10,13,0,92,11,126
2024-03-08 11:50:00,8,18,0,89,12,127
2024-03-08 12:00:00,10,19,0,99,20,148
2024-03-08 12:10:00,7,14,0,87,14,122
2024-03-08 12:20:00,8,8,0,64,12,92
2024-03-08 12:30:00,7,10,0,89,13,119
2024-03-08 12:40:00,8,14,0,92,14,128
2024-03-08 12:50:00,6,14,0,97,17,134
2024-03-08 13:00:00,9,14,0,72,13,108
2024-03-08 13:10:00,6,20,0,83,10,119
2024-03-08 13:20:00,8,16,0,77,21,122
2024-03-08 13:30:00,10,17,0,117,18,162
2024-03-08 13:40:00,12,14,0,108,14,148
2024-03-08 13:50:00,6,15,0,110,16,147
2024-03-08 14:00:00,10,13,0,91,12,126
2024-03-08 14:10:00,12,28,0,85,14,139
2024-03-08 14:20:00,12,26,0,77,16,131
2024-03-08 14:30:00,11,14,0,96,16,137
2024-03-08 14:40:00,5,15,0,82,14,116
2024-03-08 14:50:00,10,12,0,89,20,131
2024-03-08 15:00:00,13,16,0,86,15,130
2024-03-08 15:10:00,10,13,0,98,16,137
2024-03-08 15:20:00,10,19,0,98,16,143
2024-03-08 15:30:00,6,15,0,92,10,123
2024-03-08 15:40:00,10,13,0,100,13,136
2024-03-08 15:50:00,20,21,0,89,12,142
2024-03-08 16:00:00,12,17,0,97,12,138
2024-03-08 16:10:00,13,19,0,90,19,141
2024-03-08 16:20:00,10,20,0,98,12,140
2024-03-08 16:30:00,8,12,0,110,16,146
2024-03-08 16:40:00,14,25,0,112,8,159
2024-03-08 16:50:00,11,18,0,100,21,150
2024-03-08 17:00:00,10,19,0,98,9,136
2024-03-08 17:10:00,12,9,0,91,15,127
2024-03-08 17:20:00,11,15,0,102,10,138
2024-03-08 17:30:00,10,23,0,97,11,141
2024-03-08 17:40:00,5,17,0,116,8,146
2024-03-08 17:50:00,10,16,0,77,14,117
2024-03-08 18:00:00,10,23,0,84,16,133
2024-03-08 18:10:00,6,15,0,105,25,151
2024-03-08 18:20:00,13,16,0,110,25,164
2024-03-08 18:30:00,7,12,0,107,17,143
2024-03-08 18:40:00,6,12,0,93,12,123
2024-03-08 18:50:00,8,15,0,91,14,128
2024-03-08 19:00:00,5,11,0,92,15,123
2024-03-08 19:10:00,7,13,0,92,18,130
2024-03-08 19:20:00,4,11,0,81,11,107
2024-03-08 19:30:00,6,14,0,73,18,111
2024-03-08 19:40:00,4,10,0,69,11,94
2024-03-08 19:50:00,2,11,0,89,9,111
2024-03-08 20:00:00,4,10,0,62,13,89
2024-03-08 20:10:00,3,10,0,68,11,92
2024-03-08 20:20:00,2,8,0,64,7,81
2024-03-08 20:30:00,7,9,0,49,8,73
2024-03-08 20:40:00,19,24,0,43,9,95
2024-03-08 20:50:00,10,10,0,49,13,82
2024-03-08 21:00:00,14,15,0,44,18,91
2024-03-08 21:10:00,8,8,0,45,11,72
2024-03-08 21:20:00,7,7,0,33,10,57
2024-03-08 21:30:00,2,4,0,44,10,60
2024-03-08 21:40:00,1,5,0,40,14,60
2024-03-08 21:50:00,0,6,0,36,3,45
2024-03-08 22:00:00,3,6,0,39,9,57
2024-03-08 22:10:00,4,8,0,29,8,49
2024-03-08 22:20:00,1,5,0,42,8,56
2024-03-08 22:30:00,1,6,0,36,5,48
2024-03-08 22:40:00,4,5,0,43,2,54
2024-03-08 22:50:00,3,7,0,43,8,61
2024-03-08 23:00:00,5,8,0,35,6,54
2024-03-08 23:10:00,3,5,0,33,7,48
2024-03-08 23:20:00,2,7,0,33,9,51
2024-03-08 23:30:00,4,3,0,32,9,48
2024-03-08 23:40:00,1,1,0,22,4,28
2024-03-08 23:50:00,0,3,0,27,7,37
2024-03-09 00:00:00,1,4,0,25,12,42
2024-03-09 00:10:00,1,2,0,21,7,31
2024-03-09 00:20:00,2,2,0,21,5,30
2024-03-09 00:30:00,1,3,0,17,8,29
2024-03-09 00:40:00,0,3,0,17,7,27
2024-03-09 00:50:00,1,1,0,15,5,22
2024-03-09 01:00:00,2,3,0,12,7,24
2024-03-09 01:10:00,1,0,0,12,6,19
2024-03-09 01:20:00,0,2,0,8,7,17
2024-03-09 01:30:00,0,2,0,10,1,13
2024-03-09 01:40:00,2,3,0,11,0,16
2024-03-09 01:50:00,0,0,0,7,6,13
2024-03-09 02:00:00,0,5,0,16,5,26
2024-03-09 02:10:00,0,1,0,10,3,14
2024-03-09 02:20:00,0,0,0,10,9,19
2024-03-09 02:30:00,0,0,0,10,3,13
2024-03-09 02:40:00,0,1,0,6,3,10
2024-03-09 02:50:00,0,2,0,5,2,9
2024-03-09 03:00:00,0,2,0,3,2,7
2024-03-09 03:10:00,1,1,0,7,4,13
2024-03-09 03:20:00,1,0,0,7,2,10
2024-03-09 03:30:00,0,0,0,12,4,16
2024-03-09 03:40:00,0,2,0,8,3,13
2024-03-09 03:50:00,3,1,0,5,7,16
2024-03-09 04:00:00,0,0,0,9,6,15
2024-03-09 04:10:00,0,1,0,7,2,10
2024-03-09 04:20:00,0,1,0,2,5,8
2024-03-09 04:30:00,0,1,0,4,6,11
2024-03-09 04:40:00,0,0,0,5,5,10
2024-03-09 04:50:00,0,1,0,7,4,12
2024-03-09 05:00:00,0,1,0,5,3,9
2024-03-09 05:10:00,1,3,0,11,2,17
2024-03-09 05:20:00,0,2,0,6,4,12
2024-03-09 05:30:00,0,4,0,18,5,27
2024-03-09 05:40:00,0,0,0,16,4,20
2024-03-09 05:50:00,0,0,0,11,5,16
2024-03-09 06:00:00,2,2,0,7,3,14
2024-03-09 06:10:00,0,1,0,12,10,23
2024-03-09 06:20:00,2,3,0,14,6,25
2024-03-09 06:30:00,0,2,0,15,6,23
2024-03-09 06:40:00,1,2,0,9,2,14
2024-03-09 06:50:00,0,0,0,10,6,16
2024-03-09 07:00:00,2,2,0,20,3,27
2024-03-09 07:10:00,1,6,0,20,5,32
2024-03-09 07:20:00,0,2,0,16,5,23
2024-03-09 07:30:00,1,1,0,35,7,44
2024-03-09 07:40:00,0,5,0,26,1,32
2024-03-09 07:50:00,2,3,0,29,9,43
2024-03-09 08:00:00,2,6,0,38,3,49
2024-03-09 08:10:00,0,8,0,20,8,36
2024-03-09 08:20:00,5,10,0,23,8,46
2024-03-09 08:30:00,2,6,0,32,7,47
2024-03-09 08:40:00,5,6,0,36,8,55
2024-03-09 08:50:00,7,8,0,39,12,66
2024-03-09 09:00:00,5,6,0,42,10,63
2024-03-09 09:10:00,4,7,0,36,7,54
2024-03-09 09:20:00,3,9,0,55,11,78
2024-03-09 09:30:00,7,9,0,69,8,93
2024-03-09 09:40:00,7,15,0,70,15,107
2024-03-09 09:50:00,7,15,0,82,10,114
2024-03-09 10:00:00,8,7,0,57,5,77
2024-03-09 10:10:00,5,9,0,73,11,98
2024-03-09 10:20:00,4,18,0,73,10,105
2024-03-09 10:30:00,6,19,0,90,11,126
2024-03-09 10:40:00,6,15,0,90,14,125
2024-03-09 10:50:00,6,21,0,75,8,110
2024-03-09 11:00:00,8,18,0,76,8,110
2024-03-09 11:10:00,10,23,0,72,11,116
2024-03-09 11:20:00,10,22,0,80,18,130
2024-03-09 11:30:00,12,24,0,87,10,133
2024-03-09 11:40:00,7,17,0,95,7,126
2024-03-09 11:50:00,9,16,0,86,8,119
2024-03-09 12:00:00,12,19,0,79,11,121
2024-03-09 12:10:00,15,20,0,84,11,130
2024-03-09 12:20:00,14,31,0,80,18,143
2024-03-09 12:30:00,8,27,0,104,15,154
2024-03-09 12:40:00,10,16,0,93,14,133
2024-03-09 12:50:00,15,10,0,110,15,150
2024-03-09 13:00:00,11,17,0,101,15,144
2024-03-09 13:10:00,13,21,0,78,8,120
2024-03-09 13:20:00,9,16,0,99,10,134
2024-03-09 13:30:00,10,26,0,114,14,164
2024-03-09 13:40:00,17,17,0,84,14,132
2024-03-09 13:50:00,8,19,0,98,12,137
2024-03-09 14:00:00,7,19,0,93,7,126
2024-03-09 14:10:00,14,22,0,82,12,130
2024-03-09 14:20:00,14,23,0,96,13,146
2024-03-09 14:30:00,7,15,0,91,10,123
2024-03-09 14:40:00,6,20,0,79,15,120
2024-03-09 14:50:00,8,14,0,90,10,122
2024-03-09 15:00:00,9,17,0,93,13,132
2024-03-09 15:10:00,6,14,0,90,11,121
2024-03-09 15:20:00,9,17,0,99,15,140
2024-03-09 15:30:00,6,20,0,84,8,118
2024-03-09 15:40:00,6,17,0,72,6,101
2024-03-09 15:50:00,4,17,0,77,10,108
2024-03-09 16:00:00,5,16,0,85,9,115
2024-03-09 16:10:00,4,13,0,77,4,98
2024-03-09 16:20:00,6,17,0,74,3,100
2024-03-09 16:30:00,6,13,0,77,10,106
2024-03-09 16:40:00,6,14,0,91,10,121
2024-03-09 16:50:00,4,12,0,66,7,89
2024-03-09 17:00:00,1,14,0,87,11,113
2024-03-09 17:10:00,9,10,0,82,13,114
2024-03-09 17:20:00,8,14,0,77,9,108
2024-03-09 17:30:00,6,13,0,73,10,102
2024-03-09 17:40:00,8,14,0,104,10,136
2024-03-09 17:50:00,8,13,0,72,14,107
2024-03-09 18:00:00,7,15,0,72,10,104
2024-03-09 18:10:00,9,12,0,97,7,125
2024-03-09 18:20:00,3,15,0,97,8,123
2024-03-09 18:30:00,2,12,0,87,14,115
2024-03-09 18:40:00,9,13,0,87,11,120
2024-03-09 18:50:00,2,11,0,86,9,108
2024-03-09 19:00:00,4,8,0,90,13,115
2024-03-09 19:10:00,4,15,0,57,14,90
2024-03-09 19:20:00,5,13,0,69,7,94
2024-03-09 19:30:00,5,9,0,82,11,107
2024-03-09 19:40:00,5,9,0,72,7,93
2024-03-09 19:50:00,7,10,0,67,17,101
2024-03-09 20:00:00,1,3,0,75,13,92
2024-03-09 20:10:00,8,6,0,60,8,82
2024-03-09 20:20:00,4,7,0,42,16,69
2024-03-09 20:30:00,4,7,0,56,5,72
2024-03-09 20:40:00,1,10,0,38,12,61
2024-03-09 20:50:00,3,7,0,47,7,64
2024-03-09 21:00:00,2,7,0,41,15,65
2024-03-09 21:10:00,1,3,0,41,7,52
2024-03-09 21:20:00,5,5,0,46,10,66
2024-03-09 21:30:00,1,6,0,47,8,62
2024-03-09 21:40:00,1,7,0,37,9,54
2024-03-09 21:50:00,2,9,0,29,9,49
2024-03-09 22:00:00,1,1,0,35,8,45
2024-03-09 22:10:00,1,4,0,41,6,52
2024-03-09 22:20:00,2,4,0,27,13,46
2024-03-09 22:30:00,1,4,0,41,7,53
2024-03-09 22:40:00,1,6,0,28,2,37
2024-03-09 22:50:00,1,4,0,33,8,46
2024-03-09 23:00:00,2,6,0,39,12,59
2024-03-09 23:10:00,3,5,0,22,6,36
2024-03-09 23:20:00,0,8,0,34,9,51
2024-03-09 23:30:00,0,3,0,22,5,30
2024-03-09 23:40:00,3,2,0,28,3,36
2024-03-09 23:50:00,1,3,0,23,8,35
2024-03-10 00:00:00,0,2,0,16,13,31
2024-03-10 00:10:00,1,5,0,18,6,30
2024-03-10 00:20:00,0,0,0,26,9,35
2024-03-10 00:30:00,0,1,0,22,7,30
2024-03-10 00:40:00,0,1,0,24,6,31
2024-03-10 00:50:00,0,4,0,23,3,30
2024-03-10 01:00:00,0,1,0,15,6,22
2024-03-10 01:10:00,1,4,0,9,9,23
2024-03-10 01:20:00,4,4,0,21,8,37
2024-03-10 01:30:00,1,2,0,9,5,17
2024-03-10 01:40:00,0,2,0,10,2,14
2024-03-10 01:50:00,0,2,0,9,1,12
2024-03-10 02:00:00,0,0,0,9,7,16
2024-03-10 02:10:00,2,3,0,22,5,32
2024-03-10 02:20:00,0,1,0,11,5,17
2024-03-10 02:30:00,0,5,0,10,1,16
2024-03-10 02:40:00,0,1,0,8,6,15
2024-03-10 02:50:00,0,1,0,7,6,14
2024-03-10 03:00:00,1,1,0,9,2,13
2024-03-10 03:10:00,1,2,0,14,1,18
2024-03-10 03:20:00,0,0,0,12,9,21
2024-03-10 03:30:00,0,1,0,8,6,15
2024-03-10 03:40:00,0,2,0,11,3,16
2024-03-10 03:50:00,0,0,0,5,8,13
2024-03-10 04:00:00,0,0,0,13,4,17
2024-03-10 04:10:00,0,2,0,11,2,15
2024-03-10 04:20:00,1,3,0,10,5,19
2024-03-10 04:30:00,0,1,0,8,4,13
2024-03-10 04:40:00,1,2,0,7,3,13
2024-03-10 04:50:00,0,1,0,12,7,20
2024-03-10 05:00:00,1,1,0,6,5,13
2024-03-10 05:10:00,1,0,0,9,3,13
2024-03-10 05:20:00,2,4,0,9,4,19
2024-03-10 05:30:00,0,1,0,16,3,20
2024-03-10 05:40:00,0,1,0,12,3,16
2024-03-10 05:50:00,0,1,0,6,5,12
2024-03-10 06:00:00,0,0,0,2,1,3
2024-03-10 06:10:00,0,0,0,4,3,7
2024-03-10 06:20:00,0,1,0,8,1,10
2024-03-10 06:30:00,0,1,0,10,5,16
2024-03-10 06:40:00,0,1,0,10,1,12
2024-03-10 06:50:00,0,0,0,6,5,11
2024-03-10 07:00:00,1,1,0,7,1,10
2024-03-10 07:10:00,1,1,0,9,4,15
2024-03-10 07:20:00,0,0,0,6,3,9
2024-03-10 07:30:00,0,0,0,13,1,14
2024-03-10 07:40:00,1,1,0,11,2,15
2024-03-10 07:50:00,0,0,0,5,2,7
2024-03-10 08:00:00,0,0,0,5,3,8
2024-03-10 08:10:00,0,1,0,6,4,11
2024-03-10 08:20:00,0,0,0,12,4,16
2024-03-10 08:30:00,0,0,0,18,4,22
2024-03-10 08:40:00,1,1,0,16,2,20
2024-03-10 08:50:00,2,6,0,24,15,47
2024-03-10 09:00:00,2,3,0,19,10,34
2024-03-10 09:10:00,0,6,0,22,13,41
2024-03-10 09:20:00,2,4,0,38,26,70
2024-03-10 09:30:00,2,4,0,32,23,61
2024-03-10 09:40:00,3,9,0,41,22,75
2024-03-10 09:50:00,0,2,0,30,11,43
2024-03-10 10:00:00,4,3,0,38,8,53
2024-03-10 10:10:00,3,2,0,39,5,49
2024-03-10 10:20:00,0,2,0,24,5,31
2024-03-10 10:30:00,1,4,0,33,2,40
2024-03-10 10:40:00,1,1,0,36,5,43
2024-03-10 10:50:00,1,3,0,29,6,39
2024-03-10 11:00:00,0,7,0,39,6,52
2024-03-10 11:10:00,3,3,0,37,5,48
2024-03-10 11:20:00,3,2,0,43,6,54
2024-03-10 11:30:00,3,2,0,44,9,58
2024-03-10 11:40:00,2,5,0,35,5,47
2024-03-10 11:50:00,6,6,0,49,8,69
2024-03-10 12:00:00,14,13,0,47,6,80
2024-03-10 12:10:00,19,7,0,52,3,81
2024-03-10 12:20:00,11,11,0,55,7,84
2024-03-10 12:30:00,9,7,0,50,6,72
2024-03-10 12:40:00,6,3,0,51,5,65
2024-03-10 12:50:00,5,7,0,67,6,85
2024-03-10 13:00:00,3,4,0,56,4,67
2024-03-10 13:10:00,4,4,0,37,9,54
2024-03-10 13:20:00,3,3,0,40,12,58
2024-03-10 13:30:00,3,5,0,51,10,69
2024-03-10 13:40:00,3,7,0,55,4,69
2024-03-10 13:50:00,1,2,0,45,5,53
2024-03-10 14:00:00,1,6,0,54,9,70
2024-03-10 14:10:00,0,6,0,55,6,67
2024-03-10 14:20:00,2,6,0,46,8,62
2024-03-10 14:30:00,2,5,0,59,10,76
2024-03-10 14:40:00,1,4,0,52,1,58
2024-03-10 14:50:00,2,7,0,50,11,70
2024-03-10 15:00:00,4,6,0,68,5,83
2024-03-10 15:10:00,3,7,0,61,8,79
2024-03-10 15:20:00,3,1,0,53,9,66
2024-03-10 15:30:00,2,3,0,54,7,66
2024-03-10 15:40:00,2,12,0,54,8,76
2024-03-10 15:50:00,2,5,0,60,6,73
2024-03-10 16:00:00,2,3,0,46,12,63
2024-03-10 16:10:00,2,3,0,68,15,88
2024-03-10 16:20:00,1,9,0,52,14,76
2024-03-10 16:30:00,3,5,0,71,17,96
2024-03-10 16:40:00,4,7,0,65,18,94
2024-03-10 16:50:00,3,4,0,46,14,67
2024-03-10 17:00:00,1,1,0,58,6,66
2024-03-10 17:10:00,1,7,0,57,5,70
2024-03-10 17:20:00,2,8,0,64,5,79
2024-03-10 17:30:00,4,7,0,56,9,76
2024-03-10 17:40:00,2,6,0,57,6,71
2024-03-10 17:50:00,3,7,0,50,4,64
2024-03-10 18:00:00,7,11,0,58,8,84
2024-03-10 18:10:00,2,1,0,67,4,74
2024-03-10 18:20:00,2,3,0,54,7,66
2024-03-10 18:30:00,9,15,0,59,6,89
2024-03-10 18:40:00,12,8,0,46,8,74
2024-03-10 18:50:00,8,12,0,60,10,90
2024-03-10 19:00:00,9,12,0,42,8,71
2024-03-10 19:10:00,5,3,0,43,9,60
2024-03-10 19:20:00,6,4,0,52,11,73
2024-03-10 19:30:00,5,5,0,62,6,78
2024-03-10 19:40:00,1,6,0,54,4,65
2024-03-10 19:50:00,4,1,0,40,8,53
2024-03-10 20:00:00,1,2,0,39,6,48
2024-03-10 20:10:00,2,11,0,39,2,54
2024-03-10 20:20:00,1,4,0,38,5,48
2024-03-10 20:30:00,2,4,0,42,10,58
2024-03-10 20:40:00,3,5,0,40,5,53
2024-03-10 20:50:00,1,3,0,27,9,40
2024-03-10 21:00:00,0,2,0,42,5,49
2024-03-10 21:10:00,1,5,0,32,10,48
2024-03-10 21:20:00,0,2,0,33,10,45
2024-03-10 21:30:00,3,4,0,30,3,40
2024-03-10 21:40:00,2,8,0,39,8,57
2024-03-10 21:50:00,3,3,0,19,8,33
2024-03-10 22:00:00,2,3,0,22,4,31
2024-03-10 22:10:00,2,3,0,21,6,32
2024-03-10 22:20:00,0,5,0,19,5,29
2024-03-10 22:30:00,1,4,0,25,5,35
2024-03-10 22:40:00,0,3,0,15,4,22
2024-03-10 22:50:00,2,1,0,15,11,29
2024-03-10 23:00:00,1,1,0,12,6,20
2024-03-10 23:10:00,1,1,0,9,4,15
2024-03-10 23:20:00,0,4,0,9,8,21
2024-03-10 23:30:00,0,3,0,14,5,22
2024-03-10 23:40:00,0,1,0,14,3,18
2024-03-10 23:50:00,1,1,0,12,5,19
2024-03-11 00:00:00,1,0,0,11,9,21
2024-03-11 00:10:00,1,1,0,9,3,14
2024-03-11 00:20:00,0,2,0,8,2,12
2024-03-11 00:30:00,0,1,0,7,4,12
2024-03-11 00:40:00,0,1,0,6,2,9
2024-03-11 00:50:00,0,2,0,6,4,12
2024-03-11 01:00:00,0,2,0,8,5,15
2024-03-11 01:10:00,0,0,0,0,4,4
2024-03-11 01:20:00,0,0,0,4,1,5
2024-03-11 01:30:00,0,1,0,5,4,10
2024-03-11 01:40:00,0,0,0,5,2,7
2024-03-11 01:50:00,0,1,0,1,2,4
2024-03-11 02:00:00,0,0,0,4,5,9
2024-03-11 02:10:00,0,0,0,1,0,1
2024-03-11 02:20:00,0,2,0,4,2,8
2024-03-11 02:30:00,1,2,0,2,2,7
2024-03-11 02:40:00,0,1,0,7,3,11
2024-03-11 02:50:00,1,1,0,4,2,8
2024-03-11 03:00:00,0,1,0,3,0,4
2024-03-11 03:10:00,0,0,0,1,0,1
2024-03-11 03:20:00,0,0,0,3,0,3
2024-03-11 03:30:00,0,0,0,2,2,4
2024-03-11 03:40:00,0,0,0,3,5,8
2024-03-11 03:50:00,0,0,0,0,1,1
2024-03-11 04:00:00,0,1,0,5,2,8
2024-03-11 04:10:00,0,0,0,7,3,10
2024-03-11 04:20:00,0,0,0,7,4,11
2024-03-11 04:30:00,0,2,0,4,2,8
2024-03-11 04:40:00,0,1,0,4,11,16
2024-03-11 04:50:00,0,3,0,9,6,18
2024-03-11 05:00:00,0,1,0,12,4,17
2024-03-11 05:10:00,0,2,0,12,7,21
2024-03-11 05:20:00,1,5,0,22,7,35
2024-03-11 05:30:00,0,1,0,31,7,39
2024-03-11 05:40:00,0,2,0,32,6,40
2024-03-11 05:50:00,0,3,0,29,15,47
2024-03-11 06:00:00,0,1,0,44,8,53
2024-03-11 06:10:00,1,2,0,35,18,56
2024-03-11 06:20:00,1,3,0,47,19,70
2024-03-11 06:30:00,1,1,0,57,6,65
2024-03-11 06:40:00,0,4,0,68,13,85
2024-03-11 06:50:00,2,6,0,66,7,81
2024-03-11 07:00:00,5,8,0,76,10,99
2024-03-11 07:10:00,2,10,0,95,11,118
2024-03-11 07:20:00,8,12,0,96,8,124
2024-03-11 07:30:00,7,10,0,110,15,142
2024-03-11 07:40:00,7,6,0,102,10,125
2024-03-11 07:50:00,5,10,0,107,14,136
2024-03-11 08:00:00,10,10,0,111,14,145
2024-03-11 08:10:00,2,12,0,96,19,129
2024-03-11 08:20:00,7,14,0,94,16,131
2024-03-11 08:30:00,10,6,0,105,22,143
2024-03-11 08:40:00,8,11,0,93,23,135
2024-03-11 08:50:00,4,10,0,95,11,120
2024-03-11 09:00:00,6,10,0,76,13,105
2024-03-11 09:10:00,8,15,0,98,12,133
2024-03-11 09:20:00,7,12,0,82,14,115
2024-03-11 09:30:00,5,14,0,88,12,119
2024-03-11 09:40:00,5,7,0,76,13,101
2024-03-11 09:50:00,7,10,0,79,10,106
2024-03-11 10:00:00,3,8,0,82,12,105
2024-03-11 10:10:00,3,13,0,78,10,104
2024-03-11 10:20:00,2,11,0,75,16,104
2024-03-11 10:30:00,6,12,0,71,8,97
2024-03-11 10:40:00,4,11,0,85,12,112
2024-03-11 10:50:00,5,17,0,59,20,101
2024-03-11 11:00:00,8,16,0,75,8,107
2024-03-11 11:10:00,5,10,0,72,19,106
2024-03-11 11:20:00,7,8,0,79,8,102
2024-03-11 11:30:00,8,12,0,70,15,105
2024-03-11 11:40:00,7,15,0,80,19,121
2024-03-11 11:50:00,16,17,0,81,13,127
2024-03-11 12:00:00,10,16,0,74,19,119
2024-03-11 12:10:00,7,12,0,82,16,117
2024-03-11 12:20:00,9,17,0,55,21,102
2024-03-11 12:30:00,9,17,0,74,13,113
2024-03-11 12:40:00,10,14,0,75,24,123
2024-03-11 12:50:00,3,15,0,79,15,112
2024-03-11 13:00:00,7,20,0,65,13,105
2024-03-11 13:10:00,11,18,0,82,17,128
2024-03-11 13:20:00,9,20,0,72,15,116
2024-03-11 13:30:00,7,16,0,83,12,118
2024-03-11 13:40:00,8,20,0,90,8,126
2024-03-11 13:50:00,8,8,0,79,15,110
2024-03-11 14:00:00,3,7,0,70,7,87
2024-03-11 14:10:00,4,12,0,91,7,114
2024-03-11 14:20:00,6,11,0,98,12,127
2024-03-11 14:30:00,8,12,0,75,16,111
2024-03-11 14:40:00,6,12,0,76,11,105
2024-03-11 14:50:00,10,18,0,74,18,120
2024-03-11 15:00:00,5,13,0,97,19,134
2024-03-11 15:10:00,7,15,0,82,17,121
2024-03-11 15:20:00,11,13,0,81,13,118
2024-03-11 15:30:00,2,15,0,84,17,118
2024-03-11 15:40:00,12,19,0,89,15,135
2024-03-11 15:50:00,8,22,0,89,15,134
2024-03-11 16:00:00,8,18,0,99,14,139
2024-03-11 16:10:00,15,15,0,102,12,144
2024-03-11 16:20:00,7,8,0,87,13,115
2024-03-11 16:30:00,11,13,0,103,9,136
2024-03-11 16:40:00,7,14,0,97,10,128
2024-03-11 16:50:00,6,16,0,86,16,124
2024-03-11 17:00:00,8,23,0,91,11,133
2024-03-11 17:10:00,9,11,0,88,14,122
2024-03-11 17:20:00,21,20,0,115,27,183
2024-03-11 17:30:00,7,15,0,93,17,132
2024-03-11 17:40:00,12,17,0,96,9,134
2024-03-11 17:50:00,7,9,0,86,14,116
2024-03-11 18:00:00,9,12,0,84,12,117
2024-03-11 18:10:00,3,8,0,93,14,118
2024-03-11 18:20:00,5,15,0,78,12,110
2024-03-11 18:30:00,3,7,0,74,19,103
2024-03-11 18:40:00,4,13,0,65,15,97
2024-03-11 18:50:00,11,12,0,60,19,102
2024-03-11 19:00:00,7,11,0,69,13,100
2024-03-11 19:10:00,6,13,0,50,6,75
2024-03-11 19:20:00,3,8,0,62,7,80
2024-03-11 19:30:00,0,12,0,52,3,67
2024-03-11 19:40:00,5,9,0,48,13,75
2024-03-11 19:50:00,4,7,0,47,6,64
2024-03-11 20:00:00,3,8,0,40,12,63
2024-03-11 20:10:00,4,8,0,45,7,64
2024-03-11 20:20:00,1,10,0,41,12,64
2024-03-11 20:30:00,3,10,0,38,10,61
2024-03-11 20:40:00,1,7,0,31,5,44
2024-03-11 20:50:00,13,12,0,23,11,59
2024-03-11 21:00:00,7,5,0,35,16,63
2024-03-11 21:10:00,6,5,0,29,7,47
2024-03-11 21:20:00,6,10,0,30,11,57
2024-03-11 21:30:00,5,2,0,22,9,38
2024-03-11 21:40:00,2,6,0,32,7,47
2024-03-11 21:50:00,3,5,0,29,8,45
2024-03-11 22:00:00,2,2,0,24,10,38
2024-03-11 22:10:00,0,3,0,25,4,32
2024-03-11 22:20:00,0,3,0,18,5,26
2024-03-11 22:30:00,2,3,0,20,5,30
2024-03-11 22:40:00,0,2,0,28,6,36
2024-03-11 22:50:00,1,3,0,14,7,25
2024-03-11 23:00:00,1,1,0,21,7,30
2024-03-11 23:10:00,0,4,0,13,2,19
2024-03-11 23:20:00,1,1,0,20,3,25
2024-03-11 23:30:00,0,5,0,14,7,26
2024-03-11 23:40:00,0,1,0,6,5,12
2024-03-11 23:50:00,0,0,0,13,10,23
2024-03-12 00:00:00,1,1,0,14,6,22
2024-03-12 00:10:00,0,2,0,7,2,11
2024-03-12 00:20:00,0,1,0,8,3,12
2024-03-12 00:30:00,0,0,0,12,2,14
2024-03-12 00:40:00,0,0,0,8,1,9
2024-03-12 00:50:00,1,0,0,6,1,8
2024-03-12 01:00:00,0,0,0,10,3,13
2024-03-12 01:10:00,0,0,0,7,4,11
2024-03-12 01:20:00,0,0,0,2,5,7
2024-03-12 01:30:00,0,0,0,3,1,4
2024-03-12 01:40:00,0,1,0,3,1,5
2024-03-12 01:50:00,0,0,0,3,0,3
2024-03-12 02:00:00,0,1,0,10,10,21
2024-03-12 02:10:00,0,0,0,0,1,1
2024-03-12 02:20:00,0,0,0,7,4,11
2024-03-12 02:30:00,0,0,0,3,2,5
2024-03-12 02:40:00,0,0,0,5,3,8
2024-03-12 02:50:00,0,1,0,3,1,5
2024-03-12 03:00:00,0,0,0,3,1,4
2024-03-12 03:10:00,0,1,0,2,5,8
2024-03-12 03:20:00,0,0,0,3,0,3
2024-03-12 03:30:00,0,0,0,7,2,9
2024-03-12 03:40:00,0,0,0,2,2,4
2024-03-12 03:50:00,0,0,0,3,2,5
2024-03-12 04:00:00,0,0,0,2,1,3
2024-03-12 04:10:00,0,0,0,4,1,5
2024-03-12 04:20:00,0,0,0,5,0,5
2024-03-12 04:30:00,0,0,0,1,0,1
2024-03-12 04:40:00,1,3,0,5,6,15
2024-03-12 04:50:00,0,0,0,8,4,12
2024-03-12 05:00:00,0,1,0,8,1,10
2024-03-12 05:10:00,0,3,0,15,6,24
2024-03-12 05:20:00,0,3,0,20,6,29
2024-03-12 05:30:00,1,3,0,29,2,35
2024-03-12 05:40:00,0,4,0,39,7,50
2024-03-12 05:50:00,0,8,0,36,12,56
2024-03-12 06:00:00,1,1,0,33,7,42
2024-03-12 06:10:00,2,2,0,46,8,58
2024-03-12 06:20:00,0,3,0,46,5,54
2024-03-12 06:30:00,2,2,0,74,15,93
2024-03-12 06:40:00,3,1,0,58,9,71
2024-03-12 06:50:00,3,5,0,67,11,86
2024-03-12 07:00:00,1,6,0,106,9,122
2024-03-12 07:10:00,4,10,0,109,12,135
2024-03-12 07:20:00,5,11,0,94,10,120
2024-03-12 07:30:00,4,9,0,127,16,156
2024-03-12 07:40:00,4,8,0,111,22,145
2024-03-12 07:50:00,4,14,0,90,14,122
2024-03-12 08:00:00,9,7,0,94,11,121
2024-03-12 08:10:00,4,7,0,66,15,92
2024-03-12 08:20:00,5,12,0,95,15,127
2024-03-12 08:30:00,10,15,0,90,20,135
2024-03-12 08:40:00,2,11,0,104,11,128
2024-03-12 08:50:00,4,13,0,75,15,107
2024-03-12 09:00:00,5,10,0,62,19,96
2024-03-12 09:10:00,4,9,0,82,20,115
2024-03-12 09:20:00,4,6,0,75,10,95
2024-03-12 09:30:00,8,10,0,67,9,94
2024-03-12 09:40:00,6,9,0,91,11,117
2024-03-12 09:50:00,5,14,0,75,14,108
2024-03-12 10:00:00,3,10,0,62,9,84
2024-03-12 10:10:00,5,14,0,80,14,113
2024-03-12 10:20:00,3,20,0,69,10,102
2024-03-12 10:30:00,3,9,0,85,9,106
2024-03-12 10:40:00,7,12,0,74,12,105
2024-03-12 10:50:00,2,11,0,64,17,94
2024-03-12 11:00:00,5,11,0,66,12,94
2024-03-12 11:10:00,3,9,0,69,13,94
2024-03-12 11:20:00,4,4,0,72,10,90
2024-03-12 11:30:00,5,10,0,78,20,113
2024-03-12 11:40:00,6,17,0,69,8,100
2024-03-12 11:50:00,7,19,0,73,10,109
2024-03-12 12:00:00,10,9,0,73,10,102
2024-03-12 12:10:00,11,15,0,67,12,105
2024-03-12 12:20:00,9,17,0,60,16,102
2024-03-12 12:30:00,6,20,0,69,11,106
2024-03-12 12:40:00,4,9,0,65,14,92
2024-03-12 12:50:00,4,10,0,76,17,107
2024-03-12 13:00:00,15,15,0,72,12,114
2024-03-12 13:10:00,7,21,0,72,12,112
2024-03-12 13:20:00,7,9,0,74,17,107
2024-03-12 13:30:00,5,14,0,84,18,121
2024-03-12 13:40:00,4,13,0,85,12,114
2024-03-12 13:50:00,7,9,0,76,10,102
2024-03-12 14:00:00,3,7,0,81,17,108
2024-03-12 14:10:00,7,8,0,80,15,110
2024-03-12 14:20:00,10,16,0,85,10,121
2024-03-12 14:30:00,8,9,0,92,9,118
2024-03-12 14:40:00,11,13,0,83,10,117
2024-03-12 14:50:00,6,13,0,70,12,101
2024-03-12 15:00:00,5,10,0,73,17,105
2024-03-12 15:10:00,8,11,0,90,12,121
2024-03-12 15:20:00,9,21,0,78,13,121
2024-03-12 15:30:00,8,17,0,95,14,134
2024-03-12 15:40:00,10,18,0,92,21,141
2024-03-12 15:50:00,14,19,0,93,14,140
2024-03-12 16:00:00,10,15,0,81,15,121
2024-03-12 16:10:00,19,13,0,96,10,138
2024-03-12 16:20:00,10,9,0,75,14,108
2024-03-12 16:30:00,14,21,0,110,17,162
2024-03-12 16:40:00,10,21,0,84,21,136
2024-03-12 16:50:00,7,17,0,97,10,131
2024-03-12 17:00:00,7,14,0,82,14,117
2024-03-12 17:10:00,14,13,0,95,13,135
2024-03-12 17:20:00,14,18,0,110,22,164
2024-03-12 17:30:00,10,17,0,126,11,164
2024-03-12 17:40:00,8,10,0,93,12,123
2024-03-12 17:50:00,12,12,0,96,14,134
2024-03-12 18:00:00,4,13,0,98,13,128
2024-03-12 18:10:00,6,22,0,93,12,133
2024-03-12 18:20:00,5,8,0,88,9,110
2024-03-12 18:30:00,3,9,0,72,13,97
2024-03-12 18:40:00,8,14,0,74,15,111
2024-03-12 18:50:00,5,12,0,59,16,92
2024-03-12 19:00:00,2,8,0,72,6,88
2024-03-12 19:10:00,3,13,0,66,15,97
2024-03-12 19:20:00,6,10,0,66,6,88
2024-03-12 19:30:00,4,4,0,66,9,83
2024-03-12 19:40:00,4,8,0,68,13,93
2024-03-12 19:50:00,2,10,0,50,11,73
2024-03-12 20:00:00,5,5,0,29,12,51
2024-03-12 20:10:00,3,15,0,36,6,60
2024-03-12 20:20:00,4,5,0,53,7,69
2024-03-12 20:30:00,2,7,0,40,10,59
2024-03-12 20:40:00,3,6,0,42,6,57
2024-03-12 20:50:00,1,2,0,35,7,45
2024-03-12 21:00:00,3,6,0,33,8,50
2024-03-12 21:10:00,2,6,0,44,13,65
2024-03-12 21:20:00,0,3,0,29,8,40
2024-03-12 21:30:00,1,9,0,35,8,53
2024-03-12 21:40:00,3,5,0,24,3,35
2024-03-12 21:50:00,5,3,0,23,8,39
2024-03-12 22:00:00,3,5,0,26,10,44
2024-03-12 22:10:00,0,2,0,15,11,28
2024-03-12 22:20:00,4,3,0,30,10,47
2024-03-12 22:30:00,2,6,0,20,3,31
2024-03-12 22:40:00,2,2,0,30,11,45
2024-03-12 22:50:00,1,1,0,24,5,31
2024-03-12 23:00:00,3,4,0,13,11,31
2024-03-12 23:10:00,2,3,0,12,6,23
2024-03-12 23:20:00,0,0,0,17,6,23
2024-03-12 23:30:00,0,1,0,14,2,17
2024-03-12 23:40:00,0,2,0,12,2,16
2024-03-12 23:50:00,2,2,0,10,9,23
2024-03-13 00:00:00,0,2,0,11,2,15
2024-03-13 00:10:00,0,1,0,9,2,12
2024-03-13 00:20:00,0,2,0,6,3,11
2024-03-13 00:30:00,0,1,0,9,3,13
2024-03-13 00:40:00,0,1,0,6,5,12
2024-03-13 00:50:00,0,0,0,3,3,6
2024-03-13 01:00:00,2,1,0,5,5,13
2024-03-13 01:10:00,0,1,0,10,3,14
2024-03-13 01:20:00,1,0,0,2,2,5
2024-03-13 01:30:00,0,0,0,4,0,4
2024-03-13 01:40:00,0,0,0,4,2,6
2024-03-13 01:50:00,1,0,0,1,0,2
2024-03-13 02:00:00,0,0,0,4,0,4
2024-03-13 02:10:00,1,0,0,2,1,4
2024-03-13 02:20:00,0,1,0,3,4,8
2024-03-13 02:30:00,0,2,0,1,5,8
2024-03-13 02:40:00,0,1,0,4,3,8
2024-03-13 02:50:00,1,1,0,3,3,8
2024-03-13 03:00:00,1,1,0,2,0,4
2024-03-13 03:10:00,0,0,0,3,0,3
2024-03-13 03:20:00,0,0,0,4,1,5
2024-03-13 03:30:00,0,0,0,2,2,4
2024-03-13 03:40:00,0,0,0,3,1,4
2024-03-13 03:50:00,0,0,0,6,3,9
2024-03-13 04:00:00,0,0,0,4,0,4
2024-03-13 04:10:00,0,0,0,3,0,3
2024-03-13 04:20:00,0,2,0,7,2,11
2024-03-13 04:30:00,0,1,0,10,0,11
2024-03-13 04:40:00,0,3,0,8,3,14
2024-03-13 04:50:00,0,0,0,6,5,11
2024-03-13 05:00:00,0,3,0,14,0,17
2024-03-13 05:10:00,1,2,0,11,3,17
2024-03-13 05:20:00,0,3,0,13,5,21
2024-03-13 05:30:00,0,6,0,25,4,35
2024-03-13 05:40:00,2,2,0,37,8,49
2024-03-13 05:50:00,1,2,0,34,9,46
2024-03-13 06:00:00,0,1,0,39,7,47
2024-03-13 06:10:00,2,2,0,41,5,50
2024-03-13 06:20:00,0,3,0,49,7,59
2024-03-13 06:30:00,4,5,0,58,8,75
2024-03-13 06:40:00,2,4,0,69,9,84
2024-03-13 06:50:00,0,4,0,71,6,81
2024-03-13 07:00:00,4,9,0,103,14,130
2024-03-13 07:10:00,4,9,0,78,11,102
2024-03-13 07:20:00,3,11,0,100,10,124
2024-03-13 07:30:00,7,7,0,114,14,142
2024-03-13 07:40:00,8,14,0,94,23,139
2024-03-13 07:50:00,6,9,0,85,14,114
2024-03-13 08:00:00,1,4,0,98,19,122
2024-03-13 08:10:00,8,10,0,104,15,137
2024-03-13 08:20:00,4,9,0,77,14,104
2024-03-13 08:30:00,2,8,0,88,13,111
2024-03-13 08:40:00,5,10,0,111,14,140
2024-03-13 08:50:00,6,11,0,95,12,124
2024-03-13 09:00:00,4,11,0,80,12,107
2024-03-13 09:10:00,5,12,0,75,12,104
2024-03-13 09:20:00,8,11,0,78,8,105
2024-03-13 09:30:00,2,9,0,93,15,119
2024-03-13 09:40:00,4,8,0,82,19,113
2024-03-13 09:50:00,8,15,0,72,13,108
2024-03-13 10:00:00,7,11,0,76,12,106
2024-03-13 10:10:00,3,6,0,82,11,102
2024-03-13 10:20:00,4,9,0,52,12,77
2024-03-13 10:30:00,7,12,0,97,11,127
2024-03-13 10:40:00,6,10,0,71,15,102
2024-03-13 10:50:00,7,12,0,64,11,94
2024-03-13 11:00:00,9,17,0,61,14,101
2024-03-13 11:10:00,3,16,0,80,11,110
2024-03-13 11:20:00,5,13,0,69,13,100
2024-03-13 11:30:00,4,12,0,78,8,102
2024-03-13 11:40:00,6,10,0,86,8,110
2024-03-13 11:50:00,6,16,0,66,9,97
2024-03-13 12:00:00,4,12,0,75,18,109
2024-03-13 12:10:00,7,13,0,60,13,93
2024-03-13 12:20:00,6,14,0,53,15,88
2024-03-13 12:30:00,4,12,0,64,12,92
2024-03-13 12:40:00,9,21,0,77,9,116
2024-03-13 12:50:00,4,11,0,84,9,108
2024-03-13 13:00:00,5,13,0,64,12,94
2024-03-13 13:10:00,13,19,0,86,13,131
2024-03-13 13:20:00,12,11,0,67,13,103
2024-03-13 13:30:00,7,10,0,64,16,97
2024-03-13 13:40:00,9,8,0,68,12,97
2024-03-13 13:50:00,5,17,0,65,10,97
2024-03-13 14:00:00,5,12,0,77,12,106
2024-03-13 14:10:00,8,9,0,86,15,118
2024-03-13 14:20:00,12,12,0,92,17,133
2024-03-13 14:30:00,6,13,0,77,15,111
2024-03-13 14:40:00,11,18,0,87,13,129
2024-03-13 14:50:00,10,18,0,94,22,144
2024-03-13 15:00:00,11,8,0,95,14,128
2024-03-13 15:10:00,15,12,0,88,12,127
2024-03-13 15:20:00,9,15,0,78,11,113
2024-03-13 15:30:00,4,16,0,79,10,109
2024-03-13 15:40:00,11,15,0,99,18,143
2024-03-13 15:50:00,9,17,0,78,16,120
2024-03-13 16:00:00,4,14,0,78,13,109
2024-03-13 16:10:00,10,20,0,97,14,141
2024-03-13 16:20:00,10,19,0,95,20,144
2024-03-13 16:30:00,5,12,0,95,15,127
2024-03-13 16:40:00,8,14,0,101,20,143
2024-03-13 16:50:00,8,16,0,91,6,121
2024-03-13 17:00:00,7,17,0,98,17,139
2024-03-13 17:10:00,14,23,0,85,6,128
2024-03-13 17:20:00,13,17,0,99,15,144
2024-03-13 17:30:00,10,18,0,94,16,138
2024-03-13 17:40:00,22,27,0,96,17,162
2024-03-13 17:50:00,17,15,0,78,14,124
2024-03-13 18:00:00,12,8,0,102,13,135
2024-03-13 18:10:00,11,17,0,100,12,140
2024-03-13 18:20:00,9,11,0,87,9,116
2024-03-13 18:30:00,6,13,0,90,10,119
2024-03-13 18:40:00,5,15,0,85,10,115
2024-03-13 18:50:00,2,11,0,74,15,102
2024-03-13 19:00:00,9,16,0,68,16,109
2024-03-13 19:10:00,7,10,0,68,15,100
2024-03-13 19:20:00,4,15,0,49,3,71
2024-03-13 19:30:00,4,11,0,69,10,94
2024-03-13 19:40:00,3,8,0,50,10,71
2024-03-13 19:50:00,3,7,0,66,3,79
2024-03-13 20:00:00,1,13,0,43,8,65
2024-03-13 20:10:00,0,7,0,44,8,59
2024-03-13 20:20:00,2,7,0,44,9,62
2024-03-13 20:30:00,2,8,0,44,6,60
2024-03-13 20:40:00,4,4,0,30,9,47
2024-03-13 20:50:00,1,4,0,30,6,41
2024-03-13 21:00:00,2,9,0,37,12,60
2024-03-13 21:10:00,4,5,0,33,8,50
2024-03-13 21:20:00,5,4,0,24,9,42
2024-03-13 21:30:00,2,3,0,22,8,35
2024-03-13 21:40:00,2,3,0,26,6,37
2024-03-13 21:50:00,2,5,0,19,6,32
2024-03-13 22:00:00,3,7,0,26,7,43
2024-03-13 22:10:00,3,1,0,17,4,25
2024-03-13 22:20:00,2,7,0,33,5,47
2024-03-13 22:30:00,2,6,0,23,13,44
2024-03-13 22:40:00,5,9,0,41,6,61
2024-03-13 22:50:00,0,4,0,12,7,23
2024-03-13 23:00:00,0,2,0,27,6,35
2024-03-13 23:10:00,0,3,0,24,4,31
2024-03-13 23:20:00,0,1,0,13,4,18
2024-03-13 23:30:00,0,5,0,17,4,26
2024-03-13 23:40:00,1,4,0,10,1,16
2024-03-13 23:50:00,0,0,0,8,5,13
2024-03-14 00:00:00,0,2,0,15,3,20
2024-03-14 00:10:00,0,1,0,14,4,19
2024-03-14 00:20:00,0,1,0,9,1,11
2024-03-14 00:30:00,0,0,0,4,5,9
2024-03-14 00:40:00,0,2,0,6,2,10
2024-03-14 00:50:00,0,2,0,5,4,11
2024-03-14 01:00:00,0,1,0,6,5,12
2024-03-14 01:10:00,1,1,0,4,4,10
2024-03-14 01:20:00,1,0,0,6,5,12
2024-03-14 01:30:00,1,2,0,3,4,10
2024-03-14 01:40:00,0,2,0,5,5,12
2024-03-14 01:50:00,0,0,0,0,3,3
2024-03-14 02:00:00,0,0,0,3,2,5
2024-03-14 02:10:00,1,0,0,2,1,4
2024-03-14 02:20:00,0,0,0,2,5,7
2024-03-14 02:30:00,1,0,0,8,0,9
2024-03-14 02:40:00,1,2,0,2,1,6
2024-03-14 02:50:00,0,0,0,6,2,8
2024-03-14 03:00:00,0,0,0,2,3,5
2024-03-14 03:10:00,0,1,0,4,3,8
2024-03-14 03:20:00,0,0,0,2,2,4
2024-03-14 03:30:00,2,0,0,3,3,8
2024-03-14 03:40:00,0,1,0,4,3,8
2024-03-14 03:50:00,0,1,0,3,0,4
2024-03-14 04:00:00,0,0,0,3,2,5
2024-03-14 04:10:00,0,0,0,10,0,10
2024-03-14 04:20:00,0,0,0,6,1,7
2024-03-14 04:30:00,0,1,0,4,3,8
2024-03-14 04:40:00,1,2,0,5,0,8
2024-03-14 04:50:00,1,3,0,7,6,17
2024-03-14 05:00:00,0,2,0,10,2,14
2024-03-14 05:10:00,2,1,0,11,4,18
2024-03-14 05:20:00,0,4,0,24,2,30
2024-03-14 05:30:00,1,1,0,26,12,40
2024-03-14 05:40:00,0,2,0,30,7,39
2024-03-14 05:50:00,0,2,0,32,7,41
2024-03-14 06:00:00,0,2,0,39,5,46
2024-03-14 06:10:00,0,2,0,38,4,44
2024-03-14 06:20:00,0,2,0,42,7,51
2024-03-14 06:30:00,1,4,0,55,11,71
2024-03-14 06:40:00,3,7,0,61,11,82
2024-03-14 06:50:00,0,4,0,76,12,92
2024-03-14 07:00:00,2,7,0,89,14,112
2024-03-14 07:10:00,2,9,0,85,12,108
2024-03-14 07:20:00,5,7,0,80,14,106
2024-03-14 07:30:00,8,9,0,109,13,139
2024-03-14 07:40:00,11,8,0,102,19,140
2024-03-14 07:50:00,7,9,0,107,20,143
2024-03-14 08:00:00,8,10,0,85,15,118
2024-03-14 08:10:00,7,9,0,91,18,125
2024-03-14 08:20:00,13,14,0,106,14,147
2024-03-14 08:30:00,8,15,0,84,15,122
2024-03-14 08:40:00,2,10,0,97,12,121
2024-03-14 08:50:00,2,8,0,81,13,104
2024-03-14 09:00:00,2,5,0,91,9,107
2024-03-14 09:10:00,7,7,0,76,14,104
2024-03-14 09:20:00,6,10,0,90,14,120
2024-03-14 09:30:00,5,8,0,86,9,108
2024-03-14 09:40:00,6,12,0,98,16,132
2024-03-14 09:50:00,7,10,0,75,17,109
2024-03-14 10:00:00,1,7,0,80,15,103
2024-03-14 10:10:00,6,14,0,72,17,109
2024-03-14 10:20:00,5,8,0,61,15,89
2024-03-14 10:30:00,3,11,0,81,11,106
2024-03-14 10:40:00,5,10,0,82,7,104
2024-03-14 10:50:00,9,8,0,76,13,106
2024-03-14 11:00:00,5,5,0,76,11,97
2024-03-14 11:10:00,7,20,0,68,10,105
2024-03-14 11:20:00,7,16,0,68,14,105
2024-03-14 11:30:00,4,13,0,85,8,110
2024-03-14 11:40:00,3,12,0,70,17,102
2024-03-14 11:50:00,10,14,0,70,15,109
2024-03-14 12:00:00,13,16,0,79,16,124
2024-03-14 12:10:00,5,18,0,78,17,118
2024-03-14 12:20:00,7,13,0,74,10,104
2024-03-14 12:30:00,7,19,0,54,11,91
2024-03-14 12:40:00,9,20,0,79,11,119
2024-03-14 12:50:00,14,15,0,86,13,128
2024-03-14 13:00:00,14,14,0,76,14,118
2024-03-14 13:10:00,10,14,0,72,8,104
2024-03-14 13:20:00,11,12,0,71,7,101
2024-03-14 13:30:00,10,10,0,68,11,99
2024-03-14 13:40:00,6,16,0,91,10,123
2024-03-14 13:50:00,9,9,0,83,15,116
2024-03-14 14:00:00,6,16,0,74,14,110
2024-03-14 14:10:00,8,13,0,89,17,127
2024-03-14 14:20:00,8,7,0,85,16,116
2024-03-14 14:30:00,9,7,0,81,15,112
2024-03-14 14:40:00,5,10,0,84,15,114
2024-03-14 14:50:00,8,15,0,80,16,119
2024-03-14 15:00:00,4,14,0,89,26,133
2024-03-14 15:10:00,8,13,0,83,16,120
2024-03-14 15:20:00,5,12,0,82,9,108
2024-03-14 15:30:00,10,15,0,85,12,122
2024-03-14 15:40:00,4,6,0,106,13,129
2024-03-14 15:50:00,5,10,0,82,8,105
2024-03-14 16:00:00,8,18,0,92,15,133
2024-03-14 16:10:00,11,14,0,91,11,127
2024-03-14 16:20:00,6,10,0,86,18,120
2024-03-14 16:30:00,14,21,0,103,14,152
2024-03-14 16:40:00,9,8,0,68,13,98
2024-03-14 16:50:00,11,19,0,87,15,132
2024-03-14 17:00:00,12,17,0,91,14,134
2024-03-14 17:10:00,5,7,0,89,14,115
2024-03-14 17:20:00,18,23,0,99,9,149
2024-03-14 17:30:00,10,17,0,103,21,151
2024-03-14 17:40:00,5,15,0,88,18,126
2024-03-14 17:50:00,4,18,0,93,16,131
2024-03-14 18:00:00,7,15,0,106,17,145
2024-03-14 18:10:00,10,14,0,109,14,147
2024-03-14 18:20:00,6,12,0,86,12,116
2024-03-14 18:30:00,9,9,0,93,13,124
2024-03-14 18:40:00,5,11,0,76,14,106
2024-03-14 18:50:00,3,12,0,58,16,89
2024-03-14 19:00:00,5,9,0,58,14,86
2024-03-14 19:10:00,6,17,0,58,7,88
2024-03-14 19:20:00,3,6,0,60,6,75
2024-03-14 19:30:00,1,8,0,57,12,78
2024-03-14 19:40:00,1,12,0,58,16,87
2024-03-14 19:50:00,3,5,0,56,11,75
2024-03-14 20:00:00,2,8,0,45,7,62
2024-03-14 20:10:00,4,9,0,49,8,70
2024-03-14 20:20:00,2,12,0,45,13,72
2024-03-14 20:30:00,3,6,0,49,8,66
2024-03-14 20:40:00,1,7,0,41,11,60
2024-03-14 20:50:00,1,5,0,37,12,55
2024-03-14 21:00:00,0,6,0,35,9,50
2024-03-14 21:10:00,3,7,0,35,11,56
2024-03-14 21:20:00,8,9,0,27,9,53
2024-03-14 21:30:00,7,7,0,46,10,70
2024-03-14 21:40:00,3,5,0,29,7,44
2024-03-14 21:50:00,3,3,0,23,9,38
2024-03-14 22:00:00,2,7,0,25,10,44
2024-03-14 22:10:00,1,3,0,16,8,28
2024-03-14 22:20:00,2,2,0,35,11,50
2024-03-14 22:30:00,1,4,0,37,5,47
2024-03-14 22:40:00,2,4,0,24,4,34
2024-03-14 22:50:00,1,4,0,22,8,35
2024-03-14 23:00:00,1,3,0,30,6,40
2024-03-14 23:10:00,3,3,0,17,8,31
2024-03-14 23:20:00,1,2,0,17,11,31
2024-03-14 23:30:00,1,2,0,16,5,24
2024-03-14 23:40:00,0,1,0,15,2,18
2024-03-14 23:50:00,1,3,0,19,10,33
2024-03-15 00:00:00,0,3,0,12,3,18
2024-03-15 00:10:00,0,1,0,14,3,18
2024-03-15 00:20:00,0,0,0,7,7,14
2024-03-15 00:30:00,0,1,0,11,1,13
2024-03-15 00:40:00,0,0,0,6,5,11
2024-03-15 00:50:00,0,2,0,8,7,17
2024-03-15 01:00:00,0,1,0,5,3,9
2024-03-15 01:10:00,0,0,0,9,5,14
2024-03-15 01:20:00,0,1,0,5,2,8
2024-03-15 01:30:00,3,0,0,1,1,5
2024-03-15 01:40:00,0,0,0,5,2,7
2024-03-15 01:50:00,0,2,0,1,2,5
2024-03-15 02:00:00,0,0,0,4,2,6
2024-03-15 02:10:00,0,0,0,1,2,3
2024-03-15 02:20:00,0,1,0,2,5,8
2024-03-15 02:30:00,0,0,0,6,4,10
2024-03-15 02:40:00,0,0,0,4,2,6
2024-03-15 02:50:00,1,1,0,3,2,7
2024-03-15 03:00:00,0,2,0,4,0,6
2024-03-15 03:10:00,0,0,0,5,0,5
2024-03-15 03:20:00,0,0,0,7,2,9
2024-03-15 03:30:00,1,0,0,4,3,8
2024-03-15 03:40:00,0,0,0,0,6,6
2024-03-15 03:50:00,0,0,0,2,1,3
2024-03-15 04:00:00,0,0,0,2,4,6
2024-03-15 04:10:00,0,0,0,7,2,9
2024-03-15 04:20:00,0,0,0,5,2,7
2024-03-15 04:30:00,1,0,0,5,5,11
2024-03-15 04:40:00,0,1,0,7,3,11
2024-03-15 04:50:00,0,2,0,6,3,11
2024-03-15 05:00:00,0,0,0,9,0,9
2024-03-15 05:10:00,1,1,0,11,9,22
2024-03-15 05:20:00,1,4,0,15,7,27
2024-03-15 05:30:00,1,1,0,30,8,40
2024-03-15 05:40:00,0,2,0,27,7,36
2024-03-15 05:50:00,0,3,0,38,9,50
2024-03-15 06:00:00,0,2,0,33,8,43
2024-03-15 06:10:00,0,2,0,42,5,49
2024-03-15 06:20:00,0,4,0,36,7,47
2024-03-15 06:30:00,2,5,0,40,13,60
2024-03-15 06:40:00,3,2,0,46,9,60
2024-03-15 06:50:00,0,3,0,76,9,88
2024-03-15 07:00:00,3,5,0,70,13,91
2024-03-15 07:10:00,4,11,0,88,8,111
2024-03-15 07:20:00,3,11,0,87,17,118
2024-03-15 07:30:00,5,6,0,97,20,128
2024-03-15 07:40:00,6,16,0,98,25,145
2024-03-15 07:50:00,10,10,0,93,15,128
2024-03-15 08:00:00,6,7,0,90,7,110
2024-03-15 08:10:00,5,12,0,79,21,117
2024-03-15 08:20:00,3,10,0,81,11,105
2024-03-15 08:30:00,6,7,0,88,13,114
2024-03-15 08:40:00,9,11,0,97,18,135
2024-03-15 08:50:00,12,15,0,104,6,137
2024-03-15 09:00:00,4,10,0,79,19,112
2024-03-15 09:10:00,7,4,0,76,14,101
2024-03-15 09:20:00,6,10,0,80,11,107
2024-03-15 09:30:00,5,10,0,80,13,108
2024-03-15 09:40:00,6,11,0,86,12,115
2024-03-15 09:50:00,6,12,0,67,11,96
2024-03-15 10:00:00,6,17,0,71,13,107
2024-03-15 10:10:00,6,12,0,62,10,90
2024-03-15 10:20:00,6,11,0,66,10,93
2024-03-15 10:30:00,5,7,0,68,8,88
2024-03-15 10:40:00,2,12,0,73,16,103
2024-03-15 10:50:00,3,13,0,76,16,108
2024-03-15 11:00:00,6,22,0,68,19,115
2024-03-15 11:10:00,6,6,0,66,13,91
2024-03-15 11:20:00,3,11,0,76,12,102
2024-03-15 11:30:00,9,12,0,79,14,114
2024-03-15 11:40:00,16,16,0,80,11,123
2024-03-15 11:50:00,4,15,0,83,11,113
2024-03-15 12:00:00,10,16,0,64,13,103
2024-03-15 12:10:00,5,10,0,83,18,116
2024-03-15 12:20:00,13,19,0,74,16,122
2024-03-15 12:30:00,11,19,0,81,13,124
2024-03-15 12:40:00,5,15,0,89,13,122
2024-03-15 12:50:00,7,15,0,91,9,122
2024-03-15 13:00:00,8,13,0,81,21,123
2024-03-15 13:10:00,13,16,0,75,12,116
2024-03-15 13:20:00,12,16,0,71,15,114
2024-03-15 13:30:00,8,11,0,93,15,127
2024-03-15 13:40:00,12,16,0,82,15,125
2024-03-15 13:50:00,7,17,0,69,15,108
2024-03-15 14:00:00,7,14,0,74,16,111
2024-03-15 14:10:00,9,24,0,88,13,134
2024-03-15 14:20:00,19,24,0,98,15,156
2024-03-15 14:30:00,8,21,0,92,13,134
2024-03-15 14:40:00,14,16,0,86,10,126
2024-03-15 14:50:00,8,23,0,89,17,137
2024-03-15 15:00:00,8,14,0,93,14,129
2024-03-15 15:10:00,10,19,0,85,16,130
2024-03-15 15:20:00,12,10,0,83,16,121
2024-03-15 15:30:00,11,18,0,108,14,151
2024-03-15 15:40:00,10,20,0,84,15,129
2024-03-15 15:50:00,14,13,0,89,15,131
2024-03-15 16:00:00,10,15,0,82,22,129
2024-03-15 16:10:00,8,12,0,77,11,108
2024-03-15 16:20:00,5,16,0,91,12,124
2024-03-15 16:30:00,10,10,0,100,10,130
2024-03-15 16:40:00,6,20,0,100,18,144
2024-03-15 16:50:00,10,12,0,83,16,121
2024-03-15 17:00:00,9,13,0,91,11,124
2024-03-15 17:10:00,11,15,0,89,10,125
2024-03-15 17:20:00,10,12,0,98,14,134
2024-03-15 17:30:00,8,21,0,91,10,130
2024-03-15 17:40:00,12,17,0,101,12,142
2024-03-15 17:50:00,11,12,0,95,16,134
2024-03-15 18:00:00,6,19,0,109,30,164
2024-03-15 18:10:00,5,19,0,84,29,137
2024-03-15 18:20:00,10,19,0,95,19,143
2024-03-15 18:30:00,6,14,0,91,10,121
2024-03-15 18:40:00,5,15,0,74,11,105
2024-03-15 18:50:00,8,16,0,84,11,119
2024-03-15 19:00:00,6,8,0,77,18,109
2024-03-15 19:10:00,6,14,0,80,8,108
2024-03-15 19:20:00,6,5,0,55,11,77
2024-03-15 19:30:00,4,11,0,60,9,84
2024-03-15 19:40:00,5,12,0,68,10,95
2024-03-15 19:50:00,3,7,0,68,4,82
2024-03-15 20:00:00,2,5,0,59,14,80
2024-03-15 20:10:00,1,7,0,34,11,53
2024-03-15 20:20:00,6,7,0,50,13,76
2024-03-15 20:30:00,3,6,0,36,7,52
2024-03-15 20:40:00,15,17,0,53,7,92
2024-03-15 20:50:00,16,13,0,44,9,82
2024-03-15 21:00:00,5,10,0,37,9,61
2024-03-15 21:10:00,7,12,0,46,11,76
2024-03-15 21:20:00,3,8,0,34,8,53
2024-03-15 21:30:00,1,7,0,45,13,66
2024-03-15 21:40:00,1,7,0,34,13,55
2024-03-15 21:50:00,1,5,0,29,8,43
2024-03-15 22:00:00,4,7,0,33,12,56
2024-03-15 22:10:00,3,6,0,32,8,49
2024-03-15 22:20:00,2,4,0,33,9,48
2024-03-15 22:30:00,0,5,0,38,6,49
2024-03-15 22:40:00,1,7,0,34,5,47
2024-03-15 22:50:00,3,8,0,31,10,52
2024-03-15 23:00:00,2,4,0,28,6,40
2024-03-15 23:10:00,1,5,0,16,6,28
2024-03-15 23:20:00,2,2,0,39,3,46
2024-03-15 23:30:00,1,2,0,26,3,32
2024-03-15 23:40:00,0,2,0,21,3,26
2024-03-15 23:50:00,1,6,0,22,6,35
2024-03-16 00:00:00,0,4,0,22,9,35
2024-03-16 00:10:00,1,0,0,25,6,32
2024-03-16 00:20:00,1,3,0,18,4,26
2024-03-16 00:30:00,0,3,0,14,7,24
2024-03-16 00:40:00,0,1,0,16,7,24
2024-03-16 00:50:00,1,2,0,11,2,16
2024-03-16 01:00:00,0,5,0,13,9,27
2024-03-16 01:10:00,1,2,0,12,8,23
2024-03-16 01:20:00,0,9,0,17,5,31
2024-03-16 01:30:00,1,2,0,13,5,21
2024-03-16 01:40:00,1,4,0,15,4,24
2024-03-16 01:50:00,1,2,0,18,3,24
2024-03-16 02:00:00,1,4,0,9,7,21
2024-03-16 02:10:00,1,1,0,8,5,15
2024-03-16 02:20:00,2,4,0,5,6,17
2024-03-16 02:30:00,0,0,0,12,3,15
2024-03-16 02:40:00,0,2,0,6,6,14
2024-03-16 02:50:00,1,2,0,3,5,11
2024-03-16 03:00:00,0,3,0,9,3,15
2024-03-16 03:10:00,0,0,0,8,1,9
2024-03-16 03:20:00,0,0,0,4,1,5
2024-03-16 03:30:00,0,1,0,8,2,11
2024-03-16 03:40:00,0,0,0,7,4,11
2024-03-16 03:50:00,0,1,0,5,3,9
2024-03-16 04:00:00,0,1,0,2,4,7
2024-03-16 04:10:00,0,0,0,6,9,15
2024-03-16 04:20:00,0,0,0,9,1,10
2024-03-16 04:30:00,0,0,0,2,1,3
2024-03-16 04:40:00,0,0,0,3,4,7
2024-03-16 04:50:00,0,0,0,7,5,12
2024-03-16 05:00:00,0,0,0,11,0,11
2024-03-16 05:10:00,0,1,0,12,1,14
2024-03-16 05:20:00,0,1,0,15,5,21
2024-03-16 05:30:00,0,3,0,22,4,29
2024-03-16 05:40:00,1,2,0,19,4,26
2024-03-16 05:50:00,0,1,0,10,6,17
2024-03-16 06:00:00,1,0,0,12,3,16
2024-03-16 06:10:00,1,3,0,12,4,20
2024-03-16 06:20:00,0,1,0,10,6,17
2024-03-16 06:30:00,0,1,0,15,8,24
2024-03-16 06:40:00,2,5,0,11,3,21
2024-03-16 06:50:00,3,4,0,9,8,24
2024-03-16 07:00:00,3,0,0,6,3,12
2024-03-16 07:10:00,1,1,0,25,5,32
2024-03-16 07:20:00,1,2,0,13,3,19
2024-03-16 07:30:00,0,2,0,25,4,31
2024-03-16 07:40:00,3,6,0,39,7,55
2024-03-16 07:50:00,1,1,0,29,5,36
2024-03-16 08:00:00,2,4,0,28,7,41
2024-03-16 08:10:00,7,4,0,35,4,50
2024-03-16 08:20:00,1,5,0,34,5,45
2024-03-16 08:30:00,5,6,0,46,6,63
2024-03-16 08:40:00,1,4,0,40,4,49
2024-03-16 08:50:00,4,5,0,42,6,57
2024-03-16 09:00:00,8,8,0,49,7,72
2024-03-16 09:10:00,2,10,0,43,10,65
2024-03-16 09:20:00,7,10,0,59,7,83
2024-03-16 09:30:00,3,10,0,70,6,89
2024-03-16 09:40:00,8,15,0,54,9,86
2024-03-16 09:50:00,6,12,0,70,12,100
2024-03-16 10:00:00,8,11,0,78,10,107
2024-03-16 10:10:00,7,14,0,74,9,104
2024-03-16 10:20:00,6,17,0,76,15,114
2024-03-16 10:30:00,9,19,0,67,17,112
2024-03-16 10:40:00,8,15,0,85,17,125
2024-03-16 10:50:00,5,13,0,81,25,124
2024-03-16 11:00:00,4,18,0,54,7,83
2024-03-16 11:10:00,5,14,0,82,8,109
2024-03-16 11:20:00,4,14,0,95,11,124
2024-03-16 11:30:00,7,17,0,81,10,115
2024-03-16 11:40:00,5,17,0,87,9,118
2024-03-16 11:50:00,7,18,0,80,10,115
2024-03-16 12:00:00,12,18,0,87,9,126
2024-03-16 12:10:00,18,21,0,93,16,148
2024-03-16 12:20:00,13,29,0,81,16,139
2024-03-16 12:30:00,9,25,0,92,14,140
2024-03-16 12:40:00,9,21,0,107,12,149
2024-03-16 12:50:00,9,24,0,92,11,136
2024-03-16 13:00:00,8,24,0,77,13,122
2024-03-16 13:10:00,12,19,0,110,10,151
2024-03-16 13:20:00,6,24,0,90,13,133
2024-03-16 13:30:00,11,20,0,106,15,152
2024-03-16 13:40:00,5,18,0,96,16,135
2024-03-16 13:50:00,6,15,0,91,20,132
2024-03-16 14:00:00,9,22,0,119,14,164
2024-03-16 14:10:00,11,15,0,96,12,134
2024-03-16 14:20:00,7,17,0,79,10,113
2024-03-16 14:30:00,10,12,0,95,14,131
2024-03-16 14:40:00,8,13,0,85,13,119
2024-03-16 14:50:00,11,19,0,93,11,134
2024-03-16 15:00:00,6,12,0,94,11,123
2024-03-16 15:10:00,8,17,0,76,12,113
2024-03-16 15:20:00,4,10,0,78,11,103
2024-03-16 15:30:00,12,13,0,94,7,126
2024-03-16 15:40:00,9,14,0,85,8,116
2024-03-16 15:50:00,7,11,0,86,14,118
2024-03-16 16:00:00,9,16,0,73,7,105
2024-03-16 16:10:00,5,11,0,74,6,96
2024-03-16 16:20:00,4,10,0,65,7,86
2024-03-16 16:30:00,2,10,0,81,7,100
2024-03-16 16:40:00,4,10,0,85,11,110
2024-03-16 16:50:00,3,17,0,72,11,103
2024-03-16 17:00:00,5,15,0,80,11,111
2024-03-16 17:10:00,7,12,0,71,9,99
2024-03-16 17:20:00,6,13,0,71,10,100
2024-03-16 17:30:00,4,19,0,87,10,120
2024-03-16 17:40:00,3,18,0,70,11,102
2024-03-16 17:50:00,7,14,0,87,11,119
2024-03-16 18:00:00,1,16,0,96,7,120
2024-03-16 18:10:00,7,10,0,82,7,106
2024-03-16 18:20:00,3,11,0,94,8,116
2024-03-16 18:30:00,7,8,0,66,11,92
2024-03-16 18:40:00,7,8,0,93,7,115
2024-03-16 18:50:00,3,7,0,72,6,88
2024-03-16 19:00:00,5,9,0,65,7,86
2024-03-16 19:10:00,15,13,0,68,4,100
2024-03-16 19:20:00,4,11,0,61,9,85
2024-03-16 19:30:00,2,15,0,57,9,83
2024-03-16 19:40:00,3,14,0,83,8,108
2024-03-16 19:50:00,6,9,0,58,10,83
2024-03-16 20:00:00,7,12,0,71,4,94
2024-03-16 20:10:00,4,5,0,53,9,71
2024-03-16 20:20:00,3,6,0,56,4,69
2024-03-16 20:30:00,4,10,0,47,12,73
2024-03-16 20:40:00,3,9,0,40,9,61
2024-03-16 20:50:00,1,10,0,50,10,71
2024-03-16 21:00:00,2,7,0,34,7,50
2024-03-16 21:10:00,4,7,0,39,8,58
2024-03-16 21:20:00,3,11,0,31,6,51
2024-03-16 21:30:00,2,10,0,42,8,62
2024-03-16 21:40:00,1,6,0,37,1,45
2024-03-16 21:50:00,1,8,0,44,5,58
2024-03-16 22:00:00,3,15,0,31,11,60
2024-03-16 22:10:00,2,3,0,35,8,48
2024-03-16 22:20:00,1,7,0,28,11,47
2024-03-16 22:30:00,1,3,0,30,7,41
2024-03-16 22:40:00,4,3,0,37,10,54
2024-03-16 22:50:00,2,6,0,41,7,56
2024-03-16 23:00:00,1,5,0,47,5,58
2024-03-16 23:10:00,0,3,0,32,13,48
2024-03-16 23:20:00,2,3,0,29,9,43
2024-03-16 23:30:00,0,1,0,38,7,46
2024-03-16 23:40:00,0,5,0,20,9,34
2024-03-16 23:50:00,1,6,0,31,9,47
2024-03-17 00:00:00,3,3,0,24,7,37
2024-03-17 00:10:00,0,5,0,23,5,33
2024-03-17 00:20:00,3,5,0,24,10,42
2024-03-17 00:30:00,0,3,0,25,6,34
2024-03-17 00:40:00,3,3,0,19,6,31
2024-03-17 00:50:00,1,5,0,18,6,30
2024-03-17 01:00:00,1,3,0,19,11,34
2024-03-17 01:10:00,0,2,0,20,2,24
2024-03-17 01:20:00,0,0,0,17,2,19
2024-03-17 01:30:00,0,2,0,20,8,30
2024-03-17 01:40:00,1,4,0,16,5,26
2024-03-17 01:50:00,0,3,0,13,5,21
2024-03-17 02:00:00,0,3,0,14,9,26
2024-03-17 02:10:00,1,2,0,9,5,17
2024-03-17 02:20:00,0,2,0,11,5,18
2024-03-17 02:30:00,0,3,0,14,6,23
2024-03-17 02:40:00,0,2,0,4,5,11
2024-03-17 02:50:00,0,3,0,11,4,18
2024-03-17 03:00:00,0,1,0,15,6,22
2024-03-17 03:10:00,0,1,0,11,5,17
2024-03-17 03:20:00,0,1,0,4,6,11
2024-03-17 03:30:00,0,0,0,11,5,16
2024-03-17 03:40:00,0,1,0,8,1,10
2024-03-17 03:50:00,1,0,0,8,6,15
2024-03-17 04:00:00,0,0,0,3,0,3
2024-03-17 04:10:00,0,2,0,5,2,9
2024-03-17 04:20:00,0,0,0,4,3,7
2024-03-17 04:30:00,1,0,0,6,2,9
2024-03-17 04:40:00,0,2,0,9,4,15
2024-03-17 04:50:00,0,1,0,9,6,16
2024-03-17 05:00:00,0,1,0,6,2,9
2024-03-17 05:10:00,0,0,0,8,5,13
2024-03-17 05:20:00,0,2,0,11,3,16
2024-03-17 05:30:00,0,1,0,14,3,18
2024-03-17 05:40:00,1,0,0,10,1,12
2024-03-17 05:50:00,0,1,0,4,5,10
2024-03-17 06:00:00,0,0,0,5,0,5
2024-03-17 06:10:00,0,2,0,6,1,9
2024-03-17 06:20:00,0,0,0,4,2,6
2024-03-17 06:30:00,0,2,0,8,4,14
2024-03-17 06:40:00,0,2,0,4,3,9
2024-03-17 06:50:00,0,0,0,7,3,10
2024-03-17 07:00:00,0,1,0,7,4,12
2024-03-17 07:10:00,0,1,0,7,1,9
2024-03-17 07:20:00,3,1,0,15,3,22
2024-03-17 07:30:00,1,1,0,6,3,11
2024-03-17 07:40:00,0,0,0,10,3,13
2024-03-17 07:50:00,0,2,0,16,1,19
2024-03-17 08:00:00,1,1,0,7,3,12
2024-03-17 08:10:00,0,2,0,14,7,23
2024-03-17 08:20:00,2,2,0,13,5,22
2024-03-17 08:30:00,2,2,0,9,3,16
2024-03-17 08:40:00,1,1,0,17,2,21
2024-03-17 08:50:00,1,4,0,24,8,37
2024-03-17 09:00:00,1,2,0,19,8,30
2024-03-17 09:10:00,0,2,0,24,13,39
2024-03-17 09:20:00,2,10,0,38,26,76
2024-03-17 09:30:00,1,4,0,39,17,61
2024-03-17 09:40:00,4,8,0,32,18,62
2024-03-17 09:50:00,3,3,0,40,13,59
2024-03-17 10:00:00,2,5,0,35,6,48
2024-03-17 10:10:00,2,3,0,23,6,34
2024-03-17 10:20:00,1,2,0,35,5,43
2024-03-17 10:30:00,3,6,0,31,1,41
2024-03-17 10:40:00,1,4,0,44,5,54
2024-03-17 10:50:00,1,5,0,44,5,55
2024-03-17 11:00:00,5,5,0,40,10,60
2024-03-17 11:10:00,1,1,0,37,11,50
2024-03-17 11:20:00,4,5,0,33,11,53
2024-03-17 11:30:00,1,4,0,46,3,54
2024-03-17 11:40:00,4,2,0,51,6,63
2024-03-17 11:50:00,11,13,0,32,13,69
2024-03-17 12:00:00,21,10,0,50,9,90
2024-03-17 12:10:00,20,14,0,51,5,90
2024-03-17 12:20:00,3,6,0,53,5,67
2024-03-17 12:30:00,8,4,0,53,7,72
2024-03-17 12:40:00,1,5,0,41,10,57
2024-03-17 12:50:00,2,6,0,60,9,77
2024-03-17 13:00:00,5,5,0,66,13,89
2024-03-17 13:10:00,4,5,0,48,5,62
2024-03-17 13:20:00,3,9,0,39,8,59
2024-03-17 13:30:00,2,6,0,51,11,70
2024-03-17 13:40:00,2,6,0,51,4,63
2024-03-17 13:50:00,2,10,0,52,6,70
2024-03-17 14:00:00,4,3,0,62,6,75
2024-03-17 14:10:00,3,8,0,50,4,65
2024-03-17 14:20:00,5,8,0,53,5,71
2024-03-17 14:30:00,0,5,0,64,8,77
2024-03-17 14:40:00,3,6,0,65,4,78
2024-03-17 14:50:00,1,6,0,57,7,71
2024-03-17 15:00:00,2,5,0,62,8,77
2024-03-17 15:10:00,4,7,0,50,6,67
2024-03-17 15:20:00,0,6,0,68,5,79
2024-03-17 15:30:00,3,3,0,64,10,80
2024-03-17 15:40:00,1,3,0,52,5,61
2024-03-17 15:50:00,2,7,0,41,10,60
2024-03-17 16:00:00,0,7,0,40,8,55
2024-03-17 16:10:00,2,5,0,54,23,84
2024-03-17 16:20:00,3,11,0,41,18,73
2024-03-17 16:30:00,7,3,0,50,16,76
2024-03-17 16:40:00,2,5,0,54,19,80
2024-03-17 16:50:00,4,8,0,48,20,80
2024-03-17 17:00:00,2,8,0,55,3,68
2024-03-17 17:10:00,2,1,0,63,4,70
2024-03-17 17:20:00,0,7,0,48,8,63
2024-03-17 17:30:00,3,6,0,61,8,78
2024-03-17 17:40:00,3,7,0,50,4,64
2024-03-17 17:50:00,3,7,0,58,8,76
2024-03-17 18:00:00,5,6,0,55,6,72
2024-03-17 18:10:00,7,3,0,59,3,72
2024-03-17 18:20:00,3,5,0,67,7,82
2024-03-17 18:30:00,8,12,0,40,4,64
2024-03-17 18:40:00,19,6,0,41,4,70
2024-03-17 18:50:00,12,6,0,52,10,80
2024-03-17 19:00:00,6,5,0,38,9,58
2024-03-17 19:10:00,8,5,0,34,6,53
2024-03-17 19:20:00,6,6,0,33,8,53
2024-03-17 19:30:00,2,4,0,46,4,56
2024-03-17 19:40:00,0,3,0,43,4,50
2024-03-17 19:50:00,0,3,0,36,10,49
2024-03-17 20:00:00,3,3,0,51,9,66
2024-03-17 20:10:00,0,9,0,34,1,44
2024-03-17 20:20:00,0,4,0,31,10,45
2024-03-17 20:30:00,0,2,0,32,8,42
2024-03-17 20:40:00,6,7,0,27,5,45
2024-03-17 20:50:00,2,7,0,38,10,57
2024-03-17 21:00:00,0,3,0,33,5,41
2024-03-17 21:10:00,0,4,0,31,10,45
2024-03-17 21:20:00,2,2,0,18,4,26
2024-03-17 21:30:00,2,2,0,21,9,34
2024-03-17 21:40:00,2,0,0,19,5,26
2024-03-17 21:50:00,2,5,0,27,9,43
2024-03-17 22:00:00,4,3,0,21,9,37
2024-03-17 22:10:00,3,3,0,26,5,37
2024-03-17 22:20:00,1,8,0,27,7,43
2024-03-17 22:30:00,3,3,0,26,10,42
2024-03-17 22:40:00,3,5,0,17,4,29
2024-03-17 22:50:00,0,2,0,16,8,26
2024-03-17 23:00:00,1,4,0,19,6,30
2024-03-17 23:10:00,0,2,0,13,5,20
2024-03-17 23:20:00,0,1,0,13,3,17
2024-03-17 23:30:00,2,1,0,14,4,21
2024-03-17 23:40:00,0,3,0,11,6,20
2024-03-17 23:50:00,2,2,0,11,5,20
2024-03-18 00:00:00,1,0,0,8,6,15
2024-03-18 00:10:00,0,1,0,4,3,8
2024-03-18 00:20:00,1,4,0,6,1,12
2024-03-18 00:30:00,0,2,0,11,5,18
2024-03-18 00:40:00,0,1,0,3,1,5
2024-03-18 00:50:00,0,2,0,4,4,10
2024-03-18 01:00:00,0,0,0,14,2,16
2024-03-18 01:10:00,0,1,0,5,2,8
2024-03-18 01:20:00,0,0,0,6,2,8
2024-03-18 01:30:00,0,1,0,4,1,6
2024-03-18 01:40:00,0,0,0,3,0,3
2024-03-18 01:50:00,0,0,0,5,4,9
2024-03-18 02:00:00,1,0,0,3,3,7
2024-03-18 02:10:00,0,0,0,2,0,2
2024-03-18 02:20:00,0,2,0,4,1,7
2024-03-18 02:30:00,0,0,0,3,3,6
2024-03-18 02:40:00,1,1,0,5,2,9
2024-03-18 02:50:00,0,0,0,1,1,2
2024-03-18 03:00:00,0,0,0,6,1,7
2024-03-18 03:10:00,0,1,0,4,2,7
2024-03-18 03:20:00,0,1,0,2,0,3
2024-03-18 03:30:00,0,0,0,6,1,7
2024-03-18 03:40:00,0,0,0,3,2,5
2024-03-18 03:50:00,1,1,0,6,3,11
2024-03-18 04:00:00,0,0,0,2,5,7
2024-03-18 04:10:00,0,0,0,4,1,5
2024-03-18 04:20:00,0,1,0,6,5,12
2024-03-18 04:30:00,1,1,0,4,3,9
2024-03-18 04:40:00,0,0,0,13,3,16
2024-03-18 04:50:00,0,2,0,8,4,14
2024-03-18 05:00:00,1,0,0,10,4,15
2024-03-18 05:10:00,0,2,0,11,7,20
2024-03-18 05:20:00,0,1,0,17,5,23
2024-03-18 05:30:00,0,2,0,28,6,36
2024-03-18 05:40:00,0,3,0,33,8,44
2024-03-18 05:50:00,1,2,0,36,10,49
2024-03-18 06:00:00,0,1,0,37,8,46
2024-03-18 06:10:00,1,4,0,38,8,51
2024-03-18 06:20:00,0,0,0,41,10,51
2024-03-18 06:30:00,2,5,0,57,11,75
2024-03-18 06:40:00,5,7,0,66,12,90
2024-03-18 06:50:00,4,4,0,92,9,109
2024-03-18 07:00:00,1,6,0,76,14,97
2024-03-18 07:10:00,5,7,0,89,8,109
2024-03-18 07:20:00,5,6,0,97,13,121
2024-03-18 07:30:00,3,9,0,96,14,122
2024-03-18 07:40:00,6,9,0,101,7,123
2024-03-18 07:50:00,2,8,0,117,16,143
2024-03-18 08:00:00,13,12,0,101,14,140
2024-03-18 08:10:00,7,9,0,95,15,126
2024-03-18 08:20:00,4,8,0,102,19,133
2024-03-18 08:30:00,6,8,0,70,14,98
2024-03-18 08:40:00,6,13,0,94,14,127
2024-03-18 08:50:00,2,9,0,87,15,113
2024-03-18 09:00:00,6,13,0,75,9,103
2024-03-18 09:10:00,2,12,0,79,19,112
2024-03-18 09:20:00,5,6,0,95,10,116
2024-03-18 09:30:00,5,6,0,75,9,95
2024-03-18 09:40:00,5,9,0,79,20,113
2024-03-18 09:50:00,7,14,0,73,18,112
2024-03-18 10:00:00,3,8,0,79,12,102
2024-03-18 10:10:00,5,12,0,66,15,98
2024-03-18 10:20:00,7,5,0,52,13,77
2024-03-18 10:30:00,3,13,0,65,15,96
2024-03-18 10:40:00,5,7,0,76,17,105
2024-03-18 10:50:00,5,12,0,52,15,84
2024-03-18 11:00:00,7,19,0,62,8,96
2024-03-18 11:10:00,4,10,0,76,23,113
2024-03-18 11:20:00,7,12,0,71,10,100
2024-03-18 11:30:00,9,13,0,65,10,97
2024-03-18 11:40:00,7,14,0,65,17,103
2024-03-18 11:50:00,3,16,0,65,20,104
2024-03-18 12:00:00,4,9,0,73,17,103
2024-03-18 12:10:00,8,9,0,75,16,108
2024-03-18 12:20:00,4,14,0,61,17,96
2024-03-18 12:30:00,10,12,0,71,10,103
2024-03-18 12:40:00,22,15,0,85,15,137
2024-03-18 12:50:00,5,20,0,98,7,130
2024-03-18 13:00:00,9,15,0,70,15,109
2024-03-18 13:10:00,6,8,0,77,16,107
2024-03-18 13:20:00,6,10,0,59,8,83
2024-03-18 13:30:00,8,17,0,61,11,97
2024-03-18 13:40:00,4,17,0,80,7,108
2024-03-18 13:50:00,5,9,0,54,6,74
2024-03-18 14:00:00,5,18,0,74,8,105
2024-03-18 14:10:00,11,17,0,83,19,130
2024-03-18 14:20:00,6,13,0,71,9,99
2024-03-18 14:30:00,13,15,0,86,11,125
2024-03-18 14:40:00,10,8,0,90,15,123
2024-03-18 14:50:00,6,14,0,84,16,120
2024-03-18 15:00:00,16,11,0,81,10,118
2024-03-18 15:10:00,9,14,0,85,15,123
2024-03-18 15:20:00,5,10,0,95,9,119
2024-03-18 15:30:00,8,14,0,81,13,116
2024-03-18 15:40:00,6,10,0,93,19,128
2024-03-18 15:50:00,6,16,0,88,15,125
2024-03-18 16:00:00,7,14,0,92,16,129
2024-03-18 16:10:00,17,12,0,91,11,131
2024-03-18 16:20:00,10,23,0,93,20,146
2024-03-18 16:30:00,4,21,0,93,14,132
2024-03-18 16:40:00,14,11,0,94,14,133
2024-03-18 16:50:00,11,23,0,88,11,133
2024-03-18 17:00:00,10,11,0,73,12,106
2024-03-18 17:10:00,11,16,0,101,20,148
2024-03-18 17:20:00,10,22,0,114,29,175
2024-03-18 17:30:00,8,15,0,100,15,138
2024-03-18 17:40:00,11,17,0,69,11,108
2024-03-18 17:50:00,7,15,0,81,27,130
2024-03-18 18:00:00,8,17,0,96,11,132
2024-03-18 18:10:00,7,12,0,91,13,123
2024-03-18 18:20:00,5,19,0,80,11,115
2024-03-18 18:30:00,6,12,0,77,10,105
2024-03-18 18:40:00,7,14,0,68,13,102
2024-03-18 18:50:00,7,9,0,54,21,91
2024-03-18 19:00:00,14,10,0,54,10,88
2024-03-18 19:10:00,16,9,0,64,9,98
2024-03-18 19:20:00,6,16,0,53,11,86
2024-03-18 19:30:00,3,10,0,45,8,66
2024-03-18 19:40:00,0,11,0,39,13,63
2024-03-18 19:50:00,1,9,0,45,11,66
2024-03-18 20:00:00,3,10,0,53,10,76
2024-03-18 20:10:00,4,6,0,49,10,69
2024-03-18 20:20:00,2,7,0,54,6,69
2024-03-18 20:30:00,1,7,0,43,11,62
2024-03-18 20:40:00,0,6,0,41,2,49
2024-03-18 20:50:00,3,10,0,23,2,38
2024-03-18 21:00:00,5,5,0,31,9,50
2024-03-18 21:10:00,1,4,0,35,11,51
2024-03-18 21:20:00,0,4,0,30,9,43
2024-03-18 21:30:00,2,4,0,31,5,42
2024-03-18 21:40:00,3,8,0,28,7,46
2024-03-18 21:50:00,2,3,0,25,6,36
2024-03-18 22:00:00,0,4,0,23,7,34
2024-03-18 22:10:00,3,3,0,21,6,33
2024-03-18 22:20:00,2,6,0,22,6,36
2024-03-18 22:30:00,0,5,0,19,9,33
2024-03-18 22:40:00,0,3,0,18,5,26
2024-03-18 22:50:00,2,4,0,15,8,29
2024-03-18 23:00:00,0,3,0,25,5,33
2024-03-18 23:10:00,1,4,0,12,3,20
2024-03-18 23:20:00,0,1,0,11,5,17
2024-03-18 23:30:00,0,3,0,12,7,22
2024-03-18 23:40:00,0,0,0,15,3,18
2024-03-18 23:50:00,1,3,0,5,5,14
2024-03-19 00:00:00,1,2,0,10,9,22
2024-03-19 00:10:00,0,2,0,10,2,14
2024-03-19 00:20:00,0,0,0,13,4,17
2024-03-19 00:30:00,0,1,0,9,2,12
2024-03-19 00:40:00,0,0,0,6,5,11
2024-03-19 00:50:00,0,0,0,2,2,4
2024-03-19 01:00:00,0,1,0,5,0,6
2024-03-19 01:10:00,0,1,0,5,7,13
2024-03-19 01:20:00,0,0,0,2,3,5
2024-03-19 01:30:00,0,0,0,2,0,2
2024-03-19 01:40:00,0,0,0,6,3,9
2024-03-19 01:50:00,0,0,0,7,3,10
2024-03-19 02:00:00,3,3,0,4,3,13
2024-03-19 02:10:00,0,0,0,3,1,4
2024-03-19 02:20:00,1,0,0,6,3,10
2024-03-19 02:30:00,1,0,0,5,2,8
2024-03-19 02:40:00,0,1,0,3,3,7
2024-03-19 02:50:00,0,0,0,1,2,3
2024-03-19 03:00:00,0,1,0,5,1,7
2024-03-19 03:10:00,0,2,0,3,2,7
2024-03-19 03:20:00,0,0,0,8,2,10
2024-03-19 03:30:00,0,0,0,4,2,6
2024-03-19 03:40:00,0,0,0,3,2,5
2024-03-19 03:50:00,0,0,0,4,2,6
2024-03-19 04:00:00,0,2,0,4,3,9
2024-03-19 04:10:00,0,1,0,4,1,6
2024-03-19 04:20:00,0,0,0,5,3,8
2024-03-19 04:30:00,1,0,0,9,4,14
2024-03-19 04:40:00,1,0,0,8,1,10
2024-03-19 04:50:00,0,2,0,12,6,20
2024-03-19 05:00:00,0,1,0,8,4,13
2024-03-19 05:10:00,0,3,0,10,3,16
2024-03-19 05:20:00,0,2,0,22,3,27
2024-03-19 05:30:00,0,4,0,27,7,38
2024-03-19 05:40:00,1,1,0,34,7,43
2024-03-19 05:50:00,0,3,0,42,9,54
2024-03-19 06:00:00,0,2,0,40,6,48
2024-03-19 06:10:00,2,4,0,48,7,61
2024-03-19 06:20:00,2,1,0,34,3,40
2024-03-19 06:30:00,2,3,0,61,15,81
2024-03-19 06:40:00,3,5,0,65,13,86
2024-03-19 06:50:00,2,11,0,79,17,109
2024-03-19 07:00:00,3,5,0,92,13,113
2024-03-19 07:10:00,5,10,0,107,14,136
2024-03-19 07:20:00,5,13,0,95,16,129
2024-03-19 07:30:00,6,7,0,94,13,120
2024-03-19 07:40:00,6,14,0,102,23,145
2024-03-19 07:50:00,7,6,0,102,11,126
2024-03-19 08:00:00,8,7,0,80,14,109
2024-03-19 08:10:00,6,14,0,92,11,123
2024-03-19 08:20:00,7,11,0,94,10,122
2024-03-19 08:30:00,4,8,0,98,17,127
2024-03-19 08:40:00,2,5,0,97,8,112
2024-03-19 08:50:00,4,7,0,86,12,109
2024-03-19 09:00:00,4,10,0,74,12,100
2024-03-19 09:10:00,4,10,0,76,14,104
2024-03-19 09:20:00,5,5,0,77,11,98
2024-03-19 09:30:00,5,12,0,75,12,104
2024-03-19 09:40:00,3,14,0,82,8,107
2024-03-19 09:50:00,6,10,0,76,14,106
2024-03-19 10:00:00,7,10,0,93,17,127
2024-03-19 10:10:00,8,12,0,82,12,114
2024-03-19 10:20:00,5,8,0,76,13,102
2024-03-19 10:30:00,12,13,0,79,12,116
2024-03-19 10:40:00,3,11,0,77,11,102
2024-03-19 10:50:00,7,15,0,67,11,100
2024-03-19 11:00:00,3,8,0,64,13,88
2024-03-19 11:10:00,6,8,0,78,10,102
2024-03-19 11:20:00,6,13,0,70,10,99
2024-03-19 11:30:00,7,8,0,81,8,104
2024-03-19 11:40:00,6,16,0,78,8,108
2024-03-19 11:50:00,4,14,0,82,10,110
2024-03-19 12:00:00,5,8,0,68,17,98
2024-03-19 12:10:00,5,9,0,76,10,100
2024-03-19 12:20:00,9,18,0,77,11,115
2024-03-19 12:30:00,7,17,0,63,17,104
2024-03-19 12:40:00,6,14,0,78,12,110
2024-03-19 12:50:00,8,11,0,74,15,108
2024-03-19 13:00:00,11,13,0,76,16,116
2024-03-19 13:10:00,14,8,0,80,6,108
2024-03-19 13:20:00,11,15,0,79,15,120
2024-03-19 13:30:00,12,7,0,68,16,103
2024-03-19 13:40:00,2,12,0,82,8,104
2024-03-19 13:50:00,11,14,0,81,10,116
2024-03-19 14:00:00,4,13,0,76,17,110
2024-03-19 14:10:00,5,9,0,106,15,135
2024-03-19 14:20:00,14,8,0,69,10,101
2024-03-19 14:30:00,10,13,0,88,15,126
2024-03-19 14:40:00,8,15,0,72,10,105
2024-03-19 14:50:00,8,12,0,94,12,126
2024-03-19 15:00:00,18,18,0,88,16,140
2024-03-19 15:10:00,14,19,0,111,16,160
2024-03-19 15:20:00,11,19,0,98,14,142
2024-03-19 15:30:00,19,26,0,87,11,143
2024-03-19 15:40:00,20,33,0,95,6,154
2024-03-19 15:50:00,32,19,0,92,11,154
2024-03-19 16:00:00,19,16,0,89,15,139
2024-03-19 16:10:00,18,19,0,109,13,159
2024-03-19 16:20:00,20,13,0,99,13,145
2024-03-19 16:30:00,16,13,0,106,12,147
2024-03-19 16:40:00,12,15,0,85,14,126
2024-03-19 16:50:00,23,12,0,91,17,143
2024-03-19 17:00:00,15,20,0,77,14,126
2024-03-19 17:10:00,13,11,0,87,6,117
2024-03-19 17:20:00,11,15,0,101,11,138
2024-03-19 17:30:00,5,20,0,107,12,144
2024-03-19 17:40:00,14,15,0,94,13,136
2024-03-19 17:50:00,2,14,0,88,13,117
2024-03-19 18:00:00,12,15,0,83,10,120
2024-03-19 18:10:00,2,13,0,95,6,116
2024-03-19 18:20:00,6,18,0,96,11,131
2024-03-19 18:30:00,4,16,0,96,12,128
2024-03-19 18:40:00,7,16,0,92,10,125
2024-03-19 18:50:00,3,11,0,76,14,104
2024-03-19 19:00:00,6,11,0,55,8,80
2024-03-19 19:10:00,8,12,0,58,16,94
2024-03-19 19:20:00,2,6,0,56,14,78
2024-03-19 19:30:00,2,8,0,49,12,71
2024-03-19 19:40:00,4,7,0,50,9,70
2024-03-19 19:50:00,3,12,0,57,12,84
2024-03-19 20:00:00,3,14,0,68,12,97
2024-03-19 20:10:00,2,8,0,48,7,65
2024-03-19 20:20:00,4,10,0,45,7,66
2024-03-19 20:30:00,0,8,0,34,13,55
2024-03-19 20:40:00,1,8,0,37,8,54
2024-03-19 20:50:00,4,9,0,38,11,62
2024-03-19 21:00:00,1,7,0,24,7,39
2024-03-19 21:10:00,5,8,0,44,10,67
2024-03-19 21:20:00,3,6,0,32,7,48
2024-03-19 21:30:00,3,6,0,33,9,51
2024-03-19 21:40:00,1,8,0,34,9,52
2024-03-19 21:50:00,2,3,0,20,10,35
2024-03-19 22:00:00,1,6,0,29,9,45
2024-03-19 22:10:00,3,6,0,37,9,55
2024-03-19 22:20:00,2,7,0,20,3,32
2024-03-19 22:30:00,3,0,0,43,9,55
2024-03-19 22:40:00,1,4,0,28,9,42
2024-03-19 22:50:00,0,3,0,14,5,22
2024-03-19 23:00:00,3,3,0,11,4,21
2024-03-19 23:10:00,0,8,0,28,6,42
2024-03-19 23:20:00,2,1,0,15,6,24
2024-03-19 23:30:00,1,4,0,14,2,21
2024-03-19 23:40:00,0,1,0,12,3,16
2024-03-19 23:50:00,1,2,0,9,13,25
2024-03-20 00:00:00,0,1,0,12,3,16
2024-03-20 00:10:00,1,2,0,10,4,17
2024-03-20 00:20:00,0,1,0,8,7,16
2024-03-20 00:30:00,0,0,0,12,3,15
2024-03-20 00:40:00,0,0,0,4,3,7
2024-03-20 00:50:00,0,0,0,6,8,14
2024-03-20 01:00:00,1,0,0,7,2,10
2024-03-20 01:10:00,1,2,0,6,2,11
2024-03-20 01:20:00,0,2,0,6,3,11
2024-03-20 01:30:00,3,1,0,7,4,15
2024-03-20 01:40:00,0,0,0,6,5,11
2024-03-20 01:50:00,0,0,0,5,2,7
2024-03-20 02:00:00,1,1,0,2,1,5
2024-03-20 02:10:00,0,0,0,3,0,3
2024-03-20 02:20:00,2,1,0,8,5,16
2024-03-20 02:30:00,0,0,0,7,0,7
2024-03-20 02:40:00,0,1,0,0,1,2
2024-03-20 02:50:00,1,2,0,4,0,7
2024-03-20 03:00:00,0,0,0,2,2,4
2024-03-20 03:10:00,0,0,0,3,1,4
2024-03-20 03:20:00,0,0,0,6,4,10
2024-03-20 03:30:00,0,0,0,3,0,3
2024-03-20 03:40:00,1,0,0,4,4,9
2024-03-20 03:50:00,0,0,0,4,2,6
2024-03-20 04:00:00,0,0,0,4,3,7
2024-03-20 04:10:00,1,1,0,3,4,9
2024-03-20 04:20:00,0,0,0,2,2,4
2024-03-20 04:30:00,0,0,0,12,7,19
2024-03-20 04:40:00,0,1,0,9,3,13
2024-03-20 04:50:00,0,0,0,8,6,14
2024-03-20 05:00:00,0,0,0,12,4,16
2024-03-20 05:10:00,0,2,0,8,7,17
2024-03-20 05:20:00,0,3,0,17,6,26
2024-03-20 05:30:00,2,2,0,33,5,42
2024-03-20 05:40:00,1,3,0,27,10,41
2024-03-20 05:50:00,0,1,0,39,10,50
2024-03-20 06:00:00,0,2,0,39,8,49
2024-03-20 06:10:00,1,3,0,33,3,40
2024-03-20 06:20:00,3,2,0,48,8,61
2024-03-20 06:30:00,0,6,0,57,12,75
2024-03-20 06:40:00,4,3,0,72,12,91
2024-03-20 06:50:00,2,6,0,81,10,99
2024-03-20 07:00:00,4,4,0,103,8,119
2024-03-20 07:10:00,1,10,0,101,12,124
2024-03-20 07:20:00,4,6,0,111,9,130
2024-03-20 07:30:00,7,10,0,95,10,122
2024-03-20 07:40:00,8,16,0,100,18,142
2024-03-20 07:50:00,5,8,0,93,15,121
2024-03-20 08:00:00,13,13,0,89,20,135
2024-03-20 08:10:00,5,9,0,108,18,140
2024-03-20 08:20:00,2,8,0,90,11,111
2024-03-20 08:30:00,3,11,0,85,14,113
2024-03-20 08:40:00,6,8,0,104,19,137
2024-03-20 08:50:00,5,9,0,107,10,131
2024-03-20 09:00:00,4,8,0,86,12,110
2024-03-20 09:10:00,9,6,0,92,16,123
2024-03-20 09:20:00,6,7,0,96,12,121
2024-03-20 09:30:00,5,8,0,80,10,103
2024-03-20 09:40:00,3,10,0,88,15,116
2024-03-20 09:50:00,6,12,0,93,10,121
2024-03-20 10:00:00,4,12,0,89,10,115
2024-03-20 10:10:00,4,10,0,67,20,101
2024-03-20 10:20:00,5,13,0,75,12,105
2024-03-20 10:30:00,3,10,0,78,23,114
2024-03-20 10:40:00,6,13,0,68,16,103
2024-03-20 10:50:00,3,12,0,73,12,100
2024-03-20 11:00:00,4,12,0,54,13,83
2024-03-20 11:10:00,6,16,0,71,13,106
2024-03-20 11:20:00,9,15,0,58,12,94
2024-03-20 11:30:00,6,14,0,82,10,112
2024-03-20 11:40:00,4,12,0,71,9,96
2024-03-20 11:50:00,5,10,0,79,15,109
2024-03-20 12:00:00,17,7,0,71,18,113
2024-03-20 12:10:00,4,12,0,80,18,114
2024-03-20 12:20:00,10,13,0,90,15,128
2024-03-20 12:30:00,9,13,0,68,14,104
2024-03-20 12:40:00,6,15,0,77,8,106
2024-03-20 12:50:00,8,12,0,76,10,106
2024-03-20 13:00:00,14,13,0,80,15,122
2024-03-20 13:10:00,10,22,0,83,20,135
2024-03-20 13:20:00,17,17,0,76,12,122
2024-03-20 13:30:00,11,8,0,71,15,105
2024-03-20 13:40:00,7,16,0,92,11,126
2024-03-20 13:50:00,9,11,0,80,10,110
2024-03-20 14:00:00,11,11,0,74,14,110
2024-03-20 14:10:00,3,11,0,58,14,86
2024-03-20 14:20:00,11,10,0,77,11,109
2024-03-20 14:30:00,10,13,0,80,9,112
2024-03-20 14:40:00,4,9,0,99,11,123
2024-03-20 14:50:00,11,12,0,88,12,123
2024-03-20 15:00:00,6,17,0,85,15,123
2024-03-20 15:10:00,11,10,0,83,7,111
2024-03-20 15:20:00,9,16,0,93,11,129
2024-03-20 15:30:00,9,13,0,101,14,137
2024-03-20 15:40:00,23,15,0,95,14,147
2024-03-20 15:50:00,14,18,0,84,14,130
2024-03-20 16:00:00,11,11,0,98,13,133
2024-03-20 16:10:00,17,10,0,98,17,142
2024-03-20 16:20:00,21,21,0,88,9,139
2024-03-20 16:30:00,15,24,0,91,20,150
2024-03-20 16:40:00,15,19,0,84,18,136
2024-03-20 16:50:00,6,18,0,106,12,142
2024-03-20 17:00:00,8,20,0,96,15,139
2024-03-20 17:10:00,11,21,0,97,14,143
2024-03-20 17:20:00,19,18,0,80,13,130
2024-03-20 17:30:00,10,15,0,108,18,151
2024-03-20 17:40:00,11,13,0,98,20,142
2024-03-20 17:50:00,10,12,0,96,13,131
2024-03-20 18:00:00,6,14,0,104,12,136
2024-03-20 18:10:00,4,10,0,94,9,117
2024-03-20 18:20:00,5,12,0,84,7,108
2024-03-20 18:30:00,2,10,0,102,11,125
2024-03-20 18:40:00,1,17,0,84,12,114
2024-03-20 18:50:00,4,12,0,66,12,94
2024-03-20 19:00:00,7,15,0,54,15,91
2024-03-20 19:10:00,5,14,0,58,12,89
2024-03-20 19:20:00,3,9,0,50,8,70
2024-03-20 19:30:00,7,8,0,55,10,80
2024-03-20 19:40:00,3,6,0,59,14,82
2024-03-20 19:50:00,1,6,0,59,9,75
2024-03-20 20:00:00,4,10,0,47,8,69
2024-03-20 20:10:00,1,6,0,44,6,57
2024-03-20 20:20:00,2,8,0,48,12,70
2024-03-20 20:30:00,4,10,0,33,12,59
2024-03-20 20:40:00,7,8,0,44,7,66
2024-03-20 20:50:00,0,3,0,38,9,50
2024-03-20 21:00:00,1,7,0,37,10,55
2024-03-20 21:10:00,0,6,0,32,5,43
2024-03-20 21:20:00,5,7,0,33,11,56
2024-03-20 21:30:00,1,8,0,31,10,50
2024-03-20 21:40:00,1,5,0,22,4,32
2024-03-20 21:50:00,1,4,0,28,10,43
2024-03-20 22:00:00,2,5,0,38,9,54
2024-03-20 22:10:00,1,3,0,26,12,42
2024-03-20 22:20:00,1,4,0,36,12,53
2024-03-20 22:30:00,0,5,0,25,5,35
2024-03-20 22:40:00,2,1,0,32,6,41
2024-03-20 22:50:00,0,4,0,19,6,29
2024-03-20 23:00:00,0,4,0,17,3,24
2024-03-20 23:10:00,2,2,0,21,9,34
2024-03-20 23:20:00,1,1,0,14,5,21
2024-03-20 23:30:00,0,4,0,13,7,24
2024-03-20 23:40:00,0,1,0,17,3,21
2024-03-20 23:50:00,0,1,0,8,5,14
2024-03-21 00:00:00,2,0,0,19,7,28
2024-03-21 00:10:00,0,0,0,11,2,13
2024-03-21 00:20:00,0,2,0,12,2,16
2024-03-21 00:30:00,0,2,0,4,6,12
2024-03-21 00:40:00,0,1,0,4,4,9
2024-03-21 00:50:00,0,0,0,11,3,14
2024-03-21 01:00:00,0,0,0,13,6,19
2024-03-21 01:10:00,1,0,0,9,3,13
2024-03-21 01:20:00,0,0,0,2,2,4
2024-03-21 01:30:00,0,0,0,5,1,6
2024-03-21 01:40:00,2,0,0,8,3,13
2024-03-21 01:50:00,0,1,0,3,2,6
2024-03-21 02:00:00,0,1,0,3,0,4
2024-03-21 02:10:00,0,0,0,0,2,2
2024-03-21 02:20:00,2,0,0,11,5,18
2024-03-21 02:30:00,0,1,0,4,4,9
2024-03-21 02:40:00,0,2,0,2,0,4
2024-03-21 02:50:00,0,0,0,0,1,1
2024-03-21 03:00:00,0,0,0,4,3,7
2024-03-21 03:10:00,0,0,0,2,3,5
2024-03-21 03:20:00,0,0,0,6,4,10
2024-03-21 03:30:00,1,0,0,5,8,14
2024-03-21 03:40:00,0,0,0,5,3,8
2024-03-21 03:50:00,0,0,0,1,1,2
2024-03-21 04:00:00,0,0,0,3,1,4
2024-03-21 04:10:00,0,0,0,5,1,6
2024-03-21 04:20:00,0,1,0,4,5,10
2024-03-21 04:30:00,0,0,0,7,2,9
2024-03-21 04:40:00,0,0,0,6,4,10
2024-03-21 04:50:00,0,2,0,8,7,17
2024-03-21 05:00:00,0,2,0,8,2,12
2024-03-21 05:10:00,0,3,0,11,9,23
2024-03-21 05:20:00,0,2,0,17,6,25
2024-03-21 05:30:00,0,2,0,24,10,36
2024-03-21 05:40:00,2,2,0,24,8,36
2024-03-21 05:50:00,0,2,0,41,5,48
2024-03-21 06:00:00,1,2,0,31,6,40
2024-03-21 06:10:00,0,6,0,46,8,60
2024-03-21 06:20:00,1,3,0,45,7,56
2024-03-21 06:30:00,3,2,0,67,5,77
2024-03-21 06:40:00,4,6,0,66,11,87
2024-03-21 06:50:00,2,3,0,57,13,75
2024-03-21 07:00:00,2,6,0,117,20,145
2024-03-21 07:10:00,1,6,0,84,11,102
2024-03-21 07:20:00,6,14,0,96,10,126
2024-03-21 07:30:00,7,13,0,86,9,115
2024-03-21 07:40:00,7,10,0,104,24,145
2024-03-21 07:50:00,9,7,0,110,20,146
2024-03-21 08:00:00,5,11,0,118,16,150
2024-03-21 08:10:00,7,9,0,94,14,124
2024-03-21 08:20:00,7,8,0,86,8,109
2024-03-21 08:30:00,4,8,0,79,13,104
2024-03-21 08:40:00,7,14,0,119,15,155
2024-03-21 08:50:00,7,8,0,88,13,116
2024-03-21 09:00:00,6,14,0,95,14,129
2024-03-21 09:10:00,10,4,0,79,15,108
2024-03-21 09:20:00,5,9,0,89,13,116
2024-03-21 09:30:00,10,9,0,81,16,116
2024-03-21 09:40:00,4,8,0,88,13,113
2024-03-21 09:50:00,2,6,0,89,12,109
2024-03-21 10:00:00,6,11,0,60,15,92
2024-03-21 10:10:00,2,8,0,72,14,96
2024-03-21 10:20:00,3,5,0,49,7,64
2024-03-21 10:30:00,0,0,0,0,0,0
2024-03-21 10:40:00,0,0,0,0,0,0
2024-03-21 10:50:00,0,0,0,0,0,0
2024-03-21 11:00:00,0,0,0,0,0,0
2024-03-21 11:10:00,0,0,0,0,0,0
2024-03-21 11:20:00,0,0,0,0,0,0
2024-03-21 11:30:00,0,0,0,0,0,0
2024-03-21 11:40:00,0,0,0,0,0,0
2024-03-21 11:50:00,0,0,0,0,0,0
2024-03-21 12:00:00,0,0,0,0,0,0
2024-03-21 12:10:00,0,0,0,0,0,0
2024-03-21 12:20:00,0,0,0,0,0,0
2024-03-21 12:30:00,0,0,0,0,0,0
2024-03-21 12:40:00,0,0,0,0,0,0
2024-03-21 12:50:00,0,0,0,0,0,0
2024-03-21 13:00:00,0,0,0,0,0,0
2024-03-21 13:10:00,0,0,0,0,0,0
2024-03-21 13:20:00,0,0,0,0,0,0
2024-03-21 13:30:00,0,0,0,0,0,0
2024-03-21 13:40:00,0,0,0,0,0,0
2024-03-21 13:50:00,0,0,0,0,0,0
2024-03-21 14:00:00,0,0,0,0,0,0
2024-03-21 14:10:00,0,0,0,0,0,0
2024-03-21 14:20:00,0,0,0,0,0,0
2024-03-21 14:30:00,0,0,0,0,0,0
2024-03-21 14:40:00,0,0,0,0,0,0
2024-03-21 14:50:00,0,0,0,0,0,0
2024-03-21 15:00:00,0,0,0,0,0,0
2024-03-21 15:10:00,0,0,0,0,0,0
2024-03-21 15:20:00,0,0,0,0,0,0
2024-03-21 15:30:00,0,0,0,0,0,0
2024-03-21 15:40:00,0,0,0,0,0,0
2024-03-21 15:50:00,0,0,0,0,0,0
2024-03-21 16:00:00,0,0,0,0,0,0
2024-03-21 16:10:00,0,0,0,0,0,0
2024-03-21 16:20:00,0,0,0,0,0,0
2024-03-21 16:30:00,0,0,0,0,0,0
2024-03-21 16:40:00,0,0,0,0,0,0
2024-03-21 16:50:00,0,0,0,0,0,0
2024-03-21 17:00:00,0,0,0,0,0,0
2024-03-21 17:10:00,0,0,0,0,0,0
2024-03-21 17:20:00,0,0,0,0,0,0
2024-03-21 17:30:00,0,0,0,0,0,0
2024-03-21 17:40:00,0,0,0,0,0,0
2024-03-21 17:50:00,0,0,0,0,0,0
2024-03-21 18:00:00,0,0,0,0,0,0
2024-03-21 18:10:00,0,0,0,0,0,0
2024-03-21 18:20:00,0,0,0,0,0,0
2024-03-21 18:30:00,0,0,0,0,0,0
2024-03-21 18:40:00,0,0,0,0,0,0
2024-03-21 18:50:00,0,0,0,0,0,0
2024-03-21 19:00:00,0,0,0,0,0,0
2024-03-21 19:10:00,0,0,0,0,0,0
2024-03-21 19:20:00,0,0,0,0,0,0
2024-03-21 19:30:00,0,0,0,0,0,0
2024-03-21 19:40:00,0,0,0,0,0,0
2024-03-21 19:50:00,0,0,0,0,0,0
2024-03-21 20:00:00,0,0,0,0,0,0
2024-03-21 20:10:00,0,0,0,0,0,0
2024-03-21 20:20:00,0,0,0,0,0,0
2024-03-21 20:30:00,0,0,0,0,0,0
2024-03-21 20:40:00,0,0,0,0,0,0
2024-03-21 20:50:00,0,0,0,0,0,0
2024-03-21 21:00:00,0,0,0,0,0,0
2024-03-21 21:10:00,0,0,0,0,0,0
2024-03-21 21:20:00,0,0,0,0,0,0
2024-03-21 21:30:00,0,0,0,0,0,0
2024-03-21 21:40:00,0,0,0,0,0,0
2024-03-21 21:50:00,0,0,0,0,0,0
2024-03-21 22:00:00,0,0,0,0,0,0
2024-03-21 22:10:00,0,0,0,0,0,0
2024-03-21 22:20:00,0,0,0,0,0,0
2024-03-21 22:30:00,0,0,0,0,0,0
2024-03-21 22:40:00,0,0,0,0,0,0
2024-03-21 22:50:00,0,0,0,0,0,0
2024-03-21 23:00:00,0,0,0,0,0,0
2024-03-21 23:10:00,0,0,0,0,0,0
2024-03-21 23:20:00,0,0,0,0,0,0
2024-03-21 23:30:00,0,0,0,0,0,0
2024-03-21 23:40:00,0,0,0,0,0,0
2024-03-21 23:50:00,0,0,0,0,0,0
2024-03-22 00:00:00,0,0,0,0,0,0
2024-03-22 00:10:00,0,0,0,0,0,0
2024-03-22 00:20:00,0,0,0,0,0,0
2024-03-22 00:30:00,0,0,0,0,0,0
2024-03-22 00:40:00,0,0,0,0,0,0
2024-03-22 00:50:00,0,0,0,0,0,0
2024-03-22 01:00:00,0,0,0,0,0,0
2024-03-22 01:10:00,0,0,0,0,0,0
2024-03-22 01:20:00,0,0,0,0,0,0
2024-03-22 01:30:00,0,0,0,0,0,0
2024-03-22 01:40:00,0,0,0,0,0,0
2024-03-22 01:50:00,0,0,0,0,0,0
2024-03-22 02:00:00,0,0,0,0,0,0
2024-03-22 02:10:00,0,0,0,0,0,0
2024-03-22 02:20:00,0,0,0,0,0,0
2024-03-22 02:30:00,0,0,0,0,0,0
2024-03-22 02:40:00,0,0,0,0,0,0
2024-03-22 02:50:00,0,0,0,0,0,0
2024-03-22 03:00:00,0,0,0,0,0,0
2024-03-22 03:10:00,0,0,0,0,0,0
2024-03-22 03:20:00,0,0,0,0,0,0
2024-03-22 03:30:00,0,0,0,0,0,0
2024-03-22 03:40:00,0,0,0,0,0,0
2024-03-22 03:50:00,0,0,0,0,0,0
2024-03-22 04:00:00,0,0,0,0,0,0
2024-03-22 04:10:00,0,0,0,0,0,0
2024-03-22 04:20:00,0,0,0,0,0,0
2024-03-22 04:30:00,0,0,0,0,0,0
2024-03-22 04:40:00,0,0,0,0,0,0
2024-03-22 04:50:00,0,0,0,0,0,0
2024-03-22 05:00:00,0,0,0,0,0,0
2024-03-22 05:10:00,0,0,0,0,0,0
2024-03-22 05:20:00,0,0,0,0,0,0
2024-03-22 05:30:00,0,0,0,0,0,0
2024-03-22 05:40:00,0,0,0,0,0,0
2024-03-22 05:50:00,0,0,0,0,0,0
2024-03-22 06:00:00,0,0,0,0,0,0
2024-03-22 06:10:00,0,0,0,0,0,0
2024-03-22 06:20:00,0,0,0,0,0,0
2024-03-22 06:30:00,0,0,0,0,0,0
2024-03-22 06:40:00,0,0,0,0,0,0
2024-03-22 06:50:00,0,0,0,0,0,0
2024-03-22 07:00:00,0,0,0,0,0,0
2024-03-22 07:10:00,0,0,0,0,0,0
2024-03-22 07:20:00,0,0,0,0,0,0
2024-03-22 07:30:00,0,0,0,0,0,0
2024-03-22 07:40:00,0,0,0,0,0,0
2024-03-22 07:50:00,0,0,0,0,0,0
2024-03-22 08:00:00,0,0,0,0,0,0
2024-03-22 08:10:00,0,0,0,0,0,0
2024-03-22 08:20:00,0,0,0,0,0,0
2024-03-22 08:30:00,0,0,0,0,0,0
2024-03-22 08:40:00,0,0,0,0,0,0
2024-03-22 08:50:00,0,0,0,0,0,0
2024-03-22 09:00:00,0,0,0,0,0,0
2024-03-22 09:10:00,0,0,0,0,0,0
2024-03-22 09:20:00,0,0,0,0,0,0
2024-03-22 09:30:00,0,0,0,0,0,0
2024-03-22 09:40:00,0,0,0,0,0,0
2024-03-22 09:50:00,0,0,0,0,0,0
2024-03-22 10:00:00,0,0,0,0,0,0
2024-03-22 10:10:00,0,0,0,0,0,0
2024-03-22 10:20:00,0,0,0,0,0,0
2024-03-22 10:30:00,0,0,0,0,0,0
2024-03-22 10:40:00,0,0,0,0,0,0
2024-03-22 10:50:00,0,0,0,0,0,0
2024-03-22 11:00:00,0,0,0,0,0,0
2024-03-22 11:10:00,0,0,0,0,0,0
2024-03-22 11:20:00,0,0,0,0,0,0
2024-03-22 11:30:00,0,0,0,0,0,0
2024-03-22 11:40:00,0,0,0,0,0,0
2024-03-22 11:50:00,0,0,0,0,0,0
2024-03-22 12:00:00,0,0,0,0,0,0
2024-03-22 12:10:00,0,0,0,0,0,0
2024-03-22 12:20:00,0,0,0,0,0,0
2024-03-22 12:30:00,0,0,0,0,0,0
2024-03-22 12:40:00,0,0,0,0,0,0
2024-03-22 12:50:00,0,0,0,0,0,0
2024-03-22 13:00:00,0,0,0,0,0,0
2024-03-22 13:10:00,0,0,0,0,0,0
2024-03-22 13:20:00,0,0,0,0,0,0
2024-03-22 13:30:00,0,0,0,0,0,0
2024-03-22 13:40:00,0,0,0,0,0,0
2024-03-22 13:50:00,0,0,0,0,0,0
2024-03-22 14:00:00,0,0,0,0,0,0
2024-03-22 14:10:00,0,0,0,0,0,0
2024-03-22 14:20:00,0,0,0,0,0,0
2024-03-22 14:30:00,0,0,0,0,0,0
2024-03-22 14:40:00,0,0,0,0,0,0
2024-03-22 14:50:00,0,0,0,0,0,0
2024-03-22 15:00:00,0,0,0,0,0,0
2024-03-22 15:10:00,0,0,0,0,0,0
2024-03-22 15:20:00,0,0,0,0,0,0
2024-03-22 15:30:00,0,0,0,0,0,0
2024-03-22 15:40:00,0,0,0,0,0,0
2024-03-22 15:50:00,0,0,0,0,0,0
2024-03-22 16:00:00,0,0,0,0,0,0
2024-03-22 16:10:00,0,0,0,0,0,0
2024-03-22 16:20:00,0,0,0,0,0,0
2024-03-22 16:30:00,0,0,0,0,0,0
2024-03-22 16:40:00,0,0,0,0,0,0
2024-03-22 16:50:00,0,0,0,0,0,0
2024-03-22 17:00:00,0,0,0,0,0,0
2024-03-22 17:10:00,0,0,0,0,0,0
2024-03-22 17:20:00,0,0,0,0,0,0
2024-03-22 17:30:00,0,0,0,0,0,0
2024-03-22 17:40:00,0,0,0,0,0,0
2024-03-22 17:50:00,0,0,0,0,0,0
2024-03-22 18:00:00,0,0,0,0,0,0
2024-03-22 18:10:00,0,0,0,0,0,0
2024-03-22 18:20:00,0,0,0,0,0,0
2024-03-22 18:30:00,0,0,0,0,0,0
2024-03-22 18:40:00,0,0,0,0,0,0
2024-03-22 18:50:00,0,0,0,0,0,0
2024-03-22 19:00:00,0,0,0,0,0,0
2024-03-22 19:10:00,0,0,0,0,0,0
2024-03-22 19:20:00,0,0,0,0,0,0
2024-03-22 19:30:00,0,0,0,0,0,0
2024-03-22 19:40:00,0,0,0,0,0,0
2024-03-22 19:50:00,0,0,0,0,0,0
2024-03-22 20:00:00,0,0,0,0,0,0
2024-03-22 20:10:00,0,0,0,0,0,0
2024-03-22 20:20:00,0,0,0,0,0,0
2024-03-22 20:30:00,0,0,0,0,0,0
2024-03-22 20:40:00,0,0,0,0,0,0
2024-03-22 20:50:00,0,0,0,0,0,0
2024-03-22 21:00:00,0,0,0,0,0,0
2024-03-22 21:10:00,0,0,0,0,0,0
2024-03-22 21:20:00,0,0,0,0,0,0
2024-03-22 21:30:00,0,0,0,0,0,0
2024-03-22 21:40:00,0,0,0,0,0,0
2024-03-22 21:50:00,0,0,0,0,0,0
2024-03-22 22:00:00,0,0,0,0,0,0
2024-03-22 22:10:00,0,0,0,0,0,0
2024-03-22 22:20:00,0,0,0,0,0,0
2024-03-22 22:30:00,0,0,0,0,0,0
2024-03-22 22:40:00,0,0,0,0,0,0
2024-03-22 22:50:00,0,0,0,0,0,0
2024-03-22 23:00:00,0,0,0,0,0,0
2024-03-22 23:10:00,0,0,0,0,0,0
2024-03-22 23:20:00,0,0,0,0,0,0
2024-03-22 23:30:00,0,0,0,0,0,0
2024-03-22 23:40:00,0,0,0,0,0,0
2024-03-22 23:50:00,0,0,0,0,0,0
2024-03-23 00:00:00,0,0,0,0,0,0
2024-03-23 00:10:00,0,0,0,0,0,0
2024-03-23 00:20:00,0,0,0,0,0,0
2024-03-23 00:30:00,0,0,0,0,0,0
2024-03-23 00:40:00,0,0,0,0,0,0
2024-03-23 00:50:00,0,0,0,0,0,0
2024-03-23 01:00:00,0,0,0,0,0,0
2024-03-23 01:10:00,0,0,0,0,0,0
2024-03-23 01:20:00,0,0,0,0,0,0
2024-03-23 01:30:00,0,0,0,0,0,0
2024-03-23 01:40:00,0,0,0,0,0,0
2024-03-23 01:50:00,0,0,0,0,0,0
2024-03-23 02:00:00,0,0,0,0,0,0
2024-03-23 02:10:00,0,0,0,0,0,0
2024-03-23 02:20:00,0,0,0,0,0,0
2024-03-23 02:30:00,0,0,0,0,0,0
2024-03-23 02:40:00,0,0,0,0,0,0
2024-03-23 02:50:00,0,0,0,0,0,0
2024-03-23 03:00:00,0,0,0,0,0,0
2024-03-23 03:10:00,0,0,0,0,0,0
2024-03-23 03:20:00,0,0,0,0,0,0
2024-03-23 03:30:00,0,0,0,0,0,0
2024-03-23 03:40:00,0,0,0,0,0,0
2024-03-23 03:50:00,0,0,0,0,0,0
2024-03-23 04:00:00,0,0,0,0,0,0
2024-03-23 04:10:00,0,0,0,0,0,0
2024-03-23 04:20:00,0,0,0,0,0,0
2024-03-23 04:30:00,0,0,0,0,0,0
2024-03-23 04:40:00,0,0,0,0,0,0
2024-03-23 04:50:00,0,0,0,0,0,0
2024-03-23 05:00:00,0,0,0,0,0,0
2024-03-23 05:10:00,0,0,0,0,0,0
2024-03-23 05:20:00,0,0,0,0,0,0
2024-03-23 05:30:00,0,0,0,0,0,0
2024-03-23 05:40:00,0,0,0,0,0,0
2024-03-23 05:50:00,0,0,0,0,0,0
2024-03-23 06:00:00,0,0,0,0,0,0
2024-03-23 06:10:00,0,0,0,0,0,0
2024-03-23 06:20:00,0,0,0,0,0,0
2024-03-23 06:30:00,0,0,0,0,0,0
2024-03-23 06:40:00,0,0,0,0,0,0
2024-03-23 06:50:00,0,0,0,0,0,0
2024-03-23 07:00:00,0,0,0,0,0,0
2024-03-23 07:10:00,0,0,0,0,0,0
2024-03-23 07:20:00,0,0,0,0,0,0
2024-03-23 07:30:00,0,0,0,0,0,0
2024-03-23 07:40:00,0,0,0,0,0,0
2024-03-23 07:50:00,0,0,0,0,0,0
2024-03-23 08:00:00,0,0,0,0,0,0
2024-03-23 08:10:00,0,0,0,0,0,0
2024-03-23 08:20:00,0,0,0,0,0,0
2024-03-23 08:30:00,0,0,0,0,0,0
2024-03-23 08:40:00,0,0,0,0,0,0
2024-03-23 08:50:00,0,0,0,0,0,0
2024-03-23 09:00:00,0,0,0,0,0,0
2024-03-23 09:10:00,0,0,0,0,0,0
2024-03-23 09:20:00,0,0,0,0,0,0
2024-03-23 09:30:00,0,0,0,0,0,0
2024-03-23 09:40:00,0,0,0,0,0,0
2024-03-23 09:50:00,0,0,0,0,0,0
2024-03-23 10:00:00,0,0,0,0,0,0
2024-03-23 10:10:00,0,0,0,0,0,0
2024-03-23 10:20:00,0,0,0,0,0,0
2024-03-23 10:30:00,0,0,0,0,0,0
2024-03-23 10:40:00,0,0,0,0,0,0
2024-03-23 10:50:00,0,0,0,0,0,0
2024-03-23 11:00:00,0,0,0,0,0,0
2024-03-23 11:10:00,0,0,0,0,0,0
2024-03-23 11:20:00,0,0,0,0,0,0
2024-03-23 11:30:00,0,0,0,0,0,0
2024-03-23 11:40:00,0,0,0,0,0,0
2024-03-23 11:50:00,0,0,0,0,0,0
2024-03-23 12:00:00,0,0,0,0,0,0
2024-03-23 12:10:00,0,0,0,0,0,0
2024-03-23 12:20:00,0,0,0,0,0,0
2024-03-23 12:30:00,0,0,0,0,0,0
2024-03-23 12:40:00,0,0,0,0,0,0
2024-03-23 12:50:00,0,0,0,0,0,0
2024-03-23 13:00:00,0,0,0,0,0,0
2024-03-23 13:10:00,0,0,0,0,0,0
2024-03-23 13:20:00,0,0,0,0,0,0
2024-03-23 13:30:00,0,0,0,0,0,0
2024-03-23 13:40:00,0,0,0,0,0,0
2024-03-23 13:50:00,0,0,0,0,0,0
2024-03-23 14:00:00,0,0,0,0,0,0
2024-03-23 14:10:00,0,0,0,0,0,0
2024-03-23 14:20:00,0,0,0,0,0,0
2024-03-23 14:30:00,0,0,0,0,0,0
2024-03-23 14:40:00,0,0,0,0,0,0
2024-03-23 14:50:00,0,0,0,0,0,0
2024-03-23 15:00:00,0,0,0,0,0,0
2024-03-23 15:10:00,0,0,0,0,0,0
2024-03-23 15:20:00,0,0,0,0,0,0
2024-03-23 15:30:00,0,0,0,0,0,0
2024-03-23 15:40:00,0,0,0,0,0,0
2024-03-23 15:50:00,0,0,0,0,0,0
2024-03-23 16:00:00,0,0,0,0,0,0
2024-03-23 16:10:00,0,0,0,0,0,0
2024-03-23 16:20:00,0,0,0,0,0,0
2024-03-23 16:30:00,0,0,0,0,0,0
2024-03-23 16:40:00,0,0,0,0,0,0
2024-03-23 16:50:00,0,0,0,0,0,0
2024-03-23 17:00:00,0,0,0,0,0,0
2024-03-23 17:10:00,0,0,0,0,0,0
2024-03-23 17:20:00,0,0,0,0,0,0
2024-03-23 17:30:00,0,0,0,0,0,0
2024-03-23 17:40:00,0,0,0,0,0,0
2024-03-23 17:50:00,0,0,0,0,0,0
2024-03-23 18:00:00,0,0,0,0,0,0
2024-03-23 18:10:00,0,0,0,0,0,0
2024-03-23 18:20:00,0,0,0,0,0,0
2024-03-23 18:30:00,0,0,0,0,0,0
2024-03-23 18:40:00,0,0,0,0,0,0
2024-03-23 18:50:00,0,0,0,0,0,0
2024-03-23 19:00:00,0,0,0,0,0,0
2024-03-23 19:10:00,0,0,0,0,0,0
2024-03-23 19:20:00,0,0,0,0,0,0
2024-03-23 19:30:00,0,0,0,0,0,0
2024-03-23 19:40:00,0,0,0,0,0,0
2024-03-23 19:50:00,0,0,0,0,0,0
2024-03-23 20:00:00,0,0,0,0,0,0
2024-03-23 20:10:00,0,0,0,0,0,0
2024-03-23 20:20:00,0,0,0,0,0,0
2024-03-23 20:30:00,0,0,0,0,0,0
2024-03-23 20:40:00,0,0,0,0,0,0
2024-03-23 20:50:00,0,0,0,0,0,0
2024-03-23 21:00:00,0,0,0,0,0,0
2024-03-23 21:10:00,0,0,0,0,0,0
2024-03-23 21:20:00,0,0,0,0,0,0
2024-03-23 21:30:00,0,0,0,0,0,0
2024-03-23 21:40:00,0,0,0,0,0,0
2024-03-23 21:50:00,0,0,0,0,0,0
2024-03-23 22:00:00,0,0,0,0,0,0
2024-03-23 22:10:00,0,0,0,0,0,0
2024-03-23 22:20:00,0,0,0,0,0,0
2024-03-23 22:30:00,0,0,0,0,0,0
2024-03-23 22:40:00,0,0,0,0,0,0
2024-03-23 22:50:00,0,0,0,0,0,0
2024-03-23 23:00:00,0,0,0,0,0,0
2024-03-23 23:10:00,0,0,0,0,0,0
2024-03-23 23:20:00,0,0,0,0,0,0
2024-03-23 23:30:00,0,0,0,0,0,0
2024-03-23 23:40:00,0,0,0,0,0,0
2024-03-23 23:50:00,0,0,0,0,0,0
2024-03-24 00:00:00,0,0,0,0,0,0
2024-03-24 00:10:00,0,0,0,0,0,0
2024-03-24 00:20:00,0,0,0,0,0,0
2024-03-24 00:30:00,0,0,0,0,0,0
2024-03-24 00:40:00,0,0,0,0,0,0
2024-03-24 00:50:00,0,0,0,0,0,0
2024-03-24 01:00:00,0,0,0,0,0,0
2024-03-24 01:10:00,0,0,0,0,0,0
2024-03-24 01:20:00,0,0,0,0,0,0
2024-03-24 01:30:00,0,0,0,0,0,0
2024-03-24 01:40:00,0,0,0,0,0,0
2024-03-24 01:50:00,0,0,0,0,0,0
2024-03-24 02:00:00,0,0,0,0,0,0
2024-03-24 02:10:00,0,0,0,0,0,0
2024-03-24 02:20:00,0,0,0,0,0,0
2024-03-24 02:30:00,0,0,0,0,0,0
2024-03-24 02:40:00,0,0,0,0,0,0
2024-03-24 02:50:00,0,0,0,0,0,0
2024-03-24 03:00:00,0,0,0,0,0,0
2024-03-24 03:10:00,0,0,0,0,0,0
2024-03-24 03:20:00,0,0,0,0,0,0
2024-03-24 03:30:00,0,0,0,0,0,0
2024-03-24 03:40:00,0,0,0,0,0,0
2024-03-24 03:50:00,0,0,0,0,0,0
2024-03-24 04:00:00,0,0,0,0,0,0
2024-03-24 04:10:00,0,0,0,0,0,0
2024-03-24 04:20:00,0,0,0,0,0,0
2024-03-24 04:30:00,0,0,0,0,0,0
2024-03-24 04:40:00,0,0,0,0,0,0
2024-03-24 04:50:00,0,0,0,0,0,0
2024-03-24 05:00:00,0,0,0,0,0,0
2024-03-24 05:10:00,0,0,0,0,0,0
2024-03-24 05:20:00,0,0,0,0,0,0
2024-03-24 05:30:00,0,0,0,0,0,0
2024-03-24 05:40:00,0,0,0,0,0,0
2024-03-24 05:50:00,0,0,0,0,0,0
2024-03-24 06:00:00,0,0,0,0,0,0
2024-03-24 06:10:00,0,0,0,0,0,0
2024-03-24 06:20:00,0,0,0,0,0,0
2024-03-24 06:30:00,0,0,0,0,0,0
2024-03-24 06:40:00,0,0,0,0,0,0
2024-03-24 06:50:00,0,0,0,0,0,0
2024-03-24 07:00:00,0,0,0,0,0,0
2024-03-24 07:10:00,0,0,0,0,0,0
2024-03-24 07:20:00,0,0,0,0,0,0
2024-03-24 07:30:00,0,0,0,0,0,0
2024-03-24 07:40:00,0,0,0,0,0,0
2024-03-24 07:50:00,0,0,0,0,0,0
2024-03-24 08:00:00,0,0,0,0,0,0
2024-03-24 08:10:00,0,0,0,0,0,0
2024-03-24 08:20:00,0,0,0,0,0,0
2024-03-24 08:30:00,0,0,0,0,0,0
2024-03-24 08:40:00,0,0,0,0,0,0
2024-03-24 08:50:00,0,0,0,0,0,0
2024-03-24 09:00:00,0,0,0,0,0,0
2024-03-24 09:10:00,0,0,0,0,0,0
2024-03-24 09:20:00,0,0,0,0,0,0
2024-03-24 09:30:00,0,0,0,0,0,0
2024-03-24 09:40:00,0,0,0,0,0,0
2024-03-24 09:50:00,0,0,0,0,0,0
2024-03-24 10:00:00,0,0,0,0,0,0
2024-03-24 10:10:00,0,0,0,0,0,0
2024-03-24 10:20:00,0,0,0,0,0,0
2024-03-24 10:30:00,0,0,0,0,0,0
2024-03-24 10:40:00,0,0,0,0,0,0
2024-03-24 10:50:00,0,0,0,0,0,0
2024-03-24 11:00:00,0,0,0,0,0,0
2024-03-24 11:10:00,0,0,0,0,0,0
2024-03-24 11:20:00,0,0,0,0,0,0
2024-03-24 11:30:00,0,0,0,0,0,0
2024-03-24 11:40:00,0,0,0,0,0,0
2024-03-24 11:50:00,0,0,0,0,0,0
2024-03-24 12:00:00,0,0,0,0,0,0
2024-03-24 12:10:00,0,0,0,0,0,0
2024-03-24 12:20:00,0,0,0,0,0,0
2024-03-24 12:30:00,0,0,0,0,0,0
2024-03-24 12:40:00,0,0,0,0,0,0
2024-03-24 12:50:00,0,0,0,0,0,0
2024-03-24 13:00:00,0,0,0,0,0,0
2024-03-24 13:10:00,0,0,0,0,0,0
2024-03-24 13:20:00,0,0,0,0,0,0
2024-03-24 13:30:00,0,0,0,0,0,0
2024-03-24 13:40:00,0,0,0,0,0,0
2024-03-24 13:50:00,0,0,0,0,0,0
2024-03-24 14:00:00,0,0,0,0,0,0
2024-03-24 14:10:00,0,0,0,0,0,0
2024-03-24 14:20:00,0,0,0,0,0,0
2024-03-24 14:30:00,0,0,0,0,0,0
2024-03-24 14:40:00,0,0,0,0,0,0
2024-03-24 14:50:00,0,0,0,0,0,0
2024-03-24 15:00:00,0,0,0,0,0,0
2024-03-24 15:10:00,0,0,0,0,0,0
2024-03-24 15:20:00,0,0,0,0,0,0
2024-03-24 15:30:00,0,0,0,0,0,0
2024-03-24 15:40:00,0,0,0,0,0,0
2024-03-24 15:50:00,0,0,0,0,0,0
2024-03-24 16:00:00,0,0,0,0,0,0
2024-03-24 16:10:00,0,0,0,0,0,0
2024-03-24 16:20:00,0,0,0,0,0,0
2024-03-24 16:30:00,0,0,0,0,0,0
2024-03-24 16:40:00,0,0,0,0,0,0
2024-03-24 16:50:00,0,0,0,0,0,0
2024-03-24 17:00:00,0,0,0,0,0,0
2024-03-24 17:10:00,0,0,0,0,0,0
2024-03-24 17:20:00,0,0,0,0,0,0
2024-03-24 17:30:00,0,0,0,0,0,0
2024-03-24 17:40:00,0,0,0,0,0,0
2024-03-24 17:50:00,0,0,0,0,0,0
2024-03-24 18:00:00,0,0,0,0,0,0
2024-03-24 18:10:00,0,0,0,0,0,0
2024-03-24 18:20:00,0,0,0,0,0,0
2024-03-24 18:30:00,0,0,0,0,0,0
2024-03-24 18:40:00,0,0,0,0,0,0
2024-03-24 18:50:00,0,0,0,0,0,0
2024-03-24 19:00:00,0,0,0,0,0,0
2024-03-24 19:10:00,0,0,0,0,0,0
2024-03-24 19:20:00,0,0,0,0,0,0
2024-03-24 19:30:00,0,0,0,0,0,0
2024-03-24 19:40:00,0,0,0,0,0,0
2024-03-24 19:50:00,0,0,0,0,0,0
2024-03-24 20:00:00,0,0,0,0,0,0
2024-03-24 20:10:00,0,0,0,0,0,0
2024-03-24 20:20:00,0,0,0,0,0,0
2024-03-24 20:30:00,0,0,0,0,0,0
2024-03-24 20:40:00,0,0,0,0,0,0
2024-03-24 20:50:00,0,0,0,0,0,0
2024-03-24 21:00:00,0,0,0,0,0,0
2024-03-24 21:10:00,0,0,0,0,0,0
2024-03-24 21:20:00,0,0,0,0,0,0
2024-03-24 21:30:00,0,0,0,0,0,0
2024-03-24 21:40:00,0,0,0,0,0,0
2024-03-24 21:50:00,0,0,0,0,0,0
2024-03-24 22:00:00,0,0,0,0,0,0
2024-03-24 22:10:00,0,0,0,0,0,0
2024-03-24 22:20:00,0,0,0,0,0,0
2024-03-24 22:30:00,0,0,0,0,0,0
2024-03-24 22:40:00,0,0,0,0,0,0
2024-03-24 22:50:00,0,0,0,0,0,0
2024-03-24 23:00:00,0,0,0,0,0,0
2024-03-24 23:10:00,0,0,0,0,0,0
2024-03-24 23:20:00,0,0,0,0,0,0
2024-03-24 23:30:00,0,0,0,0,0,0
2024-03-24 23:40:00,0,0,0,0,0,0
2024-03-24 23:50:00,0,0,0,0,0,0
2024-03-25 00:00:00,0,0,0,0,0,0
2024-03-25 00:10:00,0,0,0,0,0,0
2024-03-25 00:20:00,0,0,0,0,0,0
2024-03-25 00:30:00,0,0,0,0,0,0
2024-03-25 00:40:00,0,0,0,0,0,0
2024-03-25 00:50:00,0,0,0,0,0,0
2024-03-25 01:00:00,0,0,0,0,0,0
2024-03-25 01:10:00,0,0,0,0,0,0
2024-03-25 01:20:00,0,0,0,0,0,0
2024-03-25 01:30:00,0,0,0,0,0,0
2024-03-25 01:40:00,0,0,0,0,0,0
2024-03-25 01:50:00,0,0,0,0,0,0
2024-03-25 02:00:00,0,0,0,0,0,0
2024-03-25 02:10:00,0,0,0,0,0,0
2024-03-25 02:20:00,0,0,0,0,0,0
2024-03-25 02:30:00,0,0,0,0,0,0
2024-03-25 02:40:00,0,0,0,0,0,0
2024-03-25 02:50:00,0,0,0,0,0,0
2024-03-25 03:00:00,0,0,0,0,0,0
2024-03-25 03:10:00,0,0,0,0,0,0
2024-03-25 03:20:00,0,0,0,0,0,0
2024-03-25 03:30:00,0,0,0,0,0,0
2024-03-25 03:40:00,0,0,0,0,0,0
2024-03-25 03:50:00,0,0,0,0,0,0
2024-03-25 04:00:00,0,0,0,0,0,0
2024-03-25 04:10:00,0,0,0,0,0,0
2024-03-25 04:20:00,0,0,0,0,0,0
2024-03-25 04:30:00,0,0,0,0,0,0
2024-03-25 04:40:00,0,0,0,0,0,0
2024-03-25 04:50:00,0,0,0,0,0,0
2024-03-25 05:00:00,0,0,0,0,0,0
2024-03-25 05:10:00,0,0,0,0,0,0
2024-03-25 05:20:00,0,0,0,0,0,0
2024-03-25 05:30:00,0,0,0,0,0,0
2024-03-25 05:40:00,0,0,0,0,0,0
2024-03-25 05:50:00,0,0,0,0,0,0
2024-03-25 06:00:00,0,0,0,0,0,0
2024-03-25 06:10:00,0,0,0,0,0,0
2024-03-25 06:20:00,0,0,0,0,0,0
2024-03-25 06:30:00,0,0,0,0,0,0
2024-03-25 06:40:00,0,0,0,0,0,0
2024-03-25 06:50:00,0,0,0,0,0,0
2024-03-25 07:00:00,0,0,0,0,0,0
2024-03-25 07:10:00,0,0,0,0,0,0
2024-03-25 07:20:00,0,0,0,0,0,0
2024-03-25 07:30:00,0,0,0,0,0,0
2024-03-25 07:40:00,0,0,0,0,0,0
2024-03-25 07:50:00,0,0,0,0,0,0
2024-03-25 08:00:00,0,0,0,0,0,0
2024-03-25 08:10:00,0,0,0,0,0,0
2024-03-25 08:20:00,0,0,0,0,0,0
2024-03-25 08:30:00,0,0,0,0,0,0
2024-03-25 08:40:00,0,0,0,0,0,0
2024-03-25 08:50:00,0,0,0,0,0,0
2024-03-25 09:00:00,0,0,0,0,0,0
2024-03-25 09:10:00,0,0,0,0,0,0
2024-03-25 09:20:00,0,0,0,0,0,0
2024-03-25 09:30:00,0,0,0,0,0,0
2024-03-25 09:40:00,0,0,0,0,0,0
2024-03-25 09:50:00,0,0,0,0,0,0
2024-03-25 10:00:00,0,0,0,0,0,0
2024-03-25 10:10:00,0,0,0,0,0,0
2024-03-25 10:20:00,0,0,0,0,0,0
2024-03-25 10:30:00,0,0,0,0,0,0
2024-03-25 10:40:00,0,0,0,0,0,0
2024-03-25 10:50:00,0,0,0,0,0,0
2024-03-25 11:00:00,0,0,0,0,0,0
2024-03-25 11:10:00,0,0,0,0,0,0
2024-03-25 11:20:00,0,0,0,0,0,0
2024-03-25 11:30:00,0,0,0,0,0,0
2024-03-25 11:40:00,0,0,0,0,0,0
2024-03-25 11:50:00,0,0,0,0,0,0
2024-03-25 12:00:00,0,0,0,0,0,0
2024-03-25 12:10:00,0,0,0,0,0,0
2024-03-25 12:20:00,0,0,0,0,0,0
2024-03-25 12:30:00,0,0,0,0,0,0
2024-03-25 12:40:00,0,0,0,0,0,0
2024-03-25 12:50:00,0,0,0,0,0,0
2024-03-25 13:00:00,0,0,0,0,0,0
2024-03-25 13:10:00,0,0,0,0,0,0
2024-03-25 13:20:00,0,0,0,0,0,0
2024-03-25 13:30:00,0,0,0,0,0,0
2024-03-25 13:40:00,0,0,0,0,0,0
2024-03-25 13:50:00,0,0,0,0,0,0
2024-03-25 14:00:00,0,0,0,0,0,0
2024-03-25 14:10:00,0,0,0,0,0,0
2024-03-25 14:20:00,0,0,0,0,0,0
2024-03-25 14:30:00,0,0,0,0,0,0
2024-03-25 14:40:00,0,0,0,0,0,0
2024-03-25 14:50:00,0,0,0,0,0,0
2024-03-25 15:00:00,0,0,0,0,0,0
2024-03-25 15:10:00,0,0,0,0,0,0
2024-03-25 15:20:00,0,0,0,0,0,0
2024-03-25 15:30:00,0,0,0,0,0,0
2024-03-25 15:40:00,0,0,0,0,0,0
2024-03-25 15:50:00,0,0,0,0,0,0
2024-03-25 16:00:00,0,0,0,0,0,0
2024-03-25 16:10:00,0,0,0,0,0,0
2024-03-25 16:20:00,0,0,0,0,0,0
2024-03-25 16:30:00,0,0,0,0,0,0
2024-03-25 16:40:00,0,0,0,0,0,0
2024-03-25 16:50:00,0,0,0,0,0,0
2024-03-25 17:00:00,0,0,0,0,0,0
2024-03-25 17:10:00,0,0,0,0,0,0
2024-03-25 17:20:00,0,0,0,0,0,0
2024-03-25 17:30:00,0,0,0,0,0,0
2024-03-25 17:40:00,0,0,0,0,0,0
2024-03-25 17:50:00,0,0,0,0,0,0
2024-03-25 18:00:00,0,0,0,0,0,0
2024-03-25 18:10:00,0,0,0,0,0,0
2024-03-25 18:20:00,0,0,0,0,0,0
2024-03-25 18:30:00,0,0,0,0,0,0
2024-03-25 18:40:00,0,0,0,0,0,0
2024-03-25 18:50:00,0,0,0,0,0,0
2024-03-25 19:00:00,0,0,0,0,0,0
2024-03-25 19:10:00,0,0,0,0,0,0
2024-03-25 19:20:00,0,0,0,0,0,0
2024-03-25 19:30:00,0,0,0,0,0,0
2024-03-25 19:40:00,0,0,0,0,0,0
2024-03-25 19:50:00,0,0,0,0,0,0
2024-03-25 20:00:00,0,0,0,0,0,0
2024-03-25 20:10:00,0,0,0,0,0,0
2024-03-25 20:20:00,0,0,0,0,0,0
2024-03-25 20:30:00,0,0,0,0,0,0
2024-03-25 20:40:00,0,0,0,0,0,0
2024-03-25 20:50:00,0,0,0,0,0,0
2024-03-25 21:00:00,0,0,0,0,0,0
2024-03-25 21:10:00,0,0,0,0,0,0
2024-03-25 21:20:00,0,0,0,0,0,0
2024-03-25 21:30:00,0,0,0,0,0,0
2024-03-25 21:40:00,0,0,0,0,0,0
2024-03-25 21:50:00,0,0,0,0,0,0
2024-03-25 22:00:00,0,0,0,0,0,0
2024-03-25 22:10:00,0,0,0,0,0,0
2024-03-25 22:20:00,0,0,0,0,0,0
2024-03-25 22:30:00,0,0,0,0,0,0
2024-03-25 22:40:00,0,0,0,0,0,0
2024-03-25 22:50:00,0,0,0,0,0,0
2024-03-25 23:00:00,0,0,0,0,0,0
2024-03-25 23:10:00,0,0,0,0,0,0
2024-03-25 23:20:00,0,0,0,0,0,0
2024-03-25 23:30:00,0,0,0,0,0,0
2024-03-25 23:40:00,0,0,0,0,0,0
2024-03-25 23:50:00,0,0,0,0,0,0
2024-03-26 00:00:00,0,0,0,0,0,0
2024-03-26 00:10:00,0,0,0,0,0,0
2024-03-26 00:20:00,0,0,0,0,0,0
2024-03-26 00:30:00,0,0,0,0,0,0
2024-03-26 00:40:00,0,0,0,0,0,0
2024-03-26 00:50:00,0,0,0,0,0,0
2024-03-26 01:00:00,0,0,0,0,0,0
2024-03-26 01:10:00,0,0,0,0,0,0
2024-03-26 01:20:00,0,0,0,0,0,0
2024-03-26 01:30:00,0,0,0,0,0,0
2024-03-26 01:40:00,0,0,0,0,0,0
2024-03-26 01:50:00,0,0,0,0,0,0
2024-03-26 02:00:00,0,0,0,0,0,0
2024-03-26 02:10:00,0,0,0,0,0,0
2024-03-26 02:20:00,0,0,0,0,0,0
2024-03-26 02:30:00,0,0,0,0,0,0
2024-03-26 02:40:00,0,0,0,0,0,0
2024-03-26 02:50:00,0,0,0,0,0,0
2024-03-26 03:00:00,0,0,0,0,0,0
2024-03-26 03:10:00,0,0,0,0,0,0
2024-03-26 03:20:00,0,0,0,0,0,0
2024-03-26 03:30:00,0,0,0,0,0,0
2024-03-26 03:40:00,0,0,0,0,0,0
2024-03-26 03:50:00,0,0,0,0,0,0
2024-03-26 04:00:00,0,0,0,0,0,0
2024-03-26 04:10:00,0,0,0,0,0,0
2024-03-26 04:20:00,0,0,0,0,0,0
2024-03-26 04:30:00,0,0,0,0,0,0
2024-03-26 04:40:00,0,0,0,0,0,0
2024-03-26 04:50:00,0,0,0,0,0,0
2024-03-26 05:00:00,0,0,0,0,0,0
2024-03-26 05:10:00,0,0,0,0,0,0
2024-03-26 05:20:00,0,0,0,0,0,0
2024-03-26 05:30:00,0,0,0,0,0,0
2024-03-26 05:40:00,0,0,0,0,0,0
2024-03-26 05:50:00,0,0,0,0,0,0
2024-03-26 06:00:00,0,0,0,0,0,0
2024-03-26 06:10:00,0,0,0,0,0,0
2024-03-26 06:20:00,0,0,0,0,0,0
2024-03-26 06:30:00,0,0,0,0,0,0
2024-03-26 06:40:00,0,0,0,0,0,0
2024-03-26 06:50:00,0,0,0,0,0,0
2024-03-26 07:00:00,0,0,0,0,0,0
2024-03-26 07:10:00,0,0,0,0,0,0
2024-03-26 07:20:00,0,0,0,0,0,0
2024-03-26 07:30:00,0,0,0,0,0,0
2024-03-26 07:40:00,0,0,0,0,0,0
2024-03-26 07:50:00,0,0,0,0,0,0
2024-03-26 08:00:00,0,0,0,0,0,0
2024-03-26 08:10:00,0,0,0,0,0,0
2024-03-26 08:20:00,0,0,0,0,0,0
2024-03-26 08:30:00,0,0,0,0,0,0
2024-03-26 08:40:00,0,0,0,0,0,0
2024-03-26 08:50:00,0,0,0,0,0,0
2024-03-26 09:00:00,0,0,0,0,0,0
2024-03-26 09:10:00,0,0,0,0,0,0
2024-03-26 09:20:00,0,0,0,0,0,0
2024-03-26 09:30:00,0,0,0,0,0,0
2024-03-26 09:40:00,0,0,0,0,0,0
2024-03-26 09:50:00,0,0,0,0,0,0
2024-03-26 10:00:00,0,0,0,0,0,0
2024-03-26 10:10:00,0,0,0,0,0,0
2024-03-26 10:20:00,0,0,0,0,0,0
2024-03-26 10:30:00,0,0,0,0,0,0
2024-03-26 10:40:00,0,0,0,0,0,0
2024-03-26 10:50:00,0,0,0,0,0,0
2024-03-26 11:00:00,0,0,0,0,0,0
2024-03-26 11:10:00,0,0,0,0,0,0
2024-03-26 11:20:00,0,0,0,0,0,0
2024-03-26 11:30:00,0,0,0,0,0,0
2024-03-26 11:40:00,0,0,0,0,0,0
2024-03-26 11:50:00,0,0,0,0,0,0
2024-03-26 12:00:00,0,0,0,0,0,0
2024-03-26 12:10:00,0,0,0,0,0,0
2024-03-26 12:20:00,0,0,0,0,0,0
2024-03-26 12:30:00,0,0,0,0,0,0
2024-03-26 12:40:00,0,0,0,0,0,0
2024-03-26 12:50:00,0,0,0,0,0,0
2024-03-26 13:00:00,0,0,0,0,0,0
2024-03-26 13:10:00,0,0,0,0,0,0
2024-03-26 13:20:00,0,0,0,0,0,0
2024-03-26 13:30:00,0,0,0,0,0,0
2024-03-26 13:40:00,0,0,0,0,0,0
2024-03-26 13:50:00,0,0,0,0,0,0
2024-03-26 14:00:00,0,0,0,0,0,0
2024-03-26 14:10:00,0,0,0,0,0,0
2024-03-26 14:20:00,0,0,0,0,0,0
2024-03-26 14:30:00,0,0,0,0,0,0
2024-03-26 14:40:00,0,0,0,0,0,0
2024-03-26 14:50:00,0,0,0,0,0,0
2024-03-26 15:00:00,0,0,0,0,0,0
2024-03-26 15:10:00,0,0,0,0,0,0
2024-03-26 15:20:00,0,0,0,0,0,0
2024-03-26 15:30:00,0,0,0,0,0,0
2024-03-26 15:40:00,0,0,0,0,0,0
2024-03-26 15:50:00,0,0,0,0,0,0
2024-03-26 16:00:00,0,0,0,0,0,0
2024-03-26 16:10:00,0,0,0,0,0,0
2024-03-26 16:20:00,0,0,0,0,0,0
2024-03-26 16:30:00,0,0,0,0,0,0
2024-03-26 16:40:00,0,0,0,0,0,0
2024-03-26 16:50:00,0,0,0,0,0,0
2024-03-26 17:00:00,0,0,0,0,0,0
2024-03-26 17:10:00,0,0,0,0,0,0
2024-03-26 17:20:00,0,0,0,0,0,0
2024-03-26 17:30:00,0,0,0,0,0,0
2024-03-26 17:40:00,0,0,0,0,0,0
2024-03-26 17:50:00,0,0,0,0,0,0
2024-03-26 18:00:00,0,0,0,0,0,0
2024-03-26 18:10:00,0,0,0,0,0,0
2024-03-26 18:20:00,0,0,0,0,0,0
2024-03-26 18:30:00,0,0,0,0,0,0
2024-03-26 18:40:00,0,0,0,0,0,0
2024-03-26 18:50:00,0,0,0,0,0,0
2024-03-26 19:00:00,0,0,0,0,0,0
2024-03-26 19:10:00,0,0,0,0,0,0
2024-03-26 19:20:00,0,0,0,0,0,0
2024-03-26 19:30:00,0,0,0,0,0,0
2024-03-26 19:40:00,0,0,0,0,0,0
2024-03-26 19:50:00,0,0,0,0,0,0
2024-03-26 20:00:00,0,0,0,0,0,0
2024-03-26 20:10:00,0,0,0,0,0,0
2024-03-26 20:20:00,0,0,0,0,0,0
2024-03-26 20:30:00,0,0,0,0,0,0
2024-03-26 20:40:00,0,0,0,0,0,0
2024-03-26 20:50:00,0,0,0,0,0,0
2024-03-26 21:00:00,0,0,0,0,0,0
2024-03-26 21:10:00,0,0,0,0,0,0
2024-03-26 21:20:00,0,0,0,0,0,0
2024-03-26 21:30:00,0,0,0,0,0,0
2024-03-26 21:40:00,0,0,0,0,0,0
2024-03-26 21:50:00,0,0,0,0,0,0
2024-03-26 22:00:00,0,0,0,0,0,0
2024-03-26 22:10:00,0,0,0,0,0,0
2024-03-26 22:20:00,0,0,0,0,0,0
2024-03-26 22:30:00,0,0,0,0,0,0
2024-03-26 22:40:00,0,0,0,0,0,0
2024-03-26 22:50:00,0,0,0,0,0,0
2024-03-26 23:00:00,0,0,0,0,0,0
2024-03-26 23:10:00,0,0,0,0,0,0
2024-03-26 23:20:00,0,0,0,0,0,0
2024-03-26 23:30:00,0,0,0,0,0,0
2024-03-26 23:40:00,0,0,0,0,0,0
2024-03-26 23:50:00,0,0,0,0,0,0
2024-03-27 00:00:00,0,0,0,0,0,0
2024-03-27 00:10:00,0,0,0,0,0,0
2024-03-27 00:20:00,0,0,0,0,0,0
2024-03-27 00:30:00,0,0,0,0,0,0
2024-03-27 00:40:00,0,0,0,0,0,0
2024-03-27 00:50:00,0,0,0,0,0,0
2024-03-27 01:00:00,0,0,0,0,0,0
2024-03-27 01:10:00,0,0,0,0,0,0
2024-03-27 01:20:00,0,0,0,0,0,0
2024-03-27 01:30:00,0,0,0,0,0,0
2024-03-27 01:40:00,0,0,0,0,0,0
2024-03-27 01:50:00,0,0,0,0,0,0
2024-03-27 02:00:00,0,0,0,0,0,0
2024-03-27 02:10:00,0,0,0,0,0,0
2024-03-27 02:20:00,0,0,0,0,0,0
2024-03-27 02:30:00,0,0,0,0,0,0
2024-03-27 02:40:00,0,0,0,0,0,0
2024-03-27 02:50:00,0,0,0,0,0,0
2024-03-27 03:00:00,0,0,0,0,0,0
2024-03-27 03:10:00,0,0,0,0,0,0
2024-03-27 03:20:00,0,0,0,0,0,0
2024-03-27 03:30:00,0,0,0,0,0,0
2024-03-27 03:40:00,0,0,0,0,0,0
2024-03-27 03:50:00,0,0,0,0,0,0
2024-03-27 04:00:00,0,0,0,0,0,0
2024-03-27 04:10:00,0,0,0,0,0,0
2024-03-27 04:20:00,0,0,0,0,0,0
2024-03-27 04:30:00,0,0,0,0,0,0
2024-03-27 04:40:00,0,0,0,0,0,0
2024-03-27 04:50:00,0,0,0,0,0,0
2024-03-27 05:00:00,0,0,0,0,0,0
2024-03-27 05:10:00,0,0,0,0,0,0
2024-03-27 05:20:00,0,0,0,0,0,0
2024-03-27 05:30:00,0,0,0,0,0,0
2024-03-27 05:40:00,0,0,0,0,0,0
2024-03-27 05:50:00,0,0,0,0,0,0
2024-03-27 06:00:00,0,0,0,0,0,0
2024-03-27 06:10:00,0,0,0,0,0,0
2024-03-27 06:20:00,0,0,0,0,0,0
2024-03-27 06:30:00,0,0,0,0,0,0
2024-03-27 06:40:00,0,0,0,0,0,0
2024-03-27 06:50:00,0,0,0,0,0,0
2024-03-27 07:00:00,0,0,0,0,0,0
2024-03-27 07:10:00,0,0,0,0,0,0
2024-03-27 07:20:00,0,0,0,0,0,0
2024-03-27 07:30:00,0,0,0,0,0,0
2024-03-27 07:40:00,0,0,0,0,0,0
2024-03-27 07:50:00,0,0,0,0,0,0
2024-03-27 08:00:00,0,0,0,0,0,0
2024-03-27 08:10:00,0,0,0,0,0,0
2024-03-27 08:20:00,0,0,0,0,0,0
2024-03-27 08:30:00,0,0,0,0,0,0
2024-03-27 08:40:00,0,0,0,0,0,0
2024-03-27 08:50:00,0,0,0,0,0,0
2024-03-27 09:00:00,0,0,0,0,0,0
2024-03-27 09:10:00,0,0,0,0,0,0
2024-03-27 09:20:00,0,0,0,0,0,0
2024-03-27 09:30:00,0,0,0,0,0,0
2024-03-27 09:40:00,0,0,0,0,0,0
2024-03-27 09:50:00,0,0,0,0,0,0
2024-03-27 10:00:00,0,0,0,0,0,0
2024-03-27 10:10:00,0,0,0,0,0,0
2024-03-27 10:20:00,0,0,0,0,0,0
2024-03-27 10:30:00,0,0,0,0,0,0
2024-03-27 10:40:00,0,0,0,0,0,0
2024-03-27 10:50:00,0,0,0,0,0,0
2024-03-27 11:00:00,0,0,0,0,0,0
2024-03-27 11:10:00,0,0,0,0,0,0
2024-03-27 11:20:00,0,0,0,0,0,0
2024-03-27 11:30:00,0,0,0,0,0,0
2024-03-27 11:40:00,0,0,0,0,0,0
2024-03-27 11:50:00,0,0,0,0,0,0
2024-03-27 12:00:00,0,0,0,0,0,0
2024-03-27 12:10:00,0,0,0,0,0,0
2024-03-27 12:20:00,0,0,0,0,0,0
2024-03-27 12:30:00,0,0,0,0,0,0
2024-03-27 12:40:00,0,0,0,0,0,0
2024-03-27 12:50:00,0,0,0,0,0,0
2024-03-27 13:00:00,0,0,0,0,0,0
2024-03-27 13:10:00,0,0,0,0,0,0
2024-03-27 13:20:00,0,0,0,0,0,0
2024-03-27 13:30:00,0,0,0,0,0,0
2024-03-27 13:40:00,0,0,0,0,0,0
2024-03-27 13:50:00,0,0,0,0,0,0
2024-03-27 14:00:00,0,0,0,0,0,0
2024-03-27 14:10:00,0,0,0,0,0,0
2024-03-27 14:20:00,0,0,0,0,0,0
2024-03-27 14:30:00,0,0,0,0,0,0
2024-03-27 14:40:00,0,0,0,0,0,0
2024-03-27 14:50:00,0,0,0,0,0,0
2024-03-27 15:00:00,0,0,0,0,0,0
2024-03-27 15:10:00,0,0,0,0,0,0
2024-03-27 15:20:00,0,0,0,0,0,0
2024-03-27 15:30:00,0,0,0,0,0,0
2024-03-27 15:40:00,0,0,0,0,0,0
2024-03-27 15:50:00,0,0,0,0,0,0
2024-03-27 16:00:00,0,0,0,0,0,0
2024-03-27 16:10:00,0,0,0,0,0,0
2024-03-27 16:20:00,0,0,0,0,0,0
2024-03-27 16:30:00,0,0,0,0,0,0
2024-03-27 16:40:00,0,0,0,0,0,0
2024-03-27 16:50:00,0,0,0,0,0,0
2024-03-27 17:00:00,0,0,0,0,0,0
2024-03-27 17:10:00,0,0,0,0,0,0
2024-03-27 17:20:00,0,0,0,0,0,0
2024-03-27 17:30:00,0,0,0,0,0,0
2024-03-27 17:40:00,0,0,0,0,0,0
2024-03-27 17:50:00,0,0,0,0,0,0
2024-03-27 18:00:00,0,0,0,0,0,0
2024-03-27 18:10:00,0,0,0,0,0,0
2024-03-27 18:20:00,0,0,0,0,0,0
2024-03-27 18:30:00,0,0,0,0,0,0
2024-03-27 18:40:00,0,0,0,0,0,0
2024-03-27 18:50:00,0,0,0,0,0,0
2024-03-27 19:00:00,0,0,0,0,0,0
2024-03-27 19:10:00,0,0,0,0,0,0
2024-03-27 19:20:00,0,0,0,0,0,0
2024-03-27 19:30:00,0,0,0,0,0,0
2024-03-27 19:40:00,0,0,0,0,0,0
2024-03-27 19:50:00,0,0,0,0,0,0
2024-03-27 20:00:00,0,0,0,0,0,0
2024-03-27 20:10:00,0,0,0,0,0,0
2024-03-27 20:20:00,0,0,0,0,0,0
2024-03-27 20:30:00,0,0,0,0,0,0
2024-03-27 20:40:00,0,0,0,0,0,0
2024-03-27 20:50:00,0,0,0,0,0,0
2024-03-27 21:00:00,0,0,0,0,0,0
2024-03-27 21:10:00,0,0,0,0,0,0
2024-03-27 21:20:00,0,0,0,0,0,0
2024-03-27 21:30:00,0,0,0,0,0,0
2024-03-27 21:40:00,0,0,0,0,0,0
2024-03-27 21:50:00,0,0,0,0,0,0
2024-03-27 22:00:00,0,0,0,0,0,0
2024-03-27 22:10:00,0,0,0,0,0,0
2024-03-27 22:20:00,0,0,0,0,0,0
2024-03-27 22:30:00,0,0,0,0,0,0
2024-03-27 22:40:00,0,0,0,0,0,0
2024-03-27 22:50:00,0,0,0,0,0,0
2024-03-27 23:00:00,0,0,0,0,0,0
2024-03-27 23:10:00,0,0,0,0,0,0
2024-03-27 23:20:00,0,0,0,0,0,0
2024-03-27 23:30:00,0,0,0,0,0,0
2024-03-27 23:40:00,0,0,0,0,0,0
2024-03-27 23:50:00,0,0,0,0,0,0
2024-03-28 00:00:00,0,0,0,0,0,0
2024-03-28 00:10:00,0,0,0,0,0,0
2024-03-28 00:20:00,0,0,0,0,0,0
2024-03-28 00:30:00,0,0,0,0,0,0
2024-03-28 00:40:00,0,0,0,0,0,0
2024-03-28 00:50:00,0,0,0,0,0,0
2024-03-28 01:00:00,0,0,0,0,0,0
2024-03-28 01:10:00,0,0,0,0,0,0
2024-03-28 01:20:00,0,0,0,0,0,0
2024-03-28 01:30:00,0,0,0,0,0,0
2024-03-28 01:40:00,0,0,0,0,0,0
2024-03-28 01:50:00,0,0,0,0,0,0
2024-03-28 02:00:00,0,0,0,0,0,0
2024-03-28 02:10:00,0,0,0,0,0,0
2024-03-28 02:20:00,0,0,0,0,0,0
2024-03-28 02:30:00,0,0,0,0,0,0
2024-03-28 02:40:00,0,0,0,0,0,0
2024-03-28 02:50:00,0,0,0,0,0,0
2024-03-28 03:00:00,0,0,0,0,0,0
2024-03-28 03:10:00,0,0,0,0,0,0
2024-03-28 03:20:00,0,0,0,0,0,0
2024-03-28 03:30:00,0,0,0,0,0,0
2024-03-28 03:40:00,0,0,0,0,0,0
2024-03-28 03:50:00,0,0,0,0,0,0
2024-03-28 04:00:00,0,0,0,0,0,0
2024-03-28 04:10:00,0,0,0,0,0,0
2024-03-28 04:20:00,0,0,0,0,0,0
2024-03-28 04:30:00,0,0,0,0,0,0
2024-03-28 04:40:00,0,0,0,0,0,0
2024-03-28 04:50:00,0,0,0,0,0,0
2024-03-28 05:00:00,0,0,0,0,0,0
2024-03-28 05:10:00,0,0,0,0,0,0
2024-03-28 05:20:00,0,0,0,0,0,0
2024-03-28 05:30:00,0,0,0,0,0,0
2024-03-28 05:40:00,0,0,0,0,0,0
2024-03-28 05:50:00,0,0,0,0,0,0
2024-03-28 06:00:00,0,0,0,0,0,0
2024-03-28 06:10:00,0,0,0,0,0,0
2024-03-28 06:20:00,0,0,0,0,0,0
2024-03-28 06:30:00,0,0,0,0,0,0
2024-03-28 06:40:00,0,0,0,0,0,0
2024-03-28 06:50:00,0,0,0,0,0,0
2024-03-28 07:00:00,0,0,0,0,0,0
2024-03-28 07:10:00,0,0,0,0,0,0
2024-03-28 07:20:00,0,0,0,0,0,0
2024-03-28 07:30:00,0,0,0,0,0,0
2024-03-28 07:40:00,0,0,0,0,0,0
2024-03-28 07:50:00,0,0,0,0,0,0
2024-03-28 08:00:00,0,0,0,0,0,0
2024-03-28 08:10:00,0,0,0,0,0,0
2024-03-28 08:20:00,0,0,0,0,0,0
2024-03-28 08:30:00,0,0,0,0,0,0
2024-03-28 08:40:00,0,0,0,0,0,0
2024-03-28 08:50:00,0,0,0,0,0,0
2024-03-28 09:00:00,0,0,0,0,0,0
2024-03-28 09:10:00,0,0,0,0,0,0
2024-03-28 09:20:00,0,0,0,0,0,0
2024-03-28 09:30:00,0,0,0,0,0,0
2024-03-28 09:40:00,0,0,0,0,0,0
2024-03-28 09:50:00,0,0,0,0,0,0
2024-03-28 10:00:00,0,0,0,0,0,0
2024-03-28 10:10:00,0,0,0,0,0,0
2024-03-28 10:20:00,0,0,0,0,0,0
2024-03-28 10:30:00,0,0,0,0,0,0
2024-03-28 10:40:00,0,0,0,0,0,0
2024-03-28 10:50:00,0,0,0,0,0,0
2024-03-28 11:00:00,0,0,0,0,0,0
2024-03-28 11:10:00,0,0,0,0,0,0
2024-03-28 11:20:00,0,0,0,0,0,0
2024-03-28 11:30:00,0,0,0,0,0,0
2024-03-28 11:40:00,0,0,0,0,0,0
2024-03-28 11:50:00,0,0,0,0,0,0
2024-03-28 12:00:00,0,0,0,0,0,0
2024-03-28 12:10:00,0,0,0,0,0,0
2024-03-28 12:20:00,0,0,0,0,0,0
2024-03-28 12:30:00,0,0,0,0,0,0
2024-03-28 12:40:00,0,0,0,0,0,0
2024-03-28 12:50:00,0,0,0,0,0,0
2024-03-28 13:00:00,0,0,0,0,0,0
2024-03-28 13:10:00,0,0,0,0,0,0
2024-03-28 13:20:00,0,0,0,0,0,0
2024-03-28 13:30:00,0,0,0,0,0,0
2024-03-28 13:40:00,0,0,0,0,0,0
2024-03-28 13:50:00,0,0,0,0,0,0
2024-03-28 14:00:00,0,0,0,0,0,0
2024-03-28 14:10:00,0,0,0,0,0,0
2024-03-28 14:20:00,0,0,0,0,0,0
2024-03-28 14:30:00,0,0,0,0,0,0
2024-03-28 14:40:00,0,0,0,0,0,0
2024-03-28 14:50:00,0,0,0,0,0,0
2024-03-28 15:00:00,0,0,0,0,0,0
2024-03-28 15:10:00,0,0,0,0,0,0
2024-03-28 15:20:00,0,0,0,0,0,0
2024-03-28 15:30:00,0,0,0,0,0,0
2024-03-28 15:40:00,0,0,0,0,0,0
2024-03-28 15:50:00,0,0,0,0,0,0
2024-03-28 16:00:00,0,0,0,0,0,0
2024-03-28 16:10:00,0,0,0,0,0,0
2024-03-28 16:20:00,0,0,0,0,0,0
2024-03-28 16:30:00,0,0,0,0,0,0
2024-03-28 16:40:00,0,0,0,0,0,0
2024-03-28 16:50:00,0,0,0,0,0,0
2024-03-28 17:00:00,0,0,0,0,0,0
2024-03-28 17:10:00,0,0,0,0,0,0
2024-03-28 17:20:00,0,0,0,0,0,0
2024-03-28 17:30:00,0,0,0,0,0,0
2024-03-28 17:40:00,0,0,0,0,0,0
2024-03-28 17:50:00,0,0,0,0,0,0
2024-03-28 18:00:00,0,0,0,0,0,0
2024-03-28 18:10:00,0,0,0,0,0,0
2024-03-28 18:20:00,0,0,0,0,0,0
2024-03-28 18:30:00,0,0,0,0,0,0
2024-03-28 18:40:00,0,0,0,0,0,0
2024-03-28 18:50:00,0,0,0,0,0,0
2024-03-28 19:00:00,0,0,0,0,0,0
2024-03-28 19:10:00,0,0,0,0,0,0
2024-03-28 19:20:00,0,0,0,0,0,0
2024-03-28 19:30:00,0,0,0,0,0,0
2024-03-28 19:40:00,0,0,0,0,0,0
2024-03-28 19:50:00,0,0,0,0,0,0
2024-03-28 20:00:00,0,0,0,0,0,0
2024-03-28 20:10:00,0,0,0,0,0,0
2024-03-28 20:20:00,0,0,0,0,0,0
2024-03-28 20:30:00,0,0,0,0,0,0
2024-03-28 20:40:00,0,0,0,0,0,0
2024-03-28 20:50:00,0,0,0,0,0,0
2024-03-28 21:00:00,0,0,0,0,0,0
2024-03-28 21:10:00,0,0,0,0,0,0
2024-03-28 21:20:00,0,0,0,0,0,0
2024-03-28 21:30:00,0,0,0,0,0,0
2024-03-28 21:40:00,0,0,0,0,0,0
2024-03-28 21:50:00,0,0,0,0,0,0
2024-03-28 22:00:00,0,0,0,0,0,0
2024-03-28 22:10:00,0,0,0,0,0,0
2024-03-28 22:20:00,0,0,0,0,0,0
2024-03-28 22:30:00,0,0,0,0,0,0
2024-03-28 22:40:00,0,0,0,0,0,0
2024-03-28 22:50:00,0,0,0,0,0,0
2024-03-28 23:00:00,0,0,0,0,0,0
2024-03-28 23:10:00,0,0,0,0,0,0
2024-03-28 23:20:00,0,0,0,0,0,0
2024-03-28 23:30:00,0,0,0,0,0,0
2024-03-28 23:40:00,0,0,0,0,0,0
2024-03-28 23:50:00,0,0,0,0,0,0
2024-03-29 00:00:00,0,0,0,0,0,0
2024-03-29 00:10:00,0,0,0,0,0,0
2024-03-29 00:20:00,0,0,0,0,0,0
2024-03-29 00:30:00,0,0,0,0,0,0
2024-03-29 00:40:00,0,0,0,0,0,0
2024-03-29 00:50:00,0,0,0,0,0,0
2024-03-29 01:00:00,0,0,0,0,0,0
2024-03-29 01:10:00,0,0,0,0,0,0
2024-03-29 01:20:00,0,0,0,0,0,0
2024-03-29 01:30:00,0,0,0,0,0,0
2024-03-29 01:40:00,0,0,0,0,0,0
2024-03-29 01:50:00,0,0,0,0,0,0
2024-03-29 02:00:00,0,0,0,0,0,0
2024-03-29 02:10:00,0,0,0,0,0,0
2024-03-29 02:20:00,0,0,0,0,0,0
2024-03-29 02:30:00,0,0,0,0,0,0
2024-03-29 02:40:00,0,0,0,0,0,0
2024-03-29 02:50:00,0,0,0,0,0,0
2024-03-29 03:00:00,0,0,0,0,0,0
2024-03-29 03:10:00,0,0,0,0,0,0
2024-03-29 03:20:00,0,0,0,0,0,0
2024-03-29 03:30:00,0,0,0,0,0,0
2024-03-29 03:40:00,0,0,0,0,0,0
2024-03-29 03:50:00,0,0,0,0,0,0
2024-03-29 04:00:00,0,0,0,0,0,0
2024-03-29 04:10:00,0,0,0,0,0,0
2024-03-29 04:20:00,0,0,0,0,0,0
2024-03-29 04:30:00,0,0,0,0,0,0
2024-03-29 04:40:00,0,0,0,0,0,0
2024-03-29 04:50:00,0,0,0,0,0,0
2024-03-29 05:00:00,0,0,0,0,0,0
2024-03-29 05:10:00,0,0,0,0,0,0
2024-03-29 05:20:00,0,0,0,0,0,0
2024-03-29 05:30:00,0,0,0,0,0,0
2024-03-29 05:40:00,0,0,0,0,0,0
2024-03-29 05:50:00,0,0,0,0,0,0
2024-03-29 06:00:00,0,0,0,0,0,0
2024-03-29 06:10:00,0,0,0,0,0,0
2024-03-29 06:20:00,0,0,0,0,0,0
2024-03-29 06:30:00,0,0,0,0,0,0
2024-03-29 06:40:00,0,0,0,0,0,0
2024-03-29 06:50:00,0,0,0,0,0,0
2024-03-29 07:00:00,0,0,0,0,0,0
2024-03-29 07:10:00,0,0,0,0,0,0
2024-03-29 07:20:00,0,0,0,0,0,0
2024-03-29 07:30:00,0,0,0,0,0,0
2024-03-29 07:40:00,0,0,0,0,0,0
2024-03-29 07:50:00,0,0,0,0,0,0
2024-03-29 08:00:00,0,0,0,0,0,0
2024-03-29 08:10:00,0,0,0,0,0,0
2024-03-29 08:20:00,0,0,0,0,0,0
2024-03-29 08:30:00,0,0,0,0,0,0
2024-03-29 08:40:00,0,0,0,0,0,0
2024-03-29 08:50:00,0,0,0,0,0,0
2024-03-29 09:00:00,0,0,0,0,0,0
2024-03-29 09:10:00,0,0,0,0,0,0
2024-03-29 09:20:00,0,0,0,0,0,0
2024-03-29 09:30:00,0,0,0,0,0,0
2024-03-29 09:40:00,0,0,0,0,0,0
2024-03-29 09:50:00,0,0,0,0,0,0
2024-03-29 10:00:00,0,0,0,0,0,0
2024-03-29 10:10:00,0,0,0,0,0,0
2024-03-29 10:20:00,0,0,0,0,0,0
2024-03-29 10:30:00,0,0,0,0,0,0
2024-03-29 10:40:00,0,0,0,0,0,0
2024-03-29 10:50:00,0,0,0,0,0,0
2024-03-29 11:00:00,0,0,0,0,0,0
2024-03-29 11:10:00,0,0,0,0,0,0
2024-03-29 11:20:00,0,0,0,0,0,0
2024-03-29 11:30:00,0,0,0,0,0,0
2024-03-29 11:40:00,0,0,0,0,0,0
2024-03-29 11:50:00,0,0,0,0,0,0
2024-03-29 12:00:00,0,0,0,0,0,0
2024-03-29 12:10:00,0,0,0,0,0,0
2024-03-29 12:20:00,0,0,0,0,0,0
2024-03-29 12:30:00,0,0,0,0,0,0
2024-03-29 12:40:00,0,0,0,0,0,0
2024-03-29 12:50:00,0,0,0,0,0,0
2024-03-29 13:00:00,0,0,0,0,0,0
2024-03-29 13:10:00,0,0,0,0,0,0
2024-03-29 13:20:00,0,0,0,0,0,0
2024-03-29 13:30:00,0,0,0,0,0,0
2024-03-29 13:40:00,0,0,0,0,0,0
2024-03-29 13:50:00,0,0,0,0,0,0
2024-03-29 14:00:00,0,0,0,0,0,0
2024-03-29 14:10:00,0,0,0,0,0,0
2024-03-29 14:20:00,0,0,0,0,0,0
2024-03-29 14:30:00,0,0,0,0,0,0
2024-03-29 14:40:00,0,0,0,0,0,0
2024-03-29 14:50:00,0,0,0,0,0,0
2024-03-29 15:00:00,0,0,0,0,0,0
2024-03-29 15:10:00,0,0,0,0,0,0
2024-03-29 15:20:00,0,0,0,0,0,0
2024-03-29 15:30:00,0,0,0,0,0,0
2024-03-29 15:40:00,0,0,0,0,0,0
2024-03-29 15:50:00,0,0,0,0,0,0
2024-03-29 16:00:00,0,0,0,0,0,0
2024-03-29 16:10:00,0,0,0,0,0,0
2024-03-29 16:20:00,0,0,0,0,0,0
2024-03-29 16:30:00,0,0,0,0,0,0
2024-03-29 16:40:00,0,0,0,0,0,0
2024-03-29 16:50:00,0,0,0,0,0,0
2024-03-29 17:00:00,0,0,0,0,0,0
2024-03-29 17:10:00,0,0,0,0,0,0
2024-03-29 17:20:00,0,0,0,0,0,0
2024-03-29 17:30:00,0,0,0,0,0,0
2024-03-29 17:40:00,0,0,0,0,0,0
2024-03-29 17:50:00,0,0,0,0,0,0
2024-03-29 18:00:00,0,0,0,0,0,0
2024-03-29 18:10:00,0,0,0,0,0,0
2024-03-29 18:20:00,0,0,0,0,0,0
2024-03-29 18:30:00,0,0,0,0,0,0
2024-03-29 18:40:00,0,0,0,0,0,0
2024-03-29 18:50:00,0,0,0,0,0,0
2024-03-29 19:00:00,0,0,0,0,0,0
2024-03-29 19:10:00,0,0,0,0,0,0
2024-03-29 19:20:00,0,0,0,0,0,0
2024-03-29 19:30:00,0,0,0,0,0,0
2024-03-29 19:40:00,0,0,0,0,0,0
2024-03-29 19:50:00,0,0,0,0,0,0
2024-03-29 20:00:00,0,0,0,0,0,0
2024-03-29 20:10:00,0,0,0,0,0,0
2024-03-29 20:20:00,0,0,0,0,0,0
2024-03-29 20:30:00,0,0,0,0,0,0
2024-03-29 20:40:00,0,0,0,0,0,0
2024-03-29 20:50:00,0,0,0,0,0,0
2024-03-29 21:00:00,0,0,0,0,0,0
2024-03-29 21:10:00,0,0,0,0,0,0
2024-03-29 21:20:00,0,0,0,0,0,0
2024-03-29 21:30:00,0,0,0,0,0,0
2024-03-29 21:40:00,0,0,0,0,0,0
2024-03-29 21:50:00,0,0,0,0,0,0
2024-03-29 22:00:00,0,0,0,0,0,0
2024-03-29 22:10:00,0,0,0,0,0,0
2024-03-29 22:20:00,0,0,0,0,0,0
2024-03-29 22:30:00,0,0,0,0,0,0
2024-03-29 22:40:00,0,0,0,0,0,0
2024-03-29 22:50:00,0,0,0,0,0,0
2024-03-29 23:00:00,0,0,0,0,0,0
2024-03-29 23:10:00,0,0,0,0,0,0
2024-03-29 23:20:00,0,0,0,0,0,0
2024-03-29 23:30:00,0,0,0,0,0,0
2024-03-29 23:40:00,0,0,0,0,0,0
2024-03-29 23:50:00,0,0,0,0,0,0
2024-03-30 00:00:00,0,0,0,0,0,0
2024-03-30 00:10:00,0,0,0,0,0,0
2024-03-30 00:20:00,0,0,0,0,0,0
2024-03-30 00:30:00,0,0,0,0,0,0
2024-03-30 00:40:00,0,0,0,0,0,0
2024-03-30 00:50:00,0,0,0,0,0,0
2024-03-30 01:00:00,0,0,0,0,0,0
2024-03-30 01:10:00,0,0,0,0,0,0
2024-03-30 01:20:00,0,0,0,0,0,0
2024-03-30 01:30:00,0,0,0,0,0,0
2024-03-30 01:40:00,0,0,0,0,0,0
2024-03-30 01:50:00,0,0,0,0,0,0
2024-03-30 02:00:00,0,0,0,0,0,0
2024-03-30 02:10:00,0,0,0,0,0,0
2024-03-30 02:20:00,0,0,0,0,0,0
2024-03-30 02:30:00,0,0,0,0,0,0
2024-03-30 02:40:00,0,0,0,0,0,0
2024-03-30 02:50:00,0,0,0,0,0,0
2024-03-30 03:00:00,0,0,0,0,0,0
2024-03-30 03:10:00,0,0,0,0,0,0
2024-03-30 03:20:00,0,0,0,0,0,0
2024-03-30 03:30:00,0,0,0,0,0,0
2024-03-30 03:40:00,0,0,0,0,0,0
2024-03-30 03:50:00,0,0,0,0,0,0
2024-03-30 04:00:00,0,0,0,0,0,0
2024-03-30 04:10:00,0,0,0,0,0,0
2024-03-30 04:20:00,0,0,0,0,0,0
2024-03-30 04:30:00,0,0,0,0,0,0
2024-03-30 04:40:00,0,0,0,0,0,0
2024-03-30 04:50:00,0,0,0,0,0,0
2024-03-30 05:00:00,0,0,0,0,0,0
2024-03-30 05:10:00,0,0,0,0,0,0
2024-03-30 05:20:00,0,0,0,0,0,0
2024-03-30 05:30:00,0,0,0,0,0,0
2024-03-30 05:40:00,0,0,0,0,0,0
2024-03-30 05:50:00,0,0,0,0,0,0
2024-03-30 06:00:00,0,0,0,0,0,0
2024-03-30 06:10:00,0,0,0,0,0,0
2024-03-30 06:20:00,0,0,0,0,0,0
2024-03-30 06:30:00,0,0,0,0,0,0
2024-03-30 06:40:00,0,0,0,0,0,0
2024-03-30 06:50:00,0,0,0,0,0,0
2024-03-30 07:00:00,0,0,0,0,0,0
2024-03-30 07:10:00,0,0,0,0,0,0
2024-03-30 07:20:00,0,0,0,0,0,0
2024-03-30 07:30:00,0,0,0,0,0,0
2024-03-30 07:40:00,0,0,0,0,0,0
2024-03-30 07:50:00,0,0,0,0,0,0
2024-03-30 08:00:00,0,0,0,0,0,0
2024-03-30 08:10:00,0,0,0,0,0,0
2024-03-30 08:20:00,0,0,0,0,0,0
2024-03-30 08:30:00,0,0,0,0,0,0
2024-03-30 08:40:00,0,0,0,0,0,0
2024-03-30 08:50:00,0,0,0,0,0,0
2024-03-30 09:00:00,0,0,0,0,0,0
2024-03-30 09:10:00,0,0,0,0,0,0
2024-03-30 09:20:00,0,0,0,0,0,0
2024-03-30 09:30:00,0,0,0,0,0,0
2024-03-30 09:40:00,0,0,0,0,0,0
2024-03-30 09:50:00,0,0,0,0,0,0
2024-03-30 10:00:00,0,0,0,0,0,0
2024-03-30 10:10:00,0,0,0,0,0,0
2024-03-30 10:20:00,0,0,0,0,0,0
2024-03-30 10:30:00,0,0,0,0,0,0
2024-03-30 10:40:00,0,0,0,0,0,0
2024-03-30 10:50:00,0,0,0,0,0,0
2024-03-30 11:00:00,0,0,0,0,0,0
2024-03-30 11:10:00,0,0,0,0,0,0
2024-03-30 11:20:00,0,0,0,0,0,0
2024-03-30 11:30:00,0,0,0,0,0,0
2024-03-30 11:40:00,0,0,0,0,0,0
2024-03-30 11:50:00,0,0,0,0,0,0
2024-03-30 12:00:00,0,0,0,0,0,0
2024-03-30 12:10:00,0,0,0,0,0,0
2024-03-30 12:20:00,0,0,0,0,0,0
2024-03-30 12:30:00,0,0,0,0,0,0
2024-03-30 12:40:00,0,0,0,0,0,0
2024-03-30 12:50:00,0,0,0,0,0,0
2024-03-30 13:00:00,0,0,0,0,0,0
2024-03-30 13:10:00,0,0,0,0,0,0
2024-03-30 13:20:00,0,0,0,0,0,0
2024-03-30 13:30:00,0,0,0,0,0,0
2024-03-30 13:40:00,0,0,0,0,0,0
2024-03-30 13:50:00,0,0,0,0,0,0
2024-03-30 14:00:00,0,0,0,0,0,0
2024-03-30 14:10:00,0,0,0,0,0,0
2024-03-30 14:20:00,0,0,0,0,0,0
2024-03-30 14:30:00,0,0,0,0,0,0
2024-03-30 14:40:00,0,0,0,0,0,0
2024-03-30 14:50:00,0,0,0,0,0,0
2024-03-30 15:00:00,0,0,0,0,0,0
2024-03-30 15:10:00,0,0,0,0,0,0
2024-03-30 15:20:00,0,0,0,0,0,0
2024-03-30 15:30:00,0,0,0,0,0,0
2024-03-30 15:40:00,0,0,0,0,0,0
2024-03-30 15:50:00,0,0,0,0,0,0
2024-03-30 16:00:00,0,0,0,0,0,0
2024-03-30 16:10:00,0,0,0,0,0,0
2024-03-30 16:20:00,0,0,0,0,0,0
2024-03-30 16:30:00,0,0,0,0,0,0
2024-03-30 16:40:00,0,0,0,0,0,0
2024-03-30 16:50:00,0,0,0,0,0,0
2024-03-30 17:00:00,0,0,0,0,0,0
2024-03-30 17:10:00,0,0,0,0,0,0
2024-03-30 17:20:00,0,0,0,0,0,0
2024-03-30 17:30:00,0,0,0,0,0,0
2024-03-30 17:40:00,0,0,0,0,0,0
2024-03-30 17:50:00,0,0,0,0,0,0
2024-03-30 18:00:00,0,0,0,0,0,0
2024-03-30 18:10:00,0,0,0,0,0,0
2024-03-30 18:20:00,0,0,0,0,0,0
2024-03-30 18:30:00,0,0,0,0,0,0
2024-03-30 18:40:00,0,0,0,0,0,0
2024-03-30 18:50:00,0,0,0,0,0,0
2024-03-30 19:00:00,0,0,0,0,0,0
2024-03-30 19:10:00,0,0,0,0,0,0
2024-03-30 19:20:00,0,0,0,0,0,0
2024-03-30 19:30:00,0,0,0,0,0,0
2024-03-30 19:40:00,0,0,0,0,0,0
2024-03-30 19:50:00,0,0,0,0,0,0
2024-03-30 20:00:00,0,0,0,0,0,0
2024-03-30 20:10:00,0,0,0,0,0,0
2024-03-30 20:20:00,0,0,0,0,0,0
2024-03-30 20:30:00,0,0,0,0,0,0
2024-03-30 20:40:00,0,0,0,0,0,0
2024-03-30 20:50:00,0,0,0,0,0,0
2024-03-30 21:00:00,0,0,0,0,0,0
2024-03-30 21:10:00,0,0,0,0,0,0
2024-03-30 21:20:00,0,0,0,0,0,0
2024-03-30 21:30:00,0,0,0,0,0,0
2024-03-30 21:40:00,0,0,0,0,0,0
2024-03-30 21:50:00,0,0,0,0,0,0
2024-03-30 22:00:00,0,0,0,0,0,0
2024-03-30 22:10:00,0,0,0,0,0,0
2024-03-30 22:20:00,0,0,0,0,0,0
2024-03-30 22:30:00,0,0,0,0,0,0
2024-03-30 22:40:00,0,0,0,0,0,0
2024-03-30 22:50:00,0,0,0,0,0,0
2024-03-30 23:00:00,0,0,0,0,0,0
2024-03-30 23:10:00,0,0,0,0,0,0
2024-03-30 23:20:00,0,0,0,0,0,0
2024-03-30 23:30:00,0,0,0,0,0,0
2024-03-30 23:40:00,0,0,0,0,0,0
2024-03-30 23:50:00,0,0,0,0,0,0
2024-03-31 00:00:00,0,0,0,0,0,0
2024-03-31 00:10:00,0,0,0,0,0,0
2024-03-31 00:20:00,0,0,0,0,0,0
2024-03-31 00:30:00,0,0,0,0,0,0
2024-03-31 00:40:00,0,0,0,0,0,0
2024-03-31 00:50:00,0,0,0,0,0,0
2024-03-31 01:00:00,0,0,0,0,0,0
2024-03-31 01:10:00,0,0,0,0,0,0
2024-03-31 01:20:00,0,0,0,0,0,0
2024-03-31 01:30:00,0,0,0,0,0,0
2024-03-31 01:40:00,0,0,0,0,0,0
2024-03-31 01:50:00,0,0,0,0,0,0
2024-03-31 02:00:00,0,0,0,0,0,0
2024-03-31 02:10:00,0,0,0,0,0,0
2024-03-31 02:20:00,0,0,0,0,0,0
2024-03-31 02:30:00,0,0,0,0,0,0
2024-03-31 02:40:00,0,0,0,0,0,0
2024-03-31 02:50:00,0,0,0,0,0,0
2024-03-31 03:00:00,0,0,0,0,0,0
2024-03-31 03:10:00,0,0,0,0,0,0
2024-03-31 03:20:00,0,0,0,0,0,0
2024-03-31 03:30:00,0,0,0,0,0,0
2024-03-31 03:40:00,0,0,0,0,0,0
2024-03-31 03:50:00,0,0,0,0,0,0
2024-03-31 04:00:00,0,0,0,0,0,0
2024-03-31 04:10:00,0,0,0,0,0,0
2024-03-31 04:20:00,0,0,0,0,0,0
2024-03-31 04:30:00,0,0,0,0,0,0
2024-03-31 04:40:00,0,0,0,0,0,0
2024-03-31 04:50:00,0,0,0,0,0,0
2024-03-31 05:00:00,0,0,0,0,0,0
2024-03-31 05:10:00,0,0,0,0,0,0
2024-03-31 05:20:00,0,0,0,0,0,0
2024-03-31 05:30:00,0,0,0,0,0,0
2024-03-31 05:40:00,0,0,0,0,0,0
2024-03-31 05:50:00,0,0,0,0,0,0
2024-03-31 06:00:00,0,0,0,0,0,0
2024-03-31 06:10:00,0,0,0,0,0,0
2024-03-31 06:20:00,0,0,0,0,0,0
2024-03-31 06:30:00,0,0,0,0,0,0
2024-03-31 06:40:00,0,0,0,0,0,0
2024-03-31 06:50:00,0,0,0,0,0,0
2024-03-31 07:00:00,0,0,0,0,0,0
2024-03-31 07:10:00,0,0,0,0,0,0
2024-03-31 07:20:00,0,0,0,0,0,0
2024-03-31 07:30:00,0,0,0,0,0,0
2024-03-31 07:40:00,0,0,0,0,0,0
2024-03-31 07:50:00,0,0,0,0,0,0
2024-03-31 08:00:00,0,0,0,0,0,0
2024-03-31 08:10:00,0,0,0,0,0,0
2024-03-31 08:20:00,0,0,0,0,0,0
2024-03-31 08:30:00,0,0,0,0,0,0
2024-03-31 08:40:00,0,0,0,0,0,0
2024-03-31 08:50:00,0,0,0,0,0,0
2024-03-31 09:00:00,0,0,0,0,0,0
2024-03-31 09:10:00,0,0,0,0,0,0
2024-03-31 09:20:00,0,0,0,0,0,0
2024-03-31 09:30:00,0,0,0,0,0,0
2024-03-31 09:40:00,0,0,0,0,0,0
2024-03-31 09:50:00,0,0,0,0,0,0
2024-03-31 10:00:00,0,0,0,0,0,0
2024-03-31 10:10:00,0,0,0,0,0,0
2024-03-31 10:20:00,0,0,0,0,0,0
2024-03-31 10:30:00,0,0,0,0,0,0
2024-03-31 10:40:00,0,0,0,0,0,0
2024-03-31 10:50:00,0,0,0,0,0,0
2024-03-31 11:00:00,0,0,0,0,0,0
2024-03-31 11:10:00,0,0,0,0,0,0
2024-03-31 11:20:00,0,0,0,0,0,0
2024-03-31 11:30:00,0,0,0,0,0,0
2024-03-31 11:40:00,0,0,0,0,0,0
2024-03-31 11:50:00,0,0,0,0,0,0
2024-03-31 12:00:00,0,0,0,0,0,0
2024-03-31 12:10:00,0,0,0,0,0,0
2024-03-31 12:20:00,0,0,0,0,0,0
2024-03-31 12:30:00,0,0,0,0,0,0
2024-03-31 12:40:00,0,0,0,0,0,0
2024-03-31 12:50:00,0,0,0,0,0,0
2024-03-31 13:00:00,0,0,0,0,0,0
2024-03-31 13:10:00,0,0,0,0,0,0
2024-03-31 13:20:00,0,0,0,0,0,0
2024-03-31 13:30:00,0,0,0,0,0,0
2024-03-31 13:40:00,0,0,0,0,0,0
2024-03-31 13:50:00,0,0,0,0,0,0
2024-03-31 14:00:00,0,0,0,0,0,0
2024-03-31 14:10:00,0,0,0,0,0,0
2024-03-31 14:20:00,0,0,0,0,0,0
2024-03-31 14:30:00,0,0,0,0,0,0
2024-03-31 14:40:00,0,0,0,0,0,0
2024-03-31 14:50:00,0,0,0,0,0,0
2024-03-31 15:00:00,0,0,0,0,0,0
2024-03-31 15:10:00,0,0,0,0,0,0
2024-03-31 15:20:00,0,0,0,0,0,0
2024-03-31 15:30:00,0,0,0,0,0,0
2024-03-31 15:40:00,0,0,0,0,0,0
2024-03-31 15:50:00,0,0,0,0,0,0
2024-03-31 16:00:00,0,0,0,0,0,0
2024-03-31 16:10:00,0,0,0,0,0,0
2024-03-31 16:20:00,0,0,0,0,0,0
2024-03-31 16:30:00,0,0,0,0,0,0
2024-03-31 16:40:00,0,0,0,0,0,0
2024-03-31 16:50:00,0,0,0,0,0,0
2024-03-31 17:00:00,0,0,0,0,0,0
2024-03-31 17:10:00,0,0,0,0,0,0
2024-03-31 17:20:00,0,0,0,0,0,0
2024-03-31 17:30:00,0,0,0,0,0,0
2024-03-31 17:40:00,0,0,0,0,0,0
2024-03-31 17:50:00,0,0,0,0,0,0
2024-03-31 18:00:00,0,0,0,0,0,0
2024-03-31 18:10:00,0,0,0,0,0,0
2024-03-31 18:20:00,0,0,0,0,0,0
2024-03-31 18:30:00,0,0,0,0,0,0
2024-03-31 18:40:00,0,0,0,0,0,0
2024-03-31 18:50:00,0,0,0,0,0,0
2024-03-31 19:00:00,0,0,0,0,0,0
2024-03-31 19:10:00,0,0,0,0,0,0
2024-03-31 19:20:00,0,0,0,0,0,0
2024-03-31 19:30:00,0,0,0,0,0,0
2024-03-31 19:40:00,0,0,0,0,0,0
2024-03-31 19:50:00,0,0,0,0,0,0
2024-03-31 20:00:00,0,0,0,0,0,0
2024-03-31 20:10:00,0,0,0,0,0,0
2024-03-31 20:20:00,0,0,0,0,0,0
2024-03-31 20:30:00,0,0,0,0,0,0
2024-03-31 20:40:00,0,0,0,0,0,0
2024-03-31 20:50:00,0,0,0,0,0,0
2024-03-31 21:00:00,0,0,0,0,0,0
2024-03-31 21:10:00,0,0,0,0,0,0
2024-03-31 21:20:00,0,0,0,0,0,0
2024-03-31 21:30:00,0,0,0,0,0,0
2024-03-31 21:40:00,0,0,0,0,0,0
2024-03-31 21:50:00,0,0,0,0,0,0
2024-03-31 22:00:00,0,0,0,0,0,0
2024-03-31 22:10:00,0,0,0,0,0,0
2024-03-31 22:20:00,0,0,0,0,0,0
2024-03-31 22:30:00,0,0,0,0,0,0
2024-03-31 22:40:00,0,0,0,0,0,0
2024-03-31 22:50:00,0,0,0,0,0,0
2024-03-31 23:00:00,0,0,0,0,0,0
2024-03-31 23:10:00,0,0,0,0,0,0
2024-03-31 23:20:00,0,0,0,0,0,0
2024-03-31 23:30:00,0,0,0,0,0,0
2024-03-31 23:40:00,0,0,0,0,0,0
2024-03-31 23:50:00,0,0,0,0,0,0
2024-04-01 00:00:00,0,0,0,0,0,0
2024-04-01 00:10:00,0,0,0,0,0,0
2024-04-01 00:20:00,0,0,0,0,0,0
2024-04-01 00:30:00,0,0,0,0,0,0
2024-04-01 00:40:00,0,0,0,0,0,0
2024-04-01 00:50:00,0,0,0,0,0,0
2024-04-01 01:00:00,0,0,0,0,0,0
2024-04-01 01:10:00,0,0,0,0,0,0
2024-04-01 01:20:00,0,0,0,0,0,0
2024-04-01 01:30:00,0,0,0,0,0,0
2024-04-01 01:40:00,0,0,0,0,0,0
2024-04-01 01:50:00,0,0,0,0,0,0
2024-04-01 02:00:00,0,0,0,0,0,0
2024-04-01 02:10:00,0,0,0,0,0,0
2024-04-01 02:20:00,0,0,0,0,0,0
2024-04-01 02:30:00,0,0,0,0,0,0
2024-04-01 02:40:00,0,0,0,0,0,0
2024-04-01 02:50:00,0,0,0,0,0,0
2024-04-01 03:00:00,0,0,0,0,0,0
2024-04-01 03:10:00,0,0,0,0,0,0
2024-04-01 03:20:00,0,0,0,0,0,0
2024-04-01 03:30:00,0,0,0,0,0,0
2024-04-01 03:40:00,0,0,0,0,0,0
2024-04-01 03:50:00,0,0,0,0,0,0
2024-04-01 04:00:00,0,0,0,0,0,0
2024-04-01 04:10:00,0,0,0,0,0,0
2024-04-01 04:20:00,0,0,0,0,0,0
2024-04-01 04:30:00,0,0,0,0,0,0
2024-04-01 04:40:00,0,0,0,0,0,0
2024-04-01 04:50:00,0,0,0,0,0,0
2024-04-01 05:00:00,0,0,0,0,0,0
2024-04-01 05:10:00,0,0,0,0,0,0
2024-04-01 05:20:00,0,0,0,0,0,0
2024-04-01 05:30:00,0,0,0,0,0,0
2024-04-01 05:40:00,0,0,0,0,0,0
2024-04-01 05:50:00,0,0,0,0,0,0
2024-04-01 06:00:00,0,0,0,0,0,0
2024-04-01 06:10:00,0,0,0,0,0,0
2024-04-01 06:20:00,0,0,0,0,0,0
2024-04-01 06:30:00,0,0,0,0,0,0
2024-04-01 06:40:00,0,0,0,0,0,0
2024-04-01 06:50:00,0,0,0,0,0,0
2024-04-01 07:00:00,0,0,0,0,0,0
2024-04-01 07:10:00,0,0,0,0,0,0
2024-04-01 07:20:00,0,0,0,0,0,0
2024-04-01 07:30:00,0,0,0,0,0,0
2024-04-01 07:40:00,0,0,0,0,0,0
2024-04-01 07:50:00,0,0,0,0,0,0
2024-04-01 08:00:00,0,0,0,0,0,0
2024-04-01 08:10:00,0,0,0,0,0,0
2024-04-01 08:20:00,0,0,0,0,0,0
2024-04-01 08:30:00,0,0,0,0,0,0
2024-04-01 08:40:00,0,0,0,0,0,0
2024-04-01 08:50:00,0,0,0,0,0,0
2024-04-01 09:00:00,0,0,0,0,0,0
2024-04-01 09:10:00,0,0,0,0,0,0
2024-04-01 09:20:00,0,0,0,0,0,0
2024-04-01 09:30:00,0,0,0,0,0,0
2024-04-01 09:40:00,0,0,0,0,0,0
2024-04-01 09:50:00,0,0,0,0,0,0
2024-04-01 10:00:00,0,0,0,0,0,0
2024-04-01 10:10:00,0,0,0,0,0,0
2024-04-01 10:20:00,0,0,0,0,0,0
2024-04-01 10:30:00,0,0,0,0,0,0
2024-04-01 10:40:00,0,0,0,0,0,0
2024-04-01 10:50:00,0,0,0,0,0,0
2024-04-01 11:00:00,0,0,0,0,0,0
2024-04-01 11:10:00,0,0,0,0,0,0
2024-04-01 11:20:00,0,0,0,0,0,0
2024-04-01 11:30:00,0,0,0,0,0,0
2024-04-01 11:40:00,0,0,0,0,0,0
2024-04-01 11:50:00,0,0,0,0,0,0
2024-04-01 12:00:00,0,0,0,0,0,0
2024-04-01 12:10:00,0,0,0,0,0,0
2024-04-01 12:20:00,0,0,0,0,0,0
2024-04-01 12:30:00,0,0,0,0,0,0
2024-04-01 12:40:00,0,0,0,0,0,0
2024-04-01 12:50:00,0,0,0,0,0,0
2024-04-01 13:00:00,0,0,0,0,0,0
2024-04-01 13:10:00,0,0,0,0,0,0
2024-04-01 13:20:00,0,0,0,0,0,0
2024-04-01 13:30:00,0,0,0,0,0,0
2024-04-01 13:40:00,0,0,0,0,0,0
2024-04-01 13:50:00,0,0,0,0,0,0
2024-04-01 14:00:00,0,0,0,0,0,0
2024-04-01 14:10:00,0,0,0,0,0,0
2024-04-01 14:20:00,0,0,0,0,0,0
2024-04-01 14:30:00,0,0,0,0,0,0
2024-04-01 14:40:00,0,0,0,0,0,0
2024-04-01 14:50:00,0,0,0,0,0,0
2024-04-01 15:00:00,0,0,0,0,0,0
2024-04-01 15:10:00,0,0,0,0,0,0
2024-04-01 15:20:00,0,0,0,0,0,0
2024-04-01 15:30:00,0,0,0,0,0,0
2024-04-01 15:40:00,0,0,0,0,0,0
2024-04-01 15:50:00,0,0,0,0,0,0
2024-04-01 16:00:00,0,0,0,0,0,0
2024-04-01 16:10:00,0,0,0,0,0,0
2024-04-01 16:20:00,0,0,0,0,0,0
2024-04-01 16:30:00,0,0,0,0,0,0
2024-04-01 16:40:00,0,0,0,0,0,0
2024-04-01 16:50:00,0,0,0,0,0,0
2024-04-01 17:00:00,0,0,0,0,0,0
2024-04-01 17:10:00,0,0,0,0,0,0
2024-04-01 17:20:00,0,0,0,0,0,0
2024-04-01 17:30:00,0,0,0,0,0,0
2024-04-01 17:40:00,0,0,0,0,0,0
2024-04-01 17:50:00,0,0,0,0,0,0
2024-04-01 18:00:00,0,0,0,0,0,0
2024-04-01 18:10:00,0,0,0,0,0,0
2024-04-01 18:20:00,0,0,0,0,0,0
2024-04-01 18:30:00,0,0,0,0,0,0
2024-04-01 18:40:00,0,0,0,0,0,0
2024-04-01 18:50:00,0,0,0,0,0,0
2024-04-01 19:00:00,0,0,0,0,0,0
2024-04-01 19:10:00,0,0,0,0,0,0
2024-04-01 19:20:00,0,0,0,0,0,0
2024-04-01 19:30:00,0,0,0,0,0,0
2024-04-01 19:40:00,0,0,0,0,0,0
2024-04-01 19:50:00,0,0,0,0,0,0
2024-04-01 20:00:00,0,0,0,0,0,0
2024-04-01 20:10:00,0,0,0,0,0,0
2024-04-01 20:20:00,0,0,0,0,0,0
2024-04-01 20:30:00,0,0,0,0,0,0
2024-04-01 20:40:00,0,0,0,0,0,0
2024-04-01 20:50:00,0,0,0,0,0,0
2024-04-01 21:00:00,0,0,0,0,0,0
2024-04-01 21:10:00,0,0,0,0,0,0
2024-04-01 21:20:00,0,0,0,0,0,0
2024-04-01 21:30:00,0,0,0,0,0,0
2024-04-01 21:40:00,0,0,0,0,0,0
2024-04-01 21:50:00,0,0,0,0,0,0
2024-04-01 22:00:00,0,0,0,0,0,0
2024-04-01 22:10:00,0,0,0,0,0,0
2024-04-01 22:20:00,0,0,0,0,0,0
2024-04-01 22:30:00,0,0,0,0,0,0
2024-04-01 22:40:00,0,0,0,0,0,0
2024-04-01 22:50:00,0,0,0,0,0,0
2024-04-01 23:00:00,0,0,0,0,0,0
2024-04-01 23:10:00,0,0,0,0,0,0
2024-04-01 23:20:00,0,0,0,0,0,0
2024-04-01 23:30:00,0,0,0,0,0,0
2024-04-01 23:40:00,0,0,0,0,0,0
2024-04-01 23:50:00,0,0,0,0,0,0
2024-04-02 00:00:00,0,0,0,0,0,0
2024-04-02 00:10:00,0,0,0,0,0,0
2024-04-02 00:20:00,0,0,0,0,0,0
2024-04-02 00:30:00,0,0,0,0,0,0
2024-04-02 00:40:00,0,0,0,0,0,0
2024-04-02 00:50:00,0,0,0,0,0,0
2024-04-02 01:00:00,0,0,0,0,0,0
2024-04-02 01:10:00,0,0,0,0,0,0
2024-04-02 01:20:00,0,0,0,0,0,0
2024-04-02 01:30:00,0,0,0,0,0,0
2024-04-02 01:40:00,0,0,0,0,0,0
2024-04-02 01:50:00,0,0,0,0,0,0
2024-04-02 02:00:00,0,0,0,0,0,0
2024-04-02 02:10:00,0,0,0,0,0,0
2024-04-02 02:20:00,0,0,0,0,0,0
2024-04-02 02:30:00,0,0,0,0,0,0
2024-04-02 02:40:00,0,0,0,0,0,0
2024-04-02 02:50:00,0,0,0,0,0,0
2024-04-02 03:00:00,0,0,0,0,0,0
2024-04-02 03:10:00,0,0,0,0,0,0
2024-04-02 03:20:00,0,0,0,0,0,0
2024-04-02 03:30:00,0,0,0,0,0,0
2024-04-02 03:40:00,0,0,0,0,0,0
2024-04-02 03:50:00,0,0,0,0,0,0
2024-04-02 04:00:00,0,0,0,0,0,0
2024-04-02 04:10:00,0,0,0,0,0,0
2024-04-02 04:20:00,0,0,0,0,0,0
2024-04-02 04:30:00,0,0,0,0,0,0
2024-04-02 04:40:00,0,0,0,0,0,0
2024-04-02 04:50:00,0,0,0,0,0,0
2024-04-02 05:00:00,0,0,0,0,0,0
2024-04-02 05:10:00,0,0,0,0,0,0
2024-04-02 05:20:00,0,0,0,0,0,0
2024-04-02 05:30:00,0,0,0,0,0,0
2024-04-02 05:40:00,0,0,0,0,0,0
2024-04-02 05:50:00,0,0,0,0,0,0
2024-04-02 06:00:00,0,0,0,0,0,0
2024-04-02 06:10:00,0,0,0,0,0,0
2024-04-02 06:20:00,0,0,0,0,0,0
2024-04-02 06:30:00,0,0,0,0,0,0
2024-04-02 06:40:00,0,0,0,0,0,0
2024-04-02 06:50:00,0,0,0,0,0,0
2024-04-02 07:00:00,0,0,0,0,0,0
2024-04-02 07:10:00,0,0,0,0,0,0
2024-04-02 07:20:00,0,0,0,0,0,0
2024-04-02 07:30:00,0,0,0,0,0,0
2024-04-02 07:40:00,0,0,0,0,0,0
2024-04-02 07:50:00,0,0,0,0,0,0
2024-04-02 08:00:00,0,0,0,0,0,0
2024-04-02 08:10:00,0,0,0,0,0,0
2024-04-02 08:20:00,0,0,0,0,0,0
2024-04-02 08:30:00,0,0,0,0,0,0
2024-04-02 08:40:00,0,0,0,0,0,0
2024-04-02 08:50:00,0,0,0,0,0,0
2024-04-02 09:00:00,0,0,0,0,0,0
2024-04-02 09:10:00,0,0,0,0,0,0
2024-04-02 09:20:00,0,0,0,0,0,0
2024-04-02 09:30:00,0,0,0,0,0,0
2024-04-02 09:40:00,0,0,0,0,0,0
2024-04-02 09:50:00,0,0,0,0,0,0
2024-04-02 10:00:00,0,0,0,0,0,0
2024-04-02 10:10:00,0,0,0,0,0,0
2024-04-02 10:20:00,0,0,0,0,0,0
2024-04-02 10:30:00,0,0,0,0,0,0
2024-04-02 10:40:00,0,0,0,0,0,0
2024-04-02 10:50:00,0,0,0,0,0,0
2024-04-02 11:00:00,0,0,0,0,0,0
2024-04-02 11:10:00,0,0,0,0,0,0
2024-04-02 11:20:00,0,0,0,0,0,0
2024-04-02 11:30:00,0,0,0,0,0,0
2024-04-02 11:40:00,0,0,0,0,0,0
2024-04-02 11:50:00,0,0,0,0,0,0
2024-04-02 12:00:00,0,0,0,0,0,0
2024-04-02 12:10:00,0,0,0,0,0,0
2024-04-02 12:20:00,0,0,0,0,0,0
2024-04-02 12:30:00,0,0,0,0,0,0
2024-04-02 12:40:00,0,0,0,0,0,0
2024-04-02 12:50:00,0,0,0,0,0,0
2024-04-02 13:00:00,0,0,0,0,0,0
2024-04-02 13:10:00,0,0,0,0,0,0
2024-04-02 13:20:00,0,0,0,0,0,0
2024-04-02 13:30:00,0,0,0,0,0,0
2024-04-02 13:40:00,0,0,0,0,0,0
2024-04-02 13:50:00,0,0,0,0,0,0
2024-04-02 14:00:00,0,0,0,0,0,0
2024-04-02 14:10:00,0,0,0,0,0,0
2024-04-02 14:20:00,0,0,0,0,0,0
2024-04-02 14:30:00,0,0,0,0,0,0
2024-04-02 14:40:00,0,0,0,0,0,0
2024-04-02 14:50:00,0,0,0,0,0,0
2024-04-02 15:00:00,0,0,0,0,0,0
2024-04-02 15:10:00,0,0,0,0,0,0
2024-04-02 15:20:00,0,0,0,0,0,0
2024-04-02 15:30:00,0,0,0,0,0,0
2024-04-02 15:40:00,0,0,0,0,0,0
2024-04-02 15:50:00,0,0,0,0,0,0
2024-04-02 16:00:00,0,0,0,0,0,0
2024-04-02 16:10:00,0,0,0,0,0,0
2024-04-02 16:20:00,0,0,0,0,0,0
2024-04-02 16:30:00,0,0,0,0,0,0
2024-04-02 16:40:00,0,0,0,0,0,0
2024-04-02 16:50:00,0,0,0,0,0,0
2024-04-02 17:00:00,0,0,0,0,0,0
2024-04-02 17:10:00,0,0,0,0,0,0
2024-04-02 17:20:00,0,0,0,0,0,0
2024-04-02 17:30:00,0,0,0,0,0,0
2024-04-02 17:40:00,0,0,0,0,0,0
2024-04-02 17:50:00,0,0,0,0,0,0
2024-04-02 18:00:00,0,0,0,0,0,0
2024-04-02 18:10:00,0,0,0,0,0,0
2024-04-02 18:20:00,0,0,0,0,0,0
2024-04-02 18:30:00,0,0,0,0,0,0
2024-04-02 18:40:00,0,0,0,0,0,0
2024-04-02 18:50:00,0,0,0,0,0,0
2024-04-02 19:00:00,0,0,0,0,0,0
2024-04-02 19:10:00,0,0,0,0,0,0
2024-04-02 19:20:00,0,0,0,0,0,0
2024-04-02 19:30:00,0,0,0,0,0,0
2024-04-02 19:40:00,0,0,0,0,0,0
2024-04-02 19:50:00,0,0,0,0,0,0
2024-04-02 20:00:00,0,0,0,0,0,0
2024-04-02 20:10:00,0,0,0,0,0,0
2024-04-02 20:20:00,0,0,0,0,0,0
2024-04-02 20:30:00,0,0,0,0,0,0
2024-04-02 20:40:00,0,0,0,0,0,0
2024-04-02 20:50:00,0,0,0,0,0,0
2024-04-02 21:00:00,0,0,0,0,0,0
2024-04-02 21:10:00,0,0,0,0,0,0
2024-04-02 21:20:00,0,0,0,0,0,0
2024-04-02 21:30:00,0,0,0,0,0,0
2024-04-02 21:40:00,0,0,0,0,0,0
2024-04-02 21:50:00,0,0,0,0,0,0
2024-04-02 22:00:00,0,0,0,0,0,0
2024-04-02 22:10:00,0,0,0,0,0,0
2024-04-02 22:20:00,0,0,0,0,0,0
2024-04-02 22:30:00,0,0,0,0,0,0
2024-04-02 22:40:00,0,0,0,0,0,0
2024-04-02 22:50:00,0,0,0,0,0,0
2024-04-02 23:00:00,0,0,0,0,0,0
2024-04-02 23:10:00,0,0,0,0,0,0
2024-04-02 23:20:00,0,0,0,0,0,0
2024-04-02 23:30:00,0,0,0,0,0,0
2024-04-02 23:40:00,0,0,0,0,0,0
2024-04-02 23:50:00,0,0,0,0,0,0
2024-04-03 00:00:00,0,0,0,0,0,0
2024-04-03 00:10:00,0,0,0,0,0,0
2024-04-03 00:20:00,0,0,0,0,0,0
2024-04-03 00:30:00,0,0,0,0,0,0
2024-04-03 00:40:00,0,0,0,0,0,0
2024-04-03 00:50:00,0,0,0,0,0,0
2024-04-03 01:00:00,0,0,0,0,0,0
2024-04-03 01:10:00,0,0,0,0,0,0
2024-04-03 01:20:00,0,0,0,0,0,0
2024-04-03 01:30:00,0,0,0,0,0,0
2024-04-03 01:40:00,0,0,0,0,0,0
2024-04-03 01:50:00,0,0,0,0,0,0
2024-04-03 02:00:00,0,0,0,0,0,0
2024-04-03 02:10:00,0,0,0,0,0,0
2024-04-03 02:20:00,0,0,0,0,0,0
2024-04-03 02:30:00,0,0,0,0,0,0
2024-04-03 02:40:00,0,0,0,0,0,0
2024-04-03 02:50:00,0,0,0,0,0,0
2024-04-03 03:00:00,0,0,0,0,0,0
2024-04-03 03:10:00,0,0,0,0,0,0
2024-04-03 03:20:00,0,0,0,0,0,0
2024-04-03 03:30:00,0,0,0,0,0,0
2024-04-03 03:40:00,0,0,0,0,0,0
2024-04-03 03:50:00,0,0,0,0,0,0
2024-04-03 04:00:00,0,0,0,0,0,0
2024-04-03 04:10:00,0,0,0,0,0,0
2024-04-03 04:20:00,0,0,0,0,0,0
2024-04-03 04:30:00,0,0,0,0,0,0
2024-04-03 04:40:00,0,0,0,0,0,0
2024-04-03 04:50:00,0,0,0,0,0,0
2024-04-03 05:00:00,0,0,0,0,0,0
2024-04-03 05:10:00,0,0,0,0,0,0
2024-04-03 05:20:00,0,0,0,0,0,0
2024-04-03 05:30:00,0,0,0,0,0,0
2024-04-03 05:40:00,0,0,0,0,0,0
2024-04-03 05:50:00,0,0,0,0,0,0
2024-04-03 06:00:00,0,0,0,0,0,0
2024-04-03 06:10:00,0,0,0,0,0,0
2024-04-03 06:20:00,0,0,0,0,0,0
2024-04-03 06:30:00,0,0,0,0,0,0
2024-04-03 06:40:00,0,0,0,0,0,0
2024-04-03 06:50:00,0,0,0,0,0,0
2024-04-03 07:00:00,0,0,0,0,0,0
2024-04-03 07:10:00,0,0,0,0,0,0
2024-04-03 07:20:00,0,0,0,0,0,0
2024-04-03 07:30:00,0,0,0,0,0,0
2024-04-03 07:40:00,0,0,0,0,0,0
2024-04-03 07:50:00,0,0,0,0,0,0
2024-04-03 08:00:00,0,0,0,0,0,0
2024-04-03 08:10:00,0,0,0,0,0,0
2024-04-03 08:20:00,0,0,0,0,0,0
2024-04-03 08:30:00,0,0,0,0,0,0
2024-04-03 08:40:00,0,0,0,0,0,0
2024-04-03 08:50:00,0,0,0,0,0,0
2024-04-03 09:00:00,0,0,0,0,0,0
2024-04-03 09:10:00,0,0,0,0,0,0
2024-04-03 09:20:00,0,0,0,0,0,0
2024-04-03 09:30:00,0,0,0,0,0,0
2024-04-03 09:40:00,0,0,0,0,0,0
2024-04-03 09:50:00,0,0,0,0,0,0
2024-04-03 10:00:00,0,0,0,0,0,0
2024-04-03 10:10:00,0,0,0,0,0,0
2024-04-03 10:20:00,0,0,0,0,0,0
2024-04-03 10:30:00,0,0,0,0,0,0
2024-04-03 10:40:00,0,0,0,0,0,0
2024-04-03 10:50:00,0,0,0,0,0,0
2024-04-03 11:00:00,0,0,0,0,0,0
2024-04-03 11:10:00,0,0,0,0,0,0
2024-04-03 11:20:00,0,0,0,0,0,0
2024-04-03 11:30:00,0,0,0,0,0,0
2024-04-03 11:40:00,0,0,0,0,0,0
2024-04-03 11:50:00,0,0,0,0,0,0
2024-04-03 12:00:00,0,0,0,0,0,0
2024-04-03 12:10:00,0,0,0,0,0,0
2024-04-03 12:20:00,0,0,0,0,0,0
2024-04-03 12:30:00,0,0,0,0,0,0
2024-04-03 12:40:00,0,0,0,0,0,0
2024-04-03 12:50:00,0,0,0,0,0,0
2024-04-03 13:00:00,0,0,0,0,0,0
2024-04-03 13:10:00,0,0,0,0,0,0
2024-04-03 13:20:00,0,0,0,0,0,0
2024-04-03 13:30:00,0,0,0,0,0,0
2024-04-03 13:40:00,0,0,0,0,0,0
2024-04-03 13:50:00,0,0,0,0,0,0
2024-04-03 14:00:00,0,0,0,0,0,0
2024-04-03 14:10:00,0,0,0,0,0,0
2024-04-03 14:20:00,0,0,0,0,0,0
2024-04-03 14:30:00,0,0,0,0,0,0
2024-04-03 14:40:00,0,0,0,0,0,0
2024-04-03 14:50:00,0,0,0,0,0,0
2024-04-03 15:00:00,0,0,0,0,0,0
2024-04-03 15:10:00,0,0,0,0,0,0
2024-04-03 15:20:00,0,0,0,0,0,0
2024-04-03 15:30:00,0,0,0,0,0,0
2024-04-03 15:40:00,0,0,0,0,0,0
2024-04-03 15:50:00,0,0,0,0,0,0
2024-04-03 16:00:00,0,0,0,0,0,0
2024-04-03 16:10:00,0,0,0,0,0,0
2024-04-03 16:20:00,0,0,0,0,0,0
2024-04-03 16:30:00,0,0,0,0,0,0
2024-04-03 16:40:00,0,0,0,0,0,0
2024-04-03 16:50:00,0,0,0,0,0,0
2024-04-03 17:00:00,0,0,0,0,0,0
2024-04-03 17:10:00,0,0,0,0,0,0
2024-04-03 17:20:00,0,0,0,0,0,0
2024-04-03 17:30:00,0,0,0,0,0,0
2024-04-03 17:40:00,0,0,0,0,0,0
2024-04-03 17:50:00,0,0,0,0,0,0
2024-04-03 18:00:00,0,0,0,0,0,0
2024-04-03 18:10:00,0,0,0,0,0,0
2024-04-03 18:20:00,0,0,0,0,0,0
2024-04-03 18:30:00,0,0,0,0,0,0
2024-04-03 18:40:00,0,0,0,0,0,0
2024-04-03 18:50:00,0,0,0,0,0,0
2024-04-03 19:00:00,0,0,0,0,0,0
2024-04-03 19:10:00,0,0,0,0,0,0
2024-04-03 19:20:00,0,0,0,0,0,0
2024-04-03 19:30:00,0,0,0,0,0,0
2024-04-03 19:40:00,0,0,0,0,0,0
2024-04-03 19:50:00,0,0,0,0,0,0
2024-04-03 20:00:00,0,0,0,0,0,0
2024-04-03 20:10:00,0,0,0,0,0,0
2024-04-03 20:20:00,0,0,0,0,0,0
2024-04-03 20:30:00,0,0,0,0,0,0
2024-04-03 20:40:00,0,0,0,0,0,0
2024-04-03 20:50:00,0,0,0,0,0,0
2024-04-03 21:00:00,0,0,0,0,0,0
2024-04-03 21:10:00,0,0,0,0,0,0
2024-04-03 21:20:00,0,0,0,0,0,0
2024-04-03 21:30:00,0,0,0,0,0,0
2024-04-03 21:40:00,0,0,0,0,0,0
2024-04-03 21:50:00,0,0,0,0,0,0
2024-04-03 22:00:00,0,0,0,0,0,0
2024-04-03 22:10:00,0,0,0,0,0,0
2024-04-03 22:20:00,0,0,0,0,0,0
2024-04-03 22:30:00,0,0,0,0,0,0
2024-04-03 22:40:00,0,0,0,0,0,0
2024-04-03 22:50:00,0,0,0,0,0,0
2024-04-03 23:00:00,0,0,0,0,0,0
2024-04-03 23:10:00,0,0,0,0,0,0
2024-04-03 23:20:00,0,0,0,0,0,0
2024-04-03 23:30:00,0,0,0,0,0,0
2024-04-03 23:40:00,0,0,0,0,0,0
2024-04-03 23:50:00,0,0,0,0,0,0
2024-04-04 00:00:00,0,0,0,0,0,0
2024-04-04 00:10:00,0,0,0,0,0,0
2024-04-04 00:20:00,0,0,0,0,0,0
2024-04-04 00:30:00,0,0,0,0,0,0
2024-04-04 00:40:00,0,0,0,0,0,0
2024-04-04 00:50:00,0,0,0,0,0,0
2024-04-04 01:00:00,0,0,0,0,0,0
2024-04-04 01:10:00,0,0,0,0,0,0
2024-04-04 01:20:00,0,0,0,0,0,0
2024-04-04 01:30:00,0,0,0,0,0,0
2024-04-04 01:40:00,0,0,0,0,0,0
2024-04-04 01:50:00,0,0,0,0,0,0
2024-04-04 02:00:00,0,0,0,0,0,0
2024-04-04 02:10:00,0,0,0,0,0,0
2024-04-04 02:20:00,0,0,0,0,0,0
2024-04-04 02:30:00,0,0,0,0,0,0
2024-04-04 02:40:00,0,0,0,0,0,0
2024-04-04 02:50:00,0,0,0,0,0,0
2024-04-04 03:00:00,0,0,0,0,0,0
2024-04-04 03:10:00,0,0,0,0,0,0
2024-04-04 03:20:00,0,0,0,0,0,0
2024-04-04 03:30:00,0,0,0,0,0,0
2024-04-04 03:40:00,0,0,0,0,0,0
2024-04-04 03:50:00,0,0,0,0,0,0
2024-04-04 04:00:00,0,0,0,0,0,0
2024-04-04 04:10:00,0,0,0,0,0,0
2024-04-04 04:20:00,0,0,0,0,0,0
2024-04-04 04:30:00,0,0,0,0,0,0
2024-04-04 04:40:00,0,0,0,0,0,0
2024-04-04 04:50:00,0,0,0,0,0,0
2024-04-04 05:00:00,0,0,0,0,0,0
2024-04-04 05:10:00,0,0,0,0,0,0
2024-04-04 05:20:00,0,0,0,0,0,0
2024-04-04 05:30:00,0,0,0,0,0,0
2024-04-04 05:40:00,0,0,0,0,0,0
2024-04-04 05:50:00,0,0,0,0,0,0
2024-04-04 06:00:00,0,0,0,0,0,0
2024-04-04 06:10:00,0,0,0,0,0,0
2024-04-04 06:20:00,0,0,0,0,0,0
2024-04-04 06:30:00,0,0,0,0,0,0
2024-04-04 06:40:00,0,0,0,0,0,0
2024-04-04 06:50:00,0,0,0,0,0,0
2024-04-04 07:00:00,0,0,0,0,0,0
2024-04-04 07:10:00,0,0,0,0,0,0
2024-04-04 07:20:00,0,0,0,0,0,0
2024-04-04 07:30:00,0,0,0,0,0,0
2024-04-04 07:40:00,0,0,0,0,0,0
2024-04-04 07:50:00,0,0,0,0,0,0
2024-04-04 08:00:00,0,0,0,0,0,0
2024-04-04 08:10:00,0,0,0,0,0,0
2024-04-04 08:20:00,0,0,0,0,0,0
2024-04-04 08:30:00,0,0,0,0,0,0
2024-04-04 08:40:00,0,0,0,0,0,0
2024-04-04 08:50:00,0,0,0,0,0,0
2024-04-04 09:00:00,0,0,0,0,0,0
2024-04-04 09:10:00,0,0,0,0,0,0
2024-04-04 09:20:00,0,0,0,0,0,0
2024-04-04 09:30:00,0,0,0,0,0,0
2024-04-04 09:40:00,0,0,0,0,0,0
2024-04-04 09:50:00,0,0,0,0,0,0
2024-04-04 10:00:00,0,0,0,0,0,0
2024-04-04 10:10:00,0,0,0,0,0,0
2024-04-04 10:20:00,0,0,0,0,0,0
2024-04-04 10:30:00,0,0,0,0,0,0
2024-04-04 10:40:00,0,0,0,0,0,0
2024-04-04 10:50:00,0,0,0,0,0,0
2024-04-04 11:00:00,0,0,0,0,0,0
2024-04-04 11:10:00,0,0,0,0,0,0
2024-04-04 11:20:00,0,0,0,0,0,0
2024-04-04 11:30:00,0,0,0,0,0,0
2024-04-04 11:40:00,0,0,0,0,0,0
2024-04-04 11:50:00,0,0,0,0,0,0
2024-04-04 12:00:00,0,0,0,0,0,0
2024-04-04 12:10:00,0,0,0,0,0,0
2024-04-04 12:20:00,0,0,0,0,0,0
2024-04-04 12:30:00,0,0,0,0,0,0
2024-04-04 12:40:00,0,0,0,0,0,0
2024-04-04 12:50:00,0,0,0,0,0,0
2024-04-04 13:00:00,0,0,0,0,0,0
2024-04-04 13:10:00,0,0,0,0,0,0
2024-04-04 13:20:00,0,0,0,0,0,0
2024-04-04 13:30:00,0,0,0,0,0,0
2024-04-04 13:40:00,0,0,0,0,0,0
2024-04-04 13:50:00,0,0,0,0,0,0
2024-04-04 14:00:00,0,0,0,0,0,0
2024-04-04 14:10:00,0,0,0,0,0,0
2024-04-04 14:20:00,0,0,0,0,0,0
2024-04-04 14:30:00,0,0,0,0,0,0
2024-04-04 14:40:00,0,0,0,0,0,0
2024-04-04 14:50:00,0,0,0,0,0,0
2024-04-04 15:00:00,0,0,0,0,0,0
2024-04-04 15:10:00,0,0,0,0,0,0
2024-04-04 15:20:00,0,0,0,0,0,0
2024-04-04 15:30:00,0,0,0,0,0,0
2024-04-04 15:40:00,0,0,0,0,0,0
2024-04-04 15:50:00,0,0,0,0,0,0
2024-04-04 16:00:00,0,0,0,0,0,0
2024-04-04 16:10:00,0,0,0,0,0,0
2024-04-04 16:20:00,0,0,0,0,0,0
2024-04-04 16:30:00,0,0,0,0,0,0
2024-04-04 16:40:00,0,0,0,0,0,0
2024-04-04 16:50:00,0,0,0,0,0,0
2024-04-04 17:00:00,0,0,0,0,0,0
2024-04-04 17:10:00,0,0,0,0,0,0
2024-04-04 17:20:00,0,0,0,0,0,0
2024-04-04 17:30:00,0,0,0,0,0,0
2024-04-04 17:40:00,0,0,0,0,0,0
2024-04-04 17:50:00,0,0,0,0,0,0
2024-04-04 18:00:00,0,0,0,0,0,0
2024-04-04 18:10:00,0,0,0,0,0,0
2024-04-04 18:20:00,0,0,0,0,0,0
2024-04-04 18:30:00,0,0,0,0,0,0
2024-04-04 18:40:00,0,0,0,0,0,0
2024-04-04 18:50:00,0,0,0,0,0,0
2024-04-04 19:00:00,0,0,0,0,0,0
2024-04-04 19:10:00,0,0,0,0,0,0
2024-04-04 19:20:00,0,0,0,0,0,0
2024-04-04 19:30:00,0,0,0,0,0,0
2024-04-04 19:40:00,0,0,0,0,0,0
2024-04-04 19:50:00,0,0,0,0,0,0
2024-04-04 20:00:00,0,0,0,0,0,0
2024-04-04 20:10:00,0,0,0,0,0,0
2024-04-04 20:20:00,0,0,0,0,0,0
2024-04-04 20:30:00,0,0,0,0,0,0
2024-04-04 20:40:00,0,0,0,0,0,0
2024-04-04 20:50:00,0,0,0,0,0,0
2024-04-04 21:00:00,0,0,0,0,0,0
2024-04-04 21:10:00,0,0,0,0,0,0
2024-04-04 21:20:00,0,0,0,0,0,0
2024-04-04 21:30:00,0,0,0,0,0,0
2024-04-04 21:40:00,0,0,0,0,0,0
2024-04-04 21:50:00,0,0,0,0,0,0
2024-04-04 22:00:00,0,0,0,0,0,0
2024-04-04 22:10:00,0,0,0,0,0,0
2024-04-04 22:20:00,0,0,0,0,0,0
2024-04-04 22:30:00,0,0,0,0,0,0
2024-04-04 22:40:00,0,0,0,0,0,0
2024-04-04 22:50:00,0,0,0,0,0,0
2024-04-04 23:00:00,0,0,0,0,0,0
2024-04-04 23:10:00,0,0,0,0,0,0
2024-04-04 23:20:00,0,0,0,0,0,0
2024-04-04 23:30:00,0,0,0,0,0,0
2024-04-04 23:40:00,0,0,0,0,0,0
2024-04-04 23:50:00,0,0,0,0,0,0
2024-04-05 00:00:00,0,0,0,0,0,0
2024-04-05 00:10:00,0,0,0,0,0,0
2024-04-05 00:20:00,0,0,0,0,0,0
2024-04-05 00:30:00,0,0,0,0,0,0
2024-04-05 00:40:00,0,0,0,0,0,0
2024-04-05 00:50:00,0,0,0,0,0,0
2024-04-05 01:00:00,0,0,0,0,0,0
2024-04-05 01:10:00,0,0,0,0,0,0
2024-04-05 01:20:00,0,0,0,0,0,0
2024-04-05 01:30:00,0,0,0,0,0,0
2024-04-05 01:40:00,0,0,0,0,0,0
2024-04-05 01:50:00,0,0,0,0,0,0
2024-04-05 02:00:00,0,0,0,0,0,0
