datetime,V42Z,V72Z,V92Z,V102Z,V122Z,V22Z,V63Z,Total
2024-03-01 01:00:00,2,4,6,1,8,0,0,21
2024-03-01 01:10:00,5,3,4,0,1,0,0,13
2024-03-01 01:20:00,2,3,1,4,4,0,0,14
2024-03-01 01:30:00,6,6,3,2,4,0,0,21
2024-03-01 01:40:00,1,8,4,2,7,0,0,22
2024-03-01 01:50:00,5,4,1,1,5,0,0,16
2024-03-01 02:00:00,2,3,1,1,1,0,0,8
2024-03-01 02:10:00,1,5,1,0,2,0,0,9
2024-03-01 02:20:00,6,1,2,1,2,0,0,12
2024-03-01 02:30:00,1,4,1,0,1,0,0,7
2024-03-01 02:40:00,2,0,2,0,1,0,0,5
2024-03-01 02:50:00,2,1,3,0,0,0,0,6
2024-03-01 03:00:00,3,2,3,0,0,0,0,8
2024-03-01 03:10:00,2,1,1,0,0,0,0,4
2024-03-01 03:20:00,1,0,4,1,4,0,0,10
2024-03-01 03:30:00,4,2,1,0,2,0,0,9
2024-03-01 03:40:00,4,2,5,4,6,0,0,21
2024-03-01 03:50:00,5,2,0,2,1,0,0,10
2024-03-01 04:00:00,4,2,1,2,6,0,0,15
2024-03-01 04:10:00,1,3,2,2,2,0,0,10
2024-03-01 04:20:00,7,3,4,2,4,0,0,20
2024-03-01 04:30:00,8,3,1,1,5,0,0,18
2024-03-01 04:40:00,2,8,4,3,2,0,0,19
2024-03-01 04:50:00,1,4,4,1,4,0,0,14
2024-03-01 05:00:00,2,9,8,6,5,0,0,30
2024-03-01 05:10:00,9,14,7,2,9,0,0,41
2024-03-01 05:20:00,7,6,7,2,15,0,0,37
2024-03-01 05:30:00,7,13,8,3,24,1,0,56
2024-03-01 05:40:00,9,20,15,8,25,0,0,77
2024-03-01 05:50:00,9,26,10,5,40,0,0,90
2024-03-01 06:00:00,16,16,16,9,31,0,0,88
2024-03-01 06:10:00,16,16,29,10,30,0,0,101
2024-03-01 06:20:00,19,24,17,11,32,0,0,103
2024-03-01 06:30:00,18,17,16,12,31,0,0,94
2024-03-01 06:40:00,19,31,19,15,42,0,0,126
2024-03-01 06:50:00,16,25,23,13,46,0,0,123
2024-03-01 07:00:00,22,27,37,19,42,1,0,148
2024-03-01 07:10:00,25,30,24,18,61,0,0,158
2024-03-01 07:20:00,25,28,28,19,64,2,0,166
2024-03-01 07:30:00,16,42,31,28,53,1,0,171
2024-03-01 07:40:00,26,43,26,28,62,1,0,186
2024-03-01 07:50:00,27,38,27,35,64,2,0,193
2024-03-01 08:00:00,27,40,27,16,39,1,0,150
2024-03-01 08:10:00,19,37,29,20,51,0,0,156
2024-03-01 08:20:00,22,41,24,32,51,1,0,171
2024-03-01 08:30:00,29,43,37,25,34,1,0,169
2024-03-01 08:40:00,24,42,21,30,61,1,0,179
2024-03-01 08:50:00,31,24,27,16,46,0,0,144
2024-03-01 09:00:00,16,43,74,21,35,0,0,189
2024-03-01 09:10:00,22,32,31,10,35,0,0,130
2024-03-01 09:20:00,26,39,23,16,45,1,0,150
2024-03-01 09:30:00,24,42,26,18,42,0,0,152
2024-03-01 09:40:00,16,36,19,20,44,0,0,135
2024-03-01 09:50:00,25,52,30,42,47,0,0,196
2024-03-01 10:00:00,26,49,27,14,33,2,0,151
2024-03-01 10:10:00,25,43,30,28,38,1,0,165
2024-03-01 10:20:00,32,62,49,13,46,0,0,202
2024-03-01 10:30:00,27,40,26,19,37,0,0,149
2024-03-01 10:40:00,24,37,20,21,44,1,0,147
2024-03-01 10:50:00,26,63,28,22,38,0,0,177
2024-03-01 11:00:00,28,42,25,26,41,1,0,163
2024-03-01 11:10:00,25,50,31,14,47,0,0,167
2024-03-01 11:20:00,23,48,44,10,38,1,0,164
2024-03-01 11:30:00,20,41,31,15,37,0,0,144
2024-03-01 11:40:00,27,62,29,26,56,1,0,201
2024-03-01 11:50:00,31,39,40,12,47,1,0,170
2024-03-01 12:00:00,25,59,41,19,34,2,0,180
2024-03-01 12:10:00,34,52,35,26,39,1,0,187
2024-03-01 12:20:00,37,48,36,21,56,3,0,201
2024-03-01 12:30:00,32,49,35,22,44,7,0,189
2024-03-01 12:40:00,25,54,45,25,49,0,0,198
2024-03-01 12:50:00,37,57,27,23,38,0,0,182
2024-03-01 13:00:00,32,67,35,25,56,1,0,216
2024-03-01 13:10:00,28,57,37,25,40,4,0,191
2024-03-01 13:20:00,31,45,35,14,52,0,0,177
2024-03-01 13:30:00,26,62,33,23,57,1,0,202
2024-03-01 13:40:00,23,42,31,25,59,2,0,182
2024-03-01 13:50:00,24,51,27,18,39,1,0,160
2024-03-01 14:00:00,27,37,27,30,48,2,0,171
2024-03-01 14:10:00,22,48,34,21,38,3,0,166
2024-03-01 14:20:00,22,76,32,18,38,2,0,188
2024-03-01 14:30:00,31,54,33,18,43,0,0,179
2024-03-01 14:40:00,26,48,27,24,52,1,0,178
2024-03-01 14:50:00,31,48,31,10,50,1,0,171
2024-03-01 15:00:00,24,44,34,19,44,2,0,167
2024-03-01 15:10:00,35,55,36,24,49,1,0,200
2024-03-01 15:20:00,31,51,28,20,44,3,0,177
2024-03-01 15:30:00,28,64,28,20,34,0,0,174
2024-03-01 15:40:00,23,51,34,25,47,3,0,183
2024-03-01 15:50:00,34,48,33,15,51,2,0,183
2024-03-01 16:00:00,31,47,32,26,50,0,0,186
2024-03-01 16:10:00,29,60,26,28,34,2,0,179
2024-03-01 16:20:00,29,54,25,22,40,6,0,176
2024-03-01 16:30:00,27,65,35,19,41,1,0,188
2024-03-01 16:40:00,23,77,32,24,43,0,0,199
2024-03-01 16:50:00,28,38,30,23,52,0,0,171
2024-03-01 17:00:00,25,62,41,27,43,1,0,199
2024-03-01 17:10:00,24,51,39,18,49,2,0,183
2024-03-01 17:20:00,29,48,25,31,51,0,0,184
2024-03-01 17:30:00,33,59,31,25,48,0,0,196
2024-03-01 17:40:00,28,50,34,27,49,4,0,192
2024-03-01 17:50:00,33,38,28,22,52,0,0,173
2024-03-01 18:00:00,23,36,35,21,35,1,0,151
2024-03-01 18:10:00,34,49,31,21,45,0,0,180
2024-03-01 18:20:00,31,48,29,18,38,1,0,165
2024-03-01 18:30:00,28,41,34,11,34,1,0,149
2024-03-01 18:40:00,32,65,31,24,32,0,0,184
2024-03-01 18:50:00,26,30,29,21,33,1,0,140
2024-03-01 19:00:00,31,56,30,20,29,0,0,166
2024-03-01 19:10:00,27,45,32,15,41,1,0,161
2024-03-01 19:20:00,21,27,32,20,40,1,0,141
2024-03-01 19:30:00,21,44,27,10,32,0,0,134
2024-03-01 19:40:00,13,45,23,15,31,0,0,127
2024-03-01 19:50:00,22,33,24,10,35,0,0,124
2024-03-01 20:00:00,19,28,26,9,17,0,0,99
2024-03-01 20:10:00,21,27,21,14,18,0,0,101
2024-03-01 20:20:00,28,29,26,12,26,0,0,121
2024-03-01 20:30:00,16,42,22,22,31,0,0,133
2024-03-01 20:40:00,16,47,26,13,19,0,0,121
2024-03-01 20:50:00,13,17,23,14,15,1,0,83
2024-03-01 21:00:00,17,19,12,7,25,0,0,80
2024-03-01 21:10:00,14,33,12,7,20,1,0,87
2024-03-01 21:20:00,20,22,20,6,20,1,0,89
2024-03-01 21:30:00,16,19,30,14,21,1,0,101
2024-03-01 21:40:00,17,27,29,4,17,0,0,94
2024-03-01 21:50:00,21,18,21,11,17,0,0,88
2024-03-01 22:00:00,16,23,31,10,18,0,0,98
2024-03-01 22:10:00,18,29,22,7,8,0,0,84
2024-03-01 22:20:00,10,26,24,7,19,0,0,86
2024-03-01 22:30:00,14,35,14,7,17,0,0,87
2024-03-01 22:40:00,11,35,14,9,17,1,0,87
2024-03-01 22:50:00,13,25,15,2,15,2,0,72
2024-03-01 23:00:00,15,21,16,5,8,0,0,65
2024-03-01 23:10:00,10,27,20,6,12,0,0,75
2024-03-01 23:20:00,15,21,18,2,12,0,0,68
2024-03-01 23:30:00,17,24,16,11,12,0,0,80
2024-03-01 23:40:00,11,23,21,3,16,0,0,74
2024-03-01 23:50:00,11,19,16,1,13,0,0,60
2024-03-02 00:00:00,10,10,12,4,9,1,0,46
2024-03-02 00:10:00,6,22,20,2,17,0,0,67
2024-03-02 00:20:00,13,14,9,4,8,0,0,48
2024-03-02 00:30:00,8,6,8,0,8,0,0,30
2024-03-02 00:40:00,2,16,12,5,6,0,0,41
2024-03-02 00:50:00,5,12,8,2,8,0,0,35
2024-03-02 01:00:00,12,3,6,3,9,0,0,33
2024-03-02 01:10:00,5,10,18,1,2,0,0,36
2024-03-02 01:20:00,8,12,13,2,3,0,0,38
2024-03-02 01:30:00,9,8,5,4,2,0,0,28
2024-03-02 01:40:00,6,7,5,1,8,0,0,27
2024-03-02 01:50:00,3,5,5,2,4,0,0,19
2024-03-02 02:00:00,3,4,5,0,0,0,0,12
2024-03-02 02:10:00,4,13,14,2,1,0,0,34
2024-03-02 02:20:00,3,6,7,2,3,0,0,21
2024-03-02 02:30:00,6,4,5,2,3,0,0,20
2024-03-02 02:40:00,3,6,22,4,0,0,0,35
2024-03-02 02:50:00,3,1,2,1,2,0,0,9
2024-03-02 03:00:00,3,7,2,1,5,0,0,18
2024-03-02 03:10:00,2,5,10,1,1,0,0,19
2024-03-02 03:20:00,3,4,7,2,5,0,0,21
2024-03-02 03:30:00,2,6,5,0,4,0,0,17
2024-03-02 03:40:00,1,3,2,2,2,0,0,10
2024-03-02 03:50:00,4,3,5,1,2,0,0,15
2024-03-02 04:00:00,2,3,4,1,1,0,0,11
2024-03-02 04:10:00,1,5,3,1,3,0,0,13
2024-03-02 04:20:00,3,2,6,2,4,0,0,17
2024-03-02 04:30:00,8,7,11,4,6,1,0,37
2024-03-02 04:40:00,2,10,9,2,5,0,0,28
2024-03-02 04:50:00,2,6,1,1,2,0,0,12
2024-03-02 05:00:00,1,7,4,1,6,0,0,19
2024-03-02 05:10:00,4,7,6,1,3,0,0,21
2024-03-02 05:20:00,5,8,5,3,6,0,0,27
2024-03-02 05:30:00,5,12,5,2,10,0,0,34
2024-03-02 05:40:00,11,13,7,3,6,0,0,40
2024-03-02 05:50:00,3,4,7,8,11,0,0,33
2024-03-02 06:00:00,3,11,7,5,5,0,0,31
2024-03-02 06:10:00,3,14,7,4,11,0,0,39
2024-03-02 06:20:00,5,13,5,2,6,0,0,31
2024-03-02 06:30:00,8,13,6,2,10,0,0,39
2024-03-02 06:40:00,11,9,7,4,11,0,0,42
2024-03-02 06:50:00,5,5,7,4,10,0,0,31
2024-03-02 07:00:00,9,11,7,2,12,0,0,41
2024-03-02 07:10:00,8,15,30,7,9,0,0,69
2024-03-02 07:20:00,7,11,7,5,10,1,0,41
2024-03-02 07:30:00,10,8,9,6,12,0,0,45
2024-03-02 07:40:00,11,12,12,10,16,0,0,61
2024-03-02 07:50:00,8,15,13,7,14,1,0,58
2024-03-02 08:00:00,9,10,9,4,9,0,0,41
2024-03-02 08:10:00,10,18,14,7,14,0,0,63
2024-03-02 08:20:00,11,10,14,5,11,0,0,51
2024-03-02 08:30:00,14,19,13,8,17,1,0,72
2024-03-02 08:40:00,14,26,17,10,24,0,0,91
2024-03-02 08:50:00,16,29,15,12,16,0,0,88
2024-03-02 09:00:00,14,32,9,9,18,0,0,82
2024-03-02 09:10:00,10,30,28,12,22,0,0,102
2024-03-02 09:20:00,12,19,21,10,30,1,0,93
2024-03-02 09:30:00,11,50,10,16,28,0,0,115
2024-03-02 09:40:00,13,48,21,14,38,1,0,135
2024-03-02 09:50:00,14,38,31,14,35,1,0,133
2024-03-02 10:00:00,10,40,21,20,33,0,0,124
2024-03-02 10:10:00,14,36,26,15,28,0,0,119
2024-03-02 10:20:00,23,68,21,13,32,2,0,159
2024-03-02 10:30:00,13,50,16,15,36,1,0,131
2024-03-02 10:40:00,13,60,27,12,21,1,0,134
2024-03-02 10:50:00,19,35,25,20,47,0,0,146
2024-03-02 11:00:00,21,45,26,13,31,1,0,137
2024-03-02 11:10:00,19,39,32,18,35,0,0,143
2024-03-02 11:20:00,28,38,28,14,27,0,0,135
2024-03-02 11:30:00,19,68,26,27,34,0,0,174
2024-03-02 11:40:00,15,41,27,18,30,0,0,131
2024-03-02 11:50:00,15,31,30,13,23,1,0,113
2024-03-02 12:00:00,30,45,21,19,35,2,0,152
2024-03-02 12:10:00,28,36,41,16,40,1,0,162
2024-03-02 12:20:00,21,43,32,13,45,0,0,154
2024-03-02 12:30:00,26,41,29,16,34,1,0,147
2024-03-02 12:40:00,22,45,33,19,44,0,0,163
2024-03-02 12:50:00,19,41,33,13,41,0,0,147
2024-03-02 13:00:00,23,64,22,19,53,2,0,183
2024-03-02 13:10:00,23,41,33,15,30,1,0,143
2024-03-02 13:20:00,27,49,27,19,32,1,0,155
2024-03-02 13:30:00,19,47,26,19,54,1,0,166
2024-03-02 13:40:00,24,52,32,20,40,0,0,168
2024-03-02 13:50:00,30,40,28,18,48,2,0,166
2024-03-02 14:00:00,31,54,34,18,30,2,0,169
2024-03-02 14:10:00,24,33,27,23,37,0,0,144
2024-03-02 14:20:00,28,48,30,20,39,0,0,165
2024-03-02 14:30:00,18,42,29,17,36,0,0,142
2024-03-02 14:40:00,27,39,29,12,32,1,0,140
2024-03-02 14:50:00,25,60,32,16,41,0,0,174
2024-03-02 15:00:00,24,35,26,11,39,2,0,137
2024-03-02 15:10:00,20,37,28,15,44,0,0,144
2024-03-02 15:20:00,19,31,37,16,31,0,0,134
2024-03-02 15:30:00,28,35,39,10,33,0,0,145
2024-03-02 15:40:00,19,37,45,17,35,1,0,154
2024-03-02 15:50:00,20,52,50,17,22,1,0,162
2024-03-02 16:00:00,26,42,29,14,26,1,0,138
2024-03-02 16:10:00,15,52,23,31,35,1,0,157
2024-03-02 16:20:00,22,35,36,16,32,1,0,142
2024-03-02 16:30:00,20,60,25,8,23,1,0,137
2024-03-02 16:40:00,17,49,26,16,29,3,0,140
2024-03-02 16:50:00,20,40,37,13,37,0,0,147
2024-03-02 17:00:00,15,36,26,14,33,1,0,125
2024-03-02 17:10:00,20,37,30,15,26,0,0,128
2024-03-02 17:20:00,20,32,41,11,42,0,0,146
2024-03-02 17:30:00,22,32,32,15,29,0,0,130
2024-03-02 17:40:00,27,31,34,14,34,2,0,142
2024-03-02 17:50:00,17,30,31,12,37,0,0,127
2024-03-02 18:00:00,23,38,27,14,36,0,0,138
2024-03-02 18:10:00,29,44,32,13,46,0,0,164
2024-03-02 18:20:00,30,32,37,12,38,1,0,150
2024-03-02 18:30:00,28,48,38,18,33,0,0,165
2024-03-02 18:40:00,29,29,26,17,25,0,0,126
2024-03-02 18:50:00,24,51,22,22,34,1,0,154
2024-03-02 19:00:00,19,43,21,18,28,0,0,129
2024-03-02 19:10:00,26,38,24,22,24,2,0,136
2024-03-02 19:20:00,23,32,39,21,36,1,0,152
2024-03-02 19:30:00,18,39,25,16,22,0,0,120
2024-03-02 19:40:00,14,36,34,16,29,1,0,130
2024-03-02 19:50:00,22,39,18,17,21,0,0,117
2024-03-02 20:00:00,20,37,24,15,22,1,0,119
2024-03-02 20:10:00,13,27,20,18,16,2,0,96
2024-03-02 20:20:00,18,46,25,11,23,1,0,124
2024-03-02 20:30:00,13,24,25,8,30,0,0,100
2024-03-02 20:40:00,18,33,19,10,20,0,0,100
2024-03-02 20:50:00,11,31,17,12,14,2,0,87
2024-03-02 21:00:00,8,14,21,10,20,2,0,75
2024-03-02 21:10:00,10,28,21,6,13,1,0,79
2024-03-02 21:20:00,21,24,20,7,14,0,0,86
2024-03-02 21:30:00,16,21,14,7,12,0,0,70
2024-03-02 21:40:00,16,22,22,7,26,0,0,93
2024-03-02 21:50:00,19,23,21,9,16,0,0,88
2024-03-02 22:00:00,16,18,32,6,18,0,0,90
2024-03-02 22:10:00,16,20,13,7,17,0,0,73
2024-03-02 22:20:00,13,27,20,3,18,0,0,81
2024-03-02 22:30:00,13,22,19,17,19,0,0,90
2024-03-02 22:40:00,20,27,21,6,15,0,0,89
2024-03-02 22:50:00,17,45,19,4,12,0,0,97
2024-03-02 23:00:00,10,26,18,9,14,1,0,78
2024-03-02 23:10:00,8,19,21,8,14,1,0,71
2024-03-02 23:20:00,12,8,6,5,15,0,0,46
2024-03-02 23:30:00,6,24,10,7,11,0,0,58
2024-03-02 23:40:00,9,29,12,9,13,0,0,72
2024-03-02 23:50:00,13,11,15,2,17,0,0,58
2024-03-03 00:00:00,10,19,12,4,5,0,0,50
2024-03-03 00:10:00,12,27,11,3,8,0,0,61
2024-03-03 00:20:00,13,14,11,6,13,0,0,57
2024-03-03 00:30:00,8,9,6,8,7,0,0,38
2024-03-03 00:40:00,14,52,10,2,17,0,0,95
2024-03-03 00:50:00,9,17,16,4,8,0,0,54
2024-03-03 01:00:00,4,11,13,2,6,0,0,36
2024-03-03 01:10:00,8,15,6,3,10,0,0,42
2024-03-03 01:20:00,10,7,11,3,9,0,0,40
2024-03-03 01:30:00,10,8,9,6,3,0,0,36
2024-03-03 01:40:00,3,17,12,1,5,0,0,38
2024-03-03 01:50:00,7,6,7,0,7,0,0,27
2024-03-03 02:00:00,8,10,9,1,0,0,0,28
2024-03-03 02:10:00,4,9,4,2,5,0,0,24
2024-03-03 02:20:00,7,3,6,0,4,0,0,20
2024-03-03 02:30:00,4,10,6,2,3,0,0,25
2024-03-03 02:40:00,6,7,2,4,3,0,0,22
2024-03-03 02:50:00,3,5,3,2,4,0,0,17
2024-03-03 03:00:00,4,4,4,0,5,0,0,17
2024-03-03 03:10:00,2,4,11,1,5,0,0,23
2024-03-03 03:20:00,3,6,2,1,3,0,0,15
2024-03-03 03:30:00,6,4,6,1,5,0,0,22
2024-03-03 03:40:00,4,3,6,1,3,0,0,17
2024-03-03 03:50:00,3,2,3,1,2,1,0,12
2024-03-03 04:00:00,5,3,5,1,3,0,0,17
2024-03-03 04:10:00,3,4,12,2,5,0,0,26
2024-03-03 04:20:00,9,4,8,2,4,0,0,27
2024-03-03 04:30:00,3,4,2,0,7,0,0,16
2024-03-03 04:40:00,8,8,9,1,2,1,0,29
2024-03-03 04:50:00,2,9,7,4,3,0,0,25
2024-03-03 05:00:00,6,3,5,1,5,0,0,20
2024-03-03 05:10:00,5,8,6,2,5,0,0,26
2024-03-03 05:20:00,5,5,6,2,5,0,0,23
2024-03-03 05:30:00,4,7,6,7,11,0,0,35
2024-03-03 05:40:00,5,8,5,4,10,1,0,33
2024-03-03 05:50:00,2,3,5,2,12,0,0,24
2024-03-03 06:00:00,1,3,4,2,10,0,0,20
2024-03-03 06:10:00,4,7,6,4,8,0,0,29
2024-03-03 06:20:00,4,5,7,3,6,0,0,25
2024-03-03 06:30:00,4,6,3,2,8,0,0,23
2024-03-03 06:40:00,7,7,5,3,7,0,0,29
2024-03-03 06:50:00,8,1,6,1,5,0,0,21
2024-03-03 07:00:00,8,3,6,1,5,0,0,23
2024-03-03 07:10:00,7,5,5,3,5,0,0,25
2024-03-03 07:20:00,4,2,5,0,6,0,0,17
2024-03-03 07:30:00,2,3,3,5,9,0,0,22
2024-03-03 07:40:00,7,7,6,2,6,0,0,28
2024-03-03 07:50:00,6,4,7,3,6,3,0,29
2024-03-03 08:00:00,2,4,7,3,4,0,0,20
2024-03-03 08:10:00,5,14,19,6,7,0,0,51
2024-03-03 08:20:00,7,10,10,9,9,0,0,45
2024-03-03 08:30:00,5,10,9,5,12,0,0,41
2024-03-03 08:40:00,10,11,6,11,9,0,0,47
2024-03-03 08:50:00,12,10,12,8,16,0,0,58
2024-03-03 09:00:00,10,13,10,3,12,0,0,48
2024-03-03 09:10:00,10,21,12,13,16,0,0,72
2024-03-03 09:20:00,9,14,17,12,26,0,0,78
2024-03-03 09:30:00,10,14,14,6,23,0,0,67
2024-03-03 09:40:00,16,19,8,18,24,0,0,85
2024-03-03 09:50:00,13,23,15,8,23,0,0,82
2024-03-03 10:00:00,18,16,12,9,23,1,0,79
2024-03-03 10:10:00,18,31,20,10,20,0,0,99
2024-03-03 10:20:00,18,17,14,7,22,0,0,78
2024-03-03 10:30:00,13,29,18,14,28,0,0,102
2024-03-03 10:40:00,15,25,24,14,21,0,0,99
2024-03-03 10:50:00,12,14,22,10,19,1,0,78
2024-03-03 11:00:00,16,34,22,10,31,0,0,113
2024-03-03 11:10:00,13,35,21,12,23,0,0,104
2024-03-03 11:20:00,20,18,17,9,23,1,0,88
2024-03-03 11:30:00,22,15,18,9,31,0,0,95
2024-03-03 11:40:00,21,33,23,20,21,0,0,118
2024-03-03 11:50:00,16,25,10,12,33,1,0,97
2024-03-03 12:00:00,17,22,23,4,27,2,0,95
2024-03-03 12:10:00,18,25,25,14,37,2,0,121
2024-03-03 12:20:00,17,27,29,11,51,0,0,135
2024-03-03 12:30:00,25,40,21,14,31,1,0,132
2024-03-03 12:40:00,21,26,22,15,35,4,0,123
2024-03-03 12:50:00,20,31,22,10,30,2,0,115
2024-03-03 13:00:00,21,27,14,8,33,0,0,103
2024-03-03 13:10:00,26,35,20,14,34,0,0,129
2024-03-03 13:20:00,21,28,26,10,28,0,0,113
2024-03-03 13:30:00,19,28,21,14,23,0,0,105
2024-03-03 13:40:00,21,27,36,12,39,1,0,136
2024-03-03 13:50:00,21,24,30,21,40,0,0,136
2024-03-03 14:00:00,22,34,32,16,45,0,0,149
2024-03-03 14:10:00,20,20,26,23,26,2,0,117
2024-03-03 14:20:00,18,36,23,13,30,0,0,120
2024-03-03 14:30:00,22,37,29,9,40,1,0,138
2024-03-03 14:40:00,24,31,15,16,40,0,0,126
2024-03-03 14:50:00,23,24,25,13,37,0,0,122
2024-03-03 15:00:00,15,29,31,16,34,0,0,125
2024-03-03 15:10:00,23,33,31,14,27,0,0,128
2024-03-03 15:20:00,24,27,23,15,47,2,0,138
2024-03-03 15:30:00,32,34,19,14,38,1,0,138
2024-03-03 15:40:00,25,47,30,11,28,0,0,141
2024-03-03 15:50:00,16,21,29,15,26,0,0,107
2024-03-03 16:00:00,27,64,40,13,23,1,0,168
2024-03-03 16:10:00,18,41,27,13,45,2,0,146
2024-03-03 16:20:00,20,37,26,18,32,3,0,136
2024-03-03 16:30:00,17,80,30,19,31,1,0,178
2024-03-03 16:40:00,33,39,20,11,41,1,0,145
2024-03-03 16:50:00,30,29,32,29,35,0,0,155
2024-03-03 17:00:00,17,41,24,18,37,0,0,137
2024-03-03 17:10:00,22,33,31,13,42,0,0,141
2024-03-03 17:20:00,25,31,27,18,36,4,0,141
2024-03-03 17:30:00,18,57,21,15,31,1,0,143
2024-03-03 17:40:00,20,56,32,16,37,2,0,163
2024-03-03 17:50:00,17,30,22,14,32,1,0,116
2024-03-03 18:00:00,31,25,39,15,30,0,0,140
2024-03-03 18:10:00,19,38,27,15,32,2,0,133
2024-03-03 18:20:00,21,31,31,18,24,0,0,125
2024-03-03 18:30:00,17,44,27,7,34,2,0,131
2024-03-03 18:40:00,15,26,47,13,32,0,0,133
2024-03-03 18:50:00,21,28,22,12,21,0,0,104
2024-03-03 19:00:00,17,26,16,12,29,1,0,101
2024-03-03 19:10:00,17,25,19,17,27,1,0,106
2024-03-03 19:20:00,21,20,20,16,23,0,0,100
2024-03-03 19:30:00,12,33,34,11,25,0,0,115
2024-03-03 19:40:00,14,40,24,9,32,0,0,119
2024-03-03 19:50:00,19,14,25,10,27,1,0,96
2024-03-03 20:00:00,16,26,23,20,27,0,0,112
2024-03-03 20:10:00,20,41,15,14,18,1,0,109
2024-03-03 20:20:00,25,33,16,8,24,1,0,107
2024-03-03 20:30:00,13,24,23,6,23,0,0,89
2024-03-03 20:40:00,15,26,16,13,24,0,0,94
2024-03-03 20:50:00,24,13,16,9,20,5,0,87
2024-03-03 21:00:00,14,16,14,2,17,0,0,63
2024-03-03 21:10:00,11,21,53,9,16,0,0,110
2024-03-03 21:20:00,12,17,18,5,8,0,0,60
2024-03-03 21:30:00,3,22,13,8,13,0,0,59
2024-03-03 21:40:00,20,21,17,7,11,0,0,76
2024-03-03 21:50:00,13,12,9,9,13,0,0,56
2024-03-03 22:00:00,12,17,24,4,14,0,0,71
2024-03-03 22:10:00,14,16,32,9,10,0,0,81
2024-03-03 22:20:00,10,18,14,5,10,0,0,57
2024-03-03 22:30:00,7,23,10,3,11,0,0,54
2024-03-03 22:40:00,5,20,9,1,6,0,0,41
2024-03-03 22:50:00,7,16,15,2,8,0,0,48
2024-03-03 23:00:00,4,18,13,3,9,0,0,47
2024-03-03 23:10:00,8,19,10,3,6,0,0,46
2024-03-03 23:20:00,8,9,8,3,7,0,0,35
2024-03-03 23:30:00,2,10,5,2,5,0,0,24
2024-03-03 23:40:00,1,19,5,3,5,0,0,33
2024-03-03 23:50:00,9,8,4,0,12,1,0,34
2024-03-04 00:00:00,5,1,2,1,4,0,0,13
2024-03-04 00:10:00,5,13,6,1,1,0,0,26
2024-03-04 00:20:00,1,8,4,1,1,0,0,15
2024-03-04 00:30:00,1,10,3,5,8,0,0,27
2024-03-04 00:40:00,1,13,4,4,2,0,0,24
2024-03-04 00:50:00,6,5,1,3,3,0,0,18
2024-03-04 01:00:00,2,1,8,1,1,0,0,13
2024-03-04 01:10:00,3,6,0,1,2,0,0,12
2024-03-04 01:20:00,2,3,1,2,6,0,0,14
2024-03-04 01:30:00,3,2,0,2,5,0,0,12
2024-03-04 01:40:00,5,4,8,2,1,0,0,20
2024-03-04 01:50:00,2,5,0,0,3,0,0,10
2024-03-04 02:00:00,1,3,2,1,5,0,0,12
2024-03-04 02:10:00,3,2,4,0,4,0,0,13
2024-03-04 02:20:00,2,2,4,4,1,0,0,13
2024-03-04 02:30:00,6,0,3,0,1,0,0,10
2024-03-04 02:40:00,3,1,3,0,0,0,0,7
2024-03-04 02:50:00,1,1,1,0,1,0,0,4
2024-03-04 03:00:00,4,0,0,1,2,0,0,7
2024-03-04 03:10:00,1,2,4,0,1,0,0,8
2024-03-04 03:20:00,1,2,4,0,0,0,0,7
2024-03-04 03:30:00,1,0,0,0,3,0,0,4
2024-03-04 03:40:00,3,3,4,2,2,0,0,14
2024-03-04 03:50:00,1,2,7,3,5,0,0,18
2024-03-04 04:00:00,4,3,2,1,2,0,0,12
2024-03-04 04:10:00,2,4,5,2,3,0,0,16
2024-03-04 04:20:00,5,5,3,0,2,0,0,15
2024-03-04 04:30:00,3,4,2,1,3,0,0,13
2024-03-04 04:40:00,9,6,21,4,3,0,0,43
2024-03-04 04:50:00,3,10,3,3,2,1,0,22
2024-03-04 05:00:00,10,7,5,4,7,0,0,33
2024-03-04 05:10:00,5,14,8,2,7,0,0,36
2024-03-04 05:20:00,8,16,10,3,12,0,0,49
2024-03-04 05:30:00,6,11,7,10,15,0,0,49
2024-03-04 05:40:00,14,33,31,7,27,0,0,112
2024-03-04 05:50:00,10,22,12,9,33,1,0,87
2024-03-04 06:00:00,19,21,17,11,44,0,0,112
2024-03-04 06:10:00,18,31,11,15,34,1,0,110
2024-03-04 06:20:00,26,28,25,11,41,1,0,132
2024-03-04 06:30:00,20,27,19,8,33,0,0,107
2024-03-04 06:40:00,24,32,23,12,58,0,0,149
2024-03-04 06:50:00,42,34,16,13,49,0,0,154
2024-03-04 07:00:00,23,36,17,14,43,0,0,133
2024-03-04 07:10:00,22,36,23,15,57,0,0,153
2024-03-04 07:20:00,23,32,12,15,58,1,0,141
2024-03-04 07:30:00,21,43,23,26,57,1,0,171
2024-03-04 07:40:00,19,43,29,36,68,1,0,196
2024-03-04 07:50:00,26,42,24,33,61,3,0,189
2024-03-04 08:00:00,19,55,30,34,51,0,0,189
2024-03-04 08:10:00,26,35,43,32,65,2,0,203
2024-03-04 08:20:00,30,45,26,27,56,2,0,186
2024-03-04 08:30:00,22,51,26,29,46,0,0,174
2024-03-04 08:40:00,22,43,29,27,53,0,0,174
2024-03-04 08:50:00,28,35,30,20,47,0,0,160
2024-03-04 09:00:00,21,45,29,30,45,3,0,173
2024-03-04 09:10:00,20,45,52,20,43,1,0,181
2024-03-04 09:20:00,16,40,25,19,38,1,0,139
2024-03-04 09:30:00,28,48,26,21,45,1,0,169
2024-03-04 09:40:00,39,47,22,23,40,0,0,171
2024-03-04 09:50:00,37,48,25,17,43,1,0,171
2024-03-04 10:00:00,23,37,26,19,36,2,0,143
2024-03-04 10:10:00,16,41,38,18,41,0,0,154
2024-03-04 10:20:00,21,38,37,13,40,0,0,149
2024-03-04 10:30:00,26,41,23,13,28,0,0,131
2024-03-04 10:40:00,31,43,30,14,46,1,0,165
2024-03-04 10:50:00,17,40,22,21,44,0,0,144
2024-03-04 11:00:00,29,40,27,13,28,0,0,137
2024-03-04 11:10:00,20,40,29,19,46,0,0,154
2024-03-04 11:20:00,28,43,28,10,30,1,0,140
2024-03-04 11:30:00,22,34,24,21,36,0,0,137
2024-03-04 11:40:00,21,39,24,13,38,0,0,135
2024-03-04 11:50:00,19,49,31,14,47,0,0,160
2024-03-04 12:00:00,24,55,39,21,39,0,0,178
2024-03-04 12:10:00,24,51,32,17,41,0,0,165
2024-03-04 12:20:00,25,46,27,21,36,0,0,155
2024-03-04 12:30:00,22,46,26,25,45,0,0,164
2024-03-04 12:40:00,22,40,36,26,48,1,0,173
2024-03-04 12:50:00,33,51,38,19,39,1,0,181
2024-03-04 13:00:00,33,52,25,14,36,0,0,160
2024-03-04 13:10:00,30,39,25,13,49,1,0,157
2024-03-04 13:20:00,25,36,31,17,40,2,0,151
2024-03-04 13:30:00,27,38,27,23,50,3,0,168
2024-03-04 13:40:00,23,40,35,24,31,3,0,156
2024-03-04 13:50:00,29,37,32,19,40,0,0,157
2024-03-04 14:00:00,33,35,37,16,30,0,0,151
2024-03-04 14:10:00,28,51,34,17,47,6,0,183
2024-03-04 14:20:00,33,50,32,12,34,1,0,162
2024-03-04 14:30:00,34,41,52,23,50,1,0,201
2024-03-04 14:40:00,29,46,21,15,37,4,0,152
2024-03-04 14:50:00,25,53,26,21,39,2,0,166
2024-03-04 15:00:00,33,45,29,17,48,1,0,173
2024-03-04 15:10:00,28,55,41,17,38,2,0,181
2024-03-04 15:20:00,29,45,38,14,58,3,0,187
2024-03-04 15:30:00,33,45,39,19,45,1,0,182
2024-03-04 15:40:00,26,49,26,18,40,1,0,160
2024-03-04 15:50:00,21,59,26,23,52,1,0,182
2024-03-04 16:00:00,32,62,36,21,44,2,0,197
2024-03-04 16:10:00,28,55,28,26,50,1,0,188
2024-03-04 16:20:00,22,43,24,29,54,2,0,174
2024-03-04 16:30:00,33,48,32,24,39,1,0,177
2024-03-04 16:40:00,30,82,42,19,49,2,0,224
2024-03-04 16:50:00,32,36,36,20,35,0,0,159
2024-03-04 17:00:00,30,66,38,29,50,1,0,214
2024-03-04 17:10:00,25,46,32,21,58,1,0,183
2024-03-04 17:20:00,21,70,40,26,46,10,0,213
2024-03-04 17:30:00,16,50,35,16,36,1,0,154
2024-03-04 17:40:00,24,46,26,27,46,1,0,170
2024-03-04 17:50:00,34,46,22,19,62,2,0,185
2024-03-04 18:00:00,25,40,31,19,36,1,0,152
2024-03-04 18:10:00,29,49,38,18,45,0,0,179
2024-03-04 18:20:00,18,84,23,29,40,1,0,195
2024-03-04 18:30:00,26,34,23,21,32,1,0,137
2024-03-04 18:40:00,32,58,25,21,38,3,0,177
2024-03-04 18:50:00,24,30,23,23,42,2,0,144
2024-03-04 19:00:00,32,26,23,6,34,0,0,121
2024-03-04 19:10:00,28,25,29,23,29,2,0,136
2024-03-04 19:20:00,21,27,21,12,28,1,0,110
2024-03-04 19:30:00,21,44,17,12,24,0,0,118
2024-03-04 19:40:00,22,44,21,11,20,0,0,118
2024-03-04 19:50:00,13,14,15,14,27,3,0,86
2024-03-04 20:00:00,24,22,18,11,22,1,0,98
2024-03-04 20:10:00,17,31,21,8,13,0,0,90
2024-03-04 20:20:00,16,24,16,10,22,1,0,89
2024-03-04 20:30:00,14,23,18,10,25,0,0,90
2024-03-04 20:40:00,21,33,14,3,23,2,0,96
2024-03-04 20:50:00,15,18,17,8,20,0,0,78
2024-03-04 21:00:00,16,30,14,3,20,0,0,83
2024-03-04 21:10:00,13,22,18,8,16,1,0,78
2024-03-04 21:20:00,14,21,15,5,17,1,0,73
2024-03-04 21:30:00,20,12,23,3,11,0,0,69
2024-03-04 21:40:00,16,16,42,6,4,0,0,84
2024-03-04 21:50:00,13,18,10,3,17,1,0,62
2024-03-04 22:00:00,19,17,17,10,13,1,0,77
2024-03-04 22:10:00,13,17,11,3,11,1,0,56
2024-03-04 22:20:00,10,17,8,7,11,0,0,53
2024-03-04 22:30:00,9,14,10,7,11,1,0,52
2024-03-04 22:40:00,8,29,17,5,13,2,0,74
2024-03-04 22:50:00,9,26,7,2,8,0,0,52
2024-03-04 23:00:00,8,6,5,5,9,0,0,33
2024-03-04 23:10:00,11,13,7,2,5,0,0,38
2024-03-04 23:20:00,6,10,13,0,6,0,0,35
2024-03-04 23:30:00,10,4,1,3,8,0,0,26
2024-03-04 23:40:00,8,15,17,2,5,0,0,47
2024-03-04 23:50:00,10,7,12,2,5,0,0,36
2024-03-05 00:00:00,2,5,4,3,6,0,0,20
2024-03-05 00:10:00,4,5,4,1,4,0,0,18
2024-03-05 00:20:00,5,4,5,2,2,0,0,18
2024-03-05 00:30:00,2,5,4,2,3,0,0,16
2024-03-05 00:40:00,1,33,8,2,2,0,0,46
2024-03-05 00:50:00,4,5,1,2,5,0,0,17
2024-03-05 01:00:00,0,4,2,2,1,0,0,9
2024-03-05 01:10:00,6,5,7,1,2,0,0,21
2024-03-05 01:20:00,1,7,3,1,2,0,0,14
2024-03-05 01:30:00,5,11,4,2,3,0,0,25
2024-03-05 01:40:00,3,1,2,3,0,0,0,9
2024-03-05 01:50:00,7,0,0,3,1,0,0,11
2024-03-05 02:00:00,2,6,3,2,2,0,0,15
2024-03-05 02:10:00,1,3,1,1,5,0,0,11
2024-03-05 02:20:00,1,2,5,1,0,0,0,9
2024-03-05 02:30:00,3,2,2,1,2,0,0,10
2024-03-05 02:40:00,3,0,0,0,3,0,0,6
2024-03-05 02:50:00,1,2,1,0,0,0,0,4
2024-03-05 03:00:00,7,1,2,0,2,0,0,12
2024-03-05 03:10:00,2,3,2,0,0,0,0,7
2024-03-05 03:20:00,2,4,2,1,1,0,0,10
2024-03-05 03:30:00,3,1,2,2,0,0,0,8
2024-03-05 03:40:00,4,0,3,0,2,0,0,9
2024-03-05 03:50:00,3,1,1,3,2,0,0,10
2024-03-05 04:00:00,1,0,1,1,5,0,0,8
2024-03-05 04:10:00,2,7,5,0,2,0,0,16
2024-03-05 04:20:00,6,0,3,1,3,0,0,13
2024-03-05 04:30:00,2,6,1,0,3,0,0,12
2024-03-05 04:40:00,2,24,1,1,2,0,0,30
2024-03-05 04:50:00,4,6,8,1,3,0,0,22
2024-03-05 05:00:00,3,8,5,6,10,0,0,32
2024-03-05 05:10:00,5,18,10,2,12,0,0,47
2024-03-05 05:20:00,7,8,14,2,7,0,0,38
2024-03-05 05:30:00,9,14,7,5,20,0,0,55
2024-03-05 05:40:00,15,16,11,6,29,0,0,77
2024-03-05 05:50:00,14,19,16,8,37,0,0,94
2024-03-05 06:00:00,12,18,16,8,39,0,0,93
2024-03-05 06:10:00,22,29,23,11,34,1,0,120
2024-03-05 06:20:00,27,34,19,10,41,0,0,131
2024-03-05 06:30:00,21,29,19,15,30,0,0,114
2024-03-05 06:40:00,20,31,20,14,62,0,0,147
2024-03-05 06:50:00,23,24,20,12,57,0,0,136
2024-03-05 07:00:00,24,33,20,17,50,2,0,146
2024-03-05 07:10:00,26,28,21,15,56,1,0,147
2024-03-05 07:20:00,17,43,20,33,60,0,0,173
2024-03-05 07:30:00,25,42,22,34,57,2,0,182
2024-03-05 07:40:00,17,42,56,28,68,0,0,211
2024-03-05 07:50:00,24,50,30,43,70,0,0,217
2024-03-05 08:00:00,24,41,27,20,36,1,0,149
2024-03-05 08:10:00,22,44,31,34,61,2,0,194
2024-03-05 08:20:00,34,45,31,36,49,0,0,195
2024-03-05 08:30:00,28,42,27,20,43,1,0,161
2024-03-05 08:40:00,31,59,41,35,70,0,0,236
2024-03-05 08:50:00,27,35,25,31,41,1,0,160
2024-03-05 09:00:00,33,64,26,31,43,0,0,197
2024-03-05 09:10:00,20,42,25,18,42,0,0,147
2024-03-05 09:20:00,24,29,26,17,45,0,0,141
2024-03-05 09:30:00,18,34,26,19,46,1,0,144
2024-03-05 09:40:00,35,44,30,20,49,0,0,178
2024-03-05 09:50:00,27,41,27,17,38,0,0,150
2024-03-05 10:00:00,33,46,23,22,39,1,0,164
2024-03-05 10:10:00,23,45,29,17,49,0,0,163
2024-03-05 10:20:00,31,42,22,17,35,1,0,148
2024-03-05 10:30:00,21,35,31,12,35,0,0,134
2024-03-05 10:40:00,24,47,27,20,36,0,0,154
2024-03-05 10:50:00,29,34,36,15,24,0,0,138
2024-03-05 11:00:00,33,34,44,22,40,0,0,173
2024-03-05 11:10:00,29,42,28,21,41,3,0,164
2024-03-05 11:20:00,30,45,29,19,38,0,0,161
2024-03-05 11:30:00,29,38,26,15,44,0,0,152
2024-03-05 11:40:00,24,48,27,21,36,3,0,159
2024-03-05 11:50:00,21,54,24,11,31,6,0,147
2024-03-05 12:00:00,31,42,23,21,40,0,0,157
2024-03-05 12:10:00,28,38,34,20,37,0,0,157
2024-03-05 12:20:00,33,49,27,22,37,1,0,169
2024-03-05 12:30:00,27,48,24,15,40,0,0,154
2024-03-05 12:40:00,22,36,51,18,48,2,0,177
2024-03-05 12:50:00,28,37,29,15,43,1,0,153
2024-03-05 13:00:00,28,38,40,13,33,0,0,152
2024-03-05 13:10:00,29,46,42,23,48,1,0,189
2024-03-05 13:20:00,24,55,28,18,58,1,0,184
2024-03-05 13:30:00,29,46,38,16,33,2,0,164
2024-03-05 13:40:00,26,41,26,20,45,0,0,158
2024-03-05 13:50:00,29,39,25,19,49,0,0,161
2024-03-05 14:00:00,36,51,32,19,35,2,0,175
2024-03-05 14:10:00,29,36,35,15,39,3,0,157
2024-03-05 14:20:00,42,39,27,26,35,0,0,169
2024-03-05 14:30:00,36,40,35,16,43,1,0,171
2024-03-05 14:40:00,32,47,25,21,53,0,0,178
2024-03-05 14:50:00,35,44,44,25,33,1,0,182
2024-03-05 15:00:00,29,39,36,26,47,0,0,177
2024-03-05 15:10:00,40,50,45,23,47,0,0,205
2024-03-05 15:20:00,27,48,32,18,54,4,0,183
2024-03-05 15:30:00,29,51,31,27,36,3,0,177
2024-03-05 15:40:00,25,50,27,24,48,4,0,178
2024-03-05 15:50:00,35,36,32,28,54,2,0,187
2024-03-05 16:00:00,24,57,34,26,55,3,0,199
2024-03-05 16:10:00,27,51,37,19,42,1,0,177
2024-03-05 16:20:00,30,47,36,24,46,3,0,186
2024-03-05 16:30:00,30,73,31,24,35,1,0,194
2024-03-05 16:40:00,28,78,28,23,65,0,0,222
2024-03-05 16:50:00,26,60,45,28,50,2,0,211
2024-03-05 17:00:00,27,66,42,22,46,11,0,214
2024-03-05 17:10:00,32,52,24,30,45,2,0,185
2024-03-05 17:20:00,25,43,27,24,61,1,0,181
2024-03-05 17:30:00,29,69,39,27,46,0,0,210
2024-03-05 17:40:00,28,57,29,30,54,2,0,200
2024-03-05 17:50:00,22,58,29,28,61,1,0,199
2024-03-05 18:00:00,22,59,29,19,46,0,0,175
2024-03-05 18:10:00,28,51,32,23,34,0,0,168
2024-03-05 18:20:00,27,61,24,27,49,1,0,189
2024-03-05 18:30:00,21,62,27,19,43,3,0,175
2024-03-05 18:40:00,15,32,26,21,41,0,0,135
2024-03-05 18:50:00,32,29,29,25,60,1,0,176
2024-03-05 19:00:00,22,45,30,27,37,0,0,161
2024-03-05 19:10:00,30,42,29,20,45,3,0,169
2024-03-05 19:20:00,20,28,24,14,32,1,0,119
2024-03-05 19:30:00,26,48,27,13,22,1,0,137
2024-03-05 19:40:00,23,25,29,18,25,0,0,120
2024-03-05 19:50:00,15,27,14,7,32,1,0,96
2024-03-05 20:00:00,18,26,26,12,29,0,0,111
2024-03-05 20:10:00,24,26,17,16,19,0,0,102
2024-03-05 20:20:00,17,29,18,14,29,0,0,107
2024-03-05 20:30:00,16,36,17,9,23,0,0,101
2024-03-05 20:40:00,24,29,44,9,24,0,0,130
2024-03-05 20:50:00,14,26,13,13,15,0,0,81
2024-03-05 21:00:00,19,18,15,5,16,0,0,73
2024-03-05 21:10:00,16,27,23,9,22,0,0,97
2024-03-05 21:20:00,17,21,16,5,9,2,0,70
2024-03-05 21:30:00,23,24,26,9,22,0,0,104
2024-03-05 21:40:00,9,18,8,5,14,0,0,54
2024-03-05 21:50:00,16,19,29,9,10,1,0,84
2024-03-05 22:00:00,22,19,17,9,23,0,0,90
2024-03-05 22:10:00,15,26,18,6,9,0,0,74
2024-03-05 22:20:00,10,17,17,2,19,0,0,65
2024-03-05 22:30:00,12,18,9,9,16,0,0,64
2024-03-05 22:40:00,10,26,16,6,6,0,0,64
2024-03-05 22:50:00,13,20,15,5,8,4,0,65
2024-03-05 23:00:00,11,11,10,6,14,0,0,52
2024-03-05 23:10:00,8,14,9,7,5,0,0,43
2024-03-05 23:20:00,5,10,13,1,4,0,0,33
2024-03-05 23:30:00,6,12,9,6,7,0,0,40
2024-03-05 23:40:00,7,11,8,0,8,0,0,34
2024-03-05 23:50:00,4,5,11,2,6,0,0,28
2024-03-06 00:00:00,6,5,4,5,7,0,0,27
2024-03-06 00:10:00,2,10,11,0,4,0,0,27
2024-03-06 00:20:00,2,2,8,4,1,0,0,17
2024-03-06 00:30:00,0,10,3,2,2,0,0,17
2024-03-06 00:40:00,8,13,10,1,3,0,0,35
2024-03-06 00:50:00,1,5,7,1,4,0,0,18
2024-03-06 01:00:00,2,6,12,2,3,0,0,25
2024-03-06 01:10:00,6,6,4,0,2,0,0,18
2024-03-06 01:20:00,4,0,5,0,2,0,0,11
2024-03-06 01:30:00,6,8,5,6,2,0,0,27
2024-03-06 01:40:00,3,4,4,2,3,0,0,16
2024-03-06 01:50:00,0,4,2,0,3,0,0,9
2024-03-06 02:00:00,1,3,3,0,2,0,0,9
2024-03-06 02:10:00,4,3,0,2,3,0,0,12
2024-03-06 02:20:00,1,2,2,3,1,0,0,9
2024-03-06 02:30:00,1,1,0,0,1,0,0,3
2024-03-06 02:40:00,1,0,5,0,2,0,0,8
2024-03-06 02:50:00,2,2,1,0,3,0,0,8
2024-03-06 03:00:00,3,0,2,0,0,0,0,5
2024-03-06 03:10:00,5,2,2,1,0,0,0,10
2024-03-06 03:20:00,4,2,3,0,0,0,0,9
2024-03-06 03:30:00,5,3,4,1,1,0,0,14
2024-03-06 03:40:00,3,2,0,2,4,0,0,11
2024-03-06 03:50:00,1,3,4,2,7,0,0,17
2024-03-06 04:00:00,2,2,4,0,5,0,0,13
2024-03-06 04:10:00,3,5,66,4,2,0,0,80
2024-03-06 04:20:00,3,2,4,0,5,0,0,14
2024-03-06 04:30:00,4,7,5,0,4,0,0,20
2024-03-06 04:40:00,6,5,2,1,3,0,0,17
2024-03-06 04:50:00,4,11,6,2,6,1,0,30
2024-03-06 05:00:00,1,6,4,6,9,0,0,26
2024-03-06 05:10:00,7,13,67,6,13,0,0,106
2024-03-06 05:20:00,9,13,11,3,8,0,0,44
2024-03-06 05:30:00,11,12,8,3,18,0,0,52
2024-03-06 05:40:00,8,19,14,7,27,0,0,75
2024-03-06 05:50:00,9,13,14,7,37,0,0,80
2024-03-06 06:00:00,22,23,228,10,41,0,0,324
2024-03-06 06:10:00,23,26,15,11,34,0,0,109
2024-03-06 06:20:00,16,24,16,10,43,0,0,109
2024-03-06 06:30:00,22,21,20,12,39,0,0,114
2024-03-06 06:40:00,20,22,23,11,65,0,0,141
2024-03-06 06:50:00,25,39,21,16,56,1,0,158
2024-03-06 07:00:00,32,39,172,18,41,0,0,302
2024-03-06 07:10:00,18,28,35,24,68,0,0,173
2024-03-06 07:20:00,26,29,120,25,55,0,0,255
2024-03-06 07:30:00,26,43,24,24,53,1,0,171
2024-03-06 07:40:00,18,32,30,33,71,1,0,185
2024-03-06 07:50:00,23,53,32,39,54,0,0,201
2024-03-06 08:00:00,29,47,47,35,62,2,0,222
2024-03-06 08:10:00,32,49,29,31,69,1,0,211
2024-03-06 08:20:00,22,47,28,24,58,1,0,180
2024-03-06 08:30:00,26,40,42,23,51,1,0,183
2024-03-06 08:40:00,23,49,37,37,56,0,0,202
2024-03-06 08:50:00,32,30,32,30,55,0,0,179
2024-03-06 09:00:00,22,49,26,21,40,0,0,158
2024-03-06 09:10:00,20,38,32,26,50,0,0,166
2024-03-06 09:20:00,13,43,27,24,37,0,0,144
2024-03-06 09:30:00,27,45,29,17,48,2,0,168
2024-03-06 09:40:00,23,69,42,16,46,0,0,196
2024-03-06 09:50:00,24,34,21,26,43,0,0,148
2024-03-06 10:00:00,21,83,54,11,32,1,0,202
2024-03-06 10:10:00,23,51,28,25,47,0,0,174
2024-03-06 10:20:00,25,40,29,17,48,0,0,159
2024-03-06 10:30:00,21,42,23,19,36,1,0,142
2024-03-06 10:40:00,23,42,30,21,52,0,0,168
2024-03-06 10:50:00,22,30,27,14,45,0,0,138
2024-03-06 11:00:00,25,45,18,16,30,0,0,134
2024-03-06 11:10:00,28,37,19,18,33,0,0,135
2024-03-06 11:20:00,29,88,64,17,39,0,0,237
2024-03-06 11:30:00,33,34,32,21,36,0,0,156
2024-03-06 11:40:00,26,40,26,25,38,0,0,155
2024-03-06 11:50:00,29,40,33,16,35,5,0,158
2024-03-06 12:00:00,38,43,40,23,37,1,0,182
2024-03-06 12:10:00,27,32,29,50,49,1,0,188
2024-03-06 12:20:00,26,47,30,25,50,3,0,181
2024-03-06 12:30:00,20,51,33,23,45,0,0,172
2024-03-06 12:40:00,24,50,27,17,42,3,0,163
2024-03-06 12:50:00,25,43,28,15,41,0,0,152
2024-03-06 13:00:00,12,61,39,16,39,0,0,167
2024-03-06 13:10:00,31,40,26,24,49,1,0,171
2024-03-06 13:20:00,21,52,31,16,38,2,0,160
2024-03-06 13:30:00,28,43,39,14,37,1,0,162
2024-03-06 13:40:00,33,205,78,11,34,0,0,361
2024-03-06 13:50:00,22,28,26,19,44,2,0,141
2024-03-06 14:00:00,34,73,28,17,38,0,0,190
2024-03-06 14:10:00,34,43,40,19,59,1,0,196
2024-03-06 14:20:00,32,59,19,16,30,2,0,158
2024-03-06 14:30:00,27,50,29,25,40,1,0,172
2024-03-06 14:40:00,27,70,30,17,54,1,0,199
2024-03-06 14:50:00,34,42,38,12,45,1,0,172
2024-03-06 15:00:00,27,59,35,10,43,1,0,175
2024-03-06 15:10:00,33,46,42,20,52,1,0,194
2024-03-06 15:20:00,29,57,52,31,45,4,0,218
2024-03-06 15:30:00,32,52,32,22,38,2,0,178
2024-03-06 15:40:00,31,53,26,25,45,4,0,184
2024-03-06 15:50:00,31,51,41,21,54,4,0,202
2024-03-06 16:00:00,28,65,29,26,56,4,0,208
2024-03-06 16:10:00,28,46,41,19,60,4,0,198
2024-03-06 16:20:00,33,51,34,28,63,5,0,214
2024-03-06 16:30:00,35,80,33,18,44,3,0,213
2024-03-06 16:40:00,20,68,25,19,39,3,0,174
2024-03-06 16:50:00,22,55,30,36,62,3,0,208
2024-03-06 17:00:00,23,54,35,29,42,1,0,184
2024-03-06 17:10:00,30,60,39,27,59,0,0,215
2024-03-06 17:20:00,29,59,33,33,60,2,0,216
2024-03-06 17:30:00,36,77,32,26,51,0,0,222
2024-03-06 17:40:00,19,59,73,19,45,1,0,216
2024-03-06 17:50:00,30,34,28,36,57,1,0,186
2024-03-06 18:00:00,35,128,38,23,66,2,0,292
2024-03-06 18:10:00,34,57,29,29,44,0,0,193
2024-03-06 18:20:00,34,40,21,29,43,0,0,167
2024-03-06 18:30:00,34,35,20,9,31,2,0,131
2024-03-06 18:40:00,25,57,27,24,46,2,0,181
2024-03-06 18:50:00,26,37,26,27,50,0,0,166
2024-03-06 19:00:00,24,55,22,16,37,0,0,154
2024-03-06 19:10:00,27,29,31,16,36,0,0,139
2024-03-06 19:20:00,31,28,19,13,28,1,0,120
2024-03-06 19:30:00,28,39,26,15,21,0,0,129
2024-03-06 19:40:00,22,35,25,16,37,0,0,135
2024-03-06 19:50:00,16,45,16,17,19,0,0,113
2024-03-06 20:00:00,25,29,33,11,25,0,0,123
2024-03-06 20:10:00,12,32,22,15,26,2,0,109
2024-03-06 20:20:00,16,40,44,19,25,2,0,146
2024-03-06 20:30:00,16,29,13,8,22,0,0,88
2024-03-06 20:40:00,19,32,17,8,26,1,0,103
2024-03-06 20:50:00,16,24,16,11,20,0,0,87
2024-03-06 21:00:00,17,24,36,8,14,3,0,102
2024-03-06 21:10:00,6,37,17,9,17,0,0,86
2024-03-06 21:20:00,21,16,18,11,18,0,0,84
2024-03-06 21:30:00,18,28,21,10,23,2,0,102
2024-03-06 21:40:00,15,19,18,7,21,0,0,80
2024-03-06 21:50:00,21,12,16,9,10,1,0,69
2024-03-06 22:00:00,19,28,13,5,10,0,0,75
2024-03-06 22:10:00,14,19,14,6,7,0,0,60
2024-03-06 22:20:00,17,26,17,10,15,0,0,85
2024-03-06 22:30:00,12,34,7,9,16,0,0,78
2024-03-06 22:40:00,10,58,14,4,14,0,0,100
2024-03-06 22:50:00,8,11,13,7,14,0,0,53
2024-03-06 23:00:00,12,21,10,5,9,0,0,57
2024-03-06 23:10:00,14,17,7,6,11,0,0,55
2024-03-06 23:20:00,7,10,10,0,4,0,0,31
2024-03-06 23:30:00,12,12,8,3,5,0,0,40
2024-03-06 23:40:00,2,17,21,0,8,0,0,48
2024-03-06 23:50:00,7,10,7,1,6,0,0,31
2024-03-07 00:00:00,6,7,4,3,6,0,0,26
2024-03-07 00:10:00,8,8,17,1,1,0,0,35
2024-03-07 00:20:00,3,6,6,2,5,0,0,22
2024-03-07 00:30:00,4,1,2,1,4,0,0,12
2024-03-07 00:40:00,4,17,23,3,2,0,0,49
2024-03-07 00:50:00,2,2,8,5,4,0,0,21
2024-03-07 01:00:00,4,8,3,2,1,0,0,18
2024-03-07 01:10:00,0,4,3,0,3,0,0,10
2024-03-07 01:20:00,3,5,1,1,3,0,0,13
2024-03-07 01:30:00,4,9,6,2,1,0,0,22
2024-03-07 01:40:00,1,2,3,3,4,0,0,13
2024-03-07 01:50:00,3,4,2,0,1,0,0,10
2024-03-07 02:00:00,0,2,3,0,1,0,0,6
2024-03-07 02:10:00,2,3,0,0,5,0,0,10
2024-03-07 02:20:00,0,3,2,3,3,0,0,11
2024-03-07 02:30:00,2,0,3,1,2,0,0,8
2024-03-07 02:40:00,4,4,1,1,1,0,0,11
2024-03-07 02:50:00,3,0,2,0,1,0,0,6
2024-03-07 03:00:00,2,4,1,0,1,0,0,8
2024-03-07 03:10:00,4,2,2,0,1,0,0,9
2024-03-07 03:20:00,2,2,1,2,4,0,0,11
2024-03-07 03:30:00,6,2,1,0,4,0,0,13
2024-03-07 03:40:00,2,1,0,1,2,0,0,6
2024-03-07 03:50:00,2,3,0,2,4,0,0,11
2024-03-07 04:00:00,2,1,2,3,3,0,0,11
2024-03-07 04:10:00,0,2,21,0,1,0,0,24
2024-03-07 04:20:00,5,1,3,0,8,0,0,17
2024-03-07 04:30:00,4,5,1,0,1,0,0,11
2024-03-07 04:40:00,4,5,12,0,4,0,0,25
2024-03-07 04:50:00,5,6,8,2,4,0,0,25
2024-03-07 05:00:00,1,8,9,3,11,0,0,32
2024-03-07 05:10:00,6,18,8,2,10,1,0,45
2024-03-07 05:20:00,7,9,9,3,8,0,0,36
2024-03-07 05:30:00,9,17,13,7,15,0,0,61
2024-03-07 05:40:00,9,14,36,4,30,0,0,93
2024-03-07 05:50:00,7,23,6,10,38,0,0,84
2024-03-07 06:00:00,26,12,16,8,43,0,0,105
2024-03-07 06:10:00,13,30,14,11,29,0,0,97
2024-03-07 06:20:00,20,28,16,7,41,0,0,112
2024-03-07 06:30:00,19,26,14,11,38,0,0,108
2024-03-07 06:40:00,19,73,22,15,51,0,0,180
2024-03-07 06:50:00,25,32,18,14,49,0,0,138
2024-03-07 07:00:00,22,26,19,15,58,0,0,140
2024-03-07 07:10:00,24,24,31,16,62,0,0,157
2024-03-07 07:20:00,19,29,27,20,60,0,0,155
2024-03-07 07:30:00,27,40,29,28,63,0,0,187
2024-03-07 07:40:00,28,44,36,37,73,0,0,218
2024-03-07 07:50:00,21,46,20,36,56,0,0,179
2024-03-07 08:00:00,34,42,32,19,49,4,0,180
2024-03-07 08:10:00,35,45,26,31,59,0,0,196
2024-03-07 08:20:00,32,32,27,30,60,0,0,181
2024-03-07 08:30:00,26,46,34,21,51,1,0,179
2024-03-07 08:40:00,23,34,37,29,42,1,0,166
2024-03-07 08:50:00,29,67,33,31,58,0,0,218
2024-03-07 09:00:00,30,98,134,25,40,0,0,327
2024-03-07 09:10:00,23,56,16,18,44,0,0,157
2024-03-07 09:20:00,28,50,27,22,33,0,0,160
2024-03-07 09:30:00,27,39,26,16,45,0,0,153
2024-03-07 09:40:00,23,56,25,20,53,0,0,177
2024-03-07 09:50:00,15,39,29,19,40,0,0,142
2024-03-07 10:00:00,25,45,25,13,42,0,0,150
2024-03-07 10:10:00,23,29,23,16,41,0,0,132
2024-03-07 10:20:00,21,41,22,17,50,1,0,152
2024-03-07 10:30:00,17,91,28,14,38,0,0,188
2024-03-07 10:40:00,25,107,116,12,56,1,0,317
2024-03-07 10:50:00,15,144,24,14,44,1,0,242
2024-03-07 11:00:00,22,52,27,15,34,0,0,150
2024-03-07 11:10:00,22,54,22,14,34,0,0,146
2024-03-07 11:20:00,24,123,35,19,33,1,0,235
2024-03-07 11:30:00,24,48,31,13,45,2,0,163
2024-03-07 11:40:00,34,72,31,18,37,1,0,193
2024-03-07 11:50:00,20,43,24,31,51,0,0,169
2024-03-07 12:00:00,30,49,38,23,26,0,0,166
2024-03-07 12:10:00,37,38,30,21,39,0,0,165
2024-03-07 12:20:00,24,58,25,23,43,3,0,176
2024-03-07 12:30:00,40,45,34,18,35,0,0,172
2024-03-07 12:40:00,37,43,30,29,60,2,0,201
2024-03-07 12:50:00,29,46,25,8,41,2,0,151
2024-03-07 13:00:00,26,154,99,28,30,3,0,340
2024-03-07 13:10:00,28,63,36,20,43,2,0,192
2024-03-07 13:20:00,17,38,39,18,40,10,0,162
2024-03-07 13:30:00,33,50,36,19,46,0,0,184
2024-03-07 13:40:00,30,51,32,23,43,3,0,182
2024-03-07 13:50:00,25,44,33,27,52,4,0,185
2024-03-07 14:00:00,31,46,64,18,29,0,0,188
2024-03-07 14:10:00,36,51,24,25,46,0,0,182
2024-03-07 14:20:00,36,49,35,14,50,1,0,185
2024-03-07 14:30:00,27,42,31,26,52,0,0,178
2024-03-07 14:40:00,27,46,40,14,52,1,0,180
2024-03-07 14:50:00,31,52,32,15,40,1,0,171
2024-03-07 15:00:00,30,51,32,20,60,0,0,193
2024-03-07 15:10:00,33,53,46,20,48,0,0,200
2024-03-07 15:20:00,38,52,39,19,50,1,0,199
2024-03-07 15:30:00,35,60,36,22,55,0,0,208
2024-03-07 15:40:00,22,52,26,29,41,5,0,175
2024-03-07 15:50:00,32,52,33,32,60,3,0,212
2024-03-07 16:00:00,32,61,46,21,52,1,0,213
2024-03-07 16:10:00,23,63,32,30,46,0,0,194
2024-03-07 16:20:00,31,102,32,23,38,2,0,228
2024-03-07 16:30:00,31,50,33,27,47,0,0,188
2024-03-07 16:40:00,33,94,65,31,55,11,0,289
2024-03-07 16:50:00,33,51,38,30,72,3,0,227
2024-03-07 17:00:00,36,56,35,24,37,1,0,189
2024-03-07 17:10:00,29,48,40,30,57,2,0,206
2024-03-07 17:20:00,27,48,31,24,64,1,0,195
2024-03-07 17:30:00,37,50,46,23,47,0,0,203
2024-03-07 17:40:00,22,56,33,32,52,2,0,197
2024-03-07 17:50:00,29,50,36,29,50,2,0,196
2024-03-07 18:00:00,33,69,33,25,54,3,0,217
2024-03-07 18:10:00,36,58,41,25,47,0,0,207
2024-03-07 18:20:00,30,58,40,24,52,1,0,205
2024-03-07 18:30:00,23,50,22,15,42,0,0,152
2024-03-07 18:40:00,29,38,31,24,40,0,0,162
2024-03-07 18:50:00,35,31,27,10,51,0,0,154
2024-03-07 19:00:00,27,30,35,17,34,2,0,145
2024-03-07 19:10:00,26,39,41,16,43,0,0,165
2024-03-07 19:20:00,22,24,29,10,33,1,0,119
2024-03-07 19:30:00,24,35,21,13,21,1,0,115
2024-03-07 19:40:00,11,37,32,11,22,0,0,113
2024-03-07 19:50:00,27,13,27,13,35,1,0,116
2024-03-07 20:00:00,25,23,39,13,24,1,0,125
2024-03-07 20:10:00,20,28,24,8,27,0,0,107
2024-03-07 20:20:00,17,23,30,13,48,1,0,132
2024-03-07 20:30:00,19,19,24,9,26,2,0,99
2024-03-07 20:40:00,18,28,28,5,19,0,0,98
2024-03-07 20:50:00,19,18,20,12,24,0,0,93
2024-03-07 21:00:00,17,42,54,5,13,1,0,132
2024-03-07 21:10:00,17,22,17,9,16,0,0,81
2024-03-07 21:20:00,15,12,20,11,20,0,0,78
2024-03-07 21:30:00,14,30,24,11,12,1,0,92
2024-03-07 21:40:00,9,22,13,4,16,0,0,64
2024-03-07 21:50:00,8,15,15,5,18,0,0,61
2024-03-07 22:00:00,18,19,11,6,16,0,0,70
2024-03-07 22:10:00,16,25,20,7,11,0,0,79
2024-03-07 22:20:00,20,57,14,1,8,0,0,100
2024-03-07 22:30:00,15,16,17,7,19,0,0,74
2024-03-07 22:40:00,11,32,76,8,20,1,0,148
2024-03-07 22:50:00,11,12,14,5,14,0,0,56
2024-03-07 23:00:00,7,17,11,6,8,0,0,49
2024-03-07 23:10:00,12,19,23,3,12,0,0,69
2024-03-07 23:20:00,7,8,10,0,10,0,0,35
2024-03-07 23:30:00,7,6,7,3,6,0,0,29
2024-03-07 23:40:00,15,13,30,6,4,0,0,68
2024-03-07 23:50:00,5,9,7,0,4,0,0,25
2024-03-08 00:00:00,7,14,9,2,3,0,0,35
2024-03-08 00:10:00,5,13,9,0,2,0,0,29
2024-03-08 00:20:00,4,7,3,1,6,0,0,21
2024-03-08 00:30:00,8,4,8,3,7,0,0,30
2024-03-08 00:40:00,4,11,23,7,4,0,0,49
2024-03-08 00:50:00,2,1,3,4,4,0,0,14
2024-03-08 01:00:00,4,3,17,1,4,0,0,29
2024-03-08 01:10:00,1,5,3,0,3,0,0,12
2024-03-08 01:20:00,4,4,3,2,4,0,0,17
2024-03-08 01:30:00,1,6,3,3,5,0,0,18
2024-03-08 01:40:00,2,2,4,1,1,0,0,10
2024-03-08 01:50:00,0,3,1,1,2,0,0,7
2024-03-08 02:00:00,1,1,3,2,5,0,0,12
2024-03-08 02:10:00,1,6,1,1,1,0,0,10
2024-03-08 02:20:00,0,1,2,1,4,0,0,8
2024-03-08 02:30:00,2,4,2,1,1,0,0,10
2024-03-08 02:40:00,1,4,6,1,2,0,0,14
2024-03-08 02:50:00,2,2,2,1,0,0,0,7
2024-03-08 03:00:00,4,1,5,0,0,0,0,10
2024-03-08 03:10:00,8,4,4,1,0,0,0,17
2024-03-08 03:20:00,3,1,0,1,2,0,0,7
2024-03-08 03:30:00,0,3,2,2,3,0,0,10
2024-03-08 03:40:00,2,1,3,1,5,0,0,12
2024-03-08 03:50:00,5,3,1,1,1,0,0,11
2024-03-08 04:00:00,2,3,2,4,3,0,0,14
2024-03-08 04:10:00,2,4,10,1,3,0,0,20
2024-03-08 04:20:00,2,1,4,1,5,0,0,13
2024-03-08 04:30:00,2,3,3,1,3,2,0,14
2024-03-08 04:40:00,5,13,5,1,4,0,0,28
2024-03-08 04:50:00,3,6,4,1,6,0,0,20
2024-03-08 05:00:00,1,8,3,2,7,0,0,21
2024-03-08 05:10:00,7,14,4,4,7,0,0,36
2024-03-08 05:20:00,6,13,6,0,10,1,0,36
2024-03-08 05:30:00,9,13,8,6,19,0,0,55
2024-03-08 05:40:00,9,16,12,8,49,0,0,94
2024-03-08 05:50:00,14,16,9,7,34,0,0,80
2024-03-08 06:00:00,18,17,16,10,28,1,0,90
2024-03-08 06:10:00,24,31,15,7,31,0,0,108
2024-03-08 06:20:00,21,28,21,5,42,0,0,117
2024-03-08 06:30:00,16,38,17,9,43,0,0,123
2024-03-08 06:40:00,20,34,16,11,58,0,0,139
2024-03-08 06:50:00,18,26,20,7,42,0,0,113
2024-03-08 07:00:00,25,32,18,12,49,0,0,136
2024-03-08 07:10:00,19,29,22,23,49,2,0,144
2024-03-08 07:20:00,21,32,22,28,59,1,0,163
2024-03-08 07:30:00,27,38,21,14,50,0,0,150
2024-03-08 07:40:00,22,36,21,37,75,1,0,192
2024-03-08 07:50:00,22,38,29,33,57,0,0,179
2024-03-08 08:00:00,22,49,26,30,47,1,0,175
2024-03-08 08:10:00,29,36,27,23,35,0,0,150
2024-03-08 08:20:00,29,36,25,24,55,0,0,169
2024-03-08 08:30:00,21,23,27,24,45,0,0,140
2024-03-08 08:40:00,24,43,26,50,39,0,0,182
2024-03-08 08:50:00,27,35,23,64,53,0,0,202
2024-03-08 09:00:00,26,53,27,29,44,0,0,179
2024-03-08 09:10:00,23,32,18,18,49,0,0,140
2024-03-08 09:20:00,20,56,23,23,41,0,0,163
2024-03-08 09:30:00,24,39,30,21,46,0,0,160
2024-03-08 09:40:00,24,41,29,12,35,0,0,141
2024-03-08 09:50:00,23,39,32,13,44,0,0,151
2024-03-08 10:00:00,25,44,23,15,40,0,0,147
2024-03-08 10:10:00,26,49,25,48,34,1,0,183
2024-03-08 10:20:00,25,45,33,25,36,0,0,164
2024-03-08 10:30:00,23,39,26,16,33,1,0,138
2024-03-08 10:40:00,31,41,21,16,46,0,0,155
2024-03-08 10:50:00,26,35,35,14,51,0,0,161
2024-03-08 11:00:00,27,43,26,22,35,0,0,153
2024-03-08 11:10:00,25,39,28,25,41,0,0,158
2024-03-08 11:20:00,40,50,31,22,36,1,0,180
2024-03-08 11:30:00,21,46,25,19,26,0,0,137
2024-03-08 11:40:00,30,53,25,22,46,0,0,176
2024-03-08 11:50:00,53,53,30,18,48,0,0,202
2024-03-08 12:00:00,34,55,25,20,47,2,0,183
2024-03-08 12:10:00,36,57,32,17,51,1,0,194
2024-03-08 12:20:00,47,39,34,16,42,4,0,182
2024-03-08 12:30:00,26,49,39,17,49,0,0,180
2024-03-08 12:40:00,28,52,34,23,58,1,0,196
2024-03-08 12:50:00,36,67,49,18,51,0,0,221
2024-03-08 13:00:00,48,55,42,17,57,1,0,220
2024-03-08 13:10:00,27,65,40,32,60,2,0,226
2024-03-08 13:20:00,28,81,36,23,42,3,0,213
2024-03-08 13:30:00,34,56,34,21,55,0,0,200
2024-03-08 13:40:00,29,49,30,13,36,0,0,157
2024-03-08 13:50:00,24,49,38,20,42,1,0,174
2024-03-08 14:00:00,25,46,39,28,45,1,0,184
2024-03-08 14:10:00,34,48,30,22,38,5,0,177
2024-03-08 14:20:00,31,56,28,22,35,2,0,174
2024-03-08 14:30:00,35,51,30,28,59,1,0,204
2024-03-08 14:40:00,37,52,42,26,53,1,0,211
2024-03-08 14:50:00,37,53,38,24,49,4,0,205
2024-03-08 15:00:00,31,51,33,28,47,3,0,193
2024-03-08 15:10:00,34,45,34,22,40,0,0,175
2024-03-08 15:20:00,26,51,37,16,42,6,0,178
2024-03-08 15:30:00,37,48,40,24,59,3,0,211
2024-03-08 15:40:00,38,49,32,16,41,1,0,177
2024-03-08 15:50:00,30,51,39,32,50,3,0,205
2024-03-08 16:00:00,19,50,40,28,45,0,0,182
2024-03-08 16:10:00,20,53,38,28,71,3,0,213
2024-03-08 16:20:00,27,57,22,26,47,1,0,180
2024-03-08 16:30:00,28,58,26,25,46,0,0,183
2024-03-08 16:40:00,33,85,28,20,39,0,0,205
2024-03-08 16:50:00,36,48,39,34,58,0,0,215
2024-03-08 17:00:00,24,63,26,30,42,2,0,187
2024-03-08 17:10:00,30,47,30,30,52,1,0,190
2024-03-08 17:20:00,27,53,35,31,58,0,0,204
2024-03-08 17:30:00,25,83,33,20,38,0,0,199
2024-03-08 17:40:00,20,57,38,20,50,0,0,185
2024-03-08 17:50:00,30,49,39,23,55,3,0,199
2024-03-08 18:00:00,25,34,35,26,32,0,0,152
2024-03-08 18:10:00,21,51,37,22,37,1,0,169
2024-03-08 18:20:00,30,51,38,11,39,0,0,169
2024-03-08 18:30:00,27,56,30,18,39,0,0,170
2024-03-08 18:40:00,26,48,36,26,42,0,0,178
2024-03-08 18:50:00,22,35,21,26,43,0,0,147
2024-03-08 19:00:00,22,42,14,19,37,1,0,135
2024-03-08 19:10:00,21,42,33,20,32,0,0,148
2024-03-08 19:20:00,23,38,40,21,38,0,0,160
2024-03-08 19:30:00,21,50,21,21,29,1,0,143
2024-03-08 19:40:00,23,36,36,16,30,2,0,143
2024-03-08 19:50:00,27,28,23,10,33,1,0,122
2024-03-08 20:00:00,17,24,20,18,27,2,0,108
2024-03-08 20:10:00,22,27,21,12,24,0,0,106
2024-03-08 20:20:00,23,20,21,12,17,1,0,94
2024-03-08 20:30:00,18,26,28,11,27,0,0,110
2024-03-08 20:40:00,17,40,31,4,38,2,0,132
2024-03-08 20:50:00,15,29,22,14,37,0,0,117
2024-03-08 21:00:00,17,19,16,8,22,0,0,82
2024-03-08 21:10:00,17,28,13,7,19,0,0,84
2024-03-08 21:20:00,20,16,16,10,24,0,0,86
2024-03-08 21:30:00,20,26,25,8,24,1,0,104
2024-03-08 21:40:00,15,28,16,9,20,0,0,88
2024-03-08 21:50:00,24,28,22,8,20,0,0,102
2024-03-08 22:00:00,16,16,22,13,14,0,0,81
2024-03-08 22:10:00,19,19,25,7,18,0,0,88
2024-03-08 22:20:00,14,24,35,6,16,0,0,95
2024-03-08 22:30:00,14,12,27,10,23,1,0,87
2024-03-08 22:40:00,21,22,32,8,19,0,0,102
2024-03-08 22:50:00,16,21,24,3,12,0,0,76
2024-03-08 23:00:00,14,14,22,6,15,0,0,71
2024-03-08 23:10:00,9,20,20,6,17,0,0,72
2024-03-08 23:20:00,10,18,15,9,13,0,0,65
2024-03-08 23:30:00,12,11,12,11,10,0,0,56
2024-03-08 23:40:00,12,16,12,7,15,0,0,62
2024-03-08 23:50:00,12,21,15,3,14,0,0,65
2024-03-09 00:00:00,12,5,10,6,11,0,0,44
2024-03-09 00:10:00,14,17,18,3,5,0,0,57
2024-03-09 00:20:00,9,16,10,2,10,0,0,47
2024-03-09 00:30:00,10,14,10,4,4,0,0,42
2024-03-09 00:40:00,10,32,9,0,5,0,0,56
2024-03-09 00:50:00,11,4,13,5,11,1,0,45
2024-03-09 01:00:00,9,13,13,6,10,0,0,51
2024-03-09 01:10:00,6,11,10,2,14,0,0,43
2024-03-09 01:20:00,10,9,9,5,6,0,0,39
2024-03-09 01:30:00,7,10,8,5,8,0,0,38
2024-03-09 01:40:00,9,12,3,6,6,0,0,36
2024-03-09 01:50:00,3,9,5,4,3,0,0,24
2024-03-09 02:00:00,4,9,2,1,4,0,0,20
2024-03-09 02:10:00,5,12,8,3,2,0,0,30
2024-03-09 02:20:00,3,2,4,0,5,0,0,14
2024-03-09 02:30:00,3,5,6,4,9,0,0,27
2024-03-09 02:40:00,3,6,4,0,2,0,0,15
2024-03-09 02:50:00,6,3,5,1,5,0,0,20
2024-03-09 03:00:00,1,2,6,3,3,0,0,15
2024-03-09 03:10:00,1,7,0,1,0,0,0,9
2024-03-09 03:20:00,2,8,6,3,3,0,0,22
2024-03-09 03:30:00,5,4,3,0,5,0,0,17
2024-03-09 03:40:00,5,2,4,3,2,0,0,16
2024-03-09 03:50:00,4,4,2,1,2,1,0,14
2024-03-09 04:00:00,7,2,5,3,2,0,0,19
2024-03-09 04:10:00,2,6,27,1,2,0,0,38
2024-03-09 04:20:00,4,2,8,3,0,1,0,18
2024-03-09 04:30:00,1,8,1,2,3,0,0,15
2024-03-09 04:40:00,1,8,4,2,2,0,0,17
2024-03-09 04:50:00,1,5,3,1,4,0,0,14
2024-03-09 05:00:00,4,5,2,5,5,0,0,21
2024-03-09 05:10:00,9,7,54,2,7,0,0,79
2024-03-09 05:20:00,4,6,8,2,6,0,0,26
2024-03-09 05:30:00,3,9,3,4,12,0,0,31
2024-03-09 05:40:00,7,9,8,4,13,0,0,41
2024-03-09 05:50:00,6,6,7,2,4,0,0,25
2024-03-09 06:00:00,3,9,6,2,6,0,0,26
2024-03-09 06:10:00,5,17,99,3,8,0,0,132
2024-03-09 06:20:00,3,17,7,1,10,0,0,38
2024-03-09 06:30:00,5,14,6,2,13,0,0,40
2024-03-09 06:40:00,10,7,21,5,13,1,0,57
2024-03-09 06:50:00,11,7,8,4,7,0,0,37
2024-03-09 07:00:00,10,5,51,1,9,0,0,76
2024-03-09 07:10:00,9,10,10,4,5,0,0,38
2024-03-09 07:20:00,5,6,12,3,13,0,0,39
2024-03-09 07:30:00,4,12,4,8,19,0,0,47
2024-03-09 07:40:00,12,15,5,7,14,0,0,53
2024-03-09 07:50:00,5,10,32,7,18,0,0,72
2024-03-09 08:00:00,7,13,15,6,17,1,0,59
2024-03-09 08:10:00,15,17,16,2,18,1,0,69
2024-03-09 08:20:00,8,15,12,9,23,0,0,67
2024-03-09 08:30:00,12,27,11,5,15,1,0,71
2024-03-09 08:40:00,13,25,106,15,24,0,0,183
2024-03-09 08:50:00,9,19,14,4,25,1,0,72
2024-03-09 09:00:00,10,28,14,16,19,0,0,87
2024-03-09 09:10:00,17,34,26,11,18,0,0,106
2024-03-09 09:20:00,11,26,20,14,27,1,0,99
2024-03-09 09:30:00,19,29,12,8,31,0,0,99
2024-03-09 09:40:00,15,53,29,11,50,1,0,159
2024-03-09 09:50:00,20,48,26,18,38,0,0,150
2024-03-09 10:00:00,28,43,21,19,41,1,0,153
2024-03-09 10:10:00,25,48,41,17,36,1,0,168
2024-03-09 10:20:00,22,35,24,8,34,2,0,125
2024-03-09 10:30:00,22,39,24,20,27,0,0,132
2024-03-09 10:40:00,24,77,58,12,36,0,0,207
2024-03-09 10:50:00,19,43,25,16,33,0,0,136
2024-03-09 11:00:00,17,44,26,12,44,0,0,143
2024-03-09 11:10:00,19,35,26,22,41,0,0,143
2024-03-09 11:20:00,28,39,25,16,40,1,0,149
2024-03-09 11:30:00,17,43,13,19,27,0,0,119
2024-03-09 11:40:00,23,48,57,15,48,0,0,191
2024-03-09 11:50:00,30,50,21,15,28,5,0,149
2024-03-09 12:00:00,39,47,27,12,33,0,0,158
2024-03-09 12:10:00,26,56,33,16,39,0,0,170
2024-03-09 12:20:00,28,40,31,14,34,1,0,148
2024-03-09 12:30:00,21,46,171,12,41,0,0,291
2024-03-09 12:40:00,23,54,33,23,38,1,0,172
2024-03-09 12:50:00,22,31,32,16,46,1,0,148
2024-03-09 13:00:00,20,50,31,9,42,2,0,154
2024-03-09 13:10:00,27,51,21,17,48,2,0,166
2024-03-09 13:20:00,29,40,31,19,32,3,0,154
2024-03-09 13:30:00,39,45,76,15,30,5,0,210
2024-03-09 13:40:00,27,33,26,21,44,1,0,152
2024-03-09 13:50:00,23,39,33,11,40,1,0,147
2024-03-09 14:00:00,23,55,24,20,26,1,0,149
2024-03-09 14:10:00,20,61,65,19,39,0,0,204
2024-03-09 14:20:00,19,64,127,13,30,1,0,254
2024-03-09 14:30:00,22,58,25,17,37,1,0,160
2024-03-09 14:40:00,37,58,31,24,39,1,0,190
2024-03-09 14:50:00,27,46,25,14,37,2,0,151
2024-03-09 15:00:00,21,42,28,11,31,1,0,134
2024-03-09 15:10:00,29,42,25,15,37,1,0,149
2024-03-09 15:20:00,19,81,34,17,38,1,0,190
2024-03-09 15:30:00,18,44,32,18,33,0,0,145
2024-03-09 15:40:00,26,46,26,13,24,1,0,136
2024-03-09 15:50:00,24,38,29,14,33,1,0,139
2024-03-09 16:00:00,17,62,34,13,22,1,0,149
2024-03-09 16:10:00,26,33,56,23,30,0,0,168
2024-03-09 16:20:00,24,50,25,12,31,2,0,144
2024-03-09 16:30:00,21,37,47,15,35,1,0,156
2024-03-09 16:40:00,16,40,21,17,22,1,0,117
2024-03-09 16:50:00,24,49,53,15,38,1,0,180
2024-03-09 17:00:00,27,38,24,13,37,0,0,139
2024-03-09 17:10:00,21,64,32,10,38,3,0,168
2024-03-09 17:20:00,20,29,18,19,35,2,0,123
2024-03-09 17:30:00,14,49,27,9,28,0,0,127
2024-03-09 17:40:00,18,38,29,18,39,2,0,144
2024-03-09 17:50:00,27,34,27,7,44,0,0,139
2024-03-09 18:00:00,18,39,28,11,32,0,0,128
2024-03-09 18:10:00,21,39,30,13,25,0,0,128
2024-03-09 18:20:00,12,20,31,14,30,0,0,107
2024-03-09 18:30:00,22,48,23,19,41,1,0,154
2024-03-09 18:40:00,23,39,21,7,31,0,0,121
2024-03-09 18:50:00,18,23,34,15,37,0,0,127
2024-03-09 19:00:00,20,37,13,23,30,0,0,123
2024-03-09 19:10:00,23,40,77,22,40,0,0,202
2024-03-09 19:20:00,19,29,28,15,33,3,0,127
2024-03-09 19:30:00,26,34,24,11,23,2,0,120
2024-03-09 19:40:00,20,34,18,13,28,0,0,113
2024-03-09 19:50:00,21,27,53,11,25,0,0,137
2024-03-09 20:00:00,22,41,19,11,27,0,0,120
2024-03-09 20:10:00,15,28,27,11,28,2,0,111
2024-03-09 20:20:00,16,20,19,8,22,1,0,86
2024-03-09 20:30:00,16,32,13,14,23,0,0,98
2024-03-09 20:40:00,19,21,11,15,25,1,0,92
2024-03-09 20:50:00,17,20,116,13,20,0,0,186
2024-03-09 21:00:00,28,26,26,11,18,2,0,111
2024-03-09 21:10:00,13,22,18,5,31,1,0,90
2024-03-09 21:20:00,14,23,20,5,18,0,0,80
2024-03-09 21:30:00,19,21,22,7,14,0,0,83
2024-03-09 21:40:00,18,28,109,10,25,1,0,191
2024-03-09 21:50:00,17,26,16,10,21,1,0,91
2024-03-09 22:00:00,9,20,11,8,11,0,0,59
2024-03-09 22:10:00,10,22,18,6,20,1,0,77
2024-03-09 22:20:00,16,29,20,5,22,1,0,93
2024-03-09 22:30:00,15,16,19,6,21,3,0,80
2024-03-09 22:40:00,17,106,320,8,16,0,0,467
2024-03-09 22:50:00,13,25,21,9,19,0,0,87
2024-03-09 23:00:00,13,19,19,5,18,0,0,74
2024-03-09 23:10:00,15,26,24,5,11,1,0,82
2024-03-09 23:20:00,13,16,21,7,23,0,0,80
2024-03-09 23:30:00,8,25,13,5,11,1,0,63
2024-03-09 23:40:00,11,41,58,8,20,0,0,138
2024-03-09 23:50:00,11,13,17,2,14,1,0,58
2024-03-10 00:00:00,7,9,8,3,13,0,0,40
2024-03-10 00:10:00,13,18,9,5,8,0,0,53
2024-03-10 00:20:00,8,14,12,3,13,0,0,50
2024-03-10 00:30:00,4,16,15,6,8,0,0,49
2024-03-10 00:40:00,5,16,23,3,6,0,0,53
2024-03-10 00:50:00,11,11,18,5,12,1,0,58
2024-03-10 01:00:00,7,17,8,4,7,0,0,43
2024-03-10 01:10:00,10,8,15,2,12,1,0,48
2024-03-10 01:20:00,13,10,6,2,1,0,0,32
2024-03-10 01:30:00,8,12,6,3,4,0,0,33
2024-03-10 01:40:00,5,15,48,5,4,0,0,77
2024-03-10 01:50:00,8,10,3,2,4,1,0,28
2024-03-10 02:00:00,5,6,4,1,4,0,0,20
2024-03-10 02:10:00,2,11,9,0,5,0,0,27
2024-03-10 02:20:00,3,3,8,3,5,1,0,23
2024-03-10 02:30:00,1,7,10,1,2,0,0,21
2024-03-10 02:40:00,3,14,59,1,5,0,0,82
2024-03-10 02:50:00,4,2,7,2,3,0,0,18
2024-03-10 03:00:00,3,4,6,0,1,0,0,14
2024-03-10 03:10:00,9,7,15,3,5,0,0,39
2024-03-10 03:20:00,2,2,7,3,5,0,0,19
2024-03-10 03:30:00,2,9,3,2,2,0,0,18
2024-03-10 03:40:00,1,7,13,3,0,0,0,24
2024-03-10 03:50:00,2,4,5,2,1,0,0,14
2024-03-10 04:00:00,2,4,3,2,3,0,0,14
2024-03-10 04:10:00,4,3,8,2,0,0,0,17
2024-03-10 04:20:00,2,7,9,1,0,0,0,19
2024-03-10 04:30:00,1,5,6,3,2,0,0,17
2024-03-10 04:40:00,1,9,6,0,2,0,0,18
2024-03-10 04:50:00,1,5,4,1,3,0,0,14
2024-03-10 05:00:00,3,3,2,1,2,0,0,11
2024-03-10 05:10:00,3,7,4,3,7,0,0,24
2024-03-10 05:20:00,5,5,9,3,5,0,0,27
2024-03-10 05:30:00,2,11,4,4,7,0,0,28
2024-03-10 05:40:00,6,11,9,2,8,0,0,36
2024-03-10 05:50:00,3,3,6,1,4,0,0,17
2024-03-10 06:00:00,6,7,4,1,9,0,0,27
2024-03-10 06:10:00,7,5,6,2,3,0,0,23
2024-03-10 06:20:00,3,11,6,4,5,0,0,29
2024-03-10 06:30:00,4,8,7,5,7,0,0,31
2024-03-10 06:40:00,6,6,3,2,6,1,0,24
2024-03-10 06:50:00,5,3,8,4,3,0,0,23
2024-03-10 07:00:00,4,6,1,2,3,0,0,16
2024-03-10 07:10:00,5,9,5,5,3,0,0,27
2024-03-10 07:20:00,3,3,2,1,5,0,0,14
2024-03-10 07:30:00,2,4,6,7,7,0,0,26
2024-03-10 07:40:00,4,6,4,3,3,0,0,20
2024-03-10 07:50:00,3,4,7,4,4,0,0,22
2024-03-10 08:00:00,2,4,6,2,9,1,0,24
2024-03-10 08:10:00,4,9,12,3,4,0,0,32
2024-03-10 08:20:00,6,2,5,5,7,0,0,25
2024-03-10 08:30:00,10,9,9,6,7,0,0,41
2024-03-10 08:40:00,9,15,17,7,5,0,0,53
2024-03-10 08:50:00,5,6,11,6,11,1,0,40
2024-03-10 09:00:00,9,12,6,4,12,0,0,43
2024-03-10 09:10:00,8,13,20,4,12,0,0,57
2024-03-10 09:20:00,11,15,7,9,11,0,0,53
2024-03-10 09:30:00,14,10,8,8,19,0,0,59
2024-03-10 09:40:00,10,22,8,10,19,1,0,70
2024-03-10 09:50:00,7,20,114,11,22,0,0,174
2024-03-10 10:00:00,15,19,10,5,19,0,0,68
2024-03-10 10:10:00,19,17,14,12,15,1,0,78
2024-03-10 10:20:00,11,23,17,6,20,1,0,78
2024-03-10 10:30:00,11,15,16,11,20,0,0,73
2024-03-10 10:40:00,10,20,17,9,22,0,0,78
2024-03-10 10:50:00,11,14,24,9,24,1,0,83
2024-03-10 11:00:00,13,15,16,10,32,1,0,87
2024-03-10 11:10:00,16,28,20,12,30,0,0,106
2024-03-10 11:20:00,16,21,14,11,32,1,0,95
2024-03-10 11:30:00,19,16,23,12,26,0,0,96
2024-03-10 11:40:00,12,28,28,8,30,0,0,106
2024-03-10 11:50:00,16,20,24,4,36,0,0,100
2024-03-10 12:00:00,25,27,22,13,35,1,0,123
2024-03-10 12:10:00,18,22,35,13,30,1,0,119
2024-03-10 12:20:00,16,22,17,8,42,2,0,107
2024-03-10 12:30:00,14,27,32,16,26,0,0,115
2024-03-10 12:40:00,21,40,21,16,30,0,0,128
2024-03-10 12:50:00,15,28,24,12,38,1,0,118
2024-03-10 13:00:00,14,22,29,10,42,0,0,117
2024-03-10 13:10:00,22,30,28,14,30,2,0,126
2024-03-10 13:20:00,19,27,22,21,27,0,0,116
2024-03-10 13:30:00,21,26,16,19,33,2,0,117
2024-03-10 13:40:00,22,28,22,20,28,0,0,120
2024-03-10 13:50:00,19,21,38,19,33,1,0,131
2024-03-10 14:00:00,21,32,28,11,43,1,0,136
2024-03-10 14:10:00,18,18,17,14,36,4,0,107
2024-03-10 14:20:00,26,35,28,15,31,4,0,139
2024-03-10 14:30:00,19,35,24,13,28,1,0,120
2024-03-10 14:40:00,17,26,18,18,36,0,0,115
2024-03-10 14:50:00,24,34,30,11,38,1,0,138
2024-03-10 15:00:00,16,36,26,15,30,3,0,126
2024-03-10 15:10:00,19,31,26,16,25,1,0,118
2024-03-10 15:20:00,17,27,28,14,41,0,0,127
2024-03-10 15:30:00,18,31,31,18,35,0,0,133
2024-03-10 15:40:00,18,42,40,12,25,3,0,140
2024-03-10 15:50:00,14,45,22,16,29,1,0,127
2024-03-10 16:00:00,22,24,25,13,19,0,0,103
2024-03-10 16:10:00,24,39,29,18,33,1,0,144
2024-03-10 16:20:00,20,25,29,17,29,1,0,121
2024-03-10 16:30:00,15,41,22,15,26,0,0,119
2024-03-10 16:40:00,25,48,30,11,32,1,0,147
2024-03-10 16:50:00,20,30,36,18,35,0,0,139
2024-03-10 17:00:00,16,59,30,20,34,0,0,159
2024-03-10 17:10:00,23,43,40,16,40,1,0,163
2024-03-10 17:20:00,19,37,24,14,40,0,0,134
2024-03-10 17:30:00,24,45,24,15,30,0,0,138
2024-03-10 17:40:00,17,32,23,12,39,0,0,123
2024-03-10 17:50:00,21,29,25,17,36,0,0,128
2024-03-10 18:00:00,18,28,35,15,42,1,0,139
2024-03-10 18:10:00,20,25,17,16,31,0,0,109
2024-03-10 18:20:00,24,28,22,12,19,1,0,106
2024-03-10 18:30:00,16,51,34,14,32,0,0,147
2024-03-10 18:40:00,20,29,24,14,22,0,0,109
2024-03-10 18:50:00,17,22,23,8,23,1,0,94
2024-03-10 19:00:00,15,35,18,19,35,0,0,122
2024-03-10 19:10:00,28,24,22,17,41,0,0,132
2024-03-10 19:20:00,22,24,19,15,26,0,0,106
2024-03-10 19:30:00,21,34,23,13,24,0,0,115
2024-03-10 19:40:00,11,30,25,15,34,0,0,115
2024-03-10 19:50:00,10,33,24,11,28,2,0,108
2024-03-10 20:00:00,20,20,13,11,21,1,0,86
2024-03-10 20:10:00,14,29,14,11,16,2,0,86
2024-03-10 20:20:00,13,24,17,9,18,0,0,81
2024-03-10 20:30:00,18,13,19,13,17,0,0,80
2024-03-10 20:40:00,19,32,16,9,19,1,0,96
2024-03-10 20:50:00,18,30,15,5,8,0,0,76
2024-03-10 21:00:00,14,23,29,10,20,2,0,98
2024-03-10 21:10:00,21,14,34,4,16,0,0,89
2024-03-10 21:20:00,19,27,23,11,12,0,0,92
2024-03-10 21:30:00,16,23,8,7,12,2,0,68
2024-03-10 21:40:00,14,17,24,5,11,0,0,71
2024-03-10 21:50:00,13,18,16,6,13,0,0,66
2024-03-10 22:00:00,12,19,14,6,12,0,0,63
2024-03-10 22:10:00,13,18,16,4,6,0,0,57
2024-03-10 22:20:00,10,17,19,7,16,0,0,69
2024-03-10 22:30:00,11,13,8,5,6,0,0,43
2024-03-10 22:40:00,7,21,12,4,10,0,0,54
2024-03-10 22:50:00,8,35,12,5,7,0,0,67
2024-03-10 23:00:00,4,6,2,5,8,0,0,25
2024-03-10 23:10:00,9,8,4,1,6,0,0,28
2024-03-10 23:20:00,4,4,4,0,4,0,0,16
2024-03-10 23:30:00,3,18,3,3,6,0,0,33
2024-03-10 23:40:00,6,6,9,7,8,0,0,36
2024-03-10 23:50:00,4,6,8,5,7,0,0,30
2024-03-11 00:00:00,5,8,6,3,2,0,0,24
2024-03-11 00:10:00,3,14,4,3,6,0,0,30
2024-03-11 00:20:00,3,12,4,3,7,1,0,30
2024-03-11 00:30:00,5,7,4,3,4,0,0,23
2024-03-11 00:40:00,1,7,4,1,1,0,0,14
2024-03-11 00:50:00,0,3,3,1,5,0,0,12
2024-03-11 01:00:00,1,3,18,0,1,0,0,23
2024-03-11 01:10:00,1,3,2,1,2,0,0,9
2024-03-11 01:20:00,1,1,1,1,3,0,0,7
2024-03-11 01:30:00,4,1,2,0,2,0,0,9
2024-03-11 01:40:00,2,4,3,2,5,0,0,16
2024-03-11 01:50:00,2,3,1,1,2,0,0,9
2024-03-11 02:00:00,0,0,2,1,1,0,0,4
2024-03-11 02:10:00,0,4,1,0,1,0,0,6
2024-03-11 02:20:00,2,2,0,1,2,0,0,7
2024-03-11 02:30:00,3,1,2,0,1,0,0,7
2024-03-11 02:40:00,1,1,1,1,1,0,0,5
2024-03-11 02:50:00,4,0,1,0,2,0,0,7
2024-03-11 03:00:00,1,1,3,0,0,0,0,5
2024-03-11 03:10:00,0,0,1,1,0,0,0,2
2024-03-11 03:20:00,0,2,2,0,1,0,0,5
2024-03-11 03:30:00,1,2,1,0,2,0,0,6
2024-03-11 03:40:00,2,1,2,2,1,0,0,8
2024-03-11 03:50:00,3,6,0,0,3,0,0,12
2024-03-11 04:00:00,4,1,2,3,2,0,0,12
2024-03-11 04:10:00,1,2,8,0,3,0,0,14
2024-03-11 04:20:00,4,3,2,2,1,0,0,12
2024-03-11 04:30:00,6,6,4,1,3,0,0,20
2024-03-11 04:40:00,5,11,2,1,6,0,0,25
2024-03-11 04:50:00,0,9,6,3,3,0,0,21
2024-03-11 05:00:00,8,8,12,1,9,0,0,38
2024-03-11 05:10:00,13,14,32,3,11,0,0,73
2024-03-11 05:20:00,5,13,9,3,16,0,0,46
2024-03-11 05:30:00,10,12,9,8,20,0,0,59
2024-03-11 05:40:00,9,14,12,10,33,0,0,78
2024-03-11 05:50:00,7,20,11,5,37,0,0,80
2024-03-11 06:00:00,13,21,19,8,34,0,0,95
2024-03-11 06:10:00,13,24,16,11,30,0,0,94
2024-03-11 06:20:00,15,39,20,11,37,0,0,122
2024-03-11 06:30:00,20,25,18,10,48,0,0,121
2024-03-11 06:40:00,14,27,18,17,50,0,0,126
2024-03-11 06:50:00,22,30,19,11,52,0,0,134
2024-03-11 07:00:00,27,30,26,17,55,0,0,155
2024-03-11 07:10:00,24,34,14,19,72,0,0,163
2024-03-11 07:20:00,27,65,20,19,63,0,0,194
2024-03-11 07:30:00,22,52,29,22,51,1,0,177
2024-03-11 07:40:00,25,37,30,27,56,1,0,176
2024-03-11 07:50:00,22,36,22,38,56,0,0,174
2024-03-11 08:00:00,16,40,34,25,38,2,0,155
2024-03-11 08:10:00,37,54,19,37,67,1,0,215
2024-03-11 08:20:00,25,45,33,40,61,0,0,204
2024-03-11 08:30:00,27,40,30,29,57,4,0,187
2024-03-11 08:40:00,20,47,57,20,51,2,0,197
2024-03-11 08:50:00,30,37,31,29,42,2,0,171
2024-03-11 09:00:00,31,46,26,33,49,0,0,185
2024-03-11 09:10:00,22,56,23,21,32,1,0,155
2024-03-11 09:20:00,26,52,31,31,43,1,0,184
2024-03-11 09:30:00,14,35,22,14,41,0,0,126
2024-03-11 09:40:00,24,39,26,17,42,0,0,148
2024-03-11 09:50:00,22,44,31,14,36,0,0,147
2024-03-11 10:00:00,0,0,0,0,0,0,0,0
2024-03-11 10:10:00,0,0,0,0,0,0,0,0
2024-03-11 10:20:00,0,0,0,0,0,0,0,0
2024-03-11 10:30:00,0,0,0,0,0,0,0,0
2024-03-11 10:40:00,0,0,0,0,0,0,0,0
2024-03-11 10:50:00,0,0,0,0,0,0,0,0
2024-03-11 11:00:00,0,0,0,0,0,0,0,0
2024-03-11 11:10:00,0,0,0,0,0,0,0,0
2024-03-11 11:20:00,0,0,0,0,0,0,0,0
2024-03-11 11:30:00,0,0,0,0,0,0,0,0
2024-03-11 11:40:00,0,0,0,0,0,0,0,0
2024-03-11 11:50:00,0,0,0,0,0,0,0,0
2024-03-11 12:00:00,0,0,0,0,0,0,0,0
2024-03-11 12:10:00,0,0,0,0,0,0,0,0
2024-03-11 12:20:00,0,0,0,0,0,0,0,0
2024-03-11 12:30:00,0,0,0,0,0,0,0,0
2024-03-11 12:40:00,5,6,5,3,18,0,0,37
2024-03-11 12:50:00,29,44,36,14,39,0,0,162
2024-03-11 13:00:00,30,82,29,15,42,0,0,198
2024-03-11 13:10:00,21,37,31,20,40,0,0,149
2024-03-11 13:20:00,32,44,33,19,42,2,0,172
2024-03-11 13:30:00,29,45,34,20,34,1,0,163
2024-03-11 13:40:00,28,34,23,21,41,1,0,148
2024-03-11 13:50:00,20,36,35,14,47,0,0,152
2024-03-11 14:00:00,33,39,38,15,35,1,0,161
2024-03-11 14:10:00,22,57,45,19,43,3,0,189
2024-03-11 14:20:00,29,47,59,13,38,2,0,188
2024-03-11 14:30:00,41,44,39,12,44,0,0,180
2024-03-11 14:40:00,35,57,37,17,49,2,0,197
2024-03-11 14:50:00,29,48,30,25,36,0,0,168
2024-03-11 15:00:00,30,44,36,19,58,0,0,187
2024-03-11 15:10:00,28,81,37,22,43,1,0,212
2024-03-11 15:20:00,26,53,32,23,47,3,0,184
2024-03-11 15:30:00,32,60,36,19,50,1,0,198
2024-03-11 15:40:00,32,46,35,32,54,1,0,200
2024-03-11 15:50:00,28,59,30,24,46,2,0,189
2024-03-11 16:00:00,25,61,35,22,39,4,0,186
2024-03-11 16:10:00,29,51,32,21,58,1,0,192
2024-03-11 16:20:00,33,42,37,27,50,2,0,191
2024-03-11 16:30:00,38,112,31,28,59,2,0,270
2024-03-11 16:40:00,35,80,32,15,40,1,0,203
2024-03-11 16:50:00,33,47,28,22,55,3,0,188
2024-03-11 17:00:00,33,49,40,24,55,2,0,203
2024-03-11 17:10:00,23,70,37,30,58,3,0,221
2024-03-11 17:20:00,28,48,34,29,55,3,0,197
2024-03-11 17:30:00,29,47,29,18,51,0,0,174
2024-03-11 17:40:00,20,46,32,27,57,2,0,184
2024-03-11 17:50:00,30,47,26,33,47,0,0,183
2024-03-11 18:00:00,34,61,31,18,45,0,0,189
2024-03-11 18:10:00,27,59,38,14,41,1,0,180
2024-03-11 18:20:00,27,37,22,27,29,2,0,144
2024-03-11 18:30:00,20,70,27,23,59,1,0,200
2024-03-11 18:40:00,20,49,29,15,26,0,0,139
2024-03-11 18:50:00,27,34,19,7,26,0,0,113
2024-03-11 19:00:00,26,38,24,11,31,1,0,131
2024-03-11 19:10:00,20,33,17,18,27,0,0,115
2024-03-11 19:20:00,18,25,26,11,24,1,0,105
2024-03-11 19:30:00,20,31,24,14,30,0,0,119
2024-03-11 19:40:00,15,23,21,13,40,0,0,112
2024-03-11 19:50:00,11,34,24,7,41,1,0,118
2024-03-11 20:00:00,23,41,22,16,22,0,0,124
2024-03-11 20:10:00,16,30,23,11,17,0,0,97
2024-03-11 20:20:00,16,12,24,9,15,1,0,77
2024-03-11 20:30:00,16,32,17,14,13,1,0,93
2024-03-11 20:40:00,14,39,33,4,8,0,0,98
2024-03-11 20:50:00,16,34,12,6,20,2,0,90
2024-03-11 21:00:00,17,32,19,13,10,0,0,91
2024-03-11 21:10:00,26,21,19,15,17,0,0,98
2024-03-11 21:20:00,21,26,15,7,11,0,0,80
2024-03-11 21:30:00,7,33,21,7,16,1,0,85
2024-03-11 21:40:00,17,20,31,8,11,0,0,87
2024-03-11 21:50:00,14,14,15,6,9,0,0,58
2024-03-11 22:00:00,17,26,20,4,7,0,0,74
2024-03-11 22:10:00,8,23,17,10,7,1,0,66
2024-03-11 22:20:00,14,20,12,1,14,0,0,61
2024-03-11 22:30:00,9,28,65,10,9,0,0,121
2024-03-11 22:40:00,12,23,12,4,11,0,0,62
2024-03-11 22:50:00,9,31,14,3,8,0,0,65
2024-03-11 23:00:00,6,8,5,2,10,0,0,31
2024-03-11 23:10:00,9,24,11,2,8,0,0,54
2024-03-11 23:20:00,4,10,13,4,10,0,0,41
2024-03-11 23:30:00,5,8,8,5,5,0,0,31
2024-03-11 23:40:00,4,8,8,2,14,0,0,36
2024-03-11 23:50:00,5,11,8,1,3,0,0,28
2024-03-12 00:00:00,4,8,6,5,5,0,0,28
2024-03-12 00:10:00,4,13,4,0,3,0,0,24
2024-03-12 00:20:00,4,10,8,1,3,0,0,26
2024-03-12 00:30:00,6,14,6,1,5,0,0,32
2024-03-12 00:40:00,3,7,18,1,3,0,0,32
2024-03-12 00:50:00,7,3,2,2,5,0,0,19
2024-03-12 01:00:00,1,3,3,1,4,0,0,12
2024-03-12 01:10:00,3,4,2,5,4,0,0,18
2024-03-12 01:20:00,0,5,5,2,1,0,0,13
2024-03-12 01:30:00,1,4,4,0,2,0,0,11
2024-03-12 01:40:00,1,2,3,3,1,0,0,10
2024-03-12 01:50:00,1,3,2,1,4,0,0,11
2024-03-12 02:00:00,1,2,2,1,1,0,0,7
2024-03-12 02:10:00,3,5,0,3,1,0,0,12
2024-03-12 02:20:00,2,9,4,1,3,0,0,19
2024-03-12 02:30:00,4,2,1,2,1,0,0,10
2024-03-12 02:40:00,2,1,2,0,0,0,0,5
2024-03-12 02:50:00,1,2,1,0,0,0,0,4
2024-03-12 03:00:00,2,0,5,3,1,0,0,11
2024-03-12 03:10:00,2,2,0,0,3,0,0,7
2024-03-12 03:20:00,3,1,0,0,2,0,0,6
2024-03-12 03:30:00,1,0,1,0,2,0,0,4
2024-03-12 03:40:00,2,5,0,2,4,0,0,13
2024-03-12 03:50:00,1,3,2,0,1,0,0,7
2024-03-12 04:00:00,0,2,3,3,3,0,0,11
2024-03-12 04:10:00,4,1,5,0,2,0,0,12
2024-03-12 04:20:00,6,3,7,1,5,0,0,22
2024-03-12 04:30:00,3,6,1,2,4,1,0,17
2024-03-12 04:40:00,4,5,2,1,3,0,0,15
2024-03-12 04:50:00,2,8,12,2,3,0,0,27
2024-03-12 05:00:00,4,10,3,3,8,1,0,29
2024-03-12 05:10:00,8,14,10,2,9,0,0,43
2024-03-12 05:20:00,9,11,10,2,12,0,0,44
2024-03-12 05:30:00,13,11,8,8,21,0,0,61
2024-03-12 05:40:00,16,22,14,9,26,0,0,87
2024-03-12 05:50:00,14,16,6,8,42,0,0,86
2024-03-12 06:00:00,11,14,13,9,45,1,0,93
2024-03-12 06:10:00,27,23,17,13,36,0,0,116
2024-03-12 06:20:00,25,29,21,13,46,1,0,135
2024-03-12 06:30:00,16,24,16,8,32,0,0,96
2024-03-12 06:40:00,25,30,19,14,69,1,0,158
2024-03-12 06:50:00,20,27,21,19,54,0,0,141
2024-03-12 07:00:00,36,30,15,17,48,0,0,146
2024-03-12 07:10:00,18,33,34,18,57,1,0,161
2024-03-12 07:20:00,26,45,42,25,73,1,0,212
2024-03-12 07:30:00,20,33,36,19,50,0,0,158
2024-03-12 07:40:00,28,43,29,41,83,1,0,225
2024-03-12 07:50:00,22,47,29,37,64,0,0,199
2024-03-12 08:00:00,27,51,31,29,61,0,0,199
2024-03-12 08:10:00,35,37,35,38,60,1,0,206
2024-03-12 08:20:00,28,56,20,28,41,4,0,177
2024-03-12 08:30:00,21,55,34,36,65,1,0,212
2024-03-12 08:40:00,27,51,24,37,53,0,0,192
2024-03-12 08:50:00,25,52,30,46,64,0,0,217
2024-03-12 09:00:00,33,49,28,31,45,0,0,186
2024-03-12 09:10:00,20,51,18,19,59,1,0,168
2024-03-12 09:20:00,27,32,27,22,44,1,0,153
2024-03-12 09:30:00,25,37,21,25,48,0,0,156
2024-03-12 09:40:00,30,37,33,25,44,1,0,170
2024-03-12 09:50:00,26,39,27,30,62,0,0,184
2024-03-12 10:00:00,30,33,34,18,36,1,0,152
2024-03-12 10:10:00,21,36,28,15,41,0,0,141
2024-03-12 10:20:00,26,41,21,17,34,0,0,139
2024-03-12 10:30:00,29,48,27,16,41,0,0,161
2024-03-12 10:40:00,25,25,24,23,57,0,0,154
2024-03-12 10:50:00,32,36,26,17,45,0,0,156
2024-03-12 11:00:00,32,49,30,18,37,0,0,166
2024-03-12 11:10:00,16,34,22,21,46,0,0,139
2024-03-12 11:20:00,21,44,37,14,36,0,0,152
2024-03-12 11:30:00,34,36,29,22,39,0,0,160
2024-03-12 11:40:00,22,58,35,17,44,0,0,176
2024-03-12 11:50:00,29,37,25,12,31,0,0,134
2024-03-12 12:00:00,20,41,34,21,38,1,0,155
2024-03-12 12:10:00,22,44,36,18,48,0,0,168
2024-03-12 12:20:00,30,36,26,22,45,2,0,161
2024-03-12 12:30:00,35,43,26,10,22,0,0,136
2024-03-12 12:40:00,25,38,24,24,42,0,0,153
2024-03-12 12:50:00,27,41,35,27,51,1,0,182
2024-03-12 13:00:00,34,45,30,18,33,0,0,160
2024-03-12 13:10:00,28,54,31,20,43,1,0,177
2024-03-12 13:20:00,25,42,27,15,50,1,0,160
2024-03-12 13:30:00,20,44,28,11,37,3,0,143
2024-03-12 13:40:00,21,45,27,17,43,0,0,153
2024-03-12 13:50:00,26,35,39,15,46,1,0,162
2024-03-12 14:00:00,31,47,28,20,37,0,0,163
2024-03-12 14:10:00,29,43,37,17,45,1,0,172
2024-03-12 14:20:00,33,46,23,16,40,1,0,159
2024-03-12 14:30:00,27,53,49,22,39,0,0,190
2024-03-12 14:40:00,38,47,76,18,44,0,0,223
2024-03-12 14:50:00,33,40,36,22,51,0,0,182
2024-03-12 15:00:00,41,49,24,13,54,1,0,182
2024-03-12 15:10:00,35,62,36,21,55,2,0,211
2024-03-12 15:20:00,28,55,42,18,65,3,0,211
2024-03-12 15:30:00,30,48,37,22,46,0,0,183
2024-03-12 15:40:00,31,55,18,23,50,3,0,180
2024-03-12 15:50:00,31,53,35,25,52,4,0,200
2024-03-12 16:00:00,29,55,26,25,54,1,0,190
2024-03-12 16:10:00,36,57,37,23,42,3,0,198
2024-03-12 16:20:00,36,167,39,23,51,3,0,319
2024-03-12 16:30:00,14,65,37,26,63,1,0,206
2024-03-12 16:40:00,27,73,32,11,51,0,0,194
2024-03-12 16:50:00,18,53,33,40,49,0,0,193
2024-03-12 17:00:00,26,62,29,31,54,0,0,202
2024-03-12 17:10:00,24,67,35,31,59,1,0,217
2024-03-12 17:20:00,28,53,27,25,67,3,0,203
2024-03-12 17:30:00,30,44,35,20,50,0,0,179
2024-03-12 17:40:00,29,69,30,24,53,1,0,206
2024-03-12 17:50:00,36,46,29,22,49,0,0,182
2024-03-12 18:00:00,28,62,34,27,61,1,0,213
2024-03-12 18:10:00,28,55,45,25,40,1,0,194
2024-03-12 18:20:00,35,34,30,25,49,2,0,175
2024-03-12 18:30:00,20,40,26,20,33,0,0,139
2024-03-12 18:40:00,24,36,16,20,41,0,0,137
2024-03-12 18:50:00,24,22,26,17,29,0,0,118
2024-03-12 19:00:00,16,70,62,18,24,0,0,190
2024-03-12 19:10:00,22,33,35,20,35,0,0,145
2024-03-12 19:20:00,26,24,27,12,35,0,0,124
2024-03-12 19:30:00,24,31,20,12,29,0,0,116
2024-03-12 19:40:00,22,44,26,15,39,0,0,146
2024-03-12 19:50:00,20,26,20,14,34,2,0,116
2024-03-12 20:00:00,17,31,21,12,33,0,0,114
2024-03-12 20:10:00,12,31,25,9,22,0,0,99
2024-03-12 20:20:00,16,30,18,10,29,2,0,105
2024-03-12 20:30:00,15,27,15,13,14,1,0,85
2024-03-12 20:40:00,19,30,20,12,19,0,0,100
2024-03-12 20:50:00,22,15,17,5,16,0,0,75
2024-03-12 21:00:00,12,21,30,13,10,1,0,87
2024-03-12 21:10:00,23,19,16,7,26,0,0,91
2024-03-12 21:20:00,18,20,20,7,19,2,0,86
2024-03-12 21:30:00,13,18,18,7,11,0,0,67
2024-03-12 21:40:00,10,24,15,8,45,0,0,102
2024-03-12 21:50:00,12,13,12,8,19,0,0,64
2024-03-12 22:00:00,20,25,10,4,19,0,0,78
2024-03-12 22:10:00,16,22,17,2,11,0,0,68
2024-03-12 22:20:00,14,24,14,3,12,0,0,67
2024-03-12 22:30:00,9,18,16,8,9,0,0,60
2024-03-12 22:40:00,13,17,34,4,5,0,0,73
2024-03-12 22:50:00,7,14,10,4,10,0,0,45
2024-03-12 23:00:00,8,9,13,10,12,0,0,52
2024-03-12 23:10:00,6,13,15,5,10,1,0,50
2024-03-12 23:20:00,6,13,9,6,5,0,0,39
2024-03-12 23:30:00,4,8,7,3,4,0,0,26
2024-03-12 23:40:00,4,7,29,1,8,0,0,49
2024-03-12 23:50:00,8,6,10,0,5,0,0,29
2024-03-13 00:00:00,2,9,5,2,5,0,0,23
2024-03-13 00:10:00,4,18,6,4,1,0,0,33
2024-03-13 00:20:00,4,3,7,1,3,0,0,18
2024-03-13 00:30:00,1,8,8,0,3,0,0,20
2024-03-13 00:40:00,0,3,57,2,3,0,0,65
2024-03-13 00:50:00,1,1,2,1,3,0,0,8
2024-03-13 01:00:00,5,6,37,2,3,0,0,53
2024-03-13 01:10:00,1,4,1,1,2,0,0,9
2024-03-13 01:20:00,0,2,2,2,3,0,0,9
2024-03-13 01:30:00,4,1,1,1,3,0,0,10
2024-03-13 01:40:00,1,3,2,0,2,0,0,8
2024-03-13 01:50:00,1,1,1,1,0,0,0,4
2024-03-13 02:00:00,0,7,0,0,2,0,0,9
2024-03-13 02:10:00,0,6,3,0,1,0,0,10
2024-03-13 02:20:00,2,4,0,1,4,0,0,11
2024-03-13 02:30:00,1,2,4,1,1,0,0,9
2024-03-13 02:40:00,0,0,1,0,2,0,0,3
2024-03-13 02:50:00,2,1,0,1,0,0,0,4
2024-03-13 03:00:00,1,4,3,0,3,0,0,11
2024-03-13 03:10:00,5,2,2,2,1,0,0,12
2024-03-13 03:20:00,5,1,4,2,3,0,0,15
2024-03-13 03:30:00,0,0,2,0,2,0,0,4
2024-03-13 03:40:00,0,3,2,1,4,0,0,10
2024-03-13 03:50:00,2,2,4,2,1,0,0,11
2024-03-13 04:00:00,5,2,3,2,2,0,0,14
2024-03-13 04:10:00,2,4,6,0,3,0,0,15
2024-03-13 04:20:00,6,3,3,1,8,0,0,21
2024-03-13 04:30:00,6,4,4,1,2,0,0,17
2024-03-13 04:40:00,5,11,4,2,2,0,0,24
2024-03-13 04:50:00,2,11,4,1,4,0,0,22
2024-03-13 05:00:00,3,10,6,5,6,0,0,30
2024-03-13 05:10:00,5,13,10,3,12,0,0,43
2024-03-13 05:20:00,5,15,9,3,13,0,0,45
2024-03-13 05:30:00,9,14,11,8,25,0,0,67
2024-03-13 05:40:00,13,12,12,9,35,0,0,81
2024-03-13 05:50:00,16,11,12,8,45,0,0,92
2024-03-13 06:00:00,17,19,20,8,28,0,0,92
2024-03-13 06:10:00,16,18,15,14,36,0,0,99
2024-03-13 06:20:00,16,30,18,12,45,0,0,121
2024-03-13 06:30:00,19,53,22,11,40,0,0,145
2024-03-13 06:40:00,17,46,21,11,60,0,0,155
2024-03-13 06:50:00,24,35,28,16,55,0,0,158
2024-03-13 07:00:00,26,33,20,11,41,0,0,131
2024-03-13 07:10:00,20,32,31,29,64,1,0,177
2024-03-13 07:20:00,22,43,33,17,77,0,0,192
2024-03-13 07:30:00,24,49,29,28,60,1,0,191
2024-03-13 07:40:00,31,34,24,32,71,1,0,193
2024-03-13 07:50:00,16,40,32,35,70,0,0,193
2024-03-13 08:00:00,27,66,30,23,41,0,0,187
2024-03-13 08:10:00,27,39,27,36,73,1,0,203
2024-03-13 08:20:00,28,43,19,31,59,2,0,182
2024-03-13 08:30:00,31,40,25,15,54,1,0,166
2024-03-13 08:40:00,39,46,37,32,55,0,0,209
2024-03-13 08:50:00,21,52,34,34,50,2,0,193
2024-03-13 09:00:00,27,46,38,33,43,0,0,187
2024-03-13 09:10:00,26,29,27,23,61,1,0,167
2024-03-13 09:20:00,25,30,24,19,39,0,0,137
2024-03-13 09:30:00,22,40,21,17,51,1,0,152
2024-03-13 09:40:00,34,36,30,22,47,1,0,170
2024-03-13 09:50:00,24,40,27,21,30,2,0,144
2024-03-13 10:00:00,23,49,33,13,45,0,0,163
2024-03-13 10:10:00,26,46,28,30,42,0,0,172
2024-03-13 10:20:00,21,52,26,17,44,0,0,160
2024-03-13 10:30:00,22,41,19,14,34,0,0,130
2024-03-13 10:40:00,23,48,28,14,56,0,0,169
2024-03-13 10:50:00,21,59,26,21,30,4,0,161
2024-03-13 11:00:00,26,34,24,19,37,1,0,141
2024-03-13 11:10:00,24,45,24,18,46,0,0,157
2024-03-13 11:20:00,23,42,31,19,28,0,0,143
2024-03-13 11:30:00,31,30,22,12,36,0,0,131
2024-03-13 11:40:00,27,49,25,19,30,1,0,151
2024-03-13 11:50:00,23,36,33,10,37,1,0,140
2024-03-13 12:00:00,32,49,40,20,28,2,0,171
2024-03-13 12:10:00,30,39,39,15,40,1,0,164
2024-03-13 12:20:00,26,55,38,14,37,2,0,172
2024-03-13 12:30:00,28,45,39,16,45,0,0,173
2024-03-13 12:40:00,34,45,31,16,42,0,0,168
2024-03-13 12:50:00,32,33,38,12,42,0,0,157
2024-03-13 13:00:00,31,44,35,17,45,2,0,174
2024-03-13 13:10:00,27,50,22,21,38,1,0,159
2024-03-13 13:20:00,35,44,25,18,33,0,0,155
2024-03-13 13:30:00,29,42,38,16,43,0,0,168
2024-03-13 13:40:00,30,47,37,11,39,1,0,165
2024-03-13 13:50:00,23,35,29,16,51,1,0,155
2024-03-13 14:00:00,29,50,30,13,45,1,0,168
2024-03-13 14:10:00,26,60,27,15,46,1,0,175
2024-03-13 14:20:00,33,44,29,27,39,2,0,174
2024-03-13 14:30:00,34,55,38,13,56,1,0,197
2024-03-13 14:40:00,34,49,34,19,37,0,0,173
2024-03-13 14:50:00,40,52,27,21,52,1,0,193
2024-03-13 15:00:00,27,67,35,13,45,1,0,188
2024-03-13 15:10:00,40,67,33,16,38,0,0,194
2024-03-13 15:20:00,31,36,34,20,60,3,0,184
2024-03-13 15:30:00,39,53,25,20,50,0,0,187
2024-03-13 15:40:00,43,56,36,29,45,3,0,212
2024-03-13 15:50:00,30,59,31,25,55,1,0,201
2024-03-13 16:00:00,32,46,24,27,39,4,0,172
2024-03-13 16:10:00,24,53,43,25,56,2,0,203
2024-03-13 16:20:00,22,54,36,26,38,2,0,178
2024-03-13 16:30:00,25,64,32,27,66,1,0,215
2024-03-13 16:40:00,32,56,20,28,48,1,0,185
2024-03-13 16:50:00,27,65,38,25,52,1,0,208
2024-03-13 17:00:00,33,51,32,22,55,1,0,194
2024-03-13 17:10:00,25,81,21,26,52,1,0,206
2024-03-13 17:20:00,34,49,44,23,55,1,0,206
2024-03-13 17:30:00,34,54,32,27,47,0,0,194
2024-03-13 17:40:00,26,61,37,31,47,3,0,205
2024-03-13 17:50:00,18,62,33,29,61,2,0,205
2024-03-13 18:00:00,27,55,46,40,53,1,0,222
2024-03-13 18:10:00,21,49,34,24,42,0,0,170
2024-03-13 18:20:00,23,51,50,17,39,2,0,182
2024-03-13 18:30:00,31,41,28,19,27,0,0,146
2024-03-13 18:40:00,21,54,26,17,26,1,0,145
2024-03-13 18:50:00,23,19,27,21,33,3,0,126
2024-03-13 19:00:00,25,36,24,19,33,1,0,138
2024-03-13 19:10:00,18,39,31,18,35,0,0,141
2024-03-13 19:20:00,38,43,22,14,32,1,0,150
2024-03-13 19:30:00,24,28,16,13,24,0,0,105
2024-03-13 19:40:00,20,43,30,14,31,1,0,139
2024-03-13 19:50:00,16,37,19,9,41,0,0,122
2024-03-13 20:00:00,19,34,21,11,26,0,0,111
2024-03-13 20:10:00,17,27,26,16,29,0,0,115
2024-03-13 20:20:00,23,22,23,15,24,1,0,108
2024-03-13 20:30:00,17,31,14,6,18,0,0,86
2024-03-13 20:40:00,18,28,20,12,12,0,0,90
2024-03-13 20:50:00,17,28,15,11,22,0,0,93
2024-03-13 21:00:00,12,32,22,13,20,0,0,99
2024-03-13 21:10:00,23,29,33,3,24,0,0,112
2024-03-13 21:20:00,28,21,27,10,17,0,0,103
2024-03-13 21:30:00,17,27,17,7,20,1,0,89
2024-03-13 21:40:00,19,21,22,4,19,0,0,85
2024-03-13 21:50:00,18,11,11,8,14,0,0,62
2024-03-13 22:00:00,16,20,13,12,21,0,0,82
2024-03-13 22:10:00,17,22,14,7,16,0,0,76
2024-03-13 22:20:00,17,25,32,5,16,0,0,95
2024-03-13 22:30:00,20,23,19,5,11,0,0,78
2024-03-13 22:40:00,9,22,18,5,8,0,0,62
2024-03-13 22:50:00,16,16,13,6,12,0,0,63
2024-03-13 23:00:00,8,15,10,2,14,1,0,50
2024-03-13 23:10:00,6,15,16,3,9,0,0,49
2024-03-13 23:20:00,10,5,6,2,8,0,0,31
2024-03-13 23:30:00,13,10,12,9,10,0,0,54
2024-03-13 23:40:00,4,25,13,4,5,0,0,51
2024-03-13 23:50:00,7,1,5,4,6,0,0,23
2024-03-14 00:00:00,6,4,10,3,7,0,0,30
2024-03-14 00:10:00,7,10,12,3,2,1,0,35
2024-03-14 00:20:00,2,8,5,4,1,0,0,20
2024-03-14 00:30:00,5,8,4,5,3,0,0,25
2024-03-14 00:40:00,1,11,5,0,3,0,0,20
2024-03-14 00:50:00,2,4,4,1,1,0,0,12
2024-03-14 01:00:00,5,5,0,1,9,0,0,20
2024-03-14 01:10:00,3,5,0,0,3,0,0,11
2024-03-14 01:20:00,3,6,4,1,7,0,0,21
2024-03-14 01:30:00,2,6,2,1,3,0,0,14
2024-03-14 01:40:00,2,4,3,1,6,0,0,16
2024-03-14 01:50:00,1,2,5,0,0,0,0,8
2024-03-14 02:00:00,0,1,2,0,1,0,0,4
2024-03-14 02:10:00,4,3,2,1,2,0,0,12
2024-03-14 02:20:00,2,1,1,1,3,0,0,8
2024-03-14 02:30:00,1,1,3,1,4,0,0,10
2024-03-14 02:40:00,3,3,3,1,0,0,0,10
2024-03-14 02:50:00,4,1,3,2,2,0,0,12
2024-03-14 03:00:00,4,3,2,1,0,0,0,10
2024-03-14 03:10:00,2,0,1,0,1,0,0,4
2024-03-14 03:20:00,1,2,2,1,2,0,0,8
2024-03-14 03:30:00,1,1,2,0,1,0,0,5
2024-03-14 03:40:00,3,4,3,1,2,0,0,13
2024-03-14 03:50:00,5,4,2,0,6,0,0,17
2024-03-14 04:00:00,3,0,4,1,2,0,0,10
2024-03-14 04:10:00,1,2,4,0,0,0,0,7
2024-03-14 04:20:00,6,2,2,0,6,0,0,16
2024-03-14 04:30:00,2,7,2,3,2,0,0,16
2024-03-14 04:40:00,2,8,35,1,5,0,0,51
2024-03-14 04:50:00,7,7,7,2,7,0,0,30
2024-03-14 05:00:00,6,6,6,5,7,0,0,30
2024-03-14 05:10:00,7,16,13,4,8,0,0,48
2024-03-14 05:20:00,11,13,8,1,10,1,0,44
2024-03-14 05:30:00,11,13,89,9,21,0,0,143
2024-03-14 05:40:00,12,17,20,6,34,0,0,89
2024-03-14 05:50:00,11,21,12,7,41,0,0,92
2024-03-14 06:00:00,18,22,14,11,27,0,0,92
2024-03-14 06:10:00,19,27,20,8,39,0,0,113
2024-03-14 06:20:00,15,28,48,13,31,0,0,135
2024-03-14 06:30:00,21,33,13,7,35,0,0,109
2024-03-14 06:40:00,21,26,22,13,55,0,0,137
2024-03-14 06:50:00,21,41,20,16,61,0,0,159
2024-03-14 07:00:00,29,40,18,17,44,0,0,148
2024-03-14 07:10:00,25,28,23,19,58,0,0,153
2024-03-14 07:20:00,26,190,132,23,70,3,0,444
2024-03-14 07:30:00,24,42,30,21,70,0,0,187
2024-03-14 07:40:00,26,49,30,29,62,0,0,196
2024-03-14 07:50:00,25,36,22,28,59,0,0,170
2024-03-14 08:00:00,24,52,39,42,50,0,0,207
2024-03-14 08:10:00,21,41,32,26,74,1,0,195
2024-03-14 08:20:00,23,22,17,14,51,1,0,128
2024-03-14 08:30:00,38,38,37,25,44,0,0,182
2024-03-14 08:40:00,32,47,25,37,59,0,0,200
2024-03-14 08:50:00,24,47,36,28,65,0,0,200
2024-03-14 09:00:00,19,58,28,19,41,1,0,166
2024-03-14 09:10:00,19,56,17,19,55,0,0,166
2024-03-14 09:20:00,23,41,34,27,44,1,0,170
2024-03-14 09:30:00,19,46,30,25,37,0,0,157
2024-03-14 09:40:00,28,34,37,24,41,0,0,164
2024-03-14 09:50:00,32,44,26,15,41,0,0,158
2024-03-14 10:00:00,19,39,25,19,43,0,0,145
2024-03-14 10:10:00,37,40,27,16,49,0,0,169
2024-03-14 10:20:00,23,38,31,15,39,0,0,146
2024-03-14 10:30:00,17,47,26,24,50,2,0,166
2024-03-14 10:40:00,28,51,28,18,37,0,0,162
2024-03-14 10:50:00,32,43,22,15,36,1,0,149
2024-03-14 11:00:00,27,57,59,17,32,0,0,192
2024-03-14 11:10:00,33,40,30,17,44,0,0,164
2024-03-14 11:20:00,25,124,45,17,37,0,0,248
2024-03-14 11:30:00,34,38,20,11,45,1,0,149
2024-03-14 11:40:00,29,40,40,9,40,0,0,158
2024-03-14 11:50:00,22,31,33,21,49,1,0,157
2024-03-14 12:00:00,28,49,28,35,42,0,0,182
2024-03-14 12:10:00,31,40,37,26,40,0,0,174
2024-03-14 12:20:00,31,36,35,17,36,0,0,155
2024-03-14 12:30:00,31,45,36,12,32,1,0,157
2024-03-14 12:40:00,27,54,35,25,33,1,0,175
2024-03-14 12:50:00,26,32,29,15,46,2,0,150
2024-03-14 13:00:00,31,50,35,22,36,0,0,174
2024-03-14 13:10:00,36,43,18,23,44,0,0,164
2024-03-14 13:20:00,29,53,45,16,49,0,0,192
2024-03-14 13:30:00,26,46,30,13,47,2,0,164
2024-03-14 13:40:00,32,41,83,15,33,0,0,204
2024-03-14 13:50:00,31,47,29,20,46,0,0,173
2024-03-14 14:00:00,27,43,36,15,33,2,0,156
2024-03-14 14:10:00,31,59,40,19,45,13,0,207
2024-03-14 14:20:00,33,55,32,13,39,5,0,177
2024-03-14 14:30:00,36,54,37,21,34,1,0,183
2024-03-14 14:40:00,27,40,35,17,45,1,0,165
2024-03-14 14:50:00,33,54,32,31,52,1,0,203
2024-03-14 15:00:00,31,55,45,23,43,1,0,198
2024-03-14 15:10:00,28,48,31,25,45,4,0,181
2024-03-14 15:20:00,29,144,36,17,40,2,0,268
2024-03-14 15:30:00,31,55,18,29,70,3,0,206
2024-03-14 15:40:00,28,57,36,25,42,2,0,190
2024-03-14 15:50:00,33,57,29,27,53,5,0,204
2024-03-14 16:00:00,34,53,40,29,47,3,0,206
2024-03-14 16:10:00,35,85,28,23,59,3,0,233
2024-03-14 16:20:00,41,61,30,21,66,2,0,221
2024-03-14 16:30:00,38,69,56,15,38,0,0,216
2024-03-14 16:40:00,24,247,66,21,48,0,0,406
2024-03-14 16:50:00,37,60,41,24,68,3,0,233
2024-03-14 17:00:00,36,56,38,20,42,1,0,193
2024-03-14 17:10:00,24,39,28,23,50,2,0,166
2024-03-14 17:20:00,33,59,33,18,73,4,0,220
2024-03-14 17:30:00,22,43,40,25,40,0,0,170
2024-03-14 17:40:00,31,92,37,31,53,2,0,246
2024-03-14 17:50:00,32,47,33,36,53,1,0,202
2024-03-14 18:00:00,28,49,28,20,37,2,0,164
2024-03-14 18:10:00,11,19,15,5,19,0,0,69
2024-03-14 18:20:00,14,18,20,6,23,0,0,81
2024-03-14 18:30:00,31,51,30,26,40,0,0,178
2024-03-14 18:40:00,38,40,27,11,35,0,0,151
2024-03-14 18:50:00,23,23,28,14,33,1,0,122
2024-03-14 19:00:00,26,28,26,15,34,0,0,129
2024-03-14 19:10:00,19,39,27,20,35,0,0,140
2024-03-14 19:20:00,26,36,71,14,38,0,0,185
2024-03-14 19:30:00,26,38,18,11,36,0,0,129
2024-03-14 19:40:00,16,41,38,14,26,1,0,136
2024-03-14 19:50:00,20,25,22,13,35,1,0,116
2024-03-14 20:00:00,22,44,30,13,28,0,0,137
2024-03-14 20:10:00,30,37,17,12,31,0,0,127
2024-03-14 20:20:00,23,27,23,10,24,1,0,108
2024-03-14 20:30:00,14,14,16,9,20,0,0,73
2024-03-14 20:40:00,13,28,60,13,18,0,0,132
2024-03-14 20:50:00,16,19,19,7,21,2,0,84
2024-03-14 21:00:00,24,23,23,5,21,1,0,97
2024-03-14 21:10:00,20,28,16,9,23,0,0,96
2024-03-14 21:20:00,29,19,19,12,17,2,0,98
2024-03-14 21:30:00,22,27,18,12,24,1,0,104
2024-03-14 21:40:00,17,32,53,6,17,0,0,125
2024-03-14 21:50:00,18,10,18,7,26,1,0,80
2024-03-14 22:00:00,26,25,26,6,27,0,0,110
2024-03-14 22:10:00,13,16,20,9,20,0,0,78
2024-03-14 22:20:00,13,20,54,9,20,0,0,116
2024-03-14 22:30:00,10,157,140,6,17,0,0,330
2024-03-14 22:40:00,17,29,16,10,17,0,0,89
2024-03-14 22:50:00,15,15,6,3,13,0,0,52
2024-03-14 23:00:00,8,11,14,3,9,0,0,45
2024-03-14 23:10:00,9,21,20,6,11,0,0,67
2024-03-14 23:20:00,10,17,35,2,14,1,0,79
2024-03-14 23:30:00,5,17,9,8,9,0,0,48
2024-03-14 23:40:00,4,22,14,2,8,0,0,50
2024-03-14 23:50:00,8,8,6,3,6,0,0,31
2024-03-15 00:00:00,4,9,4,5,7,0,0,29
2024-03-15 00:10:00,4,11,14,3,4,0,0,36
2024-03-15 00:20:00,7,4,4,6,4,0,0,25
2024-03-15 00:30:00,6,11,2,3,4,0,0,26
2024-03-15 00:40:00,3,7,8,2,4,0,0,24
2024-03-15 00:50:00,5,2,3,1,4,0,0,15
2024-03-15 01:00:00,4,11,7,4,1,0,0,27
2024-03-15 01:10:00,3,6,8,0,4,0,0,21
2024-03-15 01:20:00,2,6,5,2,3,0,0,18
2024-03-15 01:30:00,2,0,5,1,4,0,0,12
2024-03-15 01:40:00,3,5,3,1,2,0,0,14
2024-03-15 01:50:00,2,5,3,1,4,0,0,15
2024-03-15 02:00:00,0,3,4,2,2,0,0,11
2024-03-15 02:10:00,1,5,4,3,5,0,0,18
2024-03-15 02:20:00,3,2,1,2,2,0,0,10
2024-03-15 02:30:00,2,2,4,2,2,0,0,12
2024-03-15 02:40:00,1,2,1,0,1,0,0,5
2024-03-15 02:50:00,4,3,1,0,0,0,0,8
2024-03-15 03:00:00,3,0,0,0,1,0,0,4
2024-03-15 03:10:00,1,1,2,0,1,0,0,5
2024-03-15 03:20:00,2,0,3,1,1,0,0,7
2024-03-15 03:30:00,3,2,1,0,2,0,0,8
2024-03-15 03:40:00,3,1,0,2,3,0,0,9
2024-03-15 03:50:00,4,6,5,2,1,0,0,18
2024-03-15 04:00:00,4,1,1,1,2,0,0,9
2024-03-15 04:10:00,2,5,9,0,3,0,0,19
2024-03-15 04:20:00,5,4,3,0,4,0,0,16
2024-03-15 04:30:00,1,3,5,1,2,0,0,12
2024-03-15 04:40:00,6,7,17,0,5,1,0,36
2024-03-15 04:50:00,4,6,7,3,2,0,0,22
2024-03-15 05:00:00,7,5,6,3,11,0,0,32
2024-03-15 05:10:00,10,15,16,3,8,0,0,52
2024-03-15 05:20:00,5,17,7,1,13,0,0,43
2024-03-15 05:30:00,10,15,4,4,21,0,0,54
2024-03-15 05:40:00,11,12,27,8,28,0,0,86
2024-03-15 05:50:00,17,6,8,7,34,0,0,72
2024-03-15 06:00:00,11,26,17,4,40,0,0,98
2024-03-15 06:10:00,16,24,19,9,24,1,0,93
2024-03-15 06:20:00,20,18,16,6,40,0,0,100
2024-03-15 06:30:00,17,22,14,6,37,0,0,96
2024-03-15 06:40:00,15,28,21,14,47,0,0,125
2024-03-15 06:50:00,24,40,17,10,58,0,0,149
2024-03-15 07:00:00,28,39,22,18,47,0,0,154
2024-03-15 07:10:00,26,30,22,13,62,1,0,154
2024-03-15 07:20:00,23,45,39,21,52,0,0,180
2024-03-15 07:30:00,23,29,21,26,61,0,0,160
2024-03-15 07:40:00,33,35,23,32,68,1,0,192
2024-03-15 07:50:00,29,47,29,29,47,1,0,182
2024-03-15 08:00:00,33,47,28,20,62,1,0,191
2024-03-15 08:10:00,17,42,34,30,50,1,0,174
2024-03-15 08:20:00,31,41,28,28,52,1,0,181
2024-03-15 08:30:00,15,41,37,24,35,1,0,153
2024-03-15 08:40:00,24,37,30,28,49,0,0,168
2024-03-15 08:50:00,22,40,30,29,50,1,0,172
2024-03-15 09:00:00,22,50,33,22,33,0,0,160
2024-03-15 09:10:00,22,32,24,28,38,0,0,144
2024-03-15 09:20:00,22,47,26,13,36,0,0,144
2024-03-15 09:30:00,26,43,26,20,50,0,0,165
2024-03-15 09:40:00,29,45,128,15,37,0,0,254
2024-03-15 09:50:00,25,44,28,17,51,1,0,166
2024-03-15 10:00:00,27,61,25,26,36,1,0,176
2024-03-15 10:10:00,20,35,28,20,29,1,0,133
2024-03-15 10:20:00,19,45,19,22,36,1,0,142
2024-03-15 10:30:00,32,48,34,11,46,0,0,171
2024-03-15 10:40:00,19,53,24,18,47,1,0,162
2024-03-15 10:50:00,29,47,30,18,47,0,0,171
2024-03-15 11:00:00,22,38,23,17,38,2,0,140
2024-03-15 11:10:00,29,43,26,22,43,0,0,163
2024-03-15 11:20:00,30,32,32,15,51,1,0,161
2024-03-15 11:30:00,22,45,37,18,30,0,0,152
2024-03-15 11:40:00,32,53,23,21,46,0,0,175
2024-03-15 11:50:00,32,49,26,20,39,1,0,167
2024-03-15 12:00:00,32,51,62,26,38,0,0,209
2024-03-15 12:10:00,31,53,31,42,50,0,0,207
2024-03-15 12:20:00,32,60,27,13,54,0,0,186
2024-03-15 12:30:00,24,49,35,16,32,2,0,158
2024-03-15 12:40:00,27,49,32,27,54,0,0,189
2024-03-15 12:50:00,23,53,48,27,33,2,0,186
2024-03-15 13:00:00,24,57,43,22,31,1,0,178
2024-03-15 13:10:00,26,62,39,23,43,1,0,194
2024-03-15 13:20:00,23,56,33,27,54,1,0,194
2024-03-15 13:30:00,29,37,29,16,60,4,0,175
2024-03-15 13:40:00,29,45,38,25,39,0,0,176
2024-03-15 13:50:00,31,33,39,27,33,3,0,166
2024-03-15 14:00:00,23,42,39,20,38,0,0,162
2024-03-15 14:10:00,22,56,29,23,40,0,0,170
2024-03-15 14:20:00,31,57,41,19,45,2,0,195
2024-03-15 14:30:00,37,70,40,27,54,0,0,228
2024-03-15 14:40:00,41,58,23,29,45,1,0,197
2024-03-15 14:50:00,36,53,33,28,45,1,0,196
2024-03-15 15:00:00,33,48,37,26,43,2,0,189
2024-03-15 15:10:00,35,51,30,18,35,1,0,170
2024-03-15 15:20:00,24,71,94,24,52,3,0,268
2024-03-15 15:30:00,34,46,27,22,35,2,0,166
2024-03-15 15:40:00,32,65,27,25,42,0,0,191
2024-03-15 15:50:00,44,58,31,17,48,2,0,200
2024-03-15 16:00:00,29,71,93,22,46,1,0,262
2024-03-15 16:10:00,24,50,39,17,54,3,0,187
2024-03-15 16:20:00,25,59,39,25,37,3,0,188
2024-03-15 16:30:00,32,63,27,17,49,1,0,189
2024-03-15 16:40:00,26,69,29,22,33,1,0,180
2024-03-15 16:50:00,27,41,25,28,55,2,0,178
2024-03-15 17:00:00,24,57,87,29,32,2,0,231
2024-03-15 17:10:00,28,59,37,19,38,9,0,190
2024-03-15 17:20:00,20,47,32,22,45,1,0,167
2024-03-15 17:30:00,19,45,25,27,42,0,0,158
2024-03-15 17:40:00,23,62,21,21,39,0,0,166
2024-03-15 17:50:00,26,44,32,18,56,1,0,177
2024-03-15 18:00:00,31,68,34,19,31,0,0,183
2024-03-15 18:10:00,19,88,37,27,43,1,0,215
2024-03-15 18:20:00,26,55,21,31,46,0,0,179
2024-03-15 18:30:00,26,62,23,12,46,1,0,170
2024-03-15 18:40:00,22,45,30,21,35,1,0,154
2024-03-15 18:50:00,19,25,32,14,29,0,0,119
2024-03-15 19:00:00,18,34,21,19,34,0,0,126
2024-03-15 19:10:00,21,35,27,28,18,1,0,130
2024-03-15 19:20:00,30,22,39,7,18,0,0,116
2024-03-15 19:30:00,22,36,17,12,35,1,0,123
2024-03-15 19:40:00,24,32,32,19,32,0,0,139
2024-03-15 19:50:00,14,41,25,14,41,0,0,135
2024-03-15 20:00:00,16,47,45,12,32,0,0,152
2024-03-15 20:10:00,18,31,23,11,25,0,0,108
2024-03-15 20:20:00,18,29,38,16,30,3,0,134
2024-03-15 20:30:00,10,22,16,14,16,0,0,78
2024-03-15 20:40:00,15,29,22,14,10,0,0,90
2024-03-15 20:50:00,20,33,22,16,25,0,0,116
2024-03-15 21:00:00,16,23,79,12,19,0,0,149
2024-03-15 21:10:00,20,45,16,16,19,0,0,116
2024-03-15 21:20:00,20,22,25,14,19,0,0,100
2024-03-15 21:30:00,17,24,24,13,31,2,0,111
2024-03-15 21:40:00,13,49,46,10,25,3,0,146
2024-03-15 21:50:00,20,20,27,7,17,1,0,92
2024-03-15 22:00:00,19,23,31,9,16,1,0,99
2024-03-15 22:10:00,15,23,21,7,17,1,0,84
2024-03-15 22:20:00,18,32,21,10,20,0,0,101
2024-03-15 22:30:00,14,33,18,13,23,1,0,102
2024-03-15 22:40:00,15,56,42,12,13,0,0,138
2024-03-15 22:50:00,15,23,34,5,16,0,0,93
2024-03-15 23:00:00,18,27,15,6,13,1,0,80
2024-03-15 23:10:00,12,23,20,6,8,0,0,69
2024-03-15 23:20:00,11,15,22,3,13,0,0,64
2024-03-15 23:30:00,3,26,10,8,7,0,0,54
2024-03-15 23:40:00,7,20,22,4,7,0,0,60
2024-03-15 23:50:00,10,14,46,2,14,0,0,86
2024-03-16 00:00:00,13,20,12,6,14,0,0,65
2024-03-16 00:10:00,9,24,16,2,8,0,0,59
2024-03-16 00:20:00,5,9,8,2,8,1,0,33
2024-03-16 00:30:00,9,16,12,5,9,0,0,51
2024-03-16 00:40:00,6,23,59,0,15,0,0,103
2024-03-16 00:50:00,11,7,4,2,8,0,0,32
2024-03-16 01:00:00,11,5,7,4,5,0,0,32
2024-03-16 01:10:00,5,13,15,0,9,0,0,42
2024-03-16 01:20:00,7,8,8,2,5,0,0,30
2024-03-16 01:30:00,6,9,2,4,7,0,0,28
2024-03-16 01:40:00,3,11,26,2,4,0,0,46
2024-03-16 01:50:00,5,7,5,1,4,0,0,22
2024-03-16 02:00:00,4,10,5,4,4,0,0,27
2024-03-16 02:10:00,5,8,8,0,4,0,0,25
2024-03-16 02:20:00,3,2,7,1,6,0,0,19
2024-03-16 02:30:00,5,4,8,1,7,0,0,25
2024-03-16 02:40:00,1,6,121,1,6,0,0,135
2024-03-16 02:50:00,4,4,3,1,0,0,0,12
2024-03-16 03:00:00,5,2,4,3,3,0,0,17
2024-03-16 03:10:00,3,4,5,3,4,0,0,19
2024-03-16 03:20:00,3,4,2,0,2,0,0,11
2024-03-16 03:30:00,2,5,3,2,4,0,0,16
2024-03-16 03:40:00,3,4,6,1,4,0,0,18
2024-03-16 03:50:00,7,6,2,3,3,0,0,21
2024-03-16 04:00:00,1,1,3,1,5,0,0,11
2024-03-16 04:10:00,3,4,9,2,4,0,0,22
2024-03-16 04:20:00,4,5,5,0,4,0,0,18
2024-03-16 04:30:00,2,7,3,1,5,0,0,18
2024-03-16 04:40:00,1,15,4,3,5,0,0,28
2024-03-16 04:50:00,4,2,0,2,3,1,0,12
2024-03-16 05:00:00,7,0,7,3,7,0,0,24
2024-03-16 05:10:00,5,7,23,3,8,0,0,46
2024-03-16 05:20:00,5,9,8,7,6,0,0,35
2024-03-16 05:30:00,3,8,4,2,7,0,0,24
2024-03-16 05:40:00,3,8,20,3,9,1,0,44
2024-03-16 05:50:00,9,5,7,1,4,0,0,26
2024-03-16 06:00:00,3,11,21,0,8,0,0,43
2024-03-16 06:10:00,7,14,8,5,7,0,0,41
2024-03-16 06:20:00,8,19,10,1,13,0,0,51
2024-03-16 06:30:00,7,9,4,1,12,0,0,33
2024-03-16 06:40:00,8,5,20,6,9,0,0,48
2024-03-16 06:50:00,3,10,8,3,10,0,0,34
2024-03-16 07:00:00,6,11,21,2,7,0,0,47
2024-03-16 07:10:00,4,11,6,7,7,0,0,35
2024-03-16 07:20:00,5,6,13,4,7,0,0,35
2024-03-16 07:30:00,14,7,69,3,21,0,0,114
2024-03-16 07:40:00,7,13,17,8,15,0,0,60
2024-03-16 07:50:00,5,12,15,9,21,0,0,62
2024-03-16 08:00:00,9,6,12,7,9,0,0,43
2024-03-16 08:10:00,6,19,12,9,11,0,0,57
2024-03-16 08:20:00,14,13,20,14,11,0,0,72
2024-03-16 08:30:00,10,20,14,8,20,0,0,72
2024-03-16 08:40:00,17,25,32,8,20,0,0,102
2024-03-16 08:50:00,15,26,13,14,16,0,0,84
2024-03-16 09:00:00,10,42,14,9,13,0,0,88
2024-03-16 09:10:00,13,23,16,13,18,0,0,83
2024-03-16 09:20:00,14,36,18,18,25,0,0,111
2024-03-16 09:30:00,14,43,20,12,30,1,0,120
2024-03-16 09:40:00,17,37,30,13,39,0,0,136
2024-03-16 09:50:00,14,52,28,19,36,0,0,149
2024-03-16 10:00:00,13,41,15,13,26,1,0,109
2024-03-16 10:10:00,13,45,40,15,41,0,0,154
2024-03-16 10:20:00,17,43,20,18,33,4,0,135
2024-03-16 10:30:00,21,57,46,12,26,0,0,162
2024-03-16 10:40:00,20,37,33,21,29,1,0,141
2024-03-16 10:50:00,16,48,17,16,34,0,0,131
2024-03-16 11:00:00,18,50,23,14,29,0,0,134
2024-03-16 11:10:00,20,43,28,13,28,0,0,132
2024-03-16 11:20:00,19,37,30,22,28,0,0,136
2024-03-16 11:30:00,17,54,33,23,37,1,0,165
2024-03-16 11:40:00,20,53,24,13,26,0,0,136
2024-03-16 11:50:00,18,33,31,13,32,1,0,128
2024-03-16 12:00:00,24,38,23,10,34,1,0,130
2024-03-16 12:10:00,20,43,29,17,34,0,0,143
2024-03-16 12:20:00,19,51,24,13,33,1,0,141
2024-03-16 12:30:00,15,46,25,15,38,0,0,139
2024-03-16 12:40:00,17,47,39,17,45,1,0,166
2024-03-16 12:50:00,14,37,51,17,36,1,0,156
2024-03-16 13:00:00,22,41,26,13,40,1,0,143
2024-03-16 13:10:00,22,45,93,13,38,0,0,211
2024-03-16 13:20:00,18,46,26,14,38,0,0,142
2024-03-16 13:30:00,24,43,30,19,36,0,0,152
2024-03-16 13:40:00,21,56,27,21,50,2,0,177
2024-03-16 13:50:00,17,43,32,19,34,3,0,148
2024-03-16 14:00:00,19,55,34,18,33,1,0,160
2024-03-16 14:10:00,21,53,30,19,36,1,0,160
2024-03-16 14:20:00,22,39,21,17,32,0,0,131
2024-03-16 14:30:00,26,54,28,13,41,4,0,166
2024-03-16 14:40:00,18,44,181,17,37,1,0,298
2024-03-16 14:50:00,22,45,25,13,37,1,0,143
2024-03-16 15:00:00,19,44,24,10,34,1,0,132
2024-03-16 15:10:00,20,46,25,15,33,0,0,139
2024-03-16 15:20:00,24,34,25,16,25,0,0,124
2024-03-16 15:30:00,19,30,28,10,25,0,0,112
2024-03-16 15:40:00,18,31,17,13,30,1,0,110
2024-03-16 15:50:00,0,30,32,23,31,0,0,116
2024-03-16 16:00:00,9,47,23,19,39,1,0,138
2024-03-16 16:10:00,16,41,44,11,29,2,0,143
2024-03-16 16:20:00,25,42,23,16,30,0,0,136
2024-03-16 16:30:00,28,55,31,16,21,1,0,152
2024-03-16 16:40:00,26,56,28,19,28,1,0,158
2024-03-16 16:50:00,23,31,30,13,32,0,0,129
2024-03-16 17:00:00,28,30,24,19,38,2,0,141
2024-03-16 17:10:00,18,52,26,16,26,0,0,138
2024-03-16 17:20:00,24,60,24,11,26,1,0,146
2024-03-16 17:30:00,22,53,29,12,32,0,0,148
2024-03-16 17:40:00,22,40,30,12,30,1,0,135
2024-03-16 17:50:00,30,45,29,15,26,0,0,145
2024-03-16 18:00:00,26,46,35,12,31,2,0,152
2024-03-16 18:10:00,23,40,23,17,31,2,0,136
2024-03-16 18:20:00,29,33,59,12,35,1,0,169
2024-03-16 18:30:00,21,31,40,8,41,1,0,142
2024-03-16 18:40:00,32,45,25,9,35,0,0,146
2024-03-16 18:50:00,22,19,24,12,33,0,0,110
2024-03-16 19:00:00,16,31,22,15,25,1,0,110
2024-03-16 19:10:00,22,27,14,20,28,0,0,111
2024-03-16 19:20:00,25,51,57,16,31,0,0,180
2024-03-16 19:30:00,11,35,48,12,23,1,0,130
2024-03-16 19:40:00,18,32,23,17,25,1,0,116
2024-03-16 19:50:00,12,29,29,11,29,0,0,110
2024-03-16 20:00:00,23,34,17,7,41,0,0,122
2024-03-16 20:10:00,17,28,39,9,20,1,0,114
2024-03-16 20:20:00,10,26,24,10,18,0,0,88
2024-03-16 20:30:00,9,31,27,11,21,1,0,100
2024-03-16 20:40:00,12,27,22,11,14,0,0,86
2024-03-16 20:50:00,11,24,24,6,24,0,0,89
2024-03-16 21:00:00,16,24,21,8,23,1,0,93
2024-03-16 21:10:00,17,23,101,14,17,0,0,172
2024-03-16 21:20:00,17,21,22,8,12,0,0,80
2024-03-16 21:30:00,12,22,19,11,15,0,0,79
2024-03-16 21:40:00,20,25,17,10,18,0,0,90
2024-03-16 21:50:00,19,16,24,13,20,0,0,92
2024-03-16 22:00:00,14,19,21,12,17,0,0,83
2024-03-16 22:10:00,9,14,17,6,14,0,0,60
2024-03-16 22:20:00,10,18,15,8,14,1,0,66
2024-03-16 22:30:00,12,22,14,9,17,1,0,75
2024-03-16 22:40:00,12,25,16,7,22,0,0,82
2024-03-16 22:50:00,10,15,16,10,12,0,0,63
2024-03-16 23:00:00,10,28,14,6,10,1,0,69
2024-03-16 23:10:00,9,55,23,5,15,0,0,107
2024-03-16 23:20:00,15,15,11,4,13,0,0,58
2024-03-16 23:30:00,4,17,13,5,13,0,0,52
2024-03-16 23:40:00,5,36,33,3,12,0,0,89
2024-03-16 23:50:00,6,17,14,3,11,0,0,51
2024-03-17 00:00:00,5,23,7,4,14,0,0,53
2024-03-17 00:10:00,8,11,14,5,22,0,0,60
2024-03-17 00:20:00,8,9,16,2,6,0,0,41
2024-03-17 00:30:00,12,15,11,2,15,0,0,55
2024-03-17 00:40:00,10,23,12,9,10,0,0,64
2024-03-17 00:50:00,5,8,11,3,6,1,0,34
2024-03-17 01:00:00,8,15,7,6,3,0,0,39
2024-03-17 01:10:00,9,14,14,1,8,0,0,46
2024-03-17 01:20:00,8,6,8,2,8,0,0,32
2024-03-17 01:30:00,5,9,11,5,16,0,0,46
2024-03-17 01:40:00,4,9,26,6,9,0,0,54
2024-03-17 01:50:00,4,11,9,2,1,0,0,27
2024-03-17 02:00:00,3,6,6,0,2,0,0,17
2024-03-17 02:10:00,9,7,9,1,6,0,0,32
2024-03-17 02:20:00,4,4,4,0,6,0,0,18
2024-03-17 02:30:00,5,9,5,2,3,0,0,24
2024-03-17 02:40:00,0,12,3,2,3,0,0,20
2024-03-17 02:50:00,1,6,3,1,3,0,0,14
2024-03-17 03:00:00,4,4,3,1,4,0,0,16
2024-03-17 03:10:00,2,4,8,2,3,0,0,19
2024-03-17 03:20:00,3,4,4,1,6,0,0,18
2024-03-17 03:30:00,4,4,7,4,3,0,0,22
2024-03-17 03:40:00,2,9,35,2,2,0,0,50
2024-03-17 03:50:00,3,2,3,2,1,0,0,11
2024-03-17 04:00:00,0,1,3,2,0,0,0,6
2024-03-17 04:10:00,2,2,2,3,2,0,0,11
2024-03-17 04:20:00,1,4,5,1,3,0,0,14
2024-03-17 04:30:00,3,8,1,5,1,0,0,18
2024-03-17 04:40:00,3,13,32,2,2,0,0,52
2024-03-17 04:50:00,2,10,4,1,3,0,0,20
2024-03-17 05:00:00,2,1,5,1,6,0,0,15
2024-03-17 05:10:00,5,10,3,4,2,0,0,24
2024-03-17 05:20:00,2,2,6,1,9,0,0,20
2024-03-17 05:30:00,5,8,2,3,5,0,0,23
2024-03-17 05:40:00,3,9,17,1,10,0,0,40
2024-03-17 05:50:00,4,1,3,2,5,1,0,16
2024-03-17 06:00:00,9,4,4,2,5,0,0,24
2024-03-17 06:10:00,4,6,4,3,6,0,0,23
2024-03-17 06:20:00,1,21,7,1,3,0,0,33
2024-03-17 06:30:00,3,6,3,2,6,0,0,20
2024-03-17 06:40:00,6,10,14,6,3,0,0,39
2024-03-17 06:50:00,7,0,5,2,3,0,0,17
2024-03-17 07:00:00,4,5,8,4,1,0,0,22
2024-03-17 07:10:00,3,8,3,2,5,0,0,21
2024-03-17 07:20:00,2,6,5,1,7,0,0,21
2024-03-17 07:30:00,2,9,3,2,13,0,0,29
2024-03-17 07:40:00,5,4,14,3,12,0,0,38
2024-03-17 07:50:00,4,3,8,6,4,2,0,27
2024-03-17 08:00:00,3,7,5,2,10,0,0,27
2024-03-17 08:10:00,5,6,7,6,5,0,0,29
2024-03-17 08:20:00,11,6,9,4,7,0,0,37
2024-03-17 08:30:00,8,9,5,7,9,0,0,38
2024-03-17 08:40:00,15,12,134,3,10,0,0,174
2024-03-17 08:50:00,9,10,6,4,11,0,0,40
2024-03-17 09:00:00,8,6,14,6,14,0,0,48
2024-03-17 09:10:00,8,15,10,5,9,1,0,48
2024-03-17 09:20:00,13,16,86,5,18,0,0,138
2024-03-17 09:30:00,5,16,73,11,24,0,0,129
2024-03-17 09:40:00,14,15,14,6,22,1,0,72
2024-03-17 09:50:00,12,24,19,12,19,0,0,86
2024-03-17 10:00:00,17,17,19,10,20,0,0,83
2024-03-17 10:10:00,17,16,10,3,24,1,0,71
2024-03-17 10:20:00,17,15,14,4,27,1,0,78
2024-03-17 10:30:00,13,13,56,9,25,1,0,117
2024-03-17 10:40:00,13,35,28,9,22,0,0,107
2024-03-17 10:50:00,10,17,10,6,32,0,0,75
2024-03-17 11:00:00,17,23,10,9,40,0,0,99
2024-03-17 11:10:00,15,31,107,9,28,2,0,192
2024-03-17 11:20:00,16,22,26,7,16,1,0,88
2024-03-17 11:30:00,17,35,18,4,33,0,0,107
2024-03-17 11:40:00,20,20,28,9,30,0,0,107
2024-03-17 11:50:00,14,15,18,7,40,0,0,94
2024-03-17 12:00:00,17,20,27,12,41,0,0,117
2024-03-17 12:10:00,17,36,47,22,36,1,0,159
2024-03-17 12:20:00,26,29,26,9,44,2,0,136
2024-03-17 12:30:00,23,29,19,4,35,0,0,110
2024-03-17 12:40:00,24,50,25,17,31,2,0,149
2024-03-17 12:50:00,20,28,21,11,36,1,0,117
2024-03-17 13:00:00,28,19,21,12,34,0,0,114
2024-03-17 13:10:00,23,35,27,13,27,3,0,128
2024-03-17 13:20:00,16,42,23,10,30,0,0,121
2024-03-17 13:30:00,29,34,23,14,43,0,0,143
2024-03-17 13:40:00,15,34,24,19,34,1,0,127
2024-03-17 13:50:00,20,57,33,14,40,0,0,164
2024-03-17 14:00:00,27,30,24,17,30,0,0,128
2024-03-17 14:10:00,17,24,23,18,26,3,0,111
2024-03-17 14:20:00,20,31,29,15,30,3,0,128
2024-03-17 14:30:00,22,40,25,16,32,0,0,135
2024-03-17 14:40:00,21,32,34,10,36,0,0,133
2024-03-17 14:50:00,22,32,31,17,30,0,0,132
2024-03-17 15:00:00,25,26,21,19,41,1,0,133
2024-03-17 15:10:00,15,39,25,13,32,0,0,124
2024-03-17 15:20:00,22,31,24,7,48,0,0,132
2024-03-17 15:30:00,20,23,27,14,33,0,0,117
2024-03-17 15:40:00,15,91,127,21,33,0,0,287
2024-03-17 15:50:00,14,35,19,12,29,2,0,111
2024-03-17 16:00:00,19,46,18,12,21,0,0,116
2024-03-17 16:10:00,15,43,29,11,29,2,0,129
2024-03-17 16:20:00,22,50,27,12,29,2,0,142
2024-03-17 16:30:00,15,40,75,20,35,0,0,185
2024-03-17 16:40:00,22,39,28,15,29,2,0,135
2024-03-17 16:50:00,19,30,34,13,32,3,0,131
2024-03-17 17:00:00,20,41,19,18,29,0,0,127
2024-03-17 17:10:00,18,29,23,22,35,0,0,127
2024-03-17 17:20:00,23,28,44,17,31,1,0,144
2024-03-17 17:30:00,23,29,30,17,34,0,0,133
2024-03-17 17:40:00,17,30,21,14,51,0,0,133
2024-03-17 17:50:00,28,22,24,21,40,2,0,137
2024-03-17 18:00:00,20,40,21,7,40,1,0,129
2024-03-17 18:10:00,25,31,30,15,35,0,0,136
2024-03-17 18:20:00,26,53,35,22,33,0,0,169
2024-03-17 18:30:00,25,22,20,9,26,0,0,102
2024-03-17 18:40:00,17,43,19,10,26,0,0,115
2024-03-17 18:50:00,13,28,15,11,30,0,0,97
2024-03-17 19:00:00,15,29,17,6,18,0,0,85
2024-03-17 19:10:00,16,23,45,14,26,1,0,125
2024-03-17 19:20:00,15,19,18,15,32,2,0,101
2024-03-17 19:30:00,13,26,14,7,27,0,0,87
2024-03-17 19:40:00,16,27,15,14,34,0,0,106
2024-03-17 19:50:00,18,29,21,13,36,0,0,117
2024-03-17 20:00:00,12,83,238,9,25,0,0,367
2024-03-17 20:10:00,9,35,18,7,22,2,0,93
2024-03-17 20:20:00,14,21,18,6,19,0,0,78
2024-03-17 20:30:00,23,37,13,8,25,1,0,107
2024-03-17 20:40:00,16,17,14,6,17,0,0,70
2024-03-17 20:50:00,15,21,38,11,20,0,0,105
2024-03-17 21:00:00,23,12,14,5,16,1,0,71
2024-03-17 21:10:00,13,31,14,9,13,1,0,81
2024-03-17 21:20:00,20,20,24,5,14,0,0,83
2024-03-17 21:30:00,18,22,22,11,14,0,0,87
2024-03-17 21:40:00,20,18,61,3,7,0,0,109
2024-03-17 21:50:00,18,12,12,3,7,0,0,52
2024-03-17 22:00:00,11,15,9,2,11,0,0,48
2024-03-17 22:10:00,13,17,11,8,7,0,0,56
2024-03-17 22:20:00,14,21,15,2,15,0,0,67
2024-03-17 22:30:00,8,15,9,4,15,1,0,52
2024-03-17 22:40:00,8,17,18,5,10,1,0,59
2024-03-17 22:50:00,5,6,14,2,6,0,0,33
2024-03-17 23:00:00,12,12,9,4,11,0,0,48
2024-03-17 23:10:00,9,23,13,2,7,0,0,54
2024-03-17 23:20:00,6,9,6,2,10,0,0,33
2024-03-17 23:30:00,7,5,11,4,9,0,0,36
2024-03-17 23:40:00,6,16,26,4,6,0,0,58
2024-03-17 23:50:00,3,7,8,1,1,0,0,20
2024-03-18 00:00:00,3,7,5,3,4,0,0,22
2024-03-18 00:10:00,3,7,7,1,6,0,0,24
2024-03-18 00:20:00,5,1,6,2,5,0,0,19
2024-03-18 00:30:00,1,13,2,3,5,0,0,24
2024-03-18 00:40:00,9,11,11,0,2,0,0,33
2024-03-18 00:50:00,3,2,3,0,8,0,0,16
2024-03-18 01:00:00,4,1,4,5,0,0,0,14
2024-03-18 01:10:00,2,4,4,3,5,0,0,18
2024-03-18 01:20:00,2,4,4,0,1,0,0,11
2024-03-18 01:30:00,1,4,1,3,3,0,0,12
2024-03-18 01:40:00,2,1,0,1,1,0,0,5
2024-03-18 01:50:00,1,2,2,0,0,0,0,5
2024-03-18 02:00:00,1,3,4,1,1,0,0,10
2024-03-18 02:10:00,3,3,1,3,1,0,0,11
2024-03-18 02:20:00,5,2,2,3,3,0,0,15
2024-03-18 02:30:00,0,1,3,0,3,0,0,7
2024-03-18 02:40:00,2,2,0,0,2,0,0,6
2024-03-18 02:50:00,2,1,7,0,0,0,0,10
2024-03-18 03:00:00,4,4,5,0,2,0,0,15
2024-03-18 03:10:00,1,0,0,0,0,0,0,1
2024-03-18 03:20:00,3,1,0,0,2,0,0,6
2024-03-18 03:30:00,1,5,3,0,2,0,0,11
2024-03-18 03:40:00,2,1,2,2,3,0,0,10
2024-03-18 03:50:00,3,11,1,0,2,0,0,17
2024-03-18 04:00:00,1,1,1,1,1,0,0,5
2024-03-18 04:10:00,2,2,3,1,4,0,0,12
2024-03-18 04:20:00,4,4,3,0,5,0,0,16
2024-03-18 04:30:00,4,5,3,1,5,0,0,18
2024-03-18 04:40:00,2,8,5,1,4,0,0,20
2024-03-18 04:50:00,2,8,5,1,6,0,0,22
2024-03-18 05:00:00,12,14,10,7,4,0,0,47
2024-03-18 05:10:00,7,34,8,4,11,0,0,64
2024-03-18 05:20:00,11,18,31,3,13,0,0,76
2024-03-18 05:30:00,7,13,5,6,17,0,0,48
2024-03-18 05:40:00,11,17,16,7,34,0,0,85
2024-03-18 05:50:00,12,18,11,8,41,0,0,90
2024-03-18 06:00:00,23,25,26,10,34,0,0,118
2024-03-18 06:10:00,13,31,81,11,28,1,0,165
2024-03-18 06:20:00,20,26,97,8,37,0,0,188
2024-03-18 06:30:00,24,30,15,9,45,0,0,123
2024-03-18 06:40:00,25,27,20,15,39,0,0,126
2024-03-18 06:50:00,21,31,40,22,55,0,0,169
2024-03-18 07:00:00,25,44,86,21,48,0,0,224
2024-03-18 07:10:00,29,29,15,16,50,1,0,140
2024-03-18 07:20:00,32,47,23,23,62,0,0,187
2024-03-18 07:30:00,21,44,33,27,68,0,0,193
2024-03-18 07:40:00,18,32,25,31,61,0,0,167
2024-03-18 07:50:00,22,58,171,42,57,0,0,350
2024-03-18 08:00:00,31,67,28,26,43,0,0,195
2024-03-18 08:10:00,30,37,41,27,56,3,0,194
2024-03-18 08:20:00,25,56,33,28,54,0,0,196
2024-03-18 08:30:00,23,65,31,24,50,0,0,193
2024-03-18 08:40:00,22,47,60,27,47,0,0,203
2024-03-18 08:50:00,26,41,30,22,63,0,0,182
2024-03-18 09:00:00,30,43,24,25,45,1,0,168
2024-03-18 09:10:00,24,36,23,19,36,1,0,139
2024-03-18 09:20:00,14,55,112,18,34,3,0,236
2024-03-18 09:30:00,23,54,33,18,52,0,0,180
2024-03-18 09:40:00,33,40,23,27,53,0,0,176
2024-03-18 09:50:00,21,42,33,16,48,1,0,161
2024-03-18 10:00:00,26,37,28,26,39,0,0,156
2024-03-18 10:10:00,20,48,43,21,40,1,0,173
2024-03-18 10:20:00,23,233,64,17,30,0,0,367
2024-03-18 10:30:00,22,62,103,18,33,2,0,240
2024-03-18 10:40:00,19,33,33,23,40,0,0,148
2024-03-18 10:50:00,24,35,42,10,32,0,0,143
2024-03-18 11:00:00,23,62,147,21,32,0,0,285
2024-03-18 11:10:00,19,75,64,21,38,0,0,217
2024-03-18 11:20:00,25,43,30,18,31,1,0,148
2024-03-18 11:30:00,23,41,33,17,39,1,0,154
2024-03-18 11:40:00,27,65,145,19,39,0,0,295
2024-03-18 11:50:00,23,42,27,27,42,1,0,162
2024-03-18 12:00:00,21,42,29,14,29,0,0,135
2024-03-18 12:10:00,32,61,63,25,52,0,0,233
2024-03-18 12:20:00,26,42,24,17,45,0,0,154
2024-03-18 12:30:00,24,52,30,34,33,0,0,173
2024-03-18 12:40:00,19,43,20,57,42,0,0,181
2024-03-18 12:50:00,30,146,143,17,39,3,0,378
2024-03-18 13:00:00,25,45,21,20,38,0,0,149
2024-03-18 13:10:00,27,48,29,20,36,1,0,161
2024-03-18 13:20:00,30,52,22,18,56,0,0,178
2024-03-18 13:30:00,21,48,34,19,37,1,0,160
2024-03-18 13:40:00,27,48,21,14,37,4,0,151
2024-03-18 13:50:00,27,44,24,15,36,3,0,149
2024-03-18 14:00:00,24,39,34,12,32,1,0,142
2024-03-18 14:10:00,18,40,33,19,38,1,0,149
2024-03-18 14:20:00,31,52,27,9,35,1,0,155
2024-03-18 14:30:00,32,137,118,19,56,1,0,363
2024-03-18 14:40:00,29,52,27,22,50,2,0,182
2024-03-18 14:50:00,39,45,29,18,50,1,0,182
2024-03-18 15:00:00,29,48,32,13,45,1,0,168
2024-03-18 15:10:00,27,65,90,18,32,3,0,235
2024-03-18 15:20:00,25,69,78,17,52,4,0,245
2024-03-18 15:30:00,42,62,34,27,39,2,0,206
2024-03-18 15:40:00,24,54,35,22,52,1,0,188
2024-03-18 15:50:00,29,43,39,17,60,2,0,190
2024-03-18 16:00:00,38,53,27,17,41,2,0,178
2024-03-18 16:10:00,29,376,23,28,61,0,0,517
2024-03-18 16:20:00,30,55,20,21,40,6,0,172
2024-03-18 16:30:00,31,60,45,19,46,0,0,201
2024-03-18 16:40:00,41,56,37,27,44,3,0,208
2024-03-18 16:50:00,26,88,57,31,48,1,0,251
2024-03-18 17:00:00,30,86,20,27,40,0,0,203
2024-03-18 17:10:00,24,66,28,21,53,3,0,195
2024-03-18 17:20:00,33,41,30,28,44,2,0,178
2024-03-18 17:30:00,31,66,211,19,46,2,0,375
2024-03-18 17:40:00,27,54,35,27,64,0,0,207
2024-03-18 17:50:00,35,131,38,25,50,2,0,281
2024-03-18 18:00:00,28,91,78,24,28,0,0,249
2024-03-18 18:10:00,32,49,38,17,43,1,0,180
2024-03-18 18:20:00,26,41,21,20,33,2,0,143
2024-03-18 18:30:00,23,100,21,21,42,1,0,208
2024-03-18 18:40:00,18,346,73,14,31,0,0,482
2024-03-18 18:50:00,30,39,23,16,35,0,0,143
2024-03-18 19:00:00,23,49,21,9,25,0,0,127
2024-03-18 19:10:00,21,29,159,13,31,2,0,255
2024-03-18 19:20:00,20,33,18,15,43,1,0,130
2024-03-18 19:30:00,24,45,176,10,27,0,0,282
2024-03-18 19:40:00,19,30,16,14,25,1,0,105
2024-03-18 19:50:00,14,35,47,11,28,2,0,137
2024-03-18 20:00:00,16,33,24,12,29,0,0,114
2024-03-18 20:10:00,22,42,22,12,18,0,0,116
2024-03-18 20:20:00,22,31,64,10,25,0,0,152
2024-03-18 20:30:00,17,20,50,8,19,1,0,115
2024-03-18 20:40:00,13,24,18,8,16,0,0,79
2024-03-18 20:50:00,14,18,17,15,21,1,0,86
2024-03-18 21:00:00,15,21,52,14,12,1,0,115
2024-03-18 21:10:00,22,34,193,6,12,1,0,268
2024-03-18 21:20:00,22,14,18,9,10,0,0,73
2024-03-18 21:30:00,26,24,20,5,14,1,0,90
2024-03-18 21:40:00,14,21,15,9,10,0,0,69
2024-03-18 21:50:00,14,15,22,4,4,0,0,59
2024-03-18 22:00:00,15,16,16,5,13,1,0,66
2024-03-18 22:10:00,17,19,23,5,14,1,0,79
2024-03-18 22:20:00,13,21,15,5,8,1,0,63
2024-03-18 22:30:00,12,18,9,4,19,0,0,62
2024-03-18 22:40:00,12,16,13,2,9,0,0,52
2024-03-18 22:50:00,8,14,7,2,9,0,0,40
2024-03-18 23:00:00,11,8,7,2,9,0,0,37
2024-03-18 23:10:00,11,17,12,3,12,0,0,55
2024-03-18 23:20:00,10,12,10,1,8,0,0,41
2024-03-18 23:30:00,15,11,2,3,6,0,0,37
2024-03-18 23:40:00,4,11,14,2,2,0,0,33
2024-03-18 23:50:00,7,4,7,1,4,0,0,23
2024-03-19 00:00:00,5,5,5,3,10,0,0,28
2024-03-19 00:10:00,4,8,4,1,7,0,0,24
2024-03-19 00:20:00,3,8,5,2,7,0,0,25
2024-03-19 00:30:00,6,6,6,2,3,0,0,23
2024-03-19 00:40:00,5,9,3,3,3,0,0,23
2024-03-19 00:50:00,4,2,1,1,4,0,0,12
2024-03-19 01:00:00,4,3,2,1,2,0,0,12
2024-03-19 01:10:00,2,8,5,1,3,0,0,19
2024-03-19 01:20:00,1,6,4,1,1,0,0,13
2024-03-19 01:30:00,1,3,2,2,5,0,0,13
2024-03-19 01:40:00,0,4,1,0,2,0,0,7
2024-03-19 01:50:00,2,2,1,1,0,0,0,6
2024-03-19 02:00:00,1,0,1,0,1,0,0,3
2024-03-19 02:10:00,1,9,1,1,2,0,0,14
2024-03-19 02:20:00,3,5,1,1,1,0,0,11
2024-03-19 02:30:00,2,3,3,2,3,0,0,13
2024-03-19 02:40:00,0,1,0,2,1,0,0,4
2024-03-19 02:50:00,1,0,4,0,1,0,0,6
2024-03-19 03:00:00,1,1,3,2,0,0,0,7
2024-03-19 03:10:00,3,1,0,1,0,0,0,5
2024-03-19 03:20:00,5,2,3,0,0,0,0,10
2024-03-19 03:30:00,1,2,5,1,5,0,0,14
2024-03-19 03:40:00,0,0,1,1,0,0,0,2
2024-03-19 03:50:00,1,4,4,4,7,0,0,20
2024-03-19 04:00:00,1,1,2,0,3,0,0,7
2024-03-19 04:10:00,3,5,3,0,5,0,0,16
2024-03-19 04:20:00,9,4,0,0,2,0,0,15
2024-03-19 04:30:00,1,9,1,0,4,0,0,15
2024-03-19 04:40:00,3,4,3,2,4,0,0,16
2024-03-19 04:50:00,4,9,3,2,8,0,0,26
2024-03-19 05:00:00,7,6,5,2,15,0,0,35
2024-03-19 05:10:00,8,12,12,5,11,1,0,49
2024-03-19 05:20:00,8,27,11,3,15,0,0,64
2024-03-19 05:30:00,10,14,32,4,21,0,0,81
2024-03-19 05:40:00,9,21,11,6,18,0,0,65
2024-03-19 05:50:00,13,17,10,8,51,0,0,99
2024-03-19 06:00:00,12,16,21,11,29,1,0,90
2024-03-19 06:10:00,13,51,90,13,33,0,0,200
2024-03-19 06:20:00,24,26,25,9,44,0,0,128
2024-03-19 06:30:00,28,37,26,8,45,0,0,144
2024-03-19 06:40:00,30,31,19,12,51,0,0,143
2024-03-19 06:50:00,22,39,20,14,45,0,0,140
2024-03-19 07:00:00,29,38,253,14,50,0,0,384
2024-03-19 07:10:00,21,43,28,20,67,0,0,179
2024-03-19 07:20:00,22,44,26,18,66,2,0,178
2024-03-19 07:30:00,20,46,32,30,54,0,0,182
2024-03-19 07:40:00,21,26,24,36,70,0,0,177
2024-03-19 07:50:00,21,40,30,32,43,2,0,168
2024-03-19 08:00:00,25,50,21,26,45,0,0,167
2024-03-19 08:10:00,35,53,34,42,63,1,0,228
2024-03-19 08:20:00,26,40,31,24,59,1,0,181
2024-03-19 08:30:00,27,55,18,32,54,2,0,188
2024-03-19 08:40:00,24,54,29,32,63,0,0,202
2024-03-19 08:50:00,20,57,29,22,39,1,0,168
2024-03-19 09:00:00,24,52,30,25,41,1,0,173
2024-03-19 09:10:00,29,40,23,17,47,1,0,157
2024-03-19 09:20:00,14,46,25,26,44,0,0,155
2024-03-19 09:30:00,26,78,101,19,56,3,0,283
2024-03-19 09:40:00,35,37,17,9,53,0,0,151
2024-03-19 09:50:00,24,37,29,23,38,1,0,152
2024-03-19 10:00:00,23,49,58,32,39,0,0,201
2024-03-19 10:10:00,18,42,31,23,34,0,0,148
2024-03-19 10:20:00,23,87,168,11,29,0,0,318
2024-03-19 10:30:00,17,41,23,23,45,0,0,149
2024-03-19 10:40:00,24,216,172,30,32,1,0,475
2024-03-19 10:50:00,22,240,169,16,40,0,0,487
2024-03-19 11:00:00,26,38,30,14,37,0,0,145
2024-03-19 11:10:00,21,67,27,6,46,1,0,168
2024-03-19 11:20:00,28,49,24,18,35,0,0,154
2024-03-19 11:30:00,24,53,34,12,36,0,0,159
2024-03-19 11:40:00,31,41,32,12,37,2,0,155
2024-03-19 11:50:00,28,53,28,27,27,5,0,168
2024-03-19 12:00:00,24,44,54,21,31,3,0,177
2024-03-19 12:10:00,26,51,42,21,37,0,0,177
2024-03-19 12:20:00,25,55,36,19,31,1,0,167
2024-03-19 12:30:00,27,52,23,10,38,1,0,151
2024-03-19 12:40:00,26,41,35,8,37,0,0,147
2024-03-19 12:50:00,22,38,81,18,41,1,0,201
2024-03-19 13:00:00,25,36,31,18,40,6,0,156
2024-03-19 13:10:00,27,64,27,15,33,0,0,166
2024-03-19 13:20:00,25,46,26,12,119,2,0,230
2024-03-19 13:30:00,32,60,28,22,34,0,0,176
2024-03-19 13:40:00,21,69,87,22,49,2,0,250
2024-03-19 13:50:00,26,53,28,16,32,0,0,155
2024-03-19 14:00:00,26,67,47,15,27,1,0,183
2024-03-19 14:10:00,34,40,29,19,47,1,0,170
2024-03-19 14:20:00,32,69,33,20,39,1,0,194
2024-03-19 14:30:00,35,61,66,15,38,1,0,216
2024-03-19 14:40:00,27,66,29,13,57,2,0,194
2024-03-19 14:50:00,36,52,27,19,35,1,0,170
2024-03-19 15:00:00,22,48,34,15,47,3,0,169
2024-03-19 15:10:00,28,59,26,23,47,1,0,184
2024-03-19 15:20:00,31,143,49,24,41,3,0,291
2024-03-19 15:30:00,41,69,33,16,51,2,0,212
2024-03-19 15:40:00,41,51,43,29,51,2,0,217
2024-03-19 15:50:00,30,42,50,26,55,2,0,205
2024-03-19 16:00:00,37,72,28,20,48,5,0,210
2024-03-19 16:10:00,39,104,42,17,53,0,0,255
2024-03-19 16:20:00,35,61,36,25,27,7,0,191
2024-03-19 16:30:00,18,68,41,34,44,2,0,207
2024-03-19 16:40:00,28,60,39,30,51,2,0,210
2024-03-19 16:50:00,22,42,37,28,53,1,0,183
2024-03-19 17:00:00,34,57,23,31,46,2,0,193
2024-03-19 17:10:00,29,67,33,36,70,2,0,237
2024-03-19 17:20:00,29,66,34,24,59,1,0,213
2024-03-19 17:30:00,23,69,33,26,56,1,0,208
2024-03-19 17:40:00,28,57,33,21,55,0,0,194
2024-03-19 17:50:00,29,77,56,17,55,5,0,239
2024-03-19 18:00:00,22,57,28,21,45,0,0,173
2024-03-19 18:10:00,32,69,37,26,47,1,0,212
2024-03-19 18:20:00,34,61,26,29,60,1,0,211
2024-03-19 18:30:00,29,41,25,21,46,0,0,162
2024-03-19 18:40:00,29,86,34,22,50,1,0,222
2024-03-19 18:50:00,26,30,27,16,30,0,0,129
2024-03-19 19:00:00,28,37,18,18,39,0,0,140
2024-03-19 19:10:00,23,42,29,16,24,2,0,136
2024-03-19 19:20:00,16,29,27,20,36,2,0,130
2024-03-19 19:30:00,18,62,202,13,27,1,0,323
2024-03-19 19:40:00,24,39,32,17,35,1,0,148
2024-03-19 19:50:00,26,38,20,16,32,1,0,133
2024-03-19 20:00:00,18,49,20,15,28,1,0,131
2024-03-19 20:10:00,18,40,42,17,36,1,0,154
2024-03-19 20:20:00,20,80,98,12,20,0,0,230
2024-03-19 20:30:00,19,23,17,15,21,0,0,95
2024-03-19 20:40:00,20,41,25,9,23,0,0,118
2024-03-19 20:50:00,20,26,18,17,20,0,0,101
2024-03-19 21:00:00,14,30,21,11,25,1,0,102
2024-03-19 21:10:00,19,23,17,16,20,1,0,96
2024-03-19 21:20:00,16,17,51,10,10,1,0,105
2024-03-19 21:30:00,22,21,22,6,11,1,0,83
2024-03-19 21:40:00,22,20,11,7,22,0,0,82
2024-03-19 21:50:00,20,21,21,5,18,1,0,86
2024-03-19 22:00:00,21,14,14,7,18,0,0,74
2024-03-19 22:10:00,27,19,29,6,14,1,0,96
2024-03-19 22:20:00,12,23,18,2,9,0,0,64
2024-03-19 22:30:00,11,22,27,8,13,1,0,82
2024-03-19 22:40:00,7,17,28,6,18,0,0,76
2024-03-19 22:50:00,9,16,9,4,5,0,0,43
2024-03-19 23:00:00,12,25,12,6,10,0,0,65
2024-03-19 23:10:00,8,11,35,3,3,0,0,60
2024-03-19 23:20:00,4,4,6,2,4,0,0,20
2024-03-19 23:30:00,5,11,6,4,6,0,0,32
2024-03-19 23:40:00,8,16,10,0,9,0,0,43
2024-03-19 23:50:00,8,7,4,3,6,0,0,28
2024-03-20 00:00:00,5,6,3,7,8,0,0,29
2024-03-20 00:10:00,7,10,60,3,2,0,0,82
2024-03-20 00:20:00,5,8,10,2,2,0,0,27
2024-03-20 00:30:00,6,6,7,5,5,0,0,29
2024-03-20 00:40:00,1,13,3,0,7,0,0,24
2024-03-20 00:50:00,6,3,0,0,5,0,0,14
2024-03-20 01:00:00,4,7,2,1,3,0,0,17
2024-03-20 01:10:00,4,7,5,1,1,0,0,18
2024-03-20 01:20:00,4,6,3,2,4,0,0,19
2024-03-20 01:30:00,3,6,1,0,3,0,0,13
2024-03-20 01:40:00,3,9,1,3,5,0,0,21
2024-03-20 01:50:00,2,3,1,0,3,0,0,9
2024-03-20 02:00:00,3,3,1,0,1,0,0,8
2024-03-20 02:10:00,0,4,2,0,1,0,0,7
2024-03-20 02:20:00,2,0,3,2,2,0,0,9
2024-03-20 02:30:00,0,1,1,0,1,0,0,3
2024-03-20 02:40:00,2,6,3,1,2,0,0,14
2024-03-20 02:50:00,2,5,0,1,2,0,0,10
2024-03-20 03:00:00,2,0,2,1,5,0,0,10
2024-03-20 03:10:00,3,1,3,1,3,0,0,11
2024-03-20 03:20:00,4,0,1,1,3,0,0,9
2024-03-20 03:30:00,0,2,1,2,3,0,0,8
2024-03-20 03:40:00,0,2,3,1,2,0,0,8
2024-03-20 03:50:00,1,33,1,0,2,0,0,37
2024-03-20 04:00:00,1,0,3,0,0,0,0,4
2024-03-20 04:10:00,1,4,6,2,7,0,0,20
2024-03-20 04:20:00,7,1,2,0,2,0,0,12
2024-03-20 04:30:00,5,7,3,1,5,0,0,21
2024-03-20 04:40:00,9,7,4,2,6,0,0,28
2024-03-20 04:50:00,2,8,6,3,9,0,0,28
2024-03-20 05:00:00,8,10,6,3,7,0,0,34
2024-03-20 05:10:00,9,20,8,4,9,0,0,50
2024-03-20 05:20:00,7,12,11,2,13,0,0,45
2024-03-20 05:30:00,15,18,9,4,18,1,0,65
2024-03-20 05:40:00,10,15,12,7,23,1,0,68
2024-03-20 05:50:00,13,20,15,6,44,0,0,98
2024-03-20 06:00:00,15,25,12,13,27,0,0,92
2024-03-20 06:10:00,22,21,52,12,29,0,0,136
2024-03-20 06:20:00,32,31,44,6,55,0,0,168
2024-03-20 06:30:00,18,22,25,11,37,0,0,113
2024-03-20 06:40:00,20,31,27,16,60,0,0,154
2024-03-20 06:50:00,28,43,94,17,48,1,0,231
2024-03-20 07:00:00,20,39,22,21,52,0,0,154
2024-03-20 07:10:00,26,31,26,17,61,0,0,161
2024-03-20 07:20:00,23,40,28,17,36,1,0,145
2024-03-20 07:30:00,37,45,22,23,53,1,0,181
2024-03-20 07:40:00,20,64,32,24,58,0,0,198
2024-03-20 07:50:00,17,37,32,45,63,1,0,195
2024-03-20 08:00:00,31,53,31,40,51,0,0,206
2024-03-20 08:10:00,23,55,28,27,63,3,0,199
2024-03-20 08:20:00,27,42,24,23,54,0,0,170
2024-03-20 08:30:00,22,69,35,32,48,0,0,206
2024-03-20 08:40:00,28,43,29,29,57,0,0,186
2024-03-20 08:50:00,19,43,42,38,46,0,0,188
2024-03-20 09:00:00,27,49,27,29,42,0,0,174
2024-03-20 09:10:00,26,67,124,22,41,0,0,280
2024-03-20 09:20:00,19,51,36,20,33,1,0,160
2024-03-20 09:30:00,23,33,25,15,51,0,0,147
2024-03-20 09:40:00,21,45,69,21,128,1,0,285
2024-03-20 09:50:00,28,35,27,14,43,1,0,148
2024-03-20 10:00:00,34,37,34,12,43,1,0,161
2024-03-20 10:10:00,27,36,22,18,36,0,0,139
2024-03-20 10:20:00,25,88,207,16,45,0,0,381
2024-03-20 10:30:00,23,42,23,14,36,0,0,138
2024-03-20 10:40:00,26,39,34,12,52,0,0,163
2024-03-20 10:50:00,26,67,82,13,34,0,0,222
2024-03-20 11:00:00,20,40,24,23,59,0,0,166
2024-03-20 11:10:00,29,30,32,14,45,3,0,153
2024-03-20 11:20:00,29,31,27,16,46,0,0,149
2024-03-20 11:30:00,23,110,36,13,39,0,0,221
2024-03-20 11:40:00,18,49,25,18,32,3,0,145
2024-03-20 11:50:00,32,55,35,19,33,2,0,176
2024-03-20 12:00:00,27,60,39,29,40,0,0,195
2024-03-20 12:10:00,24,54,35,21,40,3,0,177
2024-03-20 12:20:00,34,52,35,21,39,0,0,181
2024-03-20 12:30:00,17,58,32,17,31,1,0,156
2024-03-20 12:40:00,29,38,34,26,46,0,0,173
2024-03-20 12:50:00,30,54,28,17,35,0,0,164
2024-03-20 13:00:00,29,50,35,17,46,1,0,178
2024-03-20 13:10:00,31,57,29,12,46,1,0,176
2024-03-20 13:20:00,36,53,38,12,41,0,0,180
2024-03-20 13:30:00,28,54,32,20,30,1,0,165
2024-03-20 13:40:00,23,44,56,24,42,3,0,192
2024-03-20 13:50:00,29,87,54,26,33,1,0,230
2024-03-20 14:00:00,26,45,26,10,37,1,0,145
2024-03-20 14:10:00,28,49,33,17,51,0,0,178
2024-03-20 14:20:00,30,66,64,18,46,0,0,224
2024-03-20 14:30:00,32,38,37,16,48,0,0,171
2024-03-20 14:40:00,39,59,28,17,54,5,0,202
2024-03-20 14:50:00,35,49,33,16,34,1,0,168
2024-03-20 15:00:00,29,53,132,15,40,1,0,270
2024-03-20 15:10:00,33,44,38,21,34,1,0,171
2024-03-20 15:20:00,38,57,44,18,50,4,0,211
2024-03-20 15:30:00,32,72,50,23,40,2,0,219
2024-03-20 15:40:00,36,48,27,24,54,1,0,190
2024-03-20 15:50:00,25,58,39,30,59,5,0,216
2024-03-20 16:00:00,33,58,32,26,41,2,0,192
2024-03-20 16:10:00,31,178,61,17,56,0,0,343
2024-03-20 16:20:00,25,54,27,22,67,2,0,197
2024-03-20 16:30:00,28,59,45,24,49,3,0,208
2024-03-20 16:40:00,40,58,24,23,57,4,0,206
2024-03-20 16:50:00,23,58,25,35,59,2,0,202
2024-03-20 17:00:00,32,73,32,31,40,4,0,212
2024-03-20 17:10:00,23,59,50,30,45,1,0,208
2024-03-20 17:20:00,24,121,34,30,55,5,0,269
2024-03-20 17:30:00,27,58,53,16,51,0,0,205
2024-03-20 17:40:00,28,57,34,31,56,2,0,208
2024-03-20 17:50:00,25,73,38,28,56,3,0,223
2024-03-20 18:00:00,27,59,39,23,47,0,0,195
2024-03-20 18:10:00,28,52,32,18,43,0,0,173
2024-03-20 18:20:00,22,40,18,17,56,0,0,153
2024-03-20 18:30:00,28,53,24,18,41,0,0,164
2024-03-20 18:40:00,33,56,25,22,49,1,0,186
2024-03-20 18:50:00,29,45,33,20,44,2,0,173
2024-03-20 19:00:00,21,46,48,20,31,0,0,166
2024-03-20 19:10:00,24,51,33,15,27,1,0,151
2024-03-20 19:20:00,16,33,21,16,33,0,0,119
2024-03-20 19:30:00,19,33,20,6,23,0,0,101
2024-03-20 19:40:00,20,48,91,13,28,0,0,200
2024-03-20 19:50:00,28,29,26,13,32,2,0,130
2024-03-20 20:00:00,20,33,27,11,35,1,0,127
2024-03-20 20:10:00,21,35,151,15,30,9,0,261
2024-03-20 20:20:00,21,29,18,12,34,0,0,114
2024-03-20 20:30:00,21,25,16,17,21,1,0,101
2024-03-20 20:40:00,12,47,19,16,18,1,0,113
2024-03-20 20:50:00,17,31,73,18,21,0,0,160
2024-03-20 21:00:00,19,29,20,9,14,0,0,91
2024-03-20 21:10:00,24,33,20,16,17,1,0,111
2024-03-20 21:20:00,19,36,16,8,23,1,0,103
2024-03-20 21:30:00,19,33,37,5,21,1,0,116
2024-03-20 21:40:00,21,19,22,8,14,0,0,84
2024-03-20 21:50:00,23,16,17,8,16,0,0,80
2024-03-20 22:00:00,15,18,17,5,20,0,0,75
2024-03-20 22:10:00,25,32,15,7,17,1,0,97
2024-03-20 22:20:00,11,18,12,4,19,0,0,64
2024-03-20 22:30:00,14,18,12,4,15,0,0,63
2024-03-20 22:40:00,17,22,11,4,8,0,0,62
2024-03-20 22:50:00,9,13,13,7,13,0,0,55
2024-03-20 23:00:00,6,18,5,5,12,0,0,46
2024-03-20 23:10:00,7,23,15,2,11,2,0,60
2024-03-20 23:20:00,7,15,13,5,5,0,0,45
2024-03-20 23:30:00,6,10,9,4,8,0,0,37
2024-03-20 23:40:00,8,13,6,4,6,0,0,37
2024-03-20 23:50:00,7,7,12,2,6,0,0,34
2024-03-21 00:00:00,10,3,7,3,7,0,0,30
2024-03-21 00:10:00,5,10,5,1,3,0,0,24
2024-03-21 00:20:00,5,3,4,3,6,0,0,21
2024-03-21 00:30:00,4,4,1,5,5,0,0,19
2024-03-21 00:40:00,1,11,8,2,9,0,0,31
2024-03-21 00:50:00,4,4,3,4,2,0,0,17
2024-03-21 01:00:00,4,1,3,1,0,0,0,9
2024-03-21 01:10:00,6,5,2,2,3,0,0,18
2024-03-21 01:20:00,4,7,7,2,4,0,0,24
2024-03-21 01:30:00,2,7,1,1,4,0,0,15
2024-03-21 01:40:00,4,10,1,3,4,0,0,22
2024-03-21 01:50:00,1,5,2,1,5,0,0,14
2024-03-21 02:00:00,1,1,2,0,4,0,0,8
2024-03-21 02:10:00,2,5,0,0,0,0,0,7
2024-03-21 02:20:00,2,5,0,1,2,0,0,10
2024-03-21 02:30:00,3,0,1,0,1,0,0,5
2024-03-21 02:40:00,1,4,1,1,0,0,0,7
2024-03-21 02:50:00,0,0,2,1,4,0,0,7
2024-03-21 03:00:00,4,3,4,0,1,0,0,12
2024-03-21 03:10:00,0,0,3,0,2,0,0,5
2024-03-21 03:20:00,4,3,1,0,2,0,0,10
2024-03-21 03:30:00,0,3,0,2,3,0,0,8
2024-03-21 03:40:00,5,0,4,1,1,0,0,11
2024-03-21 03:50:00,4,1,0,0,4,0,0,9
2024-03-21 04:00:00,3,1,4,3,2,0,0,13
2024-03-21 04:10:00,0,4,49,0,5,0,0,58
2024-03-21 04:20:00,4,5,3,1,3,0,0,16
2024-03-21 04:30:00,2,4,1,0,2,0,0,9
2024-03-21 04:40:00,4,12,3,1,4,0,0,24
2024-03-21 04:50:00,3,11,5,1,11,0,0,31
2024-03-21 05:00:00,5,4,5,0,6,1,0,21
2024-03-21 05:10:00,5,16,47,6,15,0,0,89
2024-03-21 05:20:00,7,14,12,1,12,0,0,46
2024-03-21 05:30:00,11,11,18,17,22,0,0,79
2024-03-21 05:40:00,10,13,19,9,28,0,0,79
2024-03-21 05:50:00,13,15,12,4,51,1,0,96
2024-03-21 06:00:00,16,59,124,17,33,0,0,249
2024-03-21 06:10:00,20,17,107,6,30,0,0,180
2024-03-21 06:20:00,20,28,15,6,45,0,0,114
2024-03-21 06:30:00,20,25,27,14,44,0,0,130
2024-03-21 06:40:00,19,31,24,15,57,1,0,147
2024-03-21 06:50:00,27,37,63,14,62,0,0,203
2024-03-21 07:00:00,19,41,23,14,56,0,0,153
2024-03-21 07:10:00,25,69,75,21,53,3,0,246
2024-03-21 07:20:00,23,38,19,24,56,1,0,161
2024-03-21 07:30:00,20,40,33,25,63,2,0,183
2024-03-21 07:40:00,26,264,162,32,55,0,0,539
2024-03-21 07:50:00,26,262,269,36,50,1,0,644
2024-03-21 08:00:00,17,59,25,33,65,1,0,200
2024-03-21 08:10:00,29,34,30,23,41,0,0,157
2024-03-21 08:20:00,28,56,71,23,60,3,0,241
2024-03-21 08:30:00,34,57,25,25,56,0,0,197
2024-03-21 08:40:00,21,54,171,15,41,0,0,302
2024-03-21 08:50:00,18,38,26,29,54,0,0,165
2024-03-21 09:00:00,19,70,32,16,37,0,0,174
2024-03-21 09:10:00,32,63,26,29,58,0,0,208
2024-03-21 09:20:00,27,55,107,16,32,1,0,238
2024-03-21 09:30:00,20,110,128,14,44,1,0,317
2024-03-21 09:40:00,29,36,34,12,37,0,0,148
2024-03-21 09:50:00,25,39,28,14,52,1,0,159
2024-03-21 10:00:00,26,33,25,25,39,1,0,149
2024-03-21 10:10:00,23,58,88,18,33,0,0,220
2024-03-21 10:20:00,16,145,189,19,41,2,0,412
2024-03-21 10:30:00,25,65,30,12,40,1,0,173
2024-03-21 10:40:00,20,53,35,16,51,0,0,175
2024-03-21 10:50:00,25,34,20,12,48,0,0,139
2024-03-21 11:00:00,25,48,23,10,30,0,0,136
2024-03-21 11:10:00,30,39,38,29,40,0,0,176
2024-03-21 11:20:00,25,40,32,15,35,0,0,147
2024-03-21 11:30:00,19,41,40,14,40,0,0,154
2024-03-21 11:40:00,40,44,26,13,29,0,0,152
2024-03-21 11:50:00,25,59,207,20,46,1,0,358
2024-03-21 12:00:00,25,58,30,15,40,0,0,168
2024-03-21 12:10:00,25,40,31,13,47,1,0,157
2024-03-21 12:20:00,31,45,30,17,43,1,0,167
2024-03-21 12:30:00,26,61,31,18,33,0,0,169
2024-03-21 12:40:00,23,48,52,9,42,0,0,174
2024-03-21 12:50:00,31,229,123,15,51,0,0,449
2024-03-21 13:00:00,24,60,81,14,42,0,0,221
2024-03-21 13:10:00,34,59,21,15,34,0,0,163
2024-03-21 13:20:00,31,53,31,19,46,0,0,180
2024-03-21 13:30:00,31,112,158,14,50,1,0,366
2024-03-21 13:40:00,33,56,58,22,39,2,0,210
2024-03-21 13:50:00,36,49,23,13,35,0,0,156
2024-03-21 14:00:00,31,47,32,23,37,1,0,171
2024-03-21 14:10:00,20,146,40,9,58,3,0,276
2024-03-21 14:20:00,25,122,137,17,40,0,0,341
2024-03-21 14:30:00,27,53,37,19,36,1,0,173
2024-03-21 14:40:00,25,54,30,20,51,0,0,180
2024-03-21 14:50:00,39,48,43,19,55,1,0,205
2024-03-21 15:00:00,35,54,35,20,38,1,0,183
2024-03-21 15:10:00,33,91,101,24,42,2,0,293
2024-03-21 15:20:00,34,103,32,29,51,4,0,253
2024-03-21 15:30:00,26,64,27,20,56,1,0,194
2024-03-21 15:40:00,44,51,44,19,54,6,0,218
2024-03-21 15:50:00,33,57,31,23,65,5,0,214
2024-03-21 16:00:00,37,113,125,21,38,2,0,336
2024-03-21 16:10:00,31,265,124,29,55,3,0,507
2024-03-21 16:20:00,34,75,40,29,58,2,0,238
2024-03-21 16:30:00,35,54,37,15,35,1,0,177
2024-03-21 16:40:00,30,62,37,29,68,3,0,229
2024-03-21 16:50:00,31,79,38,23,60,3,0,234
2024-03-21 17:00:00,31,69,104,65,48,7,0,324
2024-03-21 17:10:00,31,68,32,20,63,0,0,214
2024-03-21 17:20:00,36,61,33,30,55,1,0,216
2024-03-21 17:30:00,34,58,33,15,46,1,0,187
2024-03-21 17:40:00,30,64,53,34,45,1,0,227
2024-03-21 17:50:00,28,82,30,19,61,3,0,223
2024-03-21 18:00:00,27,57,34,27,48,0,0,193
2024-03-21 18:10:00,32,40,45,16,47,2,0,182
2024-03-21 18:20:00,28,60,28,17,42,0,0,175
2024-03-21 18:30:00,25,77,108,20,42,1,0,273
2024-03-21 18:40:00,23,153,68,13,30,0,0,287
2024-03-21 18:50:00,26,151,130,22,31,0,0,360
2024-03-21 19:00:00,20,33,27,22,36,2,0,140
2024-03-21 19:10:00,23,42,31,8,32,3,0,139
2024-03-21 19:20:00,21,23,173,15,23,0,0,255
2024-03-21 19:30:00,22,89,46,12,32,0,0,201
2024-03-21 19:40:00,22,45,25,12,40,2,0,146
2024-03-21 19:50:00,22,30,23,14,20,0,0,109
2024-03-21 20:00:00,16,58,89,13,34,0,0,210
2024-03-21 20:10:00,26,59,330,9,22,0,0,446
2024-03-21 20:20:00,21,86,153,13,19,0,0,292
2024-03-21 20:30:00,26,32,8,8,26,1,0,101
2024-03-21 20:40:00,18,29,12,10,25,0,0,94
2024-03-21 20:50:00,21,15,13,11,27,0,0,87
2024-03-21 21:00:00,25,68,99,10,20,0,0,222
2024-03-21 21:10:00,17,121,105,15,24,0,0,282
2024-03-21 21:20:00,21,28,14,5,12,0,0,80
2024-03-21 21:30:00,23,27,17,9,17,0,0,93
2024-03-21 21:40:00,12,28,25,9,16,0,0,90
2024-03-21 21:50:00,14,24,15,10,14,1,0,78
2024-03-21 22:00:00,14,17,11,5,13,0,0,60
2024-03-21 22:10:00,19,40,82,6,20,1,0,168
2024-03-21 22:20:00,18,12,10,1,15,1,0,57
2024-03-21 22:30:00,10,16,8,4,14,1,0,53
2024-03-21 22:40:00,13,31,15,3,14,0,0,76
2024-03-21 22:50:00,17,18,23,6,13,0,0,77
2024-03-21 23:00:00,19,21,12,7,15,0,0,74
2024-03-21 23:10:00,9,22,15,6,11,1,0,64
2024-03-21 23:20:00,7,17,10,6,12,0,0,52
2024-03-21 23:30:00,11,12,10,6,14,0,0,53
2024-03-21 23:40:00,7,40,134,4,12,0,0,197
2024-03-21 23:50:00,7,5,11,5,11,0,0,39
2024-03-22 00:00:00,7,11,6,5,12,0,0,41
2024-03-22 00:10:00,4,22,7,1,4,0,0,38
2024-03-22 00:20:00,7,3,4,3,4,0,0,21
2024-03-22 00:30:00,6,8,7,4,7,0,0,32
2024-03-22 00:40:00,3,13,6,0,4,0,0,26
2024-03-22 00:50:00,7,9,5,3,5,0,0,29
2024-03-22 01:00:00,5,4,4,2,6,0,0,21
2024-03-22 01:10:00,1,6,4,2,1,0,0,14
2024-03-22 01:20:00,4,8,3,0,2,0,0,17
2024-03-22 01:30:00,3,2,1,1,2,0,0,9
2024-03-22 01:40:00,1,5,1,0,1,0,0,8
2024-03-22 01:50:00,1,12,1,0,3,0,0,17
2024-03-22 02:00:00,1,1,3,2,4,0,0,11
2024-03-22 02:10:00,0,6,0,0,1,0,0,7
2024-03-22 02:20:00,1,2,1,0,2,0,0,6
2024-03-22 02:30:00,1,2,3,1,3,0,0,10
2024-03-22 02:40:00,6,2,5,0,4,0,0,17
2024-03-22 02:50:00,0,4,2,1,3,0,0,10
2024-03-22 03:00:00,3,0,3,1,2,0,0,9
2024-03-22 03:10:00,1,2,2,2,1,0,0,8
2024-03-22 03:20:00,5,0,0,1,2,0,0,8
2024-03-22 03:30:00,3,1,2,1,2,0,0,9
2024-03-22 03:40:00,1,4,3,3,1,0,0,12
2024-03-22 03:50:00,1,7,5,0,1,0,0,14
2024-03-22 04:00:00,4,3,0,0,2,0,0,9
2024-03-22 04:10:00,2,6,3,1,4,0,0,16
2024-03-22 04:20:00,7,2,2,1,3,0,0,15
2024-03-22 04:30:00,3,4,3,1,6,0,0,17
2024-03-22 04:40:00,11,34,2,0,3,0,0,50
2024-03-22 04:50:00,3,9,3,3,8,0,0,26
2024-03-22 05:00:00,3,5,10,2,12,0,0,32
2024-03-22 05:10:00,9,13,7,4,9,0,0,42
2024-03-22 05:20:00,9,15,3,4,8,0,0,39
2024-03-22 05:30:00,11,14,8,3,13,0,0,49
2024-03-22 05:40:00,10,12,16,6,28,0,0,72
2024-03-22 05:50:00,11,16,11,6,30,1,0,75
2024-03-22 06:00:00,16,22,12,6,35,0,0,91
2024-03-22 06:10:00,18,18,18,10,36,0,0,100
2024-03-22 06:20:00,19,32,19,7,35,0,0,112
2024-03-22 06:30:00,23,28,17,8,28,0,0,104
2024-03-22 06:40:00,38,31,31,10,65,0,0,175
2024-03-22 06:50:00,26,43,25,12,54,0,0,160
2024-03-22 07:00:00,20,30,17,14,39,0,0,120
2024-03-22 07:10:00,25,27,21,25,57,2,0,157
2024-03-22 07:20:00,23,37,21,13,49,0,0,143
2024-03-22 07:30:00,21,52,26,19,52,1,0,171
2024-03-22 07:40:00,21,66,66,30,61,1,0,245
2024-03-22 07:50:00,36,38,22,36,73,1,0,206
2024-03-22 08:00:00,14,36,22,12,32,1,0,117
2024-03-22 08:10:00,22,44,26,26,44,0,0,162
2024-03-22 08:20:00,24,39,54,20,52,1,0,190
2024-03-22 08:30:00,19,48,22,24,39,0,0,152
2024-03-22 08:40:00,18,47,28,28,47,0,0,168
2024-03-22 08:50:00,23,36,25,27,57,0,0,168
2024-03-22 09:00:00,24,34,26,35,30,0,0,149
2024-03-22 09:10:00,20,39,27,12,49,0,0,147
2024-03-22 09:20:00,20,39,30,20,38,1,0,148
2024-03-22 09:30:00,17,38,19,16,46,0,0,136
2024-03-22 09:40:00,21,38,35,18,42,2,0,156
2024-03-22 09:50:00,30,39,30,16,41,0,0,156
2024-03-22 10:00:00,32,56,28,17,44,0,0,177
2024-03-22 10:10:00,27,34,23,15,37,1,0,137
2024-03-22 10:20:00,24,46,20,17,43,0,0,150
2024-03-22 10:30:00,28,48,28,25,32,0,0,161
2024-03-22 10:40:00,28,248,84,21,44,4,0,429
2024-03-22 10:50:00,29,37,31,12,41,1,0,151
2024-03-22 11:00:00,27,53,38,18,36,1,0,173
2024-03-22 11:10:00,23,49,25,16,51,1,0,165
2024-03-22 11:20:00,27,44,22,20,58,2,0,173
2024-03-22 11:30:00,21,45,35,16,43,0,0,160
2024-03-22 11:40:00,30,45,38,21,45,0,0,179
2024-03-22 11:50:00,36,47,28,20,45,0,0,176
2024-03-22 12:00:00,28,43,32,16,52,0,0,171
2024-03-22 12:10:00,33,47,21,18,54,2,0,175
2024-03-22 12:20:00,29,84,43,22,49,1,0,228
2024-03-22 12:30:00,30,66,36,24,48,1,0,205
2024-03-22 12:40:00,19,57,31,36,62,3,0,208
2024-03-22 12:50:00,28,45,32,19,42,2,0,168
2024-03-22 13:00:00,28,78,39,23,48,2,0,218
2024-03-22 13:10:00,23,56,32,24,56,0,0,191
2024-03-22 13:20:00,33,70,24,21,49,1,0,198
2024-03-22 13:30:00,36,62,30,21,52,2,0,203
2024-03-22 13:40:00,34,70,73,26,53,1,0,257
2024-03-22 13:50:00,29,47,28,23,41,1,0,169
2024-03-22 14:00:00,27,42,38,16,46,1,0,170
2024-03-22 14:10:00,31,43,30,33,59,3,0,199
2024-03-22 14:20:00,24,62,34,20,42,2,0,184
2024-03-22 14:30:00,26,59,28,25,51,2,0,191
2024-03-22 14:40:00,27,106,58,23,41,3,0,258
2024-03-22 14:50:00,33,42,36,23,48,1,0,183
2024-03-22 15:00:00,32,60,33,25,47,3,0,200
2024-03-22 15:10:00,26,42,36,17,50,2,0,173
2024-03-22 15:20:00,32,57,25,17,41,1,0,173
2024-03-22 15:30:00,34,56,29,20,42,1,0,182
2024-03-22 15:40:00,36,76,30,34,48,1,0,225
2024-03-22 15:50:00,25,42,39,18,57,1,0,182
2024-03-22 16:00:00,29,52,43,15,40,1,0,180
2024-03-22 16:10:00,26,71,23,19,46,1,0,186
2024-03-22 16:20:00,26,110,33,24,54,2,0,249
2024-03-22 16:30:00,30,65,28,19,44,0,0,186
2024-03-22 16:40:00,30,60,35,18,43,2,0,188
2024-03-22 16:50:00,29,29,48,38,51,1,0,196
2024-03-22 17:00:00,22,55,32,26,41,2,0,178
2024-03-22 17:10:00,23,44,28,29,47,0,0,171
2024-03-22 17:20:00,34,71,61,18,53,1,0,238
2024-03-22 17:30:00,32,55,26,21,38,1,0,173
2024-03-22 17:40:00,21,53,39,20,61,0,0,194
2024-03-22 17:50:00,31,43,29,13,44,0,0,160
2024-03-22 18:00:00,23,52,32,15,35,9,0,166
2024-03-22 18:10:00,21,43,58,28,38,0,0,188
2024-03-22 18:20:00,24,47,52,25,44,3,0,195
2024-03-22 18:30:00,17,19,8,9,18,0,0,71
2024-03-22 18:40:00,10,27,18,2,9,1,0,67
2024-03-22 18:50:00,8,16,23,10,27,0,0,84
2024-03-22 19:00:00,15,35,36,16,21,1,0,124
2024-03-22 19:10:00,20,34,31,15,34,0,0,134
2024-03-22 19:20:00,26,26,36,10,25,1,0,124
2024-03-22 19:30:00,20,43,30,14,27,0,0,134
2024-03-22 19:40:00,22,40,68,22,34,1,0,187
2024-03-22 19:50:00,28,56,141,13,49,1,0,288
2024-03-22 20:00:00,20,40,19,17,31,0,0,127
2024-03-22 20:10:00,15,28,21,11,35,0,0,110
2024-03-22 20:20:00,18,32,187,13,30,0,0,280
2024-03-22 20:30:00,20,33,16,8,23,0,0,100
2024-03-22 20:40:00,14,39,20,10,21,0,0,104
2024-03-22 20:50:00,14,14,18,10,20,0,0,76
2024-03-22 21:00:00,17,32,19,11,15,1,0,95
2024-03-22 21:10:00,17,28,89,15,17,0,0,166
2024-03-22 21:20:00,18,19,22,7,12,1,0,79
2024-03-22 21:30:00,15,24,20,3,16,0,0,78
2024-03-22 21:40:00,20,20,28,7,22,0,0,97
2024-03-22 21:50:00,27,26,17,8,20,0,0,98
2024-03-22 22:00:00,23,32,14,14,22,0,0,105
2024-03-22 22:10:00,12,51,90,12,18,2,0,185
2024-03-22 22:20:00,14,19,16,9,20,0,0,78
2024-03-22 22:30:00,12,30,11,8,12,0,0,73
2024-03-22 22:40:00,15,26,24,8,13,0,0,86
2024-03-22 22:50:00,13,25,20,10,13,0,0,81
2024-03-22 23:00:00,17,19,14,6,7,3,0,66
2024-03-22 23:10:00,18,21,11,7,13,0,0,70
2024-03-22 23:20:00,17,17,14,3,15,0,0,66
2024-03-22 23:30:00,11,9,14,5,9,0,0,48
2024-03-22 23:40:00,11,25,20,2,8,0,0,66
2024-03-22 23:50:00,12,15,9,3,4,0,0,43
2024-03-23 00:00:00,13,17,12,5,10,0,0,57
2024-03-23 00:10:00,4,34,105,4,7,0,0,154
2024-03-23 00:20:00,14,19,8,1,11,0,0,53
2024-03-23 00:30:00,7,29,13,3,8,0,0,60
2024-03-23 00:40:00,6,10,8,1,6,0,0,31
2024-03-23 00:50:00,6,3,10,4,7,0,0,30
2024-03-23 01:00:00,12,17,6,7,8,0,0,50
2024-03-23 01:10:00,8,17,74,2,8,0,0,109
2024-03-23 01:20:00,10,4,5,7,6,0,0,32
2024-03-23 01:30:00,2,8,7,3,10,0,0,30
2024-03-23 01:40:00,10,11,12,1,6,0,0,40
2024-03-23 01:50:00,4,5,5,1,7,0,0,22
2024-03-23 02:00:00,4,3,8,3,4,0,0,22
2024-03-23 02:10:00,7,9,15,0,1,0,0,32
2024-03-23 02:20:00,8,5,5,2,1,0,0,21
2024-03-23 02:30:00,9,9,8,3,4,0,0,33
2024-03-23 02:40:00,4,13,10,0,7,0,0,34
2024-03-23 02:50:00,4,5,3,3,4,0,0,19
2024-03-23 03:00:00,5,2,1,1,5,0,0,14
2024-03-23 03:10:00,4,5,35,1,3,0,0,48
2024-03-23 03:20:00,4,3,1,2,1,0,0,11
2024-03-23 03:30:00,4,4,2,2,3,0,0,15
2024-03-23 03:40:00,2,7,5,1,2,0,0,17
2024-03-23 03:50:00,6,4,2,0,3,0,0,15
2024-03-23 04:00:00,4,8,1,4,1,0,0,18
2024-03-23 04:10:00,8,4,6,1,3,1,0,23
2024-03-23 04:20:00,2,8,5,2,2,0,0,19
2024-03-23 04:30:00,2,6,1,2,4,0,0,15
2024-03-23 04:40:00,4,9,5,0,9,0,0,27
2024-03-23 04:50:00,5,8,3,1,3,0,0,20
2024-03-23 05:00:00,4,5,5,1,8,0,0,23
2024-03-23 05:10:00,5,7,8,3,3,0,0,26
2024-03-23 05:20:00,5,9,7,1,4,0,0,26
2024-03-23 05:30:00,5,16,14,2,16,0,0,53
2024-03-23 05:40:00,5,9,9,6,11,0,0,40
2024-03-23 05:50:00,3,3,13,4,5,0,0,28
2024-03-23 06:00:00,1,9,8,1,4,0,0,23
2024-03-23 06:10:00,4,25,7,5,2,0,0,43
2024-03-23 06:20:00,5,9,15,3,9,0,0,41
2024-03-23 06:30:00,12,13,6,2,6,0,0,39
2024-03-23 06:40:00,7,5,5,3,7,0,0,27
2024-03-23 06:50:00,7,9,6,2,13,0,0,37
2024-03-23 07:00:00,7,8,4,2,10,1,0,32
2024-03-23 07:10:00,7,8,10,2,10,0,0,37
2024-03-23 07:20:00,3,17,9,1,7,1,0,38
2024-03-23 07:30:00,9,10,11,4,8,1,0,43
2024-03-23 07:40:00,14,12,6,13,6,0,0,51
2024-03-23 07:50:00,9,10,13,2,19,0,0,53
2024-03-23 08:00:00,5,23,11,7,9,0,0,55
2024-03-23 08:10:00,7,17,11,6,14,0,0,55
2024-03-23 08:20:00,8,10,12,5,14,0,0,49
2024-03-23 08:30:00,14,21,13,6,21,0,0,75
2024-03-23 08:40:00,14,18,10,5,23,1,0,71
2024-03-23 08:50:00,13,21,24,13,15,1,0,87
2024-03-23 09:00:00,8,24,8,15,21,1,0,77
2024-03-23 09:10:00,15,32,24,13,22,0,0,106
2024-03-23 09:20:00,16,34,13,15,33,3,0,114
2024-03-23 09:30:00,15,37,22,9,31,2,0,116
2024-03-23 09:40:00,11,27,18,17,27,0,0,100
2024-03-23 09:50:00,18,36,18,10,32,0,0,114
2024-03-23 10:00:00,20,40,21,14,28,0,0,123
2024-03-23 10:10:00,13,30,21,12,23,1,0,100
2024-03-23 10:20:00,20,25,25,9,41,0,0,120
2024-03-23 10:30:00,13,33,25,20,31,0,0,122
2024-03-23 10:40:00,18,59,21,13,29,0,0,140
2024-03-23 10:50:00,22,32,22,11,30,0,0,117
2024-03-23 11:00:00,17,32,31,15,32,0,0,127
2024-03-23 11:10:00,18,44,24,19,24,0,0,129
2024-03-23 11:20:00,20,45,28,12,32,2,0,139
2024-03-23 11:30:00,13,50,21,7,33,0,0,124
2024-03-23 11:40:00,21,46,29,11,39,0,0,146
2024-03-23 11:50:00,17,50,27,12,31,0,0,137
2024-03-23 12:00:00,21,32,20,15,39,0,0,127
2024-03-23 12:10:00,24,65,27,18,35,0,0,169
2024-03-23 12:20:00,22,36,19,14,25,1,0,117
2024-03-23 12:30:00,25,55,20,18,36,0,0,154
2024-03-23 12:40:00,17,48,27,22,40,1,0,155
2024-03-23 12:50:00,23,48,22,12,35,0,0,140
2024-03-23 13:00:00,19,51,28,10,30,2,0,140
2024-03-23 13:10:00,22,51,33,4,35,0,0,145
2024-03-23 13:20:00,20,51,27,6,33,1,0,138
2024-03-23 13:30:00,25,61,25,15,37,0,0,163
2024-03-23 13:40:00,21,46,24,15,33,0,0,139
2024-03-23 13:50:00,18,44,37,19,23,0,0,141
2024-03-23 14:00:00,25,45,25,17,29,1,0,142
2024-03-23 14:10:00,23,52,22,15,31,0,0,143
2024-03-23 14:20:00,28,49,24,17,31,0,0,149
2024-03-23 14:30:00,20,34,39,19,35,0,0,147
2024-03-23 14:40:00,21,43,26,15,34,0,0,139
2024-03-23 14:50:00,19,44,31,14,37,0,0,145
2024-03-23 15:00:00,21,50,24,12,30,0,0,137
2024-03-23 15:10:00,26,40,29,16,25,2,0,138
2024-03-23 15:20:00,28,39,41,7,45,1,0,161
2024-03-23 15:30:00,18,35,19,19,29,1,0,121
2024-03-23 15:40:00,22,42,25,21,28,0,0,138
2024-03-23 15:50:00,24,37,24,18,30,1,0,134
2024-03-23 16:00:00,15,40,21,12,31,6,0,125
2024-03-23 16:10:00,18,49,25,22,41,1,0,156
2024-03-23 16:20:00,18,43,30,14,31,0,0,136
2024-03-23 16:30:00,20,46,24,11,39,0,0,140
2024-03-23 16:40:00,31,36,25,22,27,0,0,141
2024-03-23 16:50:00,18,44,32,14,33,3,0,144
2024-03-23 17:00:00,25,69,20,19,33,2,0,168
2024-03-23 17:10:00,26,33,27,16,43,1,0,146
2024-03-23 17:20:00,25,31,31,19,51,3,0,160
2024-03-23 17:30:00,22,42,24,8,33,0,0,129
2024-03-23 17:40:00,29,29,25,13,35,1,0,132
2024-03-23 17:50:00,30,47,23,12,43,0,0,155
2024-03-23 18:00:00,20,33,18,7,34,0,0,112
2024-03-23 18:10:00,22,42,21,15,28,3,0,131
2024-03-23 18:20:00,21,30,25,14,39,0,0,129
2024-03-23 18:30:00,22,31,19,8,34,0,0,114
2024-03-23 18:40:00,24,31,15,13,32,0,0,115
2024-03-23 18:50:00,18,61,16,13,28,2,0,138
2024-03-23 19:00:00,17,30,12,10,21,0,0,90
2024-03-23 19:10:00,21,28,22,11,26,1,0,109
2024-03-23 19:20:00,27,25,23,8,27,2,0,112
2024-03-23 19:30:00,15,26,23,9,30,0,0,103
2024-03-23 19:40:00,18,31,20,13,32,1,0,115
2024-03-23 19:50:00,18,45,22,20,24,1,0,130
2024-03-23 20:00:00,15,35,18,11,34,0,0,113
2024-03-23 20:10:00,29,33,23,12,32,0,0,129
2024-03-23 20:20:00,19,18,24,8,28,0,0,97
2024-03-23 20:30:00,13,26,15,12,28,0,0,94
2024-03-23 20:40:00,12,23,14,12,20,1,0,82
2024-03-23 20:50:00,9,20,17,4,15,1,0,66
2024-03-23 21:00:00,15,24,14,6,16,0,0,75
2024-03-23 21:10:00,9,35,13,10,22,0,0,89
2024-03-23 21:20:00,19,29,15,8,17,0,0,88
2024-03-23 21:30:00,10,38,12,8,10,1,0,79
2024-03-23 21:40:00,12,18,12,4,17,0,0,63
2024-03-23 21:50:00,12,15,15,8,16,0,0,66
2024-03-23 22:00:00,14,19,17,3,11,0,0,64
2024-03-23 22:10:00,14,25,15,7,14,0,0,75
2024-03-23 22:20:00,12,24,22,10,11,0,0,79
2024-03-23 22:30:00,13,26,15,6,20,0,0,80
2024-03-23 22:40:00,14,42,20,11,15,0,0,102
2024-03-23 22:50:00,11,20,24,7,16,0,0,78
2024-03-23 23:00:00,9,39,14,16,19,0,0,97
2024-03-23 23:10:00,10,27,17,4,9,0,0,67
2024-03-23 23:20:00,13,19,12,0,13,1,0,58
2024-03-23 23:30:00,16,31,8,8,16,0,0,79
2024-03-23 23:40:00,16,19,18,3,13,1,0,70
2024-03-23 23:50:00,9,15,11,3,16,0,0,54
2024-03-24 00:00:00,9,7,13,3,8,0,0,40
2024-03-24 00:10:00,9,22,9,2,10,0,0,52
2024-03-24 00:20:00,9,13,14,3,6,0,0,45
2024-03-24 00:30:00,9,22,8,2,10,0,0,51
2024-03-24 00:40:00,6,11,4,2,10,0,0,33
2024-03-24 00:50:00,7,9,10,3,8,0,0,37
2024-03-24 01:00:00,11,5,15,8,10,0,0,49
2024-03-24 01:10:00,9,11,9,3,2,0,0,34
2024-03-24 01:20:00,8,11,11,1,6,0,0,37
2024-03-24 01:30:00,5,15,9,1,7,0,0,37
2024-03-24 01:40:00,6,19,6,2,6,0,0,39
2024-03-24 01:50:00,3,3,6,2,7,0,0,21
2024-03-24 02:00:00,2,5,6,2,3,0,0,18
2024-03-24 02:10:00,4,10,10,0,5,0,0,29
2024-03-24 02:20:00,7,2,6,2,4,0,0,21
2024-03-24 02:30:00,2,6,8,3,4,0,0,23
2024-03-24 02:40:00,5,7,7,1,2,0,0,22
2024-03-24 02:50:00,2,1,2,3,3,0,0,11
2024-03-24 03:00:00,5,5,2,1,4,1,0,18
2024-03-24 03:10:00,2,4,5,1,2,0,0,14
2024-03-24 03:20:00,1,2,4,2,8,0,0,17
2024-03-24 03:30:00,1,5,4,1,2,0,0,13
2024-03-24 03:40:00,3,1,2,3,2,0,0,11
2024-03-24 03:50:00,0,5,2,0,4,0,0,11
2024-03-24 04:00:00,4,2,3,1,2,0,0,12
2024-03-24 04:10:00,1,3,4,0,2,0,0,10
2024-03-24 04:20:00,3,4,3,0,1,0,0,11
2024-03-24 04:30:00,2,12,5,2,2,0,0,23
2024-03-24 04:40:00,4,8,6,0,3,0,0,21
2024-03-24 04:50:00,2,6,1,2,1,0,0,12
2024-03-24 05:00:00,4,7,3,2,2,0,0,18
2024-03-24 05:10:00,1,4,2,3,3,0,0,13
2024-03-24 05:20:00,4,4,4,0,6,0,0,18
2024-03-24 05:30:00,2,2,8,3,9,0,0,24
2024-03-24 05:40:00,3,5,3,4,6,0,0,21
2024-03-24 05:50:00,1,2,7,1,2,0,0,13
2024-03-24 06:00:00,6,4,2,3,4,0,0,19
2024-03-24 06:10:00,3,12,6,3,7,0,0,31
2024-03-24 06:20:00,6,9,4,2,4,0,0,25
2024-03-24 06:30:00,6,9,3,2,4,0,0,24
2024-03-24 06:40:00,5,3,4,2,3,0,0,17
2024-03-24 06:50:00,8,7,5,3,1,0,0,24
2024-03-24 07:00:00,5,6,4,2,4,0,0,21
2024-03-24 07:10:00,2,8,4,6,4,0,0,24
2024-03-24 07:20:00,4,7,3,1,4,0,0,19
2024-03-24 07:30:00,2,5,7,3,4,0,0,21
2024-03-24 07:40:00,5,5,5,2,4,0,0,21
2024-03-24 07:50:00,4,1,5,1,3,0,0,14
2024-03-24 08:00:00,2,11,7,5,6,0,0,31
2024-03-24 08:10:00,4,3,8,4,6,0,0,25
2024-03-24 08:20:00,3,9,3,3,8,0,0,26
2024-03-24 08:30:00,8,7,6,3,10,1,0,35
2024-03-24 08:40:00,11,7,3,4,9,0,0,34
2024-03-24 08:50:00,5,11,8,12,12,0,0,48
2024-03-24 09:00:00,4,19,8,8,13,0,0,52
2024-03-24 09:10:00,11,7,7,7,15,1,0,48
2024-03-24 09:20:00,6,10,7,6,15,0,0,44
2024-03-24 09:30:00,18,12,9,7,12,0,0,58
2024-03-24 09:40:00,7,11,10,9,12,0,0,49
2024-03-24 09:50:00,11,26,8,10,19,0,0,74
2024-03-24 10:00:00,10,17,9,7,16,0,0,59
2024-03-24 10:10:00,16,31,14,7,23,0,0,91
2024-03-24 10:20:00,17,15,8,7,25,0,0,72
2024-03-24 10:30:00,20,19,9,10,20,0,0,78
2024-03-24 10:40:00,15,25,10,3,25,0,0,78
2024-03-24 10:50:00,15,29,20,12,26,0,0,102
2024-03-24 11:00:00,16,13,22,6,24,0,0,81
2024-03-24 11:10:00,11,18,18,13,19,0,0,79
2024-03-24 11:20:00,10,14,14,12,8,2,0,60
2024-03-24 11:30:00,20,21,20,4,15,1,0,81
2024-03-24 11:40:00,13,23,19,12,31,0,0,98
2024-03-24 11:50:00,10,30,32,11,28,1,0,112
2024-03-24 12:00:00,20,18,16,14,31,0,0,99
2024-03-24 12:10:00,10,27,11,5,33,1,0,87
2024-03-24 12:20:00,21,29,23,12,39,1,0,125
2024-03-24 12:30:00,12,31,17,8,33,2,0,103
2024-03-24 12:40:00,13,19,73,11,29,0,0,145
2024-03-24 12:50:00,18,28,25,10,33,1,0,115
2024-03-24 13:00:00,20,23,16,11,19,0,0,89
2024-03-24 13:10:00,17,33,17,13,23,0,0,103
2024-03-24 13:20:00,18,25,21,12,24,0,0,100
2024-03-24 13:30:00,23,20,22,11,29,0,0,105
2024-03-24 13:40:00,21,19,15,16,30,0,0,101
2024-03-24 13:50:00,19,23,25,18,34,0,0,119
2024-03-24 14:00:00,24,20,37,16,27,0,0,124
2024-03-24 14:10:00,22,35,29,12,30,0,0,128
2024-03-24 14:20:00,17,26,27,19,30,0,0,119
2024-03-24 14:30:00,21,37,25,15,30,0,0,128
2024-03-24 14:40:00,25,30,17,14,31,0,0,117
2024-03-24 14:50:00,16,34,20,12,25,0,0,107
2024-03-24 15:00:00,22,20,28,15,35,0,0,120
2024-03-24 15:10:00,21,28,22,11,33,2,0,117
2024-03-24 15:20:00,20,18,18,15,41,2,0,114
2024-03-24 15:30:00,26,40,19,13,28,1,0,127
2024-03-24 15:40:00,20,34,22,18,34,0,0,128
2024-03-24 15:50:00,19,27,28,11,39,1,0,125
2024-03-24 16:00:00,16,29,17,18,40,1,0,121
2024-03-24 16:10:00,31,37,30,17,26,1,0,142
2024-03-24 16:20:00,21,32,28,18,20,2,0,121
2024-03-24 16:30:00,25,32,27,12,25,3,0,124
2024-03-24 16:40:00,18,35,19,10,37,0,0,119
2024-03-24 16:50:00,21,32,29,10,30,1,0,123
2024-03-24 17:00:00,15,36,20,12,29,0,0,112
2024-03-24 17:10:00,26,33,20,14,31,0,0,124
2024-03-24 17:20:00,18,28,22,20,44,2,0,134
2024-03-24 17:30:00,29,44,28,20,37,1,0,159
2024-03-24 17:40:00,26,28,20,20,43,0,0,137
2024-03-24 17:50:00,16,35,28,13,25,1,0,118
2024-03-24 18:00:00,21,28,19,21,25,0,0,114
2024-03-24 18:10:00,24,25,20,10,37,0,0,116
2024-03-24 18:20:00,20,34,24,17,30,1,0,126
2024-03-24 18:30:00,17,31,22,12,36,1,0,119
2024-03-24 18:40:00,19,27,28,13,43,0,0,130
2024-03-24 18:50:00,19,21,21,15,37,0,0,113
2024-03-24 19:00:00,18,30,18,13,21,1,0,101
2024-03-24 19:10:00,20,24,18,14,22,1,0,99
2024-03-24 19:20:00,14,14,14,13,21,0,0,76
2024-03-24 19:30:00,15,34,23,4,24,1,0,101
2024-03-24 19:40:00,13,26,10,22,18,0,0,89
2024-03-24 19:50:00,12,22,22,11,23,1,0,91
2024-03-24 20:00:00,21,38,21,19,31,0,0,130
2024-03-24 20:10:00,15,33,20,16,33,1,0,118
2024-03-24 20:20:00,14,23,16,10,18,0,0,81
2024-03-24 20:30:00,13,37,20,11,25,0,0,106
2024-03-24 20:40:00,13,21,17,9,18,0,0,78
2024-03-24 20:50:00,15,17,19,10,20,0,0,81
2024-03-24 21:00:00,9,13,23,7,14,1,0,67
2024-03-24 21:10:00,11,18,11,10,19,0,0,69
2024-03-24 21:20:00,17,20,16,5,18,2,0,78
2024-03-24 21:30:00,11,26,21,8,21,0,0,87
2024-03-24 21:40:00,22,19,12,8,16,0,0,77
2024-03-24 21:50:00,31,10,12,1,14,2,0,70
2024-03-24 22:00:00,13,14,14,5,15,0,0,61
2024-03-24 22:10:00,13,14,14,5,10,2,0,58
2024-03-24 22:20:00,10,12,10,4,15,0,0,51
2024-03-24 22:30:00,11,16,12,6,9,0,0,54
2024-03-24 22:40:00,10,24,7,4,14,0,0,59
2024-03-24 22:50:00,17,10,10,2,8,1,0,48
2024-03-24 23:00:00,6,16,11,4,10,0,0,47
2024-03-24 23:10:00,11,10,8,1,8,0,0,38
2024-03-24 23:20:00,7,13,8,4,5,0,0,37
2024-03-24 23:30:00,4,17,7,5,7,0,0,40
2024-03-24 23:40:00,6,14,8,2,9,0,0,39
2024-03-24 23:50:00,4,6,7,2,8,0,0,27
2024-03-25 00:00:00,6,7,5,4,1,0,0,23
2024-03-25 00:10:00,4,9,7,2,6,0,0,28
2024-03-25 00:20:00,3,4,5,2,3,0,0,17
2024-03-25 00:30:00,6,15,7,1,11,0,0,40
2024-03-25 00:40:00,1,5,4,3,1,0,0,14
2024-03-25 00:50:00,2,5,2,1,1,0,0,11
2024-03-25 01:00:00,3,6,3,4,7,0,0,23
2024-03-25 01:10:00,2,8,2,1,4,0,0,17
2024-03-25 01:20:00,5,5,4,1,3,0,0,18
2024-03-25 01:30:00,3,5,4,1,3,0,0,16
2024-03-25 01:40:00,2,2,1,1,3,0,0,9
2024-03-25 01:50:00,1,3,3,0,1,0,0,8
2024-03-25 02:00:00,2,3,3,0,3,0,0,11
2024-03-25 02:10:00,2,1,1,1,3,0,0,8
2024-03-25 02:20:00,2,2,5,0,2,0,0,11
2024-03-25 02:30:00,3,2,2,1,1,0,0,9
2024-03-25 02:40:00,2,0,2,2,2,0,0,8
2024-03-25 02:50:00,3,1,3,0,0,0,0,7
2024-03-25 03:00:00,1,3,2,1,2,0,0,9
2024-03-25 03:10:00,0,1,1,0,1,0,0,3
2024-03-25 03:20:00,1,1,2,4,2,0,0,10
2024-03-25 03:30:00,2,2,2,1,1,0,0,8
2024-03-25 03:40:00,1,0,0,2,4,0,0,7
2024-03-25 03:50:00,1,3,3,0,4,0,0,11
2024-03-25 04:00:00,2,3,3,1,2,0,0,11
2024-03-25 04:10:00,5,2,4,2,2,0,0,15
2024-03-25 04:20:00,5,3,3,0,4,0,0,15
2024-03-25 04:30:00,6,4,4,0,3,0,0,17
2024-03-25 04:40:00,3,3,3,2,6,1,0,18
2024-03-25 04:50:00,1,3,6,1,9,0,0,20
2024-03-25 05:00:00,4,9,7,3,8,0,0,31
2024-03-25 05:10:00,7,11,6,4,11,0,0,39
2024-03-25 05:20:00,3,10,6,3,11,0,0,33
2024-03-25 05:30:00,8,9,11,8,22,0,0,58
2024-03-25 05:40:00,9,16,10,12,26,0,0,73
2024-03-25 05:50:00,11,15,11,8,28,1,0,74
2024-03-25 06:00:00,14,19,10,7,33,0,0,83
2024-03-25 06:10:00,15,25,19,9,34,0,0,102
2024-03-25 06:20:00,22,31,12,8,46,0,0,119
2024-03-25 06:30:00,15,29,18,7,33,0,0,102
2024-03-25 06:40:00,35,32,13,7,28,0,0,115
2024-03-25 06:50:00,31,33,19,16,60,0,0,159
2024-03-25 07:00:00,23,30,21,19,50,0,0,143
2024-03-25 07:10:00,29,25,22,15,43,0,0,134
2024-03-25 07:20:00,22,39,22,11,61,3,0,158
2024-03-25 07:30:00,17,50,22,23,49,0,0,161
2024-03-25 07:40:00,24,28,37,21,53,2,0,165
2024-03-25 07:50:00,27,50,27,25,53,0,0,182
2024-03-25 08:00:00,33,35,28,12,37,0,0,145
2024-03-25 08:10:00,23,39,18,20,48,1,0,149
2024-03-25 08:20:00,29,55,24,33,53,1,0,195
2024-03-25 08:30:00,28,52,28,22,48,0,0,178
2024-03-25 08:40:00,23,36,29,21,39,0,0,148
2024-03-25 08:50:00,34,43,33,30,61,0,0,201
2024-03-25 09:00:00,27,46,20,20,44,1,0,158
2024-03-25 09:10:00,21,32,31,25,45,0,0,154
2024-03-25 09:20:00,21,42,24,27,56,0,0,170
2024-03-25 09:30:00,20,49,26,16,37,0,0,148
2024-03-25 09:40:00,21,59,21,28,38,1,0,168
2024-03-25 09:50:00,24,51,24,22,39,0,0,160
2024-03-25 10:00:00,20,46,29,13,50,0,0,158
2024-03-25 10:10:00,38,43,31,16,47,0,0,175
2024-03-25 10:20:00,23,42,22,15,42,0,0,144
2024-03-25 10:30:00,24,42,25,11,40,0,0,142
2024-03-25 10:40:00,27,36,28,13,40,0,0,144
2024-03-25 10:50:00,32,47,23,26,35,0,0,163
2024-03-25 11:00:00,27,47,21,13,40,0,0,148
2024-03-25 11:10:00,23,40,23,22,29,1,0,138
2024-03-25 11:20:00,26,50,36,17,31,1,0,161
2024-03-25 11:30:00,18,37,31,13,38,0,0,137
2024-03-25 11:40:00,24,37,28,15,35,0,0,139
2024-03-25 11:50:00,29,45,32,11,45,1,0,163
2024-03-25 12:00:00,25,36,31,17,30,2,0,141
2024-03-25 12:10:00,32,53,36,25,42,0,0,188
2024-03-25 12:20:00,31,32,27,17,42,2,0,151
2024-03-25 12:30:00,26,56,26,12,31,1,0,152
2024-03-25 12:40:00,21,43,27,15,44,0,0,150
2024-03-25 12:50:00,22,44,32,13,28,1,0,140
2024-03-25 13:00:00,23,42,21,13,40,0,0,139
2024-03-25 13:10:00,28,41,29,16,39,0,0,153
2024-03-25 13:20:00,23,36,27,18,41,1,0,146
2024-03-25 13:30:00,20,44,36,14,30,4,0,148
2024-03-25 13:40:00,23,46,23,18,48,7,0,165
2024-03-25 13:50:00,23,50,19,9,39,2,0,142
2024-03-25 14:00:00,28,42,43,17,45,1,0,176
2024-03-25 14:10:00,26,47,19,18,36,0,0,146
2024-03-25 14:20:00,25,51,32,10,26,0,0,144
2024-03-25 14:30:00,31,54,42,17,46,0,0,190
2024-03-25 14:40:00,30,56,25,25,48,3,0,187
2024-03-25 14:50:00,40,50,28,19,44,1,0,182
2024-03-25 15:00:00,33,52,29,18,42,1,0,175
2024-03-25 15:10:00,30,49,47,24,42,1,0,193
2024-03-25 15:20:00,44,44,32,22,42,4,0,188
2024-03-25 15:30:00,39,47,41,18,44,0,0,189
2024-03-25 15:40:00,33,51,27,17,51,2,0,181
2024-03-25 15:50:00,35,46,33,26,45,3,0,188
2024-03-25 16:00:00,39,64,34,18,35,1,0,191
2024-03-25 16:10:00,39,50,37,25,42,1,0,194
2024-03-25 16:20:00,28,51,32,30,48,4,0,193
2024-03-25 16:30:00,28,55,31,22,43,2,0,181
2024-03-25 16:40:00,33,79,34,29,54,2,0,231
2024-03-25 16:50:00,32,50,35,16,46,2,0,181
2024-03-25 17:00:00,33,62,33,31,47,1,0,207
2024-03-25 17:10:00,38,49,24,27,53,2,0,193
2024-03-25 17:20:00,28,47,33,16,44,1,0,169
2024-03-25 17:30:00,20,41,34,15,46,1,0,157
2024-03-25 17:40:00,31,56,26,19,43,0,0,175
2024-03-25 17:50:00,26,43,33,27,50,3,0,182
2024-03-25 18:00:00,25,53,22,20,34,0,0,154
2024-03-25 18:10:00,37,41,25,16,30,0,0,149
2024-03-25 18:20:00,24,40,35,20,52,1,0,172
2024-03-25 18:30:00,31,64,27,15,40,0,0,177
2024-03-25 18:40:00,29,44,24,16,37,0,0,150
2024-03-25 18:50:00,32,40,28,9,21,1,0,131
2024-03-25 19:00:00,15,60,19,13,20,0,0,127
2024-03-25 19:10:00,20,51,26,13,29,2,0,141
2024-03-25 19:20:00,25,15,27,8,16,0,0,91
2024-03-25 19:30:00,14,29,13,16,26,0,0,98
2024-03-25 19:40:00,15,26,22,13,27,1,0,104
2024-03-25 19:50:00,15,22,15,13,20,1,0,86
2024-03-25 20:00:00,18,34,26,11,30,0,0,119
2024-03-25 20:10:00,13,30,17,10,20,1,0,91
2024-03-25 20:20:00,19,32,20,11,26,1,0,109
2024-03-25 20:30:00,17,22,16,10,24,0,0,89
2024-03-25 20:40:00,16,24,14,13,16,0,0,83
2024-03-25 20:50:00,17,20,14,7,19,0,0,77
2024-03-25 21:00:00,18,22,13,5,20,1,0,79
2024-03-25 21:10:00,21,20,20,16,16,0,0,93
2024-03-25 21:20:00,17,19,17,5,21,0,0,79
2024-03-25 21:30:00,14,25,16,9,21,2,0,87
2024-03-25 21:40:00,15,18,12,5,15,1,0,66
2024-03-25 21:50:00,20,14,33,4,10,0,0,81
2024-03-25 22:00:00,25,18,20,6,10,0,0,79
2024-03-25 22:10:00,17,15,16,3,17,0,0,68
2024-03-25 22:20:00,10,18,13,0,14,0,0,55
2024-03-25 22:30:00,8,28,14,4,10,0,0,64
2024-03-25 22:40:00,14,21,13,6,7,1,0,62
2024-03-25 22:50:00,11,14,6,3,6,0,0,40
2024-03-25 23:00:00,15,21,8,6,8,0,0,58
2024-03-25 23:10:00,8,12,11,3,15,0,0,49
2024-03-25 23:20:00,12,11,12,4,6,0,0,45
2024-03-25 23:30:00,4,25,7,4,6,0,0,46
2024-03-25 23:40:00,11,13,13,2,6,0,0,45
2024-03-25 23:50:00,3,7,5,4,10,0,0,29
2024-03-26 00:00:00,8,13,7,6,5,0,0,39
2024-03-26 00:10:00,6,10,7,1,2,1,0,27
2024-03-26 00:20:00,3,6,6,4,5,0,0,24
2024-03-26 00:30:00,5,10,4,3,7,0,0,29
2024-03-26 00:40:00,0,13,5,2,6,0,0,26
2024-03-26 00:50:00,2,1,6,2,3,0,0,14
2024-03-26 01:00:00,6,6,2,0,4,0,0,18
2024-03-26 01:10:00,2,2,2,0,5,0,0,11
2024-03-26 01:20:00,3,3,2,2,5,0,0,15
2024-03-26 01:30:00,1,2,4,0,4,0,0,11
2024-03-26 01:40:00,2,5,2,0,2,0,0,11
2024-03-26 01:50:00,3,3,2,2,3,0,0,13
2024-03-26 02:00:00,1,3,1,1,2,0,0,8
2024-03-26 02:10:00,2,9,1,2,3,0,0,17
2024-03-26 02:20:00,1,1,1,0,3,0,0,6
2024-03-26 02:30:00,2,1,2,0,4,0,0,9
2024-03-26 02:40:00,0,2,3,2,1,0,0,8
2024-03-26 02:50:00,4,6,3,2,2,0,0,17
2024-03-26 03:00:00,4,0,2,2,1,0,0,9
2024-03-26 03:10:00,3,4,3,1,2,0,0,13
2024-03-26 03:20:00,2,2,2,1,2,0,0,9
2024-03-26 03:30:00,4,4,2,1,3,0,0,14
2024-03-26 03:40:00,2,2,6,0,4,0,0,14
2024-03-26 03:50:00,0,0,2,0,0,0,0,2
2024-03-26 04:00:00,2,3,1,1,3,0,0,10
2024-03-26 04:10:00,1,1,2,2,1,0,0,7
2024-03-26 04:20:00,6,4,3,0,2,0,0,15
2024-03-26 04:30:00,3,3,4,0,5,0,0,15
2024-03-26 04:40:00,7,7,4,1,5,0,0,24
2024-03-26 04:50:00,2,6,5,0,5,0,0,18
2024-03-26 05:00:00,1,6,10,4,11,0,0,32
2024-03-26 05:10:00,7,11,9,2,14,1,0,44
2024-03-26 05:20:00,7,12,10,2,9,0,0,40
2024-03-26 05:30:00,7,10,9,7,23,0,0,56
2024-03-26 05:40:00,16,18,9,8,27,0,0,78
2024-03-26 05:50:00,13,25,12,15,46,0,0,111
2024-03-26 06:00:00,19,16,18,8,33,1,0,95
2024-03-26 06:10:00,21,23,21,10,35,0,0,110
2024-03-26 06:20:00,24,29,19,11,42,0,0,125
2024-03-26 06:30:00,21,29,18,7,38,0,0,113
2024-03-26 06:40:00,20,27,26,17,51,0,0,141
2024-03-26 06:50:00,26,28,22,18,63,0,0,157
2024-03-26 07:00:00,15,28,19,12,48,0,0,122
2024-03-26 07:10:00,24,41,24,11,45,1,0,146
2024-03-26 07:20:00,18,49,17,16,57,0,0,157
2024-03-26 07:30:00,25,33,25,22,51,0,0,156
2024-03-26 07:40:00,23,35,25,21,50,0,0,154
2024-03-26 07:50:00,26,37,24,32,59,1,0,179
2024-03-26 08:00:00,22,54,22,18,35,2,0,153
2024-03-26 08:10:00,25,27,26,27,47,0,0,152
2024-03-26 08:20:00,20,39,16,27,54,0,0,156
2024-03-26 08:30:00,18,56,27,23,49,0,0,173
2024-03-26 08:40:00,21,52,29,13,43,1,0,159
2024-03-26 08:50:00,31,35,29,24,55,0,0,174
2024-03-26 09:00:00,23,44,22,33,47,0,0,169
2024-03-26 09:10:00,28,41,35,18,47,0,0,169
2024-03-26 09:20:00,25,43,18,18,33,0,0,137
2024-03-26 09:30:00,20,39,24,12,28,0,0,123
2024-03-26 09:40:00,23,30,18,28,52,1,0,152
2024-03-26 09:50:00,19,41,30,17,43,2,0,152
2024-03-26 10:00:00,21,43,24,12,42,1,0,143
2024-03-26 10:10:00,25,39,23,21,41,2,0,151
2024-03-26 10:20:00,22,39,26,8,22,0,0,117
2024-03-26 10:30:00,24,63,31,18,48,0,0,184
2024-03-26 10:40:00,27,50,26,16,48,0,0,167
2024-03-26 10:50:00,32,45,28,12,50,0,0,167
2024-03-26 11:00:00,23,57,24,17,48,0,0,169
2024-03-26 11:10:00,35,34,27,19,35,0,0,150
2024-03-26 11:20:00,25,54,58,11,48,0,0,196
2024-03-26 11:30:00,26,48,26,22,36,0,0,158
2024-03-26 11:40:00,20,41,31,22,40,1,0,155
2024-03-26 11:50:00,26,38,20,22,40,1,0,147
2024-03-26 12:00:00,25,41,30,17,33,1,0,147
2024-03-26 12:10:00,28,52,28,23,51,0,0,182
2024-03-26 12:20:00,26,51,32,14,34,2,0,159
2024-03-26 12:30:00,25,46,26,15,35,1,0,148
2024-03-26 12:40:00,20,37,27,32,45,0,0,161
2024-03-26 12:50:00,30,39,30,15,33,0,0,147
2024-03-26 13:00:00,28,48,35,25,51,0,0,187
2024-03-26 13:10:00,30,60,28,18,48,1,0,185
2024-03-26 13:20:00,22,48,23,16,36,0,0,145
2024-03-26 13:30:00,32,45,25,19,36,1,0,158
2024-03-26 13:40:00,23,40,29,16,34,1,0,143
2024-03-26 13:50:00,25,42,28,15,38,1,0,149
2024-03-26 14:00:00,22,45,37,10,35,0,0,149
2024-03-26 14:10:00,32,47,29,16,50,2,0,176
2024-03-26 14:20:00,36,50,35,16,47,1,0,185
2024-03-26 14:30:00,37,62,34,12,32,1,0,178
2024-03-26 14:40:00,29,47,25,20,45,2,0,168
2024-03-26 14:50:00,34,53,26,13,43,1,0,170
2024-03-26 15:00:00,34,53,26,16,43,1,0,173
2024-03-26 15:10:00,25,56,24,16,35,1,0,157
2024-03-26 15:20:00,30,42,38,19,58,4,0,191
2024-03-26 15:30:00,33,51,37,17,58,0,0,196
2024-03-26 15:40:00,41,42,25,16,45,2,0,171
2024-03-26 15:50:00,25,60,41,25,46,2,0,199
2024-03-26 16:00:00,27,62,41,18,46,0,0,194
2024-03-26 16:10:00,24,56,41,27,49,0,0,197
2024-03-26 16:20:00,25,55,41,21,59,2,0,203
2024-03-26 16:30:00,29,58,31,27,41,0,0,186
2024-03-26 16:40:00,28,55,34,18,48,3,0,186
2024-03-26 16:50:00,26,56,21,14,46,16,0,179
2024-03-26 17:00:00,30,54,33,22,45,2,0,186
2024-03-26 17:10:00,33,67,26,25,42,0,0,193
2024-03-26 17:20:00,33,45,30,18,69,3,0,198
2024-03-26 17:30:00,28,67,58,20,58,2,0,233
2024-03-26 17:40:00,31,48,31,20,49,2,0,181
2024-03-26 17:50:00,30,47,19,75,49,0,0,220
2024-03-26 18:00:00,28,64,27,19,52,2,0,192
2024-03-26 18:10:00,29,47,42,25,45,0,0,188
2024-03-26 18:20:00,26,49,24,21,53,1,0,174
2024-03-26 18:30:00,29,65,28,14,35,1,0,172
2024-03-26 18:40:00,22,40,23,25,42,0,0,152
2024-03-26 18:50:00,22,45,22,17,34,2,0,142
2024-03-26 19:00:00,18,32,24,9,25,0,0,108
2024-03-26 19:10:00,22,29,27,23,36,3,0,140
2024-03-26 19:20:00,19,26,25,8,26,1,0,105
2024-03-26 19:30:00,26,34,21,13,25,0,0,119
2024-03-26 19:40:00,26,24,23,13,26,0,0,112
2024-03-26 19:50:00,20,30,25,19,27,1,0,122
2024-03-26 20:00:00,17,39,29,5,31,0,0,121
2024-03-26 20:10:00,13,32,24,10,32,0,0,111
2024-03-26 20:20:00,26,32,17,6,24,0,0,105
2024-03-26 20:30:00,25,31,31,11,25,0,0,123
2024-03-26 20:40:00,11,42,15,11,25,1,0,105
2024-03-26 20:50:00,18,26,14,8,21,0,0,87
2024-03-26 21:00:00,14,23,13,15,9,0,0,74
2024-03-26 21:10:00,18,17,15,16,17,0,0,83
2024-03-26 21:20:00,18,15,16,12,14,1,0,76
2024-03-26 21:30:00,12,24,16,9,17,0,0,78
2024-03-26 21:40:00,19,14,19,6,15,2,0,75
2024-03-26 21:50:00,19,63,17,7,17,0,0,123
2024-03-26 22:00:00,11,15,17,7,13,0,0,63
2024-03-26 22:10:00,17,18,14,3,14,1,0,67
2024-03-26 22:20:00,11,13,15,2,12,0,0,53
2024-03-26 22:30:00,7,28,17,8,17,0,0,77
2024-03-26 22:40:00,9,16,16,4,15,1,0,61
2024-03-26 22:50:00,15,15,12,6,4,0,0,52
2024-03-26 23:00:00,12,16,10,2,7,0,0,47
2024-03-26 23:10:00,16,15,12,5,8,0,0,56
2024-03-26 23:20:00,9,12,7,3,8,1,0,40
2024-03-26 23:30:00,7,13,18,6,11,0,0,55
2024-03-26 23:40:00,8,13,5,3,8,0,0,37
2024-03-26 23:50:00,6,7,3,2,8,0,0,26
2024-03-27 00:00:00,7,16,8,4,3,0,0,38
2024-03-27 00:10:00,4,7,8,2,10,0,0,31
2024-03-27 00:20:00,7,4,6,2,6,0,0,25
2024-03-27 00:30:00,3,12,10,3,9,0,0,37
2024-03-27 00:40:00,3,5,6,3,2,0,0,19
2024-03-27 00:50:00,3,8,5,1,2,1,0,20
2024-03-27 01:00:00,5,6,1,1,5,0,0,18
2024-03-27 01:10:00,1,2,3,3,3,0,0,12
2024-03-27 01:20:00,4,4,2,2,6,0,0,18
2024-03-27 01:30:00,4,7,3,2,2,1,0,19
2024-03-27 01:40:00,2,4,2,2,2,0,0,12
2024-03-27 01:50:00,4,4,2,0,1,0,0,11
2024-03-27 02:00:00,0,4,1,0,1,0,0,6
2024-03-27 02:10:00,0,5,2,0,2,0,0,9
2024-03-27 02:20:00,5,0,2,0,6,0,0,13
2024-03-27 02:30:00,3,4,1,0,1,0,0,9
2024-03-27 02:40:00,0,1,4,1,5,0,0,11
2024-03-27 02:50:00,1,0,0,0,1,0,0,2
2024-03-27 03:00:00,4,2,2,0,1,0,0,9
2024-03-27 03:10:00,4,4,1,2,2,0,0,13
2024-03-27 03:20:00,3,3,4,0,1,0,0,11
2024-03-27 03:30:00,4,5,1,1,3,0,0,14
2024-03-27 03:40:00,2,1,0,0,3,0,0,6
2024-03-27 03:50:00,1,0,0,2,7,0,0,10
2024-03-27 04:00:00,1,4,3,1,2,0,0,11
2024-03-27 04:10:00,2,1,2,1,1,0,0,7
2024-03-27 04:20:00,5,7,2,1,5,0,0,20
2024-03-27 04:30:00,4,11,4,2,3,0,0,24
2024-03-27 04:40:00,2,7,7,3,4,0,0,23
2024-03-27 04:50:00,2,13,7,0,6,0,0,28
2024-03-27 05:00:00,6,11,8,1,9,0,0,35
2024-03-27 05:10:00,7,8,9,2,14,0,0,40
2024-03-27 05:20:00,7,14,9,4,7,1,0,42
2024-03-27 05:30:00,10,31,10,8,24,0,0,83
2024-03-27 05:40:00,9,17,21,7,23,0,0,77
2024-03-27 05:50:00,12,21,9,5,39,0,0,86
2024-03-27 06:00:00,23,19,18,9,29,0,0,98
2024-03-27 06:10:00,22,25,14,9,36,1,0,107
2024-03-27 06:20:00,21,20,15,5,35,1,0,97
2024-03-27 06:30:00,19,34,18,11,54,0,0,136
2024-03-27 06:40:00,21,34,20,13,59,0,0,147
2024-03-27 06:50:00,26,28,20,11,53,1,0,139
2024-03-27 07:00:00,24,24,23,10,49,0,0,130
2024-03-27 07:10:00,18,19,21,12,49,2,0,121
2024-03-27 07:20:00,29,39,23,20,48,0,0,159
2024-03-27 07:30:00,28,38,27,19,39,0,0,151
2024-03-27 07:40:00,20,47,22,19,52,1,0,161
2024-03-27 07:50:00,24,30,21,21,36,1,0,133
2024-03-27 08:00:00,21,46,26,17,44,1,0,155
2024-03-27 08:10:00,26,28,21,29,45,0,0,149
2024-03-27 08:20:00,16,35,19,27,47,2,0,146
2024-03-27 08:30:00,21,36,21,24,41,1,0,144
2024-03-27 08:40:00,17,35,32,28,52,1,0,165
2024-03-27 08:50:00,20,47,25,19,60,0,0,171
2024-03-27 09:00:00,20,45,18,25,32,0,0,140
2024-03-27 09:10:00,17,22,22,23,44,0,0,128
2024-03-27 09:20:00,27,52,33,16,37,0,0,165
2024-03-27 09:30:00,30,35,24,13,50,0,0,152
2024-03-27 09:40:00,17,37,25,19,43,0,0,141
2024-03-27 09:50:00,20,38,26,9,43,0,0,136
2024-03-27 10:00:00,23,46,16,10,59,0,0,154
2024-03-27 10:10:00,29,43,24,11,33,0,0,140
2024-03-27 10:20:00,23,36,21,14,26,0,0,120
2024-03-27 10:30:00,27,46,31,19,48,0,0,171
2024-03-27 10:40:00,23,40,27,18,46,0,0,154
2024-03-27 10:50:00,25,45,29,20,29,0,0,148
2024-03-27 11:00:00,26,41,35,16,41,1,0,160
2024-03-27 11:10:00,20,40,38,12,43,0,0,153
2024-03-27 11:20:00,27,45,24,11,38,0,0,145
2024-03-27 11:30:00,28,42,37,21,36,0,0,164
2024-03-27 11:40:00,30,45,17,10,38,3,0,143
2024-03-27 11:50:00,23,40,26,22,35,2,0,148
2024-03-27 12:00:00,21,35,24,18,45,2,0,145
2024-03-27 12:10:00,31,49,22,16,35,0,0,153
2024-03-27 12:20:00,19,42,27,19,45,2,0,154
2024-03-27 12:30:00,29,46,36,13,38,0,0,162
2024-03-27 12:40:00,28,52,38,19,40,1,0,178
2024-03-27 12:50:00,26,50,24,17,37,0,0,154
2024-03-27 13:00:00,26,47,31,18,57,0,0,179
2024-03-27 13:10:00,30,53,21,23,41,1,0,169
2024-03-27 13:20:00,20,53,27,9,41,0,0,150
2024-03-27 13:30:00,25,38,31,18,47,0,0,159
2024-03-27 13:40:00,29,63,30,23,43,0,0,188
2024-03-27 13:50:00,30,55,34,19,42,1,0,181
2024-03-27 14:00:00,33,46,23,14,32,1,0,149
2024-03-27 14:10:00,35,59,28,17,34,1,0,174
2024-03-27 14:20:00,27,48,24,17,40,0,0,156
2024-03-27 14:30:00,31,62,33,14,48,4,0,192
2024-03-27 14:40:00,31,55,30,21,35,0,0,172
2024-03-27 14:50:00,43,46,29,12,44,2,0,176
2024-03-27 15:00:00,32,54,24,26,55,1,0,192
2024-03-27 15:10:00,29,58,32,17,40,1,0,177
2024-03-27 15:20:00,29,56,28,17,45,2,0,177
2024-03-27 15:30:00,29,48,38,19,43,0,0,177
2024-03-27 15:40:00,32,56,27,27,59,2,0,203
2024-03-27 15:50:00,34,61,29,23,55,3,0,205
2024-03-27 16:00:00,29,65,36,21,37,1,0,189
2024-03-27 16:10:00,28,59,40,31,43,3,0,204
2024-03-27 16:20:00,31,53,40,29,47,3,0,203
2024-03-27 16:30:00,22,54,38,16,47,0,0,177
2024-03-27 16:40:00,35,76,22,26,46,2,0,207
2024-03-27 16:50:00,32,91,33,22,46,1,0,225
2024-03-27 17:00:00,22,98,31,30,49,2,0,232
2024-03-27 17:10:00,25,58,24,32,52,0,0,191
2024-03-27 17:20:00,23,52,32,26,56,1,0,190
2024-03-27 17:30:00,25,66,24,19,48,0,0,182
2024-03-27 17:40:00,31,55,36,34,56,1,0,213
2024-03-27 17:50:00,30,42,28,14,42,0,0,156
2024-03-27 18:00:00,19,55,27,22,46,2,0,171
2024-03-27 18:10:00,26,57,33,31,43,2,0,192
2024-03-27 18:20:00,30,46,28,20,36,1,0,161
2024-03-27 18:30:00,27,61,28,16,42,0,0,174
2024-03-27 18:40:00,28,41,30,17,37,0,0,153
2024-03-27 18:50:00,24,29,21,16,28,0,0,118
2024-03-27 19:00:00,16,50,24,15,28,0,0,133
2024-03-27 19:10:00,17,43,26,15,28,0,0,129
2024-03-27 19:20:00,25,35,21,21,26,0,0,128
2024-03-27 19:30:00,25,50,17,13,28,0,0,133
2024-03-27 19:40:00,15,37,31,12,25,0,0,120
2024-03-27 19:50:00,15,36,21,16,26,1,0,115
2024-03-27 20:00:00,24,40,23,14,23,2,0,126
2024-03-27 20:10:00,15,30,26,12,49,0,0,132
2024-03-27 20:20:00,20,33,23,12,31,1,0,120
2024-03-27 20:30:00,21,20,17,14,23,0,0,95
2024-03-27 20:40:00,7,39,20,16,23,1,0,106
2024-03-27 20:50:00,12,16,15,6,21,2,0,72
2024-03-27 21:00:00,20,16,17,10,21,10,0,94
2024-03-27 21:10:00,14,23,20,15,15,0,0,87
2024-03-27 21:20:00,16,19,20,10,23,1,0,89
2024-03-27 21:30:00,16,28,13,7,13,0,0,77
2024-03-27 21:40:00,16,18,17,4,24,0,0,79
2024-03-27 21:50:00,19,20,22,10,12,3,0,86
2024-03-27 22:00:00,24,24,19,13,15,0,0,95
2024-03-27 22:10:00,11,17,16,7,8,0,0,59
2024-03-27 22:20:00,24,29,15,7,16,0,0,91
2024-03-27 22:30:00,10,22,15,9,18,0,0,74
2024-03-27 22:40:00,14,23,12,9,15,0,0,73
2024-03-27 22:50:00,12,15,8,1,12,0,0,48
2024-03-27 23:00:00,12,16,12,3,15,0,0,58
2024-03-27 23:10:00,14,13,7,5,13,0,0,52
2024-03-27 23:20:00,3,16,11,4,11,0,0,45
2024-03-27 23:30:00,8,22,10,8,8,0,0,56
2024-03-27 23:40:00,5,16,14,3,9,1,0,48
2024-03-27 23:50:00,7,6,9,1,7,0,0,30
2024-03-28 00:00:00,9,10,11,7,5,0,0,42
2024-03-28 00:10:00,5,13,10,1,7,0,0,36
2024-03-28 00:20:00,3,12,7,2,4,0,0,28
2024-03-28 00:30:00,9,10,7,4,12,0,0,42
2024-03-28 00:40:00,4,6,5,2,4,0,0,21
2024-03-28 00:50:00,2,9,4,2,3,0,0,20
2024-03-28 01:00:00,6,3,2,1,6,0,0,18
2024-03-28 01:10:00,2,12,5,0,3,0,0,22
2024-03-28 01:20:00,2,5,4,1,6,0,0,18
2024-03-28 01:30:00,2,5,4,1,3,0,0,15
2024-03-28 01:40:00,2,2,1,1,0,0,0,6
2024-03-28 01:50:00,2,4,2,1,4,0,0,13
2024-03-28 02:00:00,0,3,3,2,1,0,0,9
2024-03-28 02:10:00,0,3,2,0,1,0,0,6
2024-03-28 02:20:00,0,2,1,0,2,0,0,5
2024-03-28 02:30:00,2,4,5,1,5,0,0,17
2024-03-28 02:40:00,3,0,1,1,1,0,0,6
2024-03-28 02:50:00,4,2,1,2,2,0,0,11
2024-03-28 03:00:00,2,0,2,2,0,0,0,6
2024-03-28 03:10:00,0,3,0,1,2,0,0,6
2024-03-28 03:20:00,2,0,1,0,1,0,0,4
2024-03-28 03:30:00,3,4,3,1,3,0,0,14
2024-03-28 03:40:00,3,0,3,1,0,0,0,7
2024-03-28 03:50:00,3,2,0,0,5,0,0,10
2024-03-28 04:00:00,1,2,3,2,1,0,0,9
2024-03-28 04:10:00,2,1,1,1,1,0,0,6
2024-03-28 04:20:00,3,5,4,2,5,0,0,19
2024-03-28 04:30:00,3,7,7,1,1,0,0,19
2024-03-28 04:40:00,5,5,4,3,7,1,0,25
2024-03-28 04:50:00,4,7,6,1,3,0,0,21
2024-03-28 05:00:00,1,7,10,1,7,0,0,26
2024-03-28 05:10:00,8,5,6,6,11,1,0,37
2024-03-28 05:20:00,6,16,10,3,15,0,0,50
2024-03-28 05:30:00,9,15,12,10,15,0,0,61
2024-03-28 05:40:00,11,13,14,9,28,1,0,76
2024-03-28 05:50:00,12,22,11,10,35,0,0,90
2024-03-28 06:00:00,15,16,18,7,30,0,0,86
2024-03-28 06:10:00,20,27,14,10,34,2,0,107
2024-03-28 06:20:00,23,29,13,12,42,0,0,119
2024-03-28 06:30:00,27,30,16,7,33,0,0,113
2024-03-28 06:40:00,22,28,16,8,54,0,0,128
2024-03-28 06:50:00,22,25,21,8,56,0,0,132
2024-03-28 07:00:00,28,35,26,7,49,0,0,145
2024-03-28 07:10:00,23,30,19,11,32,1,0,116
2024-03-28 07:20:00,19,35,23,18,40,1,0,136
2024-03-28 07:30:00,18,35,25,18,47,0,0,143
2024-03-28 07:40:00,19,42,37,19,46,3,0,166
2024-03-28 07:50:00,22,45,20,28,39,0,0,154
2024-03-28 08:00:00,16,39,17,23,60,0,0,155
2024-03-28 08:10:00,20,24,28,20,30,2,0,124
2024-03-28 08:20:00,17,44,23,17,44,0,0,145
2024-03-28 08:30:00,20,39,23,33,39,1,0,155
2024-03-28 08:40:00,26,33,33,19,49,0,0,160
2024-03-28 08:50:00,21,30,19,27,51,2,0,150
2024-03-28 09:00:00,29,38,20,16,38,0,0,141
2024-03-28 09:10:00,21,46,30,27,43,0,0,167
2024-03-28 09:20:00,18,32,18,22,37,1,0,128
2024-03-28 09:30:00,24,44,27,18,39,0,0,152
2024-03-28 09:40:00,38,33,16,22,43,2,0,154
2024-03-28 09:50:00,29,48,31,23,48,0,0,179
2024-03-28 10:00:00,18,44,30,19,36,0,0,147
2024-03-28 10:10:00,22,50,24,26,40,0,0,162
2024-03-28 10:20:00,16,63,23,29,58,0,0,189
2024-03-28 10:30:00,23,100,26,25,30,0,0,204
2024-03-28 10:40:00,21,47,43,17,44,0,0,172
2024-03-28 10:50:00,25,51,38,15,42,1,0,172
2024-03-28 11:00:00,23,37,23,15,47,0,0,145
2024-03-28 11:10:00,20,51,20,17,33,1,0,142
2024-03-28 11:20:00,26,60,21,14,32,1,0,154
2024-03-28 11:30:00,33,50,28,15,43,1,0,170
2024-03-28 11:40:00,25,54,26,17,37,0,0,159
2024-03-28 11:50:00,28,37,27,21,53,1,0,167
2024-03-28 12:00:00,31,64,28,19,50,0,0,192
2024-03-28 12:10:00,24,46,30,25,35,0,0,160
2024-03-28 12:20:00,30,48,26,16,32,0,0,152
2024-03-28 12:30:00,37,61,25,28,41,2,0,194
2024-03-28 12:40:00,31,71,29,17,40,2,0,190
2024-03-28 12:50:00,24,63,43,20,38,0,0,188
2024-03-28 13:00:00,36,59,34,16,36,1,0,182
2024-03-28 13:10:00,25,66,34,24,50,2,0,201
2024-03-28 13:20:00,29,42,29,17,41,0,0,158
2024-03-28 13:30:00,25,52,25,21,44,0,0,167
2024-03-28 13:40:00,27,51,29,22,34,0,0,163
2024-03-28 13:50:00,19,35,30,27,58,1,0,170
2024-03-28 14:00:00,26,57,36,23,48,1,0,191
2024-03-28 14:10:00,27,104,28,19,33,1,0,212
2024-03-28 14:20:00,29,55,32,26,51,3,0,196
2024-03-28 14:30:00,31,59,34,15,37,0,0,176
2024-03-28 14:40:00,37,50,37,23,50,0,0,197
2024-03-28 14:50:00,43,49,33,19,50,3,0,197
2024-03-28 15:00:00,35,49,30,15,51,0,0,180
2024-03-28 15:10:00,36,73,33,29,52,2,0,225
2024-03-28 15:20:00,34,52,30,18,56,3,0,193
2024-03-28 15:30:00,36,74,33,25,48,1,0,217
2024-03-28 15:40:00,29,75,28,29,54,3,0,218
2024-03-28 15:50:00,27,61,36,23,54,2,0,203
2024-03-28 16:00:00,30,62,36,28,44,2,0,202
2024-03-28 16:10:00,37,55,44,23,51,2,0,212
2024-03-28 16:20:00,27,56,32,32,51,1,0,199
2024-03-28 16:30:00,36,88,44,30,57,1,0,256
2024-03-28 16:40:00,27,100,35,15,50,1,0,228
2024-03-28 16:50:00,33,51,25,23,54,0,0,186
2024-03-28 17:00:00,34,61,22,24,31,2,0,174
2024-03-28 17:10:00,28,69,44,18,47,2,0,208
2024-03-28 17:20:00,30,36,30,22,53,1,0,172
2024-03-28 17:30:00,32,76,33,22,55,0,0,218
2024-03-28 17:40:00,26,72,30,103,54,0,0,285
2024-03-28 17:50:00,31,48,30,17,45,1,0,172
2024-03-28 18:00:00,33,51,25,22,27,2,0,160
2024-03-28 18:10:00,26,52,34,21,32,0,0,165
2024-03-28 18:20:00,28,53,17,17,33,4,0,152
2024-03-28 18:30:00,30,59,28,18,34,0,0,169
2024-03-28 18:40:00,31,54,19,27,41,1,0,173
2024-03-28 18:50:00,16,30,27,21,28,1,0,123
2024-03-28 19:00:00,47,41,32,15,35,0,0,170
2024-03-28 19:10:00,23,43,23,16,24,0,0,129
2024-03-28 19:20:00,18,37,15,13,31,1,0,115
2024-03-28 19:30:00,23,51,20,19,29,0,0,142
2024-03-28 19:40:00,20,27,24,21,24,1,0,117
2024-03-28 19:50:00,19,31,22,10,20,0,0,102
2024-03-28 20:00:00,21,43,21,17,33,1,0,136
2024-03-28 20:10:00,15,42,16,16,29,1,0,119
2024-03-28 20:20:00,21,35,22,12,23,1,0,114
2024-03-28 20:30:00,14,39,18,12,27,0,0,110
2024-03-28 20:40:00,21,47,26,11,28,0,0,133
2024-03-28 20:50:00,13,23,18,9,19,0,0,82
2024-03-28 21:00:00,16,25,22,9,32,0,0,104
2024-03-28 21:10:00,30,27,24,15,20,0,0,116
2024-03-28 21:20:00,24,29,23,9,19,0,0,104
2024-03-28 21:30:00,11,24,20,9,15,1,0,80
2024-03-28 21:40:00,14,29,19,9,14,1,0,86
2024-03-28 21:50:00,19,20,20,11,10,0,0,80
2024-03-28 22:00:00,22,28,23,6,20,0,0,99
2024-03-28 22:10:00,13,30,24,7,19,1,0,94
2024-03-28 22:20:00,16,22,24,11,23,0,0,96
2024-03-28 22:30:00,16,22,11,9,22,0,0,80
2024-03-28 22:40:00,10,27,12,10,21,0,0,80
2024-03-28 22:50:00,14,24,18,5,9,0,0,70
2024-03-28 23:00:00,14,26,14,4,12,0,0,70
2024-03-28 23:10:00,13,24,17,2,10,0,0,66
2024-03-28 23:20:00,13,17,12,4,8,0,0,54
2024-03-28 23:30:00,10,18,11,6,13,0,0,58
2024-03-28 23:40:00,11,22,10,1,7,0,0,51
2024-03-28 23:50:00,12,12,12,6,13,0,0,55
2024-03-29 00:00:00,5,31,9,5,9,0,0,59
2024-03-29 00:10:00,7,18,12,3,13,0,0,53
2024-03-29 00:20:00,6,22,7,6,8,0,0,49
2024-03-29 00:30:00,8,14,8,4,15,0,0,49
2024-03-29 00:40:00,7,7,5,4,10,0,0,33
2024-03-29 00:50:00,7,18,8,1,8,0,0,42
2024-03-29 01:00:00,0,8,15,2,12,0,0,37
2024-03-29 01:10:00,2,13,9,0,7,0,0,31
2024-03-29 01:20:00,6,3,8,4,2,0,0,23
2024-03-29 01:30:00,4,17,9,1,8,0,0,39
2024-03-29 01:40:00,9,3,6,1,2,1,0,22
2024-03-29 01:50:00,3,8,5,1,6,0,0,23
2024-03-29 02:00:00,2,3,3,2,4,0,0,14
2024-03-29 02:10:00,6,7,3,1,3,0,0,20
2024-03-29 02:20:00,1,3,3,1,7,0,0,15
2024-03-29 02:30:00,4,7,5,3,4,0,0,23
2024-03-29 02:40:00,2,7,3,2,3,0,0,17
2024-03-29 02:50:00,4,4,1,0,2,0,0,11
2024-03-29 03:00:00,1,3,3,1,1,0,0,9
2024-03-29 03:10:00,2,8,4,3,1,0,0,18
2024-03-29 03:20:00,3,3,3,1,3,0,0,13
2024-03-29 03:30:00,2,4,5,0,4,0,0,15
2024-03-29 03:40:00,3,3,3,1,1,0,0,11
2024-03-29 03:50:00,1,4,2,0,2,0,0,9
2024-03-29 04:00:00,1,3,4,5,3,0,0,16
2024-03-29 04:10:00,1,2,0,0,4,0,0,7
2024-03-29 04:20:00,3,6,5,0,3,0,0,17
2024-03-29 04:30:00,0,7,4,0,4,0,0,15
2024-03-29 04:40:00,3,11,5,0,1,0,0,20
2024-03-29 04:50:00,2,7,6,2,2,0,0,19
2024-03-29 05:00:00,2,6,6,1,9,0,0,24
2024-03-29 05:10:00,5,1,8,2,1,1,0,18
2024-03-29 05:20:00,3,8,1,9,8,0,0,29
2024-03-29 05:30:00,2,2,5,2,15,0,0,26
2024-03-29 05:40:00,4,3,4,4,13,1,0,29
2024-03-29 05:50:00,3,5,3,3,10,1,0,25
2024-03-29 06:00:00,2,14,7,2,7,0,0,32
2024-03-29 06:10:00,4,7,5,1,8,0,0,25
2024-03-29 06:20:00,5,13,1,1,15,0,0,35
2024-03-29 06:30:00,4,11,6,2,9,0,0,32
2024-03-29 06:40:00,6,4,5,1,10,0,0,26
2024-03-29 06:50:00,5,5,9,1,5,1,0,26
2024-03-29 07:00:00,3,6,5,2,6,0,0,22
2024-03-29 07:10:00,3,5,3,4,4,0,0,19
2024-03-29 07:20:00,3,4,7,0,1,1,0,16
2024-03-29 07:30:00,5,3,6,1,8,0,0,23
2024-03-29 07:40:00,3,7,4,7,5,0,0,26
2024-03-29 07:50:00,4,5,5,5,4,0,0,23
2024-03-29 08:00:00,4,6,5,3,6,1,0,25
2024-03-29 08:10:00,2,7,6,7,4,0,0,26
2024-03-29 08:20:00,3,9,9,2,10,0,0,33
2024-03-29 08:30:00,11,16,8,8,4,3,0,50
2024-03-29 08:40:00,6,12,13,1,7,1,0,40
2024-03-29 08:50:00,6,12,7,3,13,0,0,41
2024-03-29 09:00:00,4,11,5,6,13,1,0,40
2024-03-29 09:10:00,9,15,8,4,7,0,0,43
2024-03-29 09:20:00,8,11,11,4,17,0,0,51
2024-03-29 09:30:00,7,14,11,7,13,1,0,53
2024-03-29 09:40:00,14,10,5,8,17,1,0,55
2024-03-29 09:50:00,8,19,10,8,12,0,0,57
2024-03-29 10:00:00,10,10,13,4,13,0,0,50
2024-03-29 10:10:00,10,15,11,13,14,0,0,63
2024-03-29 10:20:00,12,14,17,6,17,1,0,67
2024-03-29 10:30:00,16,15,11,6,11,0,0,59
2024-03-29 10:40:00,12,17,8,6,11,0,0,54
2024-03-29 10:50:00,9,10,16,11,23,0,0,69
2024-03-29 11:00:00,12,15,15,9,13,0,0,64
2024-03-29 11:10:00,10,28,10,10,10,2,0,70
2024-03-29 11:20:00,10,15,12,5,26,1,0,69
2024-03-29 11:30:00,10,26,15,5,24,0,0,80
2024-03-29 11:40:00,10,13,13,6,22,1,0,65
2024-03-29 11:50:00,8,13,19,6,18,0,0,64
2024-03-29 12:00:00,14,19,11,9,27,1,0,81
2024-03-29 12:10:00,21,23,21,9,40,1,0,115
2024-03-29 12:20:00,19,18,15,20,21,0,0,93
2024-03-29 12:30:00,14,31,21,5,31,0,0,102
2024-03-29 12:40:00,10,24,16,12,44,0,0,106
2024-03-29 12:50:00,14,36,21,11,31,0,0,113
2024-03-29 13:00:00,17,16,14,11,22,0,0,80
2024-03-29 13:10:00,24,46,14,16,30,0,0,130
2024-03-29 13:20:00,17,30,22,13,30,1,0,113
2024-03-29 13:30:00,18,27,26,10,16,0,0,97
2024-03-29 13:40:00,29,27,24,13,26,1,0,120
2024-03-29 13:50:00,16,28,18,12,23,0,0,97
2024-03-29 14:00:00,20,23,23,11,17,0,0,94
2024-03-29 14:10:00,22,21,22,22,24,0,0,111
2024-03-29 14:20:00,22,21,22,15,24,0,0,104
2024-03-29 14:30:00,20,35,30,11,27,6,0,129
2024-03-29 14:40:00,23,26,17,14,37,0,0,117
2024-03-29 14:50:00,20,28,21,12,30,0,0,111
2024-03-29 15:00:00,20,29,19,11,23,1,0,103
2024-03-29 15:10:00,17,24,21,5,24,4,0,95
2024-03-29 15:20:00,18,22,19,4,28,0,0,91
2024-03-29 15:30:00,19,31,10,14,21,1,0,96
2024-03-29 15:40:00,20,29,19,11,26,0,0,105
2024-03-29 15:50:00,16,27,22,12,31,0,0,108
2024-03-29 16:00:00,17,39,14,14,27,0,0,111
2024-03-29 16:10:00,21,33,21,10,14,1,0,100
2024-03-29 16:20:00,16,24,23,13,22,0,0,98
2024-03-29 16:30:00,15,38,21,9,12,0,0,95
2024-03-29 16:40:00,34,46,13,13,20,2,0,128
2024-03-29 16:50:00,24,24,24,10,26,4,0,112
2024-03-29 17:00:00,20,30,18,8,35,0,0,111
2024-03-29 17:10:00,23,21,23,16,29,1,0,113
2024-03-29 17:20:00,20,23,20,22,35,0,0,120
2024-03-29 17:30:00,11,22,16,14,27,2,0,92
2024-03-29 17:40:00,25,28,17,8,30,4,0,112
2024-03-29 17:50:00,17,16,24,7,30,0,0,94
2024-03-29 18:00:00,23,24,23,4,18,0,0,92
2024-03-29 18:10:00,25,52,16,14,26,0,0,133
2024-03-29 18:20:00,18,23,20,13,30,1,0,105
2024-03-29 18:30:00,18,22,13,11,30,0,0,94
2024-03-29 18:40:00,19,26,16,10,28,0,0,99
2024-03-29 18:50:00,16,21,20,10,25,1,0,93
2024-03-29 19:00:00,9,22,23,5,12,1,0,72
2024-03-29 19:10:00,14,18,34,15,23,0,0,104
2024-03-29 19:20:00,13,21,28,9,10,0,0,81
2024-03-29 19:30:00,13,26,14,17,15,2,0,87
2024-03-29 19:40:00,16,16,11,8,20,0,0,71
2024-03-29 19:50:00,11,36,24,9,12,0,0,92
2024-03-29 20:00:00,19,22,11,7,13,2,0,74
2024-03-29 20:10:00,14,33,16,11,27,1,0,102
2024-03-29 20:20:00,19,26,17,16,20,0,0,98
2024-03-29 20:30:00,16,38,22,10,16,0,0,102
2024-03-29 20:40:00,14,21,10,11,18,0,0,74
2024-03-29 20:50:00,11,21,17,5,18,1,0,73
2024-03-29 21:00:00,9,27,18,9,22,0,0,85
2024-03-29 21:10:00,21,23,10,9,20,0,0,83
2024-03-29 21:20:00,13,19,11,7,21,0,0,71
2024-03-29 21:30:00,16,18,10,8,20,0,0,72
2024-03-29 21:40:00,11,15,16,5,16,0,0,63
2024-03-29 21:50:00,19,14,13,7,26,0,0,79
2024-03-29 22:00:00,14,25,17,6,15,0,0,77
2024-03-29 22:10:00,16,25,22,5,13,0,0,81
2024-03-29 22:20:00,7,12,13,8,11,0,0,51
2024-03-29 22:30:00,10,14,14,10,10,0,0,58
2024-03-29 22:40:00,7,16,8,7,11,0,0,49
2024-03-29 22:50:00,13,20,15,2,9,0,0,59
2024-03-29 23:00:00,7,13,12,3,9,1,0,45
2024-03-29 23:10:00,10,15,18,5,10,0,0,58
2024-03-29 23:20:00,6,19,11,3,7,1,0,47
2024-03-29 23:30:00,12,19,14,5,8,0,0,58
2024-03-29 23:40:00,9,9,9,3,13,0,0,43
2024-03-29 23:50:00,10,8,10,1,6,0,0,35
2024-03-30 00:00:00,7,15,8,7,11,0,0,48
2024-03-30 00:10:00,2,7,10,2,6,0,0,27
2024-03-30 00:20:00,7,12,8,2,5,0,0,34
2024-03-30 00:30:00,4,12,7,3,6,0,0,32
2024-03-30 00:40:00,6,12,2,1,11,0,0,32
2024-03-30 00:50:00,5,11,10,1,5,0,0,32
2024-03-30 01:00:00,5,9,8,2,9,0,0,33
2024-03-30 01:10:00,5,9,7,0,7,0,0,28
2024-03-30 01:20:00,4,7,8,2,4,0,0,25
2024-03-30 01:30:00,4,9,5,3,6,0,0,27
2024-03-30 01:40:00,8,6,6,1,3,0,0,24
2024-03-30 01:50:00,6,4,6,0,1,0,0,17
2024-03-30 02:00:00,2,4,8,1,3,0,0,18
2024-03-30 02:10:00,1,5,4,0,4,0,0,14
2024-03-30 02:20:00,5,9,3,1,3,0,0,21
2024-03-30 02:30:00,2,2,4,2,3,0,0,13
2024-03-30 02:40:00,4,9,0,1,3,0,0,17
2024-03-30 02:50:00,5,3,5,0,2,0,0,15
2024-03-30 03:00:00,2,1,6,0,1,0,0,10
2024-03-30 03:10:00,4,0,1,0,4,0,0,9
2024-03-30 03:20:00,4,4,3,3,1,0,0,15
2024-03-30 03:30:00,1,7,0,1,3,0,0,12
2024-03-30 03:40:00,0,4,7,2,2,0,0,15
2024-03-30 03:50:00,2,1,2,2,1,1,0,9
2024-03-30 04:00:00,2,4,3,3,3,0,0,15
2024-03-30 04:10:00,3,2,0,0,3,0,0,8
2024-03-30 04:20:00,3,4,7,0,2,0,0,16
2024-03-30 04:30:00,1,12,4,1,4,0,0,22
2024-03-30 04:40:00,7,7,3,1,2,0,0,20
2024-03-30 04:50:00,1,12,4,2,4,0,0,23
2024-03-30 05:00:00,5,6,7,2,5,1,0,26
2024-03-30 05:10:00,5,10,5,2,3,0,0,25
2024-03-30 05:20:00,6,8,7,4,6,0,0,31
2024-03-30 05:30:00,5,10,5,3,14,0,0,37
2024-03-30 05:40:00,2,12,4,4,13,0,0,35
2024-03-30 05:50:00,4,15,11,4,8,0,0,42
2024-03-30 06:00:00,4,5,4,2,13,0,0,28
2024-03-30 06:10:00,3,13,9,5,12,0,0,42
2024-03-30 06:20:00,3,4,4,4,12,1,0,28
2024-03-30 06:30:00,12,16,5,2,9,0,0,44
2024-03-30 06:40:00,8,7,7,2,8,0,0,32
2024-03-30 06:50:00,6,5,6,4,9,0,0,30
2024-03-30 07:00:00,5,10,7,2,10,0,0,34
2024-03-30 07:10:00,6,9,8,2,4,1,0,30
2024-03-30 07:20:00,6,6,5,3,11,0,0,31
2024-03-30 07:30:00,7,11,8,6,10,0,0,42
2024-03-30 07:40:00,6,10,7,7,12,0,0,42
2024-03-30 07:50:00,6,15,10,6,15,0,0,52
2024-03-30 08:00:00,6,8,8,6,9,0,0,37
2024-03-30 08:10:00,12,13,13,6,11,0,0,55
2024-03-30 08:20:00,9,15,11,6,23,1,0,65
2024-03-30 08:30:00,10,20,14,7,8,0,0,59
2024-03-30 08:40:00,8,17,12,10,19,0,0,66
2024-03-30 08:50:00,15,24,13,10,15,0,0,77
2024-03-30 09:00:00,9,27,12,13,12,0,0,73
2024-03-30 09:10:00,10,34,29,8,32,1,0,114
2024-03-30 09:20:00,13,35,24,20,20,2,0,114
2024-03-30 09:30:00,15,26,30,12,24,0,0,107
2024-03-30 09:40:00,18,27,26,14,39,1,0,125
2024-03-30 09:50:00,12,35,21,8,20,3,0,99
2024-03-30 10:00:00,19,46,19,15,29,0,0,128
2024-03-30 10:10:00,16,32,32,11,27,0,0,118
2024-03-30 10:20:00,10,67,23,14,23,0,0,137
2024-03-30 10:30:00,21,55,21,12,33,0,0,142
2024-03-30 10:40:00,18,48,29,18,33,1,0,147
2024-03-30 10:50:00,18,59,24,10,55,0,0,166
2024-03-30 11:00:00,13,44,25,14,23,1,0,120
2024-03-30 11:10:00,23,47,37,10,47,1,0,165
2024-03-30 11:20:00,19,38,30,12,25,1,0,125
2024-03-30 11:30:00,18,36,25,4,28,1,0,112
2024-03-30 11:40:00,16,73,28,21,29,2,0,169
2024-03-30 11:50:00,19,37,21,18,39,0,0,134
2024-03-30 12:00:00,20,39,30,14,31,0,0,134
2024-03-30 12:10:00,21,56,30,15,31,0,0,153
2024-03-30 12:20:00,26,38,24,15,40,1,0,144
2024-03-30 12:30:00,17,44,32,20,24,0,0,137
2024-03-30 12:40:00,21,47,29,19,38,0,0,154
2024-03-30 12:50:00,22,30,24,16,25,0,0,117
2024-03-30 13:00:00,20,53,28,10,32,0,0,143
2024-03-30 13:10:00,34,46,29,9,20,1,0,139
2024-03-30 13:20:00,23,33,19,18,35,1,0,129
2024-03-30 13:30:00,22,60,22,11,33,1,0,149
2024-03-30 13:40:00,16,43,29,8,32,0,0,128
2024-03-30 13:50:00,25,42,23,20,31,0,0,141
2024-03-30 14:00:00,22,50,26,21,31,0,0,150
2024-03-30 14:10:00,24,39,33,19,38,0,0,153
2024-03-30 14:20:00,23,41,36,14,31,1,0,146
2024-03-30 14:30:00,26,45,23,16,30,0,0,140
2024-03-30 14:40:00,25,31,34,12,40,0,0,142
2024-03-30 14:50:00,26,37,32,18,34,0,0,147
2024-03-30 15:00:00,23,39,25,17,26,1,0,131
2024-03-30 15:10:00,30,40,29,18,22,0,0,139
2024-03-30 15:20:00,24,31,23,12,37,0,0,127
2024-03-30 15:30:00,28,38,25,6,34,0,0,131
2024-03-30 15:40:00,16,38,29,11,31,0,0,125
2024-03-30 15:50:00,23,39,24,10,31,0,0,127
2024-03-30 16:00:00,22,46,26,13,21,5,0,133
2024-03-30 16:10:00,14,29,21,14,22,2,0,102
2024-03-30 16:20:00,28,33,27,15,25,0,0,128
2024-03-30 16:30:00,17,27,27,12,25,6,0,114
2024-03-30 16:40:00,26,38,25,15,26,0,0,130
2024-03-30 16:50:00,19,35,20,14,26,1,0,115
2024-03-30 17:00:00,27,37,31,5,28,2,0,130
2024-03-30 17:10:00,19,37,27,12,25,0,0,120
2024-03-30 17:20:00,13,25,30,21,26,0,0,115
2024-03-30 17:30:00,17,42,26,14,17,1,0,117
2024-03-30 17:40:00,29,31,24,12,28,0,0,124
2024-03-30 17:50:00,19,19,32,14,37,0,0,121
2024-03-30 18:00:00,14,40,27,10,22,0,0,113
2024-03-30 18:10:00,24,25,16,10,20,1,0,96
2024-03-30 18:20:00,18,28,23,13,32,0,0,114
2024-03-30 18:30:00,19,23,20,9,36,0,0,107
2024-03-30 18:40:00,21,20,21,22,27,0,0,111
2024-03-30 18:50:00,12,20,24,6,20,0,0,82
2024-03-30 19:00:00,14,22,17,9,21,1,0,84
2024-03-30 19:10:00,11,21,19,11,24,2,0,88
2024-03-30 19:20:00,21,21,16,10,22,1,0,91
2024-03-30 19:30:00,14,20,13,5,15,1,0,68
2024-03-30 19:40:00,16,24,15,10,19,0,0,84
2024-03-30 19:50:00,15,20,14,11,11,2,0,73
2024-03-30 20:00:00,14,34,18,7,18,2,0,93
2024-03-30 20:10:00,18,46,15,19,22,1,0,121
2024-03-30 20:20:00,12,28,35,10,28,3,0,116
2024-03-30 20:30:00,15,24,17,14,24,2,0,96
2024-03-30 20:40:00,11,23,14,11,25,0,0,84
2024-03-30 20:50:00,13,20,14,8,21,2,0,78
2024-03-30 21:00:00,13,19,21,10,15,0,0,78
2024-03-30 21:10:00,11,13,20,15,11,1,0,71
2024-03-30 21:20:00,14,18,20,8,14,0,0,74
2024-03-30 21:30:00,18,22,17,5,14,0,0,76
2024-03-30 21:40:00,11,18,19,7,17,2,0,74
2024-03-30 21:50:00,16,14,17,8,15,0,0,70
2024-03-30 22:00:00,15,12,19,9,30,0,0,85
2024-03-30 22:10:00,17,17,13,3,16,1,0,67
2024-03-30 22:20:00,9,20,26,6,19,0,0,80
2024-03-30 22:30:00,11,20,10,13,18,0,0,72
2024-03-30 22:40:00,18,19,22,5,11,0,0,75
2024-03-30 22:50:00,16,19,23,3,9,0,0,70
2024-03-30 23:00:00,15,24,17,4,15,1,0,76
2024-03-30 23:10:00,9,20,11,5,7,0,0,52
2024-03-30 23:20:00,11,25,13,0,12,0,0,61
2024-03-30 23:30:00,9,22,17,6,10,0,0,64
2024-03-30 23:40:00,6,10,9,6,13,0,0,44
2024-03-30 23:50:00,7,8,19,3,8,0,0,45
2024-03-31 00:00:00,10,15,7,3,12,0,0,47
2024-03-31 00:10:00,11,7,14,1,9,1,0,43
2024-03-31 00:20:00,11,14,7,7,7,0,0,46
2024-03-31 00:30:00,7,14,7,3,7,0,0,38
2024-03-31 00:40:00,16,12,12,3,8,0,0,51
2024-03-31 00:50:00,7,7,21,4,5,0,0,44
2024-03-31 01:00:00,6,10,8,2,4,0,0,30
2024-03-31 01:10:00,5,13,8,3,3,0,0,32
2024-03-31 01:20:00,10,7,11,4,8,0,0,40
2024-03-31 01:30:00,4,9,3,4,7,0,0,27
2024-03-31 01:40:00,2,8,8,2,7,0,0,27
2024-03-31 01:50:00,3,5,3,0,8,0,0,19
2024-03-31 02:00:00,0,0,0,0,0,0,0,0
2024-03-31 02:10:00,0,0,0,0,0,0,0,0
2024-03-31 02:20:00,0,0,0,0,0,0,0,0
2024-03-31 02:30:00,0,0,0,0,0,0,0,0
2024-03-31 02:40:00,0,0,0,0,0,0,0,0
2024-03-31 02:50:00,0,0,0,0,0,0,0,0
2024-03-31 03:00:00,0,0,0,0,0,0,0,0
2024-03-31 03:10:00,0,0,0,0,0,0,0,0
2024-03-31 03:20:00,0,0,0,0,0,0,0,0
2024-03-31 03:30:00,0,0,0,0,0,0,0,0
2024-03-31 03:40:00,0,0,0,0,0,0,0,0
2024-03-31 03:50:00,0,0,0,0,0,0,0,0
2024-03-31 04:00:00,3,4,6,3,7,0,0,23
2024-03-31 04:10:00,1,6,7,0,3,0,0,17
2024-03-31 04:20:00,4,6,6,0,5,0,0,21
2024-03-31 04:30:00,4,7,7,3,4,0,0,25
2024-03-31 04:40:00,2,3,8,2,4,0,0,19
2024-03-31 04:50:00,4,2,1,3,1,0,0,11
2024-03-31 05:00:00,3,3,9,0,4,0,0,19
2024-03-31 05:10:00,4,6,2,5,4,1,0,22
2024-03-31 05:20:00,9,6,2,4,5,1,0,27
2024-03-31 05:30:00,3,7,5,4,16,0,0,35
2024-03-31 05:40:00,11,5,10,5,6,0,0,37
2024-03-31 05:50:00,4,10,7,2,12,0,0,35
2024-03-31 06:00:00,8,3,9,2,8,0,0,30
2024-03-31 06:10:00,4,5,7,4,13,0,0,33
2024-03-31 06:20:00,2,8,5,3,14,0,0,32
2024-03-31 06:30:00,7,9,3,4,14,0,0,37
2024-03-31 06:40:00,9,3,7,1,7,0,0,27
2024-03-31 06:50:00,8,13,6,7,6,0,0,40
2024-03-31 07:00:00,0,8,7,1,4,0,0,20
2024-03-31 07:10:00,6,5,2,2,4,0,0,19
2024-03-31 07:20:00,3,7,3,0,8,1,0,22
2024-03-31 07:30:00,5,5,4,1,3,0,0,18
2024-03-31 07:40:00,1,6,1,6,9,0,0,23
2024-03-31 07:50:00,4,5,5,1,7,0,0,22
2024-03-31 08:00:00,4,3,2,3,6,0,0,18
2024-03-31 08:10:00,4,6,4,4,3,0,0,21
2024-03-31 08:20:00,3,7,8,3,5,0,0,26
2024-03-31 08:30:00,1,3,6,2,8,0,0,20
2024-03-31 08:40:00,5,6,6,1,10,0,0,28
2024-03-31 08:50:00,4,7,11,3,5,0,0,30
2024-03-31 09:00:00,2,12,7,6,11,0,0,38
2024-03-31 09:10:00,9,7,7,6,11,1,0,41
2024-03-31 09:20:00,5,10,7,5,16,0,0,43
2024-03-31 09:30:00,8,13,7,4,15,0,0,47
2024-03-31 09:40:00,8,7,5,8,15,0,0,43
2024-03-31 09:50:00,3,9,13,3,9,1,0,38
2024-03-31 10:00:00,8,13,9,4,15,0,0,49
2024-03-31 10:10:00,11,9,12,6,14,0,0,52
2024-03-31 10:20:00,15,7,11,4,21,0,0,58
2024-03-31 10:30:00,12,21,14,6,11,0,0,64
2024-03-31 10:40:00,13,15,13,9,23,0,0,73
2024-03-31 10:50:00,15,17,15,7,27,1,0,82
2024-03-31 11:00:00,12,9,10,9,20,0,0,60
2024-03-31 11:10:00,13,19,19,10,20,0,0,81
2024-03-31 11:20:00,11,13,15,6,16,1,0,62
2024-03-31 11:30:00,16,15,12,6,17,0,0,66
2024-03-31 11:40:00,11,17,17,12,24,0,0,81
2024-03-31 11:50:00,15,20,14,9,26,1,0,85
2024-03-31 12:00:00,14,14,20,12,23,0,0,83
2024-03-31 12:10:00,19,18,13,8,27,0,0,85
2024-03-31 12:20:00,20,19,21,6,30,0,0,96
2024-03-31 12:30:00,19,22,23,8,29,0,0,101
2024-03-31 12:40:00,20,29,24,6,23,0,0,102
2024-03-31 12:50:00,13,14,13,9,21,0,0,70
2024-03-31 13:00:00,17,14,14,10,29,0,0,84
2024-03-31 13:10:00,15,18,14,8,25,0,0,80
2024-03-31 13:20:00,15,24,23,7,26,0,0,95
2024-03-31 13:30:00,21,26,11,6,30,0,0,94
2024-03-31 13:40:00,11,19,19,9,25,0,0,83
2024-03-31 13:50:00,20,12,25,8,17,0,0,82
2024-03-31 14:00:00,17,22,17,10,30,1,0,97
2024-03-31 14:10:00,16,21,17,13,22,0,0,89
2024-03-31 14:20:00,21,13,18,14,34,2,0,102
2024-03-31 14:30:00,13,17,21,12,29,0,0,92
2024-03-31 14:40:00,13,18,21,9,25,0,0,86
2024-03-31 14:50:00,19,22,23,14,32,0,0,110
2024-03-31 15:00:00,20,17,22,9,35,3,0,106
2024-03-31 15:10:00,18,21,21,9,26,0,0,95
2024-03-31 15:20:00,15,17,34,9,25,0,0,100
2024-03-31 15:30:00,12,23,19,9,21,0,0,84
2024-03-31 15:40:00,25,17,25,8,24,0,0,99
2024-03-31 15:50:00,12,19,21,13,23,1,0,89
2024-03-31 16:00:00,14,29,16,9,18,0,0,86
2024-03-31 16:10:00,21,26,25,10,25,1,0,108
2024-03-31 16:20:00,17,17,25,12,17,1,0,89
2024-03-31 16:30:00,18,36,22,16,20,0,0,112
2024-03-31 16:40:00,17,20,20,4,29,3,0,93
2024-03-31 16:50:00,17,25,23,7,39,0,0,111
2024-03-31 17:00:00,20,16,24,10,40,0,0,110
2024-03-31 17:10:00,18,28,24,7,33,0,0,110
2024-03-31 17:20:00,16,18,18,18,22,0,0,92
2024-03-31 17:30:00,29,21,20,11,27,0,0,108
2024-03-31 17:40:00,34,28,26,11,34,1,0,134
2024-03-31 17:50:00,21,24,27,10,17,0,0,99
2024-03-31 18:00:00,16,21,21,10,23,0,0,91
2024-03-31 18:10:00,20,29,23,14,32,0,0,118
2024-03-31 18:20:00,19,31,17,13,34,0,0,114
2024-03-31 18:30:00,17,21,14,7,32,0,0,91
2024-03-31 18:40:00,13,20,20,15,29,1,0,98
2024-03-31 18:50:00,18,26,21,13,32,1,0,111
2024-03-31 19:00:00,16,16,18,17,25,0,0,92
2024-03-31 19:10:00,18,19,29,10,27,1,0,104
2024-03-31 19:20:00,15,33,25,11,41,0,0,125
2024-03-31 19:30:00,21,19,18,6,33,0,0,97
2024-03-31 19:40:00,19,26,20,10,24,0,0,99
2024-03-31 19:50:00,16,20,22,9,21,1,0,89
2024-03-31 20:00:00,9,12,16,6,16,0,0,59
2024-03-31 20:10:00,8,24,11,4,15,1,0,63
2024-03-31 20:20:00,15,21,13,6,20,0,0,75
2024-03-31 20:30:00,11,25,14,9,14,1,0,74
2024-03-31 20:40:00,10,18,22,6,23,2,0,81
2024-03-31 20:50:00,14,11,22,8,23,1,0,79
2024-03-31 21:00:00,16,29,20,8,14,0,0,87
2024-03-31 21:10:00,14,23,15,6,22,0,0,80
2024-03-31 21:20:00,10,28,19,5,18,1,0,81
2024-03-31 21:30:00,15,18,19,12,22,0,0,86
2024-03-31 21:40:00,15,14,18,8,32,1,0,88
2024-03-31 21:50:00,15,14,19,5,22,0,0,75
2024-03-31 22:00:00,19,20,23,4,17,0,0,83
2024-03-31 22:10:00,7,13,13,4,20,0,0,57
2024-03-31 22:20:00,6,23,12,4,15,1,0,61
2024-03-31 22:30:00,9,14,14,3,25,1,0,66
2024-03-31 22:40:00,14,19,10,6,9,0,0,58
2024-03-31 22:50:00,15,13,17,2,10,0,0,57
2024-03-31 23:00:00,16,15,17,8,11,0,0,67
2024-03-31 23:10:00,12,13,20,5,4,0,0,54
2024-03-31 23:20:00,15,13,14,5,9,1,0,57
2024-03-31 23:30:00,10,11,17,4,9,0,0,51
2024-03-31 23:40:00,14,12,9,5,16,0,0,56
2024-03-31 23:50:00,8,11,8,5,12,0,0,44
2024-04-01 00:00:00,13,14,13,2,10,0,0,52
2024-04-01 00:10:00,10,13,10,0,11,0,0,44
2024-04-01 00:20:00,10,8,9,2,6,0,0,35
2024-04-01 00:30:00,5,13,7,5,10,0,0,40
2024-04-01 00:40:00,9,11,8,1,6,0,0,35
2024-04-01 00:50:00,6,10,4,1,10,0,0,31
2024-04-01 01:00:00,3,6,9,2,7,0,0,27
2024-04-01 01:10:00,9,13,5,3,4,0,0,34
2024-04-01 01:20:00,5,7,11,1,4,0,0,28
2024-04-01 01:30:00,6,4,5,3,4,0,0,22
2024-04-01 01:40:00,8,6,8,1,7,0,0,30
2024-04-01 01:50:00,2,3,10,2,2,0,0,19
2024-04-01 02:00:00,3,7,8,4,5,1,0,28
2024-04-01 02:10:00,3,5,4,3,4,0,0,19
2024-04-01 02:20:00,5,4,4,1,2,0,0,16
2024-04-01 02:30:00,4,3,5,1,6,0,0,19
2024-04-01 02:40:00,4,7,5,1,3,0,0,20
2024-04-01 02:50:00,2,1,7,0,1,0,0,11
2024-04-01 03:00:00,1,0,3,0,3,0,0,7
2024-04-01 03:10:00,5,1,4,2,6,0,0,18
2024-04-01 03:20:00,8,2,5,0,5,0,0,20
2024-04-01 03:30:00,2,2,1,0,4,0,0,9
2024-04-01 03:40:00,3,4,2,2,3,0,0,14
2024-04-01 03:50:00,4,3,2,0,5,0,0,14
2024-04-01 04:00:00,3,6,4,1,3,2,0,19
2024-04-01 04:10:00,0,3,3,3,6,0,0,15
2024-04-01 04:20:00,3,6,6,0,4,0,0,19
2024-04-01 04:30:00,2,1,5,2,3,0,0,13
2024-04-01 04:40:00,2,6,2,2,2,0,0,14
2024-04-01 04:50:00,0,4,3,0,1,0,0,8
2024-04-01 05:00:00,4,4,2,2,5,0,0,17
2024-04-01 05:10:00,2,4,3,2,1,0,0,12
2024-04-01 05:20:00,8,6,1,1,7,0,0,23
2024-04-01 05:30:00,7,2,3,0,16,0,0,28
2024-04-01 05:40:00,3,6,6,3,9,1,0,28
2024-04-01 05:50:00,6,1,1,0,5,0,0,13
2024-04-01 06:00:00,10,5,5,0,9,0,0,29
2024-04-01 06:10:00,7,10,7,3,9,0,0,36
2024-04-01 06:20:00,7,20,5,2,11,0,0,45
2024-04-01 06:30:00,6,7,3,1,5,0,0,22
2024-04-01 06:40:00,5,12,5,5,8,0,0,35
2024-04-01 06:50:00,4,13,3,1,4,0,0,25
2024-04-01 07:00:00,4,4,3,1,1,0,0,13
2024-04-01 07:10:00,4,3,2,3,5,0,0,17
2024-04-01 07:20:00,3,7,1,1,3,0,0,15
2024-04-01 07:30:00,2,4,2,1,3,0,0,12
2024-04-01 07:40:00,1,3,2,1,2,0,0,9
2024-04-01 07:50:00,1,4,1,2,7,0,0,15
2024-04-01 08:00:00,2,3,7,4,4,0,0,20
2024-04-01 08:10:00,3,6,5,1,5,0,0,20
2024-04-01 08:20:00,6,3,4,2,5,0,0,20
2024-04-01 08:30:00,3,9,4,1,4,0,0,21
2024-04-01 08:40:00,6,9,5,3,3,0,0,26
2024-04-01 08:50:00,2,6,5,2,8,0,0,23
2024-04-01 09:00:00,1,9,3,5,7,1,0,26
2024-04-01 09:10:00,6,8,7,6,7,0,0,34
2024-04-01 09:20:00,3,6,10,0,12,0,0,31
2024-04-01 09:30:00,6,12,7,6,10,0,0,41
2024-04-01 09:40:00,6,6,7,7,13,0,0,39
2024-04-01 09:50:00,6,19,13,4,20,1,0,63
2024-04-01 10:00:00,5,15,12,4,8,0,0,44
2024-04-01 10:10:00,8,13,7,5,13,0,0,46
2024-04-01 10:20:00,10,13,14,3,18,0,0,58
2024-04-01 10:30:00,10,24,15,6,12,0,0,67
2024-04-01 10:40:00,12,12,8,9,11,1,0,53
2024-04-01 10:50:00,7,8,14,7,16,0,0,52
2024-04-01 11:00:00,11,25,13,9,11,0,0,69
2024-04-01 11:10:00,17,21,18,15,19,0,0,90
2024-04-01 11:20:00,17,29,14,7,18,0,0,85
2024-04-01 11:30:00,15,26,18,11,27,0,0,97
2024-04-01 11:40:00,8,10,12,9,14,0,0,53
2024-04-01 11:50:00,16,23,14,2,19,1,0,75
2024-04-01 12:00:00,15,20,12,4,24,0,0,75
2024-04-01 12:10:00,17,22,13,11,26,0,0,89
2024-04-01 12:20:00,14,23,23,3,26,0,0,89
2024-04-01 12:30:00,12,25,17,9,24,1,0,88
2024-04-01 12:40:00,15,24,14,9,28,2,0,92
2024-04-01 12:50:00,12,20,20,7,30,2,0,91
2024-04-01 13:00:00,16,28,19,15,21,1,0,100
2024-04-01 13:10:00,16,31,24,13,21,0,0,105
2024-04-01 13:20:00,10,20,18,7,28,0,0,83
2024-04-01 13:30:00,16,20,13,9,32,0,0,90
2024-04-01 13:40:00,16,28,16,17,25,0,0,102
2024-04-01 13:50:00,19,20,22,12,15,0,0,88
2024-04-01 14:00:00,14,18,17,5,19,1,0,74
2024-04-01 14:10:00,16,30,14,10,24,0,0,94
2024-04-01 14:20:00,16,40,22,5,25,0,0,108
2024-04-01 14:30:00,19,25,27,10,20,0,0,101
2024-04-01 14:40:00,19,41,15,11,36,0,0,122
2024-04-01 14:50:00,19,19,22,8,28,1,0,97
2024-04-01 15:00:00,12,25,19,12,27,0,0,95
2024-04-01 15:10:00,19,26,26,10,24,0,0,105
2024-04-01 15:20:00,17,20,18,10,25,1,0,91
2024-04-01 15:30:00,11,24,21,14,29,0,0,99
2024-04-01 15:40:00,19,29,19,12,24,0,0,103
2024-04-01 15:50:00,18,27,20,9,21,0,0,95
2024-04-01 16:00:00,21,19,20,16,17,1,0,94
2024-04-01 16:10:00,16,23,15,11,17,0,0,82
2024-04-01 16:20:00,24,25,25,17,25,2,0,118
2024-04-01 16:30:00,22,32,22,10,39,1,0,126
2024-04-01 16:40:00,24,28,22,9,21,0,0,104
2024-04-01 16:50:00,21,24,22,11,29,0,0,107
2024-04-01 17:00:00,14,26,22,12,28,0,0,102
2024-04-01 17:10:00,15,30,14,5,25,2,0,91
2024-04-01 17:20:00,21,35,23,19,32,2,0,132
2024-04-01 17:30:00,16,24,26,14,32,3,0,115
2024-04-01 17:40:00,16,30,23,11,21,0,0,101
2024-04-01 17:50:00,19,19,24,9,29,0,0,100
2024-04-01 18:00:00,18,38,22,13,24,0,0,115
2024-04-01 18:10:00,16,28,19,6,22,1,0,92
2024-04-01 18:20:00,14,29,25,13,28,1,0,110
2024-04-01 18:30:00,22,33,16,14,22,0,0,107
2024-04-01 18:40:00,17,23,20,14,26,0,0,100
2024-04-01 18:50:00,19,19,23,7,19,2,0,89
2024-04-01 19:00:00,17,25,17,7,29,1,0,96
2024-04-01 19:10:00,16,31,25,15,27,3,0,117
2024-04-01 19:20:00,16,36,30,17,30,0,0,129
2024-04-01 19:30:00,15,35,29,14,17,1,0,111
2024-04-01 19:40:00,14,22,24,15,20,0,0,95
2024-04-01 19:50:00,14,16,29,13,15,0,0,87
2024-04-01 20:00:00,21,25,25,13,24,0,0,108
2024-04-01 20:10:00,15,27,23,11,15,1,0,92
2024-04-01 20:20:00,8,21,23,5,15,0,0,72
2024-04-01 20:30:00,11,24,13,8,21,2,0,79
2024-04-01 20:40:00,8,19,14,9,21,1,0,72
2024-04-01 20:50:00,13,28,15,8,20,1,0,85
2024-04-01 21:00:00,16,28,19,7,16,0,0,86
2024-04-01 21:10:00,18,36,17,9,36,1,0,117
2024-04-01 21:20:00,17,28,20,8,36,0,0,109
2024-04-01 21:30:00,17,24,13,11,22,1,0,88
2024-04-01 21:40:00,15,16,18,10,20,0,0,79
2024-04-01 21:50:00,7,23,15,10,15,2,0,72
2024-04-01 22:00:00,5,20,15,5,17,0,0,62
2024-04-01 22:10:00,13,15,13,5,12,0,0,58
2024-04-01 22:20:00,14,16,12,6,15,0,0,63
2024-04-01 22:30:00,10,16,15,5,11,0,0,57
2024-04-01 22:40:00,3,15,8,10,12,0,0,48
2024-04-01 22:50:00,10,19,15,5,9,0,0,58
2024-04-01 23:00:00,14,11,15,3,5,0,0,48
2024-04-01 23:10:00,8,13,7,2,16,0,0,46
2024-04-01 23:20:00,7,17,15,5,7,0,0,51
2024-04-01 23:30:00,13,17,14,7,9,0,0,60
2024-04-01 23:40:00,12,11,8,4,9,0,0,44
2024-04-01 23:50:00,8,8,9,3,6,0,0,34
2024-04-02 00:00:00,10,13,6,5,7,0,0,41
2024-04-02 00:10:00,6,9,10,3,13,1,0,42
2024-04-02 00:20:00,15,8,5,3,5,0,0,36
2024-04-02 00:30:00,12,12,7,4,3,0,0,38
2024-04-02 00:40:00,3,6,7,2,3,0,0,21
2024-04-02 00:50:00,4,12,4,1,5,0,0,26
2024-04-02 01:00:00,3,9,7,1,6,0,0,26
2024-04-02 01:10:00,0,3,3,2,3,0,0,11
2024-04-02 01:20:00,0,8,3,1,4,1,0,17
2024-04-02 01:30:00,1,16,3,0,2,0,0,22
2024-04-02 01:40:00,6,8,2,4,4,0,0,24
2024-04-02 01:50:00,3,4,5,1,2,0,0,15
2024-04-02 02:00:00,5,2,1,0,2,0,0,10
2024-04-02 02:10:00,1,5,2,2,1,0,0,11
2024-04-02 02:20:00,2,5,1,0,2,0,0,10
2024-04-02 02:30:00,3,3,2,1,1,0,0,10
2024-04-02 02:40:00,2,2,3,1,2,0,0,10
2024-04-02 02:50:00,4,4,3,1,2,0,0,14
2024-04-02 03:00:00,4,2,1,0,3,0,0,10
2024-04-02 03:10:00,1,0,1,1,1,0,0,4
2024-04-02 03:20:00,3,8,3,1,1,0,0,16
2024-04-02 03:30:00,2,3,2,2,1,0,0,10
2024-04-02 03:40:00,8,4,5,3,4,0,0,24
2024-04-02 03:50:00,0,2,1,0,3,0,0,6
2024-04-02 04:00:00,1,3,1,2,3,0,0,10
2024-04-02 04:10:00,2,0,5,0,5,0,0,12
2024-04-02 04:20:00,0,6,3,0,2,0,0,11
2024-04-02 04:30:00,2,2,2,2,2,0,0,10
2024-04-02 04:40:00,2,1,4,0,8,1,0,16
2024-04-02 04:50:00,2,12,6,2,8,0,0,30
2024-04-02 05:00:00,4,8,9,0,6,0,0,27
2024-04-02 05:10:00,4,17,10,2,12,0,0,45
2024-04-02 05:20:00,7,10,9,1,16,0,0,43
2024-04-02 05:30:00,9,18,9,6,17,0,0,59
2024-04-02 05:40:00,12,15,9,7,24,0,0,67
2024-04-02 05:50:00,11,20,7,8,27,1,0,74
2024-04-02 06:00:00,17,22,18,10,38,0,0,105
2024-04-02 06:10:00,15,27,15,9,24,0,0,90
2024-04-02 06:20:00,17,23,19,6,35,0,0,100
2024-04-02 06:30:00,26,27,20,13,38,0,0,124
2024-04-02 06:40:00,16,24,17,16,47,0,0,120
2024-04-02 06:50:00,16,25,19,11,38,1,0,110
2024-04-02 07:00:00,19,40,16,9,38,1,0,123
2024-04-02 07:10:00,24,27,21,9,55,1,0,137
2024-04-02 07:20:00,17,38,21,14,56,0,0,146
2024-04-02 07:30:00,19,35,30,14,39,1,0,138
2024-04-02 07:40:00,23,29,24,24,42,0,0,142
2024-04-02 07:50:00,22,50,26,23,48,1,0,170
2024-04-02 08:00:00,18,32,31,18,40,0,0,139
2024-04-02 08:10:00,19,46,22,15,38,0,0,140
2024-04-02 08:20:00,23,31,23,18,29,1,0,125
2024-04-02 08:30:00,23,37,24,26,38,1,0,149
2024-04-02 08:40:00,24,34,29,19,50,0,0,156
2024-04-02 08:50:00,25,40,23,24,48,0,0,160
2024-04-02 09:00:00,21,35,26,25,30,0,0,137
2024-04-02 09:10:00,21,36,20,17,35,0,0,129
2024-04-02 09:20:00,18,38,26,16,32,1,0,131
2024-04-02 09:30:00,25,59,29,20,40,0,0,173
2024-04-02 09:40:00,25,52,26,11,34,0,0,148
2024-04-02 09:50:00,23,48,24,17,33,0,0,145
2024-04-02 10:00:00,21,47,22,18,35,0,0,143
2024-04-02 10:10:00,18,49,24,12,35,0,0,138
2024-04-02 10:20:00,22,33,28,20,30,0,0,133
2024-04-02 10:30:00,18,40,27,17,36,0,0,138
2024-04-02 10:40:00,26,36,30,18,42,0,0,152
2024-04-02 10:50:00,30,51,25,18,31,0,0,155
2024-04-02 11:00:00,17,41,33,19,29,1,0,140
2024-04-02 11:10:00,35,34,25,17,43,0,0,154
2024-04-02 11:20:00,19,44,29,10,29,0,0,131
2024-04-02 11:30:00,21,41,25,10,47,1,0,145
2024-04-02 11:40:00,28,42,30,24,27,0,0,151
2024-04-02 11:50:00,22,82,33,22,39,0,0,198
2024-04-02 12:00:00,25,35,26,16,35,1,0,138
2024-04-02 12:10:00,24,39,36,18,34,0,0,151
2024-04-02 12:20:00,23,40,26,17,39,1,0,146
2024-04-02 12:30:00,28,46,30,15,25,1,0,145
2024-04-02 12:40:00,21,60,27,16,48,2,0,174
2024-04-02 12:50:00,21,48,27,10,31,0,0,137
2024-04-02 13:00:00,11,41,24,16,34,1,0,127
2024-04-02 13:10:00,28,48,27,16,36,1,0,156
2024-04-02 13:20:00,23,66,19,12,31,1,0,152
2024-04-02 13:30:00,31,50,33,12,40,1,0,167
2024-04-02 13:40:00,25,39,39,15,27,0,0,145
2024-04-02 13:50:00,22,38,29,25,43,0,0,157
2024-04-02 14:00:00,27,59,27,19,34,1,0,167
2024-04-02 14:10:00,28,38,24,17,40,2,0,149
2024-04-02 14:20:00,32,49,31,16,41,0,0,169
2024-04-02 14:30:00,25,52,34,21,41,5,0,178
2024-04-02 14:40:00,43,53,33,22,50,0,0,201
2024-04-02 14:50:00,30,57,29,22,44,0,0,182
2024-04-02 15:00:00,23,66,28,13,39,1,0,170
2024-04-02 15:10:00,32,49,34,24,50,1,0,190
2024-04-02 15:20:00,28,61,33,21,31,3,0,177
2024-04-02 15:30:00,38,60,36,14,51,3,0,202
2024-04-02 15:40:00,29,63,29,14,38,2,0,175
2024-04-02 15:50:00,33,54,46,14,42,3,0,192
2024-04-02 16:00:00,31,64,33,22,43,2,0,195
2024-04-02 16:10:00,43,52,32,18,46,0,0,191
2024-04-02 16:20:00,36,45,38,32,32,0,0,183
2024-04-02 16:30:00,28,64,37,19,49,0,0,197
2024-04-02 16:40:00,29,66,28,22,57,3,0,205
2024-04-02 16:50:00,29,55,29,18,45,3,0,179
2024-04-02 17:00:00,46,73,27,27,53,2,0,228
2024-04-02 17:10:00,29,58,40,23,46,1,0,197
2024-04-02 17:20:00,31,49,31,22,55,3,0,191
2024-04-02 17:30:00,23,45,19,16,47,1,0,151
2024-04-02 17:40:00,36,67,20,18,35,2,0,178
2024-04-02 17:50:00,25,45,23,33,41,2,0,169
2024-04-02 18:00:00,18,58,29,26,39,1,0,171
2024-04-02 18:10:00,32,42,21,20,29,0,0,144
2024-04-02 18:20:00,31,40,23,14,33,2,0,143
2024-04-02 18:30:00,24,52,28,19,35,0,0,158
2024-04-02 18:40:00,20,40,27,16,27,1,0,131
2024-04-02 18:50:00,22,49,32,12,33,0,0,148
2024-04-02 19:00:00,16,34,33,16,21,0,0,120
2024-04-02 19:10:00,27,42,23,11,29,2,0,134
2024-04-02 19:20:00,25,47,25,13,30,0,0,140
2024-04-02 19:30:00,21,37,19,14,27,2,0,120
2024-04-02 19:40:00,17,33,26,18,27,0,0,121
2024-04-02 19:50:00,15,22,18,13,22,0,0,90
2024-04-02 20:00:00,17,30,26,12,23,0,0,108
2024-04-02 20:10:00,17,20,22,8,16,0,0,83
2024-04-02 20:20:00,14,25,18,5,18,0,0,80
2024-04-02 20:30:00,19,21,22,13,16,0,0,91
2024-04-02 20:40:00,14,26,14,9,18,1,0,82
2024-04-02 20:50:00,22,24,19,13,18,0,0,96
2024-04-02 21:00:00,14,28,18,9,14,0,0,83
2024-04-02 21:10:00,12,31,16,8,19,1,0,87
2024-04-02 21:20:00,18,17,29,8,21,1,0,94
2024-04-02 21:30:00,20,22,15,1,22,0,0,80
2024-04-02 21:40:00,14,24,16,5,16,0,0,75
2024-04-02 21:50:00,17,12,17,13,16,1,0,76
2024-04-02 22:00:00,14,22,8,10,12,0,0,66
2024-04-02 22:10:00,15,18,21,7,22,0,0,83
2024-04-02 22:20:00,19,18,15,6,13,0,0,71
2024-04-02 22:30:00,13,14,9,11,8,0,0,55
2024-04-02 22:40:00,17,17,17,7,8,0,0,66
2024-04-02 22:50:00,15,11,19,7,9,0,0,61
2024-04-02 23:00:00,20,25,15,7,10,2,0,79
2024-04-02 23:10:00,9,12,13,1,8,0,0,43
2024-04-02 23:20:00,4,6,16,4,7,0,0,37
2024-04-02 23:30:00,8,13,6,2,9,0,0,38
2024-04-02 23:40:00,6,4,13,3,2,0,0,28
2024-04-02 23:50:00,5,8,9,4,9,0,0,35
2024-04-03 00:00:00,10,8,8,3,9,0,0,38
2024-04-03 00:10:00,7,11,7,1,2,0,0,28
2024-04-03 00:20:00,3,10,5,1,4,0,0,23
2024-04-03 00:30:00,5,6,6,5,3,0,0,25
2024-04-03 00:40:00,5,17,7,2,7,0,0,38
2024-04-03 00:50:00,1,5,4,1,6,0,0,17
2024-04-03 01:00:00,0,4,5,2,7,0,0,18
2024-04-03 01:10:00,0,7,5,2,5,0,0,19
2024-04-03 01:20:00,4,6,4,0,5,0,0,19
2024-04-03 01:30:00,3,5,7,0,0,0,0,15
2024-04-03 01:40:00,2,1,1,2,2,0,0,8
2024-04-03 01:50:00,2,2,4,1,7,0,0,16
2024-04-03 02:00:00,3,9,5,2,2,0,0,21
2024-04-03 02:10:00,1,3,3,1,5,0,0,13
2024-04-03 02:20:00,3,3,2,2,6,0,0,16
2024-04-03 02:30:00,2,4,2,1,1,0,0,10
2024-04-03 02:40:00,2,5,1,0,5,0,0,13
2024-04-03 02:50:00,3,1,2,1,2,0,0,9
2024-04-03 03:00:00,3,1,0,0,5,0,0,9
2024-04-03 03:10:00,2,6,2,0,1,0,0,11
2024-04-03 03:20:00,4,3,3,2,3,0,0,15
2024-04-03 03:30:00,2,2,1,2,1,0,0,8
2024-04-03 03:40:00,2,3,2,0,0,0,0,7
2024-04-03 03:50:00,3,0,5,3,9,0,0,20
2024-04-03 04:00:00,1,4,1,1,3,0,0,10
2024-04-03 04:10:00,3,1,2,1,2,0,0,9
2024-04-03 04:20:00,4,3,4,0,1,0,0,12
2024-04-03 04:30:00,5,3,3,3,4,0,0,18
2024-04-03 04:40:00,5,5,4,0,3,0,0,17
2024-04-03 04:50:00,3,9,7,1,4,0,0,24
2024-04-03 05:00:00,7,10,12,2,11,0,0,42
2024-04-03 05:10:00,4,13,9,4,13,0,0,43
2024-04-03 05:20:00,9,11,10,0,15,0,0,45
2024-04-03 05:30:00,9,16,9,8,16,0,0,58
2024-04-03 05:40:00,10,18,13,7,24,0,0,72
2024-04-03 05:50:00,15,18,17,12,41,0,0,103
2024-04-03 06:00:00,14,17,12,8,24,0,0,75
2024-04-03 06:10:00,19,23,16,12,31,0,0,101
2024-04-03 06:20:00,18,19,12,15,46,1,0,111
2024-04-03 06:30:00,19,26,15,10,35,1,0,106
2024-04-03 06:40:00,18,26,20,16,45,0,0,125
2024-04-03 06:50:00,24,34,18,11,46,2,0,135
2024-04-03 07:00:00,19,31,19,13,41,0,0,123
2024-04-03 07:10:00,24,22,19,12,58,0,0,135
2024-04-03 07:20:00,25,47,23,26,45,1,0,167
2024-04-03 07:30:00,22,34,22,17,50,0,0,145
2024-04-03 07:40:00,15,46,27,19,44,1,0,152
2024-04-03 07:50:00,27,41,27,19,44,2,0,160
2024-04-03 08:00:00,17,43,22,21,45,0,0,148
2024-04-03 08:10:00,18,51,22,19,45,0,0,155
2024-04-03 08:20:00,17,42,23,18,34,0,0,134
2024-04-03 08:30:00,17,39,25,24,42,0,0,147
2024-04-03 08:40:00,27,44,25,27,53,0,0,176
2024-04-03 08:50:00,24,68,28,23,50,0,0,193
2024-04-03 09:00:00,22,39,28,13,41,0,0,143
2024-04-03 09:10:00,19,37,24,24,39,0,0,143
2024-04-03 09:20:00,23,42,22,18,32,0,0,137
2024-04-03 09:30:00,22,45,24,18,26,0,0,135
2024-04-03 09:40:00,24,36,23,14,36,1,0,134
2024-04-03 09:50:00,30,70,27,20,39,0,0,186
2024-04-03 10:00:00,17,29,138,16,40,0,0,240
2024-04-03 10:10:00,24,41,18,15,39,1,0,138
2024-04-03 10:20:00,20,59,23,19,41,0,0,162
2024-04-03 10:30:00,22,53,28,17,38,0,0,158
2024-04-03 10:40:00,23,39,27,15,44,0,0,148
2024-04-03 10:50:00,27,41,24,15,33,0,0,140
2024-04-03 11:00:00,21,37,26,12,64,0,0,160
2024-04-03 11:10:00,26,37,21,14,30,0,0,128
2024-04-03 11:20:00,21,48,25,17,40,1,0,152
2024-04-03 11:30:00,22,35,20,10,43,0,0,130
2024-04-03 11:40:00,26,40,28,15,34,1,0,144
2024-04-03 11:50:00,30,34,25,15,44,2,0,150
2024-04-03 12:00:00,33,51,26,13,37,1,0,161
2024-04-03 12:10:00,26,50,33,18,29,2,0,158
2024-04-03 12:20:00,24,33,31,11,42,1,0,142
2024-04-03 12:30:00,22,52,20,10,33,1,0,138
2024-04-03 12:40:00,30,31,24,12,45,0,0,142
2024-04-03 12:50:00,30,49,31,15,29,0,0,154
2024-04-03 13:00:00,21,29,29,17,31,0,0,127
2024-04-03 13:10:00,25,32,32,21,41,0,0,151
2024-04-03 13:20:00,24,42,37,19,39,1,0,162
2024-04-03 13:30:00,25,26,29,24,43,1,0,148
2024-04-03 13:40:00,40,52,37,11,34,0,0,174
2024-04-03 13:50:00,27,36,23,13,38,0,0,137
2024-04-03 14:00:00,23,33,25,20,40,1,0,142
2024-04-03 14:10:00,41,34,31,18,44,2,0,170
2024-04-03 14:20:00,34,40,26,26,40,2,0,168
2024-04-03 14:30:00,29,56,34,18,32,1,0,170
2024-04-03 14:40:00,28,41,24,17,35,0,0,145
2024-04-03 14:50:00,33,36,28,19,35,1,0,152
2024-04-03 15:00:00,25,40,40,10,35,0,0,150
2024-04-03 15:10:00,32,43,25,20,44,1,0,165
2024-04-03 15:20:00,25,35,24,16,33,2,0,135
2024-04-03 15:30:00,32,51,34,16,51,1,0,185
2024-04-03 15:40:00,35,58,31,22,33,2,0,181
2024-04-03 15:50:00,29,39,32,36,40,2,0,178
2024-04-03 16:00:00,23,60,32,13,27,2,0,157
2024-04-03 16:10:00,37,64,28,23,42,0,0,194
2024-04-03 16:20:00,27,44,33,16,55,5,0,180
2024-04-03 16:30:00,37,61,25,30,51,4,0,208
2024-04-03 16:40:00,31,42,36,26,52,1,0,188
2024-04-03 16:50:00,36,48,30,26,46,0,0,186
2024-04-03 17:00:00,24,53,34,21,46,2,0,180
2024-04-03 17:10:00,25,63,35,25,47,0,0,195
2024-04-03 17:20:00,30,55,21,36,65,1,0,208
2024-04-03 17:30:00,28,56,28,34,54,1,0,201
2024-04-03 17:40:00,26,49,25,17,45,0,0,162
2024-04-03 17:50:00,28,48,35,22,43,3,0,179
2024-04-03 18:00:00,17,50,32,27,52,0,0,178
2024-04-03 18:10:00,28,61,23,25,30,2,0,169
2024-04-03 18:20:00,30,42,25,20,39,1,0,157
2024-04-03 18:30:00,28,50,38,17,47,1,0,181
2024-04-03 18:40:00,23,39,19,18,32,0,0,131
2024-04-03 18:50:00,32,40,33,13,36,0,0,154
2024-04-03 19:00:00,26,39,24,12,24,0,0,125
2024-04-03 19:10:00,23,36,22,16,36,0,0,133
2024-04-03 19:20:00,28,19,28,18,30,1,0,124
2024-04-03 19:30:00,20,50,27,11,24,0,0,132
2024-04-03 19:40:00,24,34,20,13,28,0,0,119
2024-04-03 19:50:00,17,26,22,4,31,0,0,100
2024-04-03 20:00:00,19,32,26,14,21,3,0,115
2024-04-03 20:10:00,17,50,19,6,17,0,0,109
2024-04-03 20:20:00,15,19,22,11,16,2,0,85
2024-04-03 20:30:00,13,26,23,12,18,0,0,92
2024-04-03 20:40:00,13,28,17,8,20,1,0,87
2024-04-03 20:50:00,18,29,18,5,38,0,0,108
2024-04-03 21:00:00,16,24,22,4,16,0,0,82
2024-04-03 21:10:00,18,30,24,8,20,0,0,100
2024-04-03 21:20:00,15,34,21,7,25,0,0,102
2024-04-03 21:30:00,7,17,22,4,20,1,0,71
2024-04-03 21:40:00,13,26,11,4,22,0,0,76
2024-04-03 21:50:00,12,17,16,4,14,2,0,65
2024-04-03 22:00:00,17,26,13,10,20,0,0,86
2024-04-03 22:10:00,16,13,17,4,20,0,0,70
2024-04-03 22:20:00,7,17,17,4,13,0,0,58
2024-04-03 22:30:00,12,17,11,8,17,0,0,65
2024-04-03 22:40:00,17,19,15,3,13,0,0,67
2024-04-03 22:50:00,15,20,12,7,17,1,0,72
2024-04-03 23:00:00,20,15,16,7,10,1,0,69
2024-04-03 23:10:00,10,14,12,2,8,0,0,46
2024-04-03 23:20:00,5,13,9,6,9,4,0,46
2024-04-03 23:30:00,8,18,11,7,8,0,0,52
2024-04-03 23:40:00,9,16,14,3,3,0,0,45
2024-04-03 23:50:00,9,6,5,5,2,0,0,27
2024-04-04 00:00:00,7,11,10,4,6,0,0,38
2024-04-04 00:10:00,1,5,7,0,6,0,0,19
2024-04-04 00:20:00,5,12,5,1,7,0,0,30
2024-04-04 00:30:00,3,16,8,1,4,0,0,32
2024-04-04 00:40:00,5,8,6,3,6,0,0,28
2024-04-04 00:50:00,4,8,5,1,3,0,0,21
2024-04-04 01:00:00,2,7,9,2,4,0,0,24
2024-04-04 01:10:00,1,6,2,3,5,0,0,17
2024-04-04 01:20:00,4,3,1,0,3,0,0,11
2024-04-04 01:30:00,4,3,6,1,2,0,0,16
2024-04-04 01:40:00,6,8,2,0,5,0,0,21
2024-04-04 01:50:00,4,3,1,0,3,0,0,11
2024-04-04 02:00:00,3,9,5,3,4,0,0,24
2024-04-04 02:10:00,2,2,3,0,3,0,0,10
2024-04-04 02:20:00,0,4,2,2,4,0,0,12
2024-04-04 02:30:00,3,7,2,1,2,0,0,15
2024-04-04 02:40:00,1,4,2,2,3,0,0,12
2024-04-04 02:50:00,3,3,3,1,4,0,0,14
2024-04-04 03:00:00,1,3,0,1,2,0,0,7
2024-04-04 03:10:00,4,4,1,0,1,0,0,10
2024-04-04 03:20:00,2,2,1,0,2,0,0,7
2024-04-04 03:30:00,3,5,3,2,2,0,0,15
2024-04-04 03:40:00,3,2,5,1,3,0,0,14
2024-04-04 03:50:00,4,7,0,1,4,0,0,16
2024-04-04 04:00:00,2,3,3,2,5,0,0,15
2024-04-04 04:10:00,3,0,3,3,6,0,0,15
2024-04-04 04:20:00,4,7,3,0,2,0,0,16
2024-04-04 04:30:00,1,1,5,1,4,0,0,12
2024-04-04 04:40:00,6,5,5,1,3,0,0,20
2024-04-04 04:50:00,6,10,5,0,3,0,0,24
2024-04-04 05:00:00,6,6,9,1,15,0,0,37
2024-04-04 05:10:00,7,11,5,3,11,0,0,37
2024-04-04 05:20:00,8,16,6,4,12,1,0,47
2024-04-04 05:30:00,14,12,6,6,30,0,0,68
2024-04-04 05:40:00,16,17,15,6,24,0,0,78
2024-04-04 05:50:00,15,16,11,7,37,0,0,86
2024-04-04 06:00:00,12,15,14,7,38,1,0,87
2024-04-04 06:10:00,16,24,12,12,21,0,0,85
2024-04-04 06:20:00,18,25,24,5,29,0,0,101
2024-04-04 06:30:00,13,47,16,10,37,0,0,123
2024-04-04 06:40:00,13,29,15,15,52,0,0,124
2024-04-04 06:50:00,20,30,14,10,54,0,0,128
2024-04-04 07:00:00,22,29,17,8,33,0,0,109
2024-04-04 07:10:00,23,26,26,16,47,0,0,138
2024-04-04 07:20:00,29,36,19,12,52,2,0,150
2024-04-04 07:30:00,18,38,21,15,39,0,0,131
2024-04-04 07:40:00,22,38,28,19,40,4,0,151
2024-04-04 07:50:00,20,29,23,25,48,0,0,145
2024-04-04 08:00:00,20,39,22,15,38,0,0,134
2024-04-04 08:10:00,21,32,13,29,43,2,0,140
2024-04-04 08:20:00,25,29,27,20,39,3,0,143
2024-04-04 08:30:00,30,41,19,21,35,0,0,146
2024-04-04 08:40:00,33,29,22,20,49,1,0,154
2024-04-04 08:50:00,28,24,24,27,49,0,0,152
2024-04-04 09:00:00,19,33,29,20,46,1,0,148
2024-04-04 09:10:00,17,26,32,16,37,1,0,129
2024-04-04 09:20:00,22,23,20,12,37,0,0,114
2024-04-04 09:30:00,14,35,29,11,29,1,0,119
2024-04-04 09:40:00,23,24,17,15,39,2,0,120
2024-04-04 09:50:00,27,45,25,17,43,0,0,157
2024-04-04 10:00:00,23,47,24,21,45,0,0,160
2024-04-04 10:10:00,20,55,19,18,32,0,0,144
2024-04-04 10:20:00,27,24,16,14,43,0,0,124
2024-04-04 10:30:00,19,30,20,11,31,0,0,111
2024-04-04 10:40:00,24,33,26,16,40,0,0,139
2024-04-04 10:50:00,23,45,25,11,45,0,0,149
2024-04-04 11:00:00,20,36,27,19,32,1,0,135
2024-04-04 11:10:00,23,39,26,21,37,0,0,146
2024-04-04 11:20:00,36,51,21,18,50,0,0,176
2024-04-04 11:30:00,21,51,25,17,41,1,0,156
2024-04-04 11:40:00,27,37,31,13,38,0,0,146
2024-04-04 11:50:00,32,39,34,22,44,0,0,171
2024-04-04 12:00:00,28,43,19,16,67,1,0,174
2024-04-04 12:10:00,30,34,31,19,39,0,0,153
2024-04-04 12:20:00,32,37,27,24,39,0,0,159
2024-04-04 12:30:00,18,45,22,23,33,0,0,141
2024-04-04 12:40:00,26,42,38,10,51,0,0,167
2024-04-04 12:50:00,25,47,24,15,40,0,0,151
2024-04-04 13:00:00,18,39,24,16,39,0,0,136
2024-04-04 13:10:00,36,28,33,16,34,1,0,148
2024-04-04 13:20:00,27,38,28,18,40,2,0,153
2024-04-04 13:30:00,30,51,26,19,28,0,0,154
2024-04-04 13:40:00,29,59,21,17,33,1,0,160
2024-04-04 13:50:00,14,38,31,17,53,0,0,153
2024-04-04 14:00:00,27,53,27,8,27,1,0,143
2024-04-04 14:10:00,34,39,32,18,38,0,0,161
2024-04-04 14:20:00,33,35,24,20,47,3,0,162
2024-04-04 14:30:00,33,44,31,20,42,1,0,171
2024-04-04 14:40:00,29,46,27,12,47,1,0,162
2024-04-04 14:50:00,32,39,39,16,45,1,0,172
2024-04-04 15:00:00,29,55,29,22,45,0,0,180
2024-04-04 15:10:00,30,67,25,24,35,0,0,181
2024-04-04 15:20:00,23,56,35,19,50,1,0,184
2024-04-04 15:30:00,37,55,39,21,54,4,0,210
2024-04-04 15:40:00,31,51,28,20,46,4,0,180
2024-04-04 15:50:00,31,45,27,21,51,8,0,183
2024-04-04 16:00:00,25,55,22,33,41,2,0,178
2024-04-04 16:10:00,29,57,29,25,54,3,0,197
2024-04-04 16:20:00,32,52,26,26,56,2,0,194
2024-04-04 16:30:00,28,59,35,23,37,5,0,187
2024-04-04 16:40:00,40,41,43,24,38,0,0,186
2024-04-04 16:50:00,27,47,28,34,45,3,0,184
2024-04-04 17:00:00,37,58,26,19,45,2,0,187
2024-04-04 17:10:00,34,95,22,30,54,0,0,235
2024-04-04 17:20:00,26,49,21,12,34,1,0,143
2024-04-04 17:30:00,28,65,35,21,62,0,0,211
2024-04-04 17:40:00,31,54,26,30,36,0,0,177
2024-04-04 17:50:00,28,55,33,34,38,1,0,189
2024-04-04 18:00:00,23,46,24,33,41,0,0,167
2024-04-04 18:10:00,19,59,33,17,44,0,0,172
2024-04-04 18:20:00,18,46,23,17,50,0,0,154
2024-04-04 18:30:00,30,38,19,13,29,0,0,129
2024-04-04 18:40:00,27,106,17,16,48,0,0,214
2024-04-04 18:50:00,19,46,22,16,28,1,0,132
2024-04-04 19:00:00,24,38,31,15,18,0,0,126
2024-04-04 19:10:00,23,45,23,17,26,0,0,134
2024-04-04 19:20:00,18,35,22,17,38,0,0,130
2024-04-04 19:30:00,17,38,17,12,33,0,0,117
2024-04-04 19:40:00,20,43,20,14,25,0,0,122
2024-04-04 19:50:00,24,21,24,17,21,0,0,107
2024-04-04 20:00:00,13,16,11,12,18,3,0,73
2024-04-04 20:10:00,20,26,18,12,21,1,0,98
2024-04-04 20:20:00,16,21,22,7,25,1,0,92
2024-04-04 20:30:00,19,24,18,17,14,0,0,92
2024-04-04 20:40:00,20,36,15,9,23,0,0,103
2024-04-04 20:50:00,7,20,17,7,20,0,0,71
2024-04-04 21:00:00,11,25,16,14,11,0,0,77
2024-04-04 21:10:00,17,39,11,10,23,1,0,101
2024-04-04 21:20:00,21,37,19,10,23,1,0,111
2024-04-04 21:30:00,14,22,17,10,22,0,0,85
2024-04-04 21:40:00,19,31,9,13,26,0,0,98
2024-04-04 21:50:00,15,12,18,7,22,1,0,75
2024-04-04 22:00:00,11,25,21,4,13,0,0,74
2024-04-04 22:10:00,15,24,9,6,20,0,0,74
2024-04-04 22:20:00,7,15,10,7,13,0,0,52
2024-04-04 22:30:00,12,18,16,11,16,0,0,73
2024-04-04 22:40:00,14,14,12,12,12,0,0,64
2024-04-04 22:50:00,21,9,20,10,13,0,0,73
2024-04-04 23:00:00,9,22,12,6,17,0,0,66
2024-04-04 23:10:00,11,13,13,2,9,0,0,48
2024-04-04 23:20:00,10,10,8,2,8,0,0,38
2024-04-04 23:30:00,5,22,11,8,7,0,0,53
2024-04-04 23:40:00,8,18,4,7,8,2,0,47
2024-04-04 23:50:00,12,8,7,3,10,1,0,41
2024-04-05 00:00:00,7,6,12,4,6,0,0,35
2024-04-05 00:10:00,8,13,7,0,6,0,0,34
2024-04-05 00:20:00,6,8,6,2,2,0,0,24
2024-04-05 00:30:00,7,23,7,5,9,1,0,52
2024-04-05 00:40:00,7,4,4,4,3,0,0,22
2024-04-05 00:50:00,5,6,2,2,6,0,0,21
2024-04-05 01:00:00,1,4,1,0,3,0,0,9
2024-04-05 01:10:00,7,7,3,2,3,0,0,22
2024-04-05 01:20:00,2,4,4,1,6,0,0,17
2024-04-05 01:30:00,3,5,7,1,5,0,0,21
2024-04-05 01:40:00,1,12,4,1,2,0,0,20
2024-04-05 01:50:00,2,1,5,2,2,0,0,12
2024-04-05 02:00:00,0,0,1,0,2,0,0,3
